label,province,model,bodyType,month,isSpringFestival,sales12MonthAgo,sales11MonthAgo,sales10MonthAgo,sales9MonthAgo,sales8MonthAgo,sales7MonthAgo,sales6MonthAgo,sales5MonthAgo,sales4MonthAgo,sales3MonthAgo,sales2MonthAgo,sales1MonthAgo,averageSales2Month,averageSales3Month,firstOrderTrend1,firstOrderTrend2,secondOrderTrend
305,1,1,1,1,1,292,134,323,266,271,235,260,162,265,228,369,374,372.0,324.0,5,141,-136
434,2,1,1,1,1,466,227,260,216,308,279,419,246,217,310,402,456,429.0,389.0,54,92,-38
180,3,1,1,1,1,257,123,206,149,236,164,187,153,157,178,204,219,212.0,200.0,15,26,-11
468,4,1,1,1,1,408,160,362,404,445,351,322,244,337,371,460,563,512.0,465.0,103,89,14
500,5,1,1,1,1,610,311,358,373,360,329,335,345,623,350,453,570,512.0,458.0,117,103,14
198,6,1,1,1,1,206,125,152,155,154,138,108,127,159,136,179,226,202.0,180.0,47,43,4
468,7,1,1,1,1,503,254,418,482,482,353,339,259,422,394,483,601,542.0,493.0,118,89,29
248,8,1,1,1,1,236,126,197,211,250,166,178,189,194,233,215,260,238.0,236.0,45,-18,63
2692,9,1,1,1,1,3635,932,2407,2080,2897,2187,2183,1804,2265,2711,3532,3800,3666.0,3348.0,268,821,-553
425,10,1,1,1,1,450,224,347,259,363,291,276,249,267,349,472,505,488.0,442.0,33,123,-90
800,11,1,1,1,1,876,540,791,629,780,561,554,569,631,764,871,1010,940.0,882.0,139,107,32
236,12,1,1,1,1,253,86,138,143,167,149,136,95,156,166,204,262,233.0,211.0,58,38,20
260,13,1,1,1,1,306,138,237,254,280,252,227,235,225,228,291,305,298.0,275.0,14,63,-49
405,14,1,1,1,1,537,225,304,394,313,330,384,256,301,351,521,505,513.0,459.0,-16,170,-186
633,15,1,1,1,1,650,342,504,483,638,453,457,422,545,702,660,865,762.0,742.0,205,-42,247
497,16,1,1,1,1,635,275,418,368,357,440,329,325,381,447,480,474,477.0,467.0,-6,33,-39
347,17,1,1,1,1,525,157,288,266,308,275,250,286,299,327,364,474,419.0,388.0,110,37,73
292,18,1,1,1,1,462,150,315,287,307,223,276,226,258,368,331,404,368.0,368.0,73,-37,110
650,19,1,1,1,1,791,433,807,807,900,645,700,556,721,769,941,997,969.0,902.0,56,172,-116
115,20,1,1,1,1,195,141,127,106,114,181,131,111,101,120,155,199,177.0,158.0,44,35,9
305,21,1,1,1,1,298,116,246,259,414,206,262,204,187,324,393,440,416.0,386.0,47,69,-22
292,22,1,1,1,1,309,148,482,356,398,288,194,351,302,310,458,461,460.0,410.0,3,148,-145
268,1,2,2,1,1,389,262,484,342,349,376,356,410,417,271,639,518,578.0,476.0,-121,368,-489
292,2,2,2,1,1,306,222,275,246,290,259,337,266,368,334,609,519,564.0,487.0,-90,275,-365
175,3,2,2,1,1,260,125,189,191,270,175,231,216,208,216,370,337,354.0,308.0,-33,154,-187
368,4,2,2,1,1,449,209,527,412,406,405,459,464,449,231,675,811,743.0,572.0,136,444,-308
657,5,2,2,1,1,757,504,885,758,701,656,684,758,1227,469,1053,1125,1089.0,882.0,72,584,-512
301,6,2,2,1,1,275,169,202,232,224,252,293,358,325,253,574,507,540.0,445.0,-67,321,-388
775,7,2,2,1,1,890,445,807,1100,977,862,990,917,1222,876,1567,1574,1570.0,1339.0,7,691,-684
290,8,2,2,1,1,387,164,299,314,339,253,284,382,372,320,590,571,580.0,494.0,-19,270,-289
5136,9,2,2,1,1,8330,2585,8611,7234,9327,8266,8709,10596,10140,6925,13598,11515,12556.0,10679.0,-2083,6673,-8756
750,10,2,2,1,1,801,411,855,658,835,723,792,866,969,642,1386,1258,1322.0,1095.0,-128,744,-872
1445,11,2,2,1,1,1685,1328,2057,1655,2026,1678,1827,2216,2075,1763,3112,2877,2994.0,2584.0,-235,1349,-1584
435,12,2,2,1,1,393,167,359,359,396,344,400,420,535,356,595,741,668.0,564.0,146,239,-93
498,13,2,2,1,1,788,354,516,591,633,520,604,569,722,520,1137,974,1056.0,877.0,-163,617,-780
645,14,2,2,1,1,850,396,544,698,673,695,718,785,808,565,1273,1234,1254.0,1024.0,-39,708,-747
1135,15,2,2,1,1,1438,1026,1659,1539,1625,1420,1737,1785,1658,1293,2709,2467,2588.0,2156.0,-242,1416,-1658
703,16,2,2,1,1,762,375,804,713,668,835,675,883,908,742,1001,1050,1026.0,931.0,49,259,-210
689,17,2,2,1,1,678,402,678,683,657,625,567,721,958,582,1112,1192,1152.0,962.0,80,530,-450
856,18,2,2,1,1,1115,577,1254,1127,1467,1202,1533,1388,1310,817,2205,1578,1892.0,1533.0,-627,1388,-2015
1110,19,2,2,1,1,1304,783,1838,1870,2279,1544,2253,2301,1915,1064,2892,2161,2526.0,2039.0,-731,1828,-2559
244,20,2,2,1,1,188,130,218,213,199,327,300,319,331,173,470,398,434.0,347.0,-72,297,-369
340,21,2,2,1,1,240,138,255,320,486,412,553,492,462,375,582,607,594.0,521.0,25,207,-182
447,22,2,2,1,1,467,291,946,626,765,687,670,1107,843,480,1076,1018,1047.0,858.0,-58,596,-654
157,1,3,1,1,1,232,77,213,184,219,211,160,159,169,112,163,167,165.0,147.0,4,51,-47
290,2,3,1,1,1,297,206,253,260,265,254,351,309,270,218,354,350,352.0,307.0,-4,136,-140
279,3,3,1,1,1,259,91,210,228,261,237,261,246,234,155,184,233,208.0,191.0,49,29,20
549,4,3,1,1,1,805,257,551,670,627,552,633,554,583,457,611,677,644.0,582.0,66,154,-88
516,5,3,1,1,1,423,187,348,327,372,413,373,319,387,300,411,434,422.0,382.0,23,111,-88
176,6,3,1,1,1,138,64,119,116,119,126,118,108,157,129,128,138,133.0,132.0,10,-1,11
420,7,3,1,1,1,337,152,316,317,345,393,358,328,376,327,415,400,408.0,381.0,-15,88,-103
179,8,3,1,1,1,166,63,160,161,165,161,170,152,135,111,141,197,169.0,150.0,56,30,26
1713,9,3,1,1,1,1775,549,1579,1472,1652,1649,1691,1490,1683,1421,1989,1829,1909.0,1746.0,-160,568,-728
211,10,3,1,1,1,207,109,184,157,187,179,178,141,192,165,181,173,177.0,173.0,-8,16,-24
470,11,3,1,1,1,463,218,361,393,413,417,373,340,401,333,437,427,432.0,399.0,-10,104,-114
126,12,3,1,1,1,97,40,75,95,119,89,94,84,108,90,107,109,108.0,102.0,2,17,-15
389,13,3,1,1,1,326,139,233,302,305,302,324,321,309,274,302,328,315.0,301.0,26,28,-2
377,14,3,1,1,1,271,172,259,323,298,340,309,300,327,262,352,337,344.0,317.0,-15,90,-105
401,15,3,1,1,1,381,174,327,357,357,351,316,352,336,342,428,424,426.0,398.0,-4,86,-90
321,16,3,1,1,1,226,130,210,242,242,268,203,201,303,211,267,280,274.0,253.0,13,56,-43
284,17,3,1,1,1,259,118,212,237,248,277,255,193,250,211,244,275,260.0,243.0,31,33,-2
167,18,3,1,1,1,137,66,105,124,113,128,123,95,124,106,151,157,154.0,138.0,6,45,-39
506,19,3,1,1,1,543,246,417,495,542,501,506,466,488,346,464,567,516.0,459.0,103,118,-15
213,20,3,1,1,1,172,105,176,130,156,186,166,134,169,138,184,155,170.0,159.0,-29,46,-75
297,21,3,1,1,1,248,114,253,239,271,255,273,253,271,195,252,267,260.0,238.0,15,57,-42
315,22,3,1,1,1,362,187,216,276,357,324,293,304,239,208,258,336,297.0,267.0,78,50,28
117,1,4,2,1,1,243,118,232,238,251,282,229,249,216,166,212,210,211.0,196.0,-2,46,-48
173,2,4,2,1,1,238,105,163,123,154,116,231,232,256,209,270,308,289.0,262.0,38,61,-23
89,3,4,2,1,1,190,69,114,106,123,97,118,134,193,128,165,176,170.0,156.0,11,37,-26
136,4,4,2,1,1,335,190,324,305,237,267,308,309,286,179,246,342,294.0,256.0,96,67,29
351,5,4,2,1,1,528,292,452,413,430,414,426,492,712,401,438,436,437.0,425.0,-2,37,-39
264,6,4,2,1,1,308,191,244,230,261,218,300,368,358,250,325,348,336.0,308.0,23,75,-52
225,7,4,2,1,1,424,173,389,484,405,407,399,489,606,454,468,556,512.0,493.0,88,14,74
92,8,4,2,1,1,182,74,128,130,124,127,123,233,187,181,144,181,162.0,169.0,37,-37,74
2391,9,4,2,1,1,4260,1368,3766,3317,3840,3624,4020,4618,5211,4012,4216,4195,4206.0,4141.0,-21,204,-225
248,10,4,2,1,1,414,192,344,277,350,329,360,409,444,331,432,386,409.0,383.0,-46,101,-147
680,11,4,2,1,1,902,507,940,829,888,876,892,1148,1130,943,1033,1154,1094.0,1043.0,121,90,31
208,12,4,2,1,1,248,140,184,170,221,210,194,288,380,260,302,351,326.0,304.0,49,42,7
248,13,4,2,1,1,409,191,358,362,423,480,475,550,584,385,397,419,408.0,400.0,22,12,10
338,14,4,2,1,1,455,244,376,449,371,468,562,658,673,556,567,651,609.0,591.0,84,11,73
747,15,4,2,1,1,1040,511,990,1039,1012,1006,1138,1244,1296,1228,1343,1310,1326.0,1294.0,-33,115,-148
450,16,4,2,1,1,675,282,547,533,457,595,544,655,744,726,677,787,732.0,730.0,110,-49,159
394,17,4,2,1,1,547,238,482,529,476,494,503,610,619,436,474,674,574.0,528.0,200,38,162
231,18,4,2,1,1,464,152,423,426,506,417,546,535,615,563,615,519,567.0,566.0,-96,52,-148
213,19,4,2,1,1,649,305,554,649,665,803,867,1031,840,522,652,848,750.0,674.0,196,130,66
123,20,4,2,1,1,187,100,193,183,200,348,324,316,208,150,157,208,182.0,172.0,51,7,44
148,21,4,2,1,1,259,112,192,194,239,237,272,274,262,219,225,317,271.0,254.0,92,6,86
90,22,4,2,1,1,291,125,253,261,255,248,232,335,334,222,288,303,296.0,271.0,15,66,-51
199,1,5,3,1,1,365,138,302,182,202,234,212,256,234,168,249,477,363.0,298.0,228,81,147
4785,2,5,3,1,1,4147,2559,2705,2130,2397,2353,2868,2565,3307,3096,3216,4503,3860.0,3605.0,1287,120,1167
504,3,5,3,1,1,567,257,434,313,361,329,346,368,502,360,520,675,598.0,518.0,155,160,-5
151,4,5,3,1,1,456,125,304,246,278,163,179,202,242,199,305,514,410.0,339.0,209,106,103
1724,5,5,3,1,1,1772,1289,1498,1056,1064,1118,1183,1230,1449,1007,1411,1954,1682.0,1457.0,543,404,139
2152,6,5,3,1,1,2289,1946,1532,1224,1396,1210,1260,1418,1458,1238,1535,2328,1932.0,1700.0,793,297,496
4483,7,5,3,1,1,5481,3478,2813,2653,3587,2963,3398,3600,3519,3268,3907,6576,5242.0,4584.0,2669,639,2030
2093,8,5,3,1,1,2166,1096,1300,1076,1493,1193,1334,1452,1749,1354,1585,2844,2214.0,1928.0,1259,231,1028
1611,9,5,3,1,1,2118,794,1712,1309,1820,1577,1457,1550,1999,1555,2007,3029,2518.0,2197.0,1022,452,570
3084,10,5,3,1,1,4779,2843,2715,1831,2371,1991,2051,2291,2515,2293,2687,4443,3565.0,3141.0,1756,394,1362
2165,11,5,3,1,1,2358,1736,2075,1392,1679,1539,1776,1799,1764,1493,1942,3067,2504.0,2167.0,1125,449,676
1290,12,5,3,1,1,1882,1085,1047,877,1066,892,885,890,1111,824,980,1510,1245.0,1105.0,530,156,374
3870,13,5,3,1,1,4112,2579,2548,2351,2960,2437,2748,3368,3303,2808,3641,6231,4936.0,4227.0,2590,833,1757
5825,14,5,3,1,1,7051,4158,3545,2891,3967,3302,3413,3591,3584,3821,4668,7650,6159.0,5380.0,2982,847,2135
1260,15,5,3,1,1,1411,1111,1340,943,1216,1213,1206,1016,1295,1112,1294,2062,1678.0,1489.0,768,182,586
1919,16,5,3,1,1,1923,1058,1238,1013,1221,954,900,992,1202,958,1353,2198,1776.0,1503.0,845,395,450
2364,17,5,3,1,1,2637,1476,1924,1609,1715,1491,1500,1678,1773,1354,1770,2693,2232.0,1939.0,923,416,507
592,18,5,3,1,1,670,399,702,458,576,545,512,565,573,523,688,892,790.0,701.0,204,165,39
924,19,5,3,1,1,1203,557,1124,894,1170,1034,1023,1010,1135,824,1154,1710,1432.0,1229.0,556,330,226
250,20,5,3,1,1,370,194,204,191,258,225,203,204,284,201,250,357,304.0,269.0,107,49,58
2072,21,5,3,1,1,2683,1145,1221,1008,1213,1083,1173,1245,1658,1590,1877,3217,2547.0,2228.0,1340,287,1053
506,22,5,3,1,1,721,458,819,646,736,776,785,835,795,518,816,982,899.0,772.0,166,298,-132
382,1,6,1,1,1,431,80,202,198,232,330,331,445,555,272,582,623,602.0,492.0,41,310,-269
484,2,6,1,1,1,248,178,199,246,327,333,428,409,543,553,546,680,613.0,593.0,134,-7,141
551,3,6,1,1,1,939,321,444,472,638,517,552,645,831,715,836,832,834.0,794.0,-4,121,-125
212,4,6,1,1,1,458,72,162,260,324,331,345,369,502,362,440,598,519.0,467.0,158,78,80
1223,5,6,1,1,1,1221,607,864,847,961,1004,1032,1165,1460,1050,1385,1850,1618.0,1428.0,465,335,130
1515,6,6,1,1,1,1440,758,744,849,934,1047,1058,1409,1565,1256,1491,1666,1578.0,1471.0,175,235,-60
1706,7,6,1,1,1,1657,614,897,1413,1635,1575,1773,2139,2580,2061,2146,2737,2442.0,2315.0,591,85,506
533,8,6,1,1,1,639,250,365,433,477,430,532,655,690,724,762,993,878.0,826.0,231,38,193
5607,9,6,1,1,1,6442,1441,3854,3887,5187,5010,5237,6544,8215,6582,6734,6492,6613.0,6603.0,-242,152,-394
799,10,6,1,1,1,719,385,570,472,589,632,639,680,913,743,853,894,874.0,830.0,41,110,-69
1728,11,6,1,1,1,2063,799,1459,1467,1717,1679,1859,2252,2410,2283,2584,2672,2628.0,2513.0,88,301,-213
1027,12,6,1,1,1,1070,496,549,619,761,704,848,964,1340,1065,1086,1291,1188.0,1147.0,205,21,184
2119,13,6,1,1,1,1775,770,1146,1445,1808,1966,2293,2864,3253,2277,2327,2703,2515.0,2436.0,376,50,326
2952,14,6,1,1,1,2481,1247,1386,1910,2169,2264,2690,3318,3446,2827,2797,3447,3122.0,3024.0,650,-30,680
795,15,6,1,1,1,1156,264,593,721,949,928,974,1151,1369,1262,1632,1972,1802.0,1622.0,340,370,-30
1566,16,6,1,1,1,1769,799,1011,1012,1027,1207,1181,1412,1938,1686,1663,2151,1907.0,1833.0,488,-23,511
1651,17,6,1,1,1,1843,832,1249,1396,1570,1605,1889,1918,2573,2247,1966,2770,2368.0,2328.0,804,-281,1085
264,18,6,1,1,1,356,83,172,208,292,259,301,348,390,371,447,476,462.0,431.0,29,76,-47
241,19,6,1,1,1,299,109,187,283,311,261,323,369,397,317,403,513,458.0,411.0,110,86,24
803,20,6,1,1,1,771,312,479,530,585,806,750,810,888,646,803,1149,976.0,866.0,346,157,189
620,21,6,1,1,1,524,176,306,358,387,403,502,566,687,665,655,845,750.0,722.0,190,-10,200
399,22,6,1,1,1,605,218,468,492,550,570,602,652,669,544,740,1032,886.0,772.0,292,196,96
1265,1,7,3,1,1,1178,527,1063,994,1124,945,1154,1068,958,710,977,1212,1094.0,966.0,235,267,-32
104,2,7,3,1,1,77,43,70,57,124,99,83,62,79,45,66,119,92.0,77.0,53,21,32
86,3,7,3,1,1,67,19,65,50,51,85,56,51,54,43,56,75,66.0,58.0,19,13,6
1352,4,7,3,1,1,1071,361,867,872,926,824,1014,976,1027,677,793,1627,1210.0,1032.0,834,116,718
208,5,7,3,1,1,156,82,223,166,175,144,210,234,199,102,145,321,233.0,189.0,176,43,133
253,6,7,3,1,1,149,96,149,190,155,149,157,167,182,145,176,251,214.0,191.0,75,31,44
878,7,7,3,1,1,635,335,562,729,614,644,701,698,710,494,739,1047,893.0,760.0,308,245,63
165,8,7,3,1,1,133,53,106,96,90,115,93,101,121,83,105,184,144.0,124.0,79,22,57
762,9,7,3,1,1,585,183,472,491,557,511,479,453,514,463,571,819,695.0,618.0,248,108,140
92,10,7,3,1,1,58,32,56,38,32,27,46,65,36,87,45,96,70.0,76.0,51,-42,93
974,11,7,3,1,1,739,394,680,808,786,664,704,653,923,563,731,1002,866.0,765.0,271,168,103
118,12,7,3,1,1,91,42,55,107,79,54,83,56,89,43,74,97,86.0,71.0,23,31,-8
470,13,7,3,1,1,250,130,229,240,232,241,288,302,284,232,288,493,390.0,338.0,205,56,149
517,14,7,3,1,1,383,182,314,390,376,374,353,356,387,282,366,596,481.0,415.0,230,84,146
534,15,7,3,1,1,395,262,365,466,382,390,895,578,350,278,533,736,634.0,516.0,203,255,-52
151,16,7,3,1,1,109,47,93,139,123,130,108,119,115,66,94,173,134.0,111.0,79,28,51
101,17,7,3,1,1,80,46,72,140,72,59,68,91,68,60,83,119,101.0,87.0,36,23,13
123,18,7,3,1,1,77,35,128,219,92,103,107,123,99,106,97,170,134.0,124.0,73,-9,82
181,19,7,3,1,1,160,72,139,266,153,169,211,178,184,111,151,300,226.0,187.0,149,40,109
60,20,7,3,1,1,81,39,102,106,65,63,75,66,120,43,58,100,79.0,67.0,42,15,27
234,21,7,3,1,1,175,81,169,185,153,156,195,228,164,136,164,313,238.0,204.0,149,28,121
129,22,7,3,1,1,108,54,90,127,69,65,102,113,130,76,95,177,136.0,116.0,82,19,63
325,1,8,2,1,1,992,253,606,561,484,494,547,504,605,431,543,697,620.0,557.0,154,112,42
40,2,8,2,1,1,191,100,83,82,70,56,86,60,80,64,106,112,109.0,94.0,6,42,-36
31,3,8,2,1,1,102,48,55,66,70,55,54,65,50,48,60,75,68.0,61.0,15,12,3
40,4,8,2,1,1,210,76,141,177,131,96,96,105,107,59,86,132,109.0,92.0,46,27,19
216,5,8,2,1,1,429,195,188,226,211,185,192,194,379,187,278,408,343.0,291.0,130,91,39
357,6,8,2,1,1,762,275,330,375,352,304,284,383,452,363,447,587,517.0,466.0,140,84,56
320,7,8,2,1,1,898,281,405,655,512,403,384,434,524,437,477,555,516.0,490.0,78,40,38
30,8,8,2,1,1,114,28,50,77,84,53,53,40,61,59,55,64,60.0,59.0,9,-4,13
121,9,8,2,1,1,609,57,219,282,274,225,205,191,284,225,342,408,375.0,325.0,66,117,-51
68,10,8,2,1,1,170,66,75,77,81,56,48,72,86,66,86,129,108.0,94.0,43,20,23
893,11,8,2,1,1,1906,974,1119,1203,1261,881,934,1240,1311,1156,1271,1767,1519.0,1398.0,496,115,381
169,12,8,2,1,1,344,118,149,241,252,167,187,201,205,175,224,302,263.0,234.0,78,49,29
80,13,8,2,1,1,279,88,169,204,145,156,130,129,149,129,127,215,171.0,157.0,88,-2,90
183,14,8,2,1,1,558,189,277,347,264,222,222,264,300,257,320,368,344.0,315.0,48,63,-15
445,15,8,2,1,1,1566,633,762,810,793,638,611,791,867,742,941,1163,1052.0,949.0,222,199,23
211,16,8,2,1,1,453,152,191,266,209,221,204,189,253,233,287,401,344.0,307.0,114,54,60
201,17,8,2,1,1,459,160,191,256,228,177,169,202,213,182,259,315,287.0,252.0,56,77,-21
54,18,8,2,1,1,237,56,96,99,97,66,59,77,86,70,117,145,131.0,111.0,28,47,-19
28,19,8,2,1,1,158,40,89,169,79,56,94,56,78,81,68,104,86.0,84.0,36,-13,49
28,20,8,2,1,1,81,39,57,50,37,61,45,63,77,40,57,62,60.0,53.0,5,17,-12
107,21,8,2,1,1,275,100,108,169,156,96,102,126,137,141,113,177,145.0,144.0,64,-28,92
11,22,8,2,1,1,38,20,36,50,45,25,30,29,39,29,28,30,29.0,29.0,2,-1,3
940,1,9,1,1,1,1572,511,1006,969,925,835,829,878,839,851,1537,1734,1636.0,1374.0,197,686,-489
400,2,9,1,1,1,612,360,410,333,370,297,444,406,375,464,639,732,686.0,612.0,93,175,-82
322,3,9,1,1,1,463,213,302,350,427,288,345,346,426,433,493,573,533.0,500.0,80,60,20
659,4,9,1,1,1,895,307,553,585,621,593,551,572,648,532,915,1057,986.0,835.0,142,383,-241
1072,5,9,1,1,1,1417,680,747,869,835,754,816,821,1394,1020,1293,1876,1584.0,1396.0,583,273,310
1015,6,9,1,1,1,1219,528,678,800,749,648,689,782,938,1018,1287,1597,1442.0,1301.0,310,269,41
1077,7,9,1,1,1,2241,744,1062,1662,1314,1119,1240,1232,1497,1547,1722,2394,2058.0,1888.0,672,175,497
375,8,9,1,1,1,677,222,358,423,462,359,317,365,407,489,581,742,662.0,604.0,161,92,69
949,9,9,1,1,1,2250,484,919,955,1092,904,1023,986,1197,1508,2163,2594,2378.0,2088.0,431,655,-224
341,10,9,1,1,1,594,202,368,262,320,307,308,261,338,373,502,713,608.0,529.0,211,129,82
1466,11,9,1,1,1,2192,1018,1351,1369,1459,1195,1141,1497,1413,1635,2059,2647,2353.0,2114.0,588,424,164
753,12,9,1,1,1,1062,383,549,710,757,635,717,687,798,900,1083,1527,1305.0,1170.0,444,183,261
691,13,9,1,1,1,1028,449,745,695,817,660,609,745,771,828,1012,1235,1124.0,1025.0,223,184,39
1000,14,9,1,1,1,1627,672,938,1124,951,899,929,998,1228,1191,1470,2122,1796.0,1594.0,652,279,373
1003,15,9,1,1,1,1657,604,799,913,926,862,813,942,1042,1090,1626,2068,1847.0,1595.0,442,536,-94
1025,16,9,1,1,1,1510,552,799,894,947,966,785,977,1135,1284,1519,1632,1576.0,1478.0,113,235,-122
1217,17,9,1,1,1,1650,634,928,1065,1061,902,924,1034,1175,1168,1619,2178,1898.0,1655.0,559,451,108
522,18,9,1,1,1,850,264,347,323,473,273,417,426,426,568,767,913,840.0,749.0,146,199,-53
254,19,9,1,1,1,446,195,288,386,363,316,315,365,365,407,443,594,518.0,481.0,151,36,115
420,20,9,1,1,1,540,203,303,331,291,407,357,329,386,354,500,762,631.0,539.0,262,146,116
365,21,9,1,1,1,746,267,401,396,383,263,316,283,360,444,478,651,564.0,524.0,173,34,139
142,22,9,1,1,1,266,123,274,347,288,202,213,233,201,203,289,372,330.0,288.0,83,86,-3
635,1,10,2,1,1,1709,545,1276,1391,1398,1353,1616,1715,1560,1261,1546,1428,1487.0,1412.0,-118,285,-403
249,2,10,2,1,1,390,240,300,304,335,298,451,462,412,350,412,626,519.0,463.0,214,62,152
285,3,10,2,1,1,558,212,323,304,432,328,313,335,434,451,516,701,608.0,556.0,185,65,120
106,4,10,2,1,1,334,101,202,284,280,232,247,248,278,174,264,913,588.0,450.0,649,90,559
1134,5,10,2,1,1,1710,1083,1323,1763,1713,1549,1800,1833,2351,1555,1783,2691,2237.0,2010.0,908,228,680
1607,6,10,2,1,1,2375,1182,1314,1838,2005,1957,2071,2572,2578,2110,2138,2356,2247.0,2201.0,218,28,190
2048,7,10,2,1,1,3723,1428,1837,3584,3723,2665,3185,3623,4079,3911,3787,4830,4308.0,4176.0,1043,-124,1167
317,8,10,2,1,1,646,264,390,562,695,612,635,770,774,678,852,1073,962.0,868.0,221,174,47
695,9,10,2,1,1,1777,393,1288,1748,2151,1841,2105,2230,2219,1912,2435,2500,2468.0,2282.0,65,523,-458
475,10,10,2,1,1,677,309,481,401,605,509,467,597,723,646,783,869,826.0,766.0,86,137,-51
2657,11,10,2,1,1,4998,2924,3351,4265,5237,4119,4343,5439,5089,5170,5016,5865,5440.0,5350.0,849,-154,1003
923,12,10,2,1,1,1261,548,685,1136,1339,997,1282,1228,1446,1175,1376,1737,1556.0,1429.0,361,201,160
900,13,10,2,1,1,1931,954,1178,1462,1915,1717,1730,2030,2166,1672,1926,2621,2274.0,2073.0,695,254,441
1683,14,10,2,1,1,2603,1210,1347,2464,2148,2124,2569,3033,2794,2644,2874,3243,3058.0,2920.0,369,230,139
1289,15,10,2,1,1,3101,1398,2016,2464,3027,2635,2644,3079,3258,3003,3295,3490,3392.0,3263.0,195,292,-97
929,16,10,2,1,1,1782,664,796,1212,1354,1346,1388,1694,1779,1500,1547,1624,1586.0,1557.0,77,47,30
989,17,10,2,1,1,1687,733,970,1484,1556,1388,1464,1556,1793,1457,1585,1952,1768.0,1665.0,367,128,239
546,18,10,2,1,1,893,228,546,695,1147,600,1040,913,859,836,1130,958,1044.0,975.0,-172,294,-466
205,19,10,2,1,1,589,209,435,639,553,466,570,710,667,540,619,821,720.0,660.0,202,79,123
296,20,10,2,1,1,370,225,233,248,344,487,446,463,501,422,419,597,508.0,479.0,178,-3,181
413,21,10,2,1,1,741,258,403,620,717,590,762,830,880,891,912,1151,1032.0,985.0,239,21,218
118,22,10,2,1,1,299,175,240,355,391,233,247,332,298,250,347,415,381.0,337.0,68,97,-29
79,1,11,2,1,1,204,38,145,116,132,121,130,170,225,144,225,270,248.0,213.0,45,81,-36
296,2,11,2,1,1,184,103,104,130,150,124,141,193,215,192,267,384,326.0,281.0,117,75,42
248,3,11,2,1,1,389,174,191,134,180,155,165,211,257,237,359,450,404.0,349.0,91,122,-31
118,4,11,2,1,1,207,72,213,666,671,764,635,596,755,684,938,1287,1112.0,970.0,349,254,95
1326,5,11,2,1,1,955,807,671,665,754,743,840,1135,1134,707,1002,2805,1904.0,1505.0,1803,295,1508
903,6,11,2,1,1,792,626,432,458,431,427,626,807,752,716,977,1443,1210.0,1045.0,466,261,205
1878,7,11,2,1,1,1924,1342,1025,1289,1432,1325,1510,2013,2253,1752,2198,3785,2992.0,2578.0,1587,446,1141
603,8,11,2,1,1,452,270,276,293,383,273,396,591,635,370,1993,2925,2459.0,1763.0,932,1623,-691
914,9,11,2,1,1,1224,289,994,1031,1203,1183,1216,1851,1526,1065,2044,2419,2232.0,1843.0,375,979,-604
666,10,11,2,1,1,498,276,260,250,385,389,373,565,452,368,493,935,714.0,599.0,442,125,317
910,11,11,2,1,1,1062,779,828,897,1057,971,1038,1263,1231,1184,1531,2308,1920.0,1674.0,777,347,430
999,12,11,2,1,1,1049,652,459,469,546,479,591,657,831,701,917,1377,1147.0,998.0,460,216,244
1110,13,11,2,1,1,919,741,471,479,696,616,754,991,941,754,1144,2067,1606.0,1322.0,923,390,533
2272,14,11,2,1,1,2130,1382,887,1161,1258,1321,1528,1922,1491,1090,1965,3560,2762.0,2205.0,1595,875,720
1028,15,11,2,1,1,1779,823,1584,1570,1718,1900,1877,2534,1978,2287,3147,4324,3736.0,3253.0,1177,860,317
1004,16,11,2,1,1,890,443,424,420,420,475,487,636,528,521,941,1534,1238.0,999.0,593,420,173
1133,17,11,2,1,1,1524,937,896,945,1034,885,1014,1148,1102,762,1142,1719,1430.0,1208.0,577,380,197
434,18,11,2,1,1,671,190,590,596,665,596,710,861,605,468,762,1967,1364.0,1066.0,1205,294,911
199,19,11,2,1,1,214,132,202,209,189,242,328,373,319,239,291,520,406.0,350.0,229,52,177
432,20,11,2,1,1,378,271,206,305,265,352,383,500,317,253,326,532,429.0,370.0,206,73,133
919,21,11,2,1,1,927,421,382,511,669,670,984,1191,1013,830,1010,1651,1330.0,1164.0,641,180,461
135,22,11,2,1,1,193,79,88,79,102,96,114,179,154,114,204,257,230.0,192.0,53,90,-37
63,1,12,2,1,1,78,23,47,54,61,91,84,82,78,75,125,158,142.0,119.0,33,50,-17
421,2,12,2,1,1,341,217,206,208,229,212,242,297,409,425,375,535,455.0,445.0,160,-50,210
363,3,12,2,1,1,352,150,198,157,157,141,155,186,321,287,448,676,562.0,470.0,228,161,67
86,4,12,2,1,1,235,72,142,158,142,166,192,229,328,289,360,496,428.0,382.0,136,71,65
724,5,12,2,1,1,756,453,466,458,502,542,612,740,894,870,831,1260,1046.0,987.0,429,-39,468
576,6,12,2,1,1,363,266,304,266,327,272,360,423,570,478,510,806,658.0,598.0,296,32,264
1529,7,12,2,1,1,1789,1114,946,977,950,814,1067,1385,1544,1660,1778,2915,2346.0,2118.0,1137,118,1019
615,8,12,2,1,1,429,225,305,328,438,304,387,526,657,689,668,1092,880.0,816.0,424,-21,445
718,9,12,2,1,1,641,221,467,644,800,706,726,1003,987,1170,1384,1437,1410.0,1330.0,53,214,-161
452,10,12,2,1,1,285,206,238,200,244,215,205,275,336,321,463,659,561.0,481.0,196,142,54
543,11,12,2,1,1,444,284,374,406,417,417,424,503,619,691,743,1008,876.0,814.0,265,52,213
634,12,12,2,1,1,527,325,271,316,324,321,323,384,576,518,577,816,696.0,637.0,239,59,180
1304,13,12,2,1,1,1277,883,734,754,897,796,976,1190,1442,1308,1432,2365,1898.0,1702.0,933,124,809
1526,14,12,2,1,1,1463,751,731,764,796,796,921,1180,1362,1148,1406,2228,1817.0,1594.0,822,258,564
438,15,12,2,1,1,450,256,491,555,599,497,546,656,656,660,874,1121,998.0,885.0,247,214,33
635,16,12,2,1,1,427,284,280,340,316,308,353,445,594,534,655,903,779.0,697.0,248,121,127
773,17,12,2,1,1,899,477,571,590,590,570,561,665,852,609,763,1216,990.0,863.0,453,154,299
249,18,12,2,1,1,201,95,214,227,185,203,218,279,280,218,239,420,330.0,292.0,181,21,160
287,19,12,2,1,1,295,149,240,267,276,253,308,361,450,328,514,641,578.0,494.0,127,186,-59
296,20,12,2,1,1,218,155,141,187,187,221,263,289,325,272,292,402,347.0,322.0,110,20,90
815,21,12,2,1,1,785,388,397,433,446,383,562,667,705,729,755,1158,956.0,881.0,403,26,377
166,22,12,2,1,1,272,131,179,118,155,141,189,179,249,176,328,336,332.0,280.0,8,152,-144
180,1,13,1,1,1,320,130,160,94,156,130,143,149,181,158,314,461,388.0,311.0,147,156,-9
1059,2,13,1,1,1,785,338,404,239,336,248,387,336,447,627,757,1396,1076.0,927.0,639,130,509
520,3,13,1,1,1,363,137,199,117,165,174,186,216,287,324,527,720,624.0,524.0,193,203,-10
101,4,13,1,1,1,362,109,157,85,99,100,137,177,237,199,242,487,364.0,309.0,245,43,202
1860,5,13,1,1,1,1794,901,983,554,759,618,741,845,1263,1243,1605,2433,2019.0,1760.0,828,362,466
1440,6,13,1,1,1,1233,660,594,483,561,546,651,840,1069,1269,1370,2298,1834.0,1646.0,928,101,827
2217,7,13,1,1,1,1412,621,625,585,723,768,927,999,1485,1686,2126,3804,2965.0,2539.0,1678,440,1238
772,8,13,1,1,1,494,232,272,166,255,224,271,379,496,642,748,1215,982.0,868.0,467,106,361
1040,9,13,1,1,1,1574,298,728,449,600,502,550,650,835,848,1467,2021,1744.0,1445.0,554,619,-65
738,10,13,1,1,1,527,174,351,170,257,240,225,284,342,388,511,880,696.0,593.0,369,123,246
1540,11,13,1,1,1,1591,861,985,648,883,678,762,1001,1116,1451,1816,2525,2170.0,1931.0,709,365,344
1015,12,13,1,1,1,905,504,443,270,410,377,409,440,725,733,889,1320,1104.0,981.0,431,156,275
1882,13,13,1,1,1,1293,623,634,487,781,785,958,1014,1437,1548,2026,3281,2654.0,2285.0,1255,478,777
2324,14,13,1,1,1,1515,786,582,542,634,719,857,953,1313,1473,1843,2975,2409.0,2097.0,1132,370,762
958,15,13,1,1,1,1861,640,897,591,746,723,731,805,1089,1175,1502,2235,1868.0,1637.0,733,327,406
1148,16,13,1,1,1,1123,492,599,444,503,489,505,669,868,924,1339,1557,1448.0,1273.0,218,415,-197
1235,17,13,1,1,1,1080,399,488,309,371,399,407,438,633,772,835,1281,1058.0,963.0,446,63,383
518,18,13,1,1,1,489,190,303,174,227,178,234,282,307,414,622,877,750.0,638.0,255,208,47
311,19,13,1,1,1,351,155,236,155,177,191,236,231,291,296,396,542,469.0,411.0,146,100,46
489,20,13,1,1,1,459,252,295,169,207,227,218,259,311,316,419,666,542.0,467.0,247,103,144
1036,21,13,1,1,1,709,331,283,202,287,271,303,362,519,627,715,1549,1132.0,964.0,834,88,746
401,22,13,1,1,1,587,248,377,252,344,319,336,422,442,411,616,998,807.0,675.0,382,205,177
423,1,14,1,1,1,871,360,517,534,459,422,464,522,661,472,781,1047,914.0,767.0,266,309,-43
1354,2,14,1,1,1,1704,825,894,856,985,706,939,877,1084,1148,1159,1879,1519.0,1395.0,720,11,709
814,3,14,1,1,1,744,297,457,492,583,433,551,578,725,701,941,1442,1192.0,1028.0,501,240,261
274,4,14,1,1,1,963,297,397,406,411,391,454,496,664,474,569,1295,932.0,779.0,726,95,631
2540,5,14,1,1,1,3386,1779,1779,1892,1614,1306,1417,1488,2289,1556,2162,4188,3175.0,2635.0,2026,606,1420
2495,6,14,1,1,1,2327,1365,1104,1361,1443,1295,1412,1803,1996,1889,2073,3650,2862.0,2537.0,1577,184,1393
3467,7,14,1,1,1,3259,1514,1781,2492,2580,2168,2583,2886,3461,3252,3594,6275,4934.0,4374.0,2681,342,2339
743,8,14,1,1,1,885,293,482,602,630,509,619,652,805,800,914,1576,1245.0,1097.0,662,114,548
1784,9,14,1,1,1,3438,552,1659,1766,2201,1866,1837,2246,2808,2902,3269,4342,3806.0,3504.0,1073,367,706
892,10,14,1,1,1,898,312,603,500,655,477,518,574,670,621,739,1316,1028.0,892.0,577,118,459
3032,11,14,1,1,1,3796,2048,2831,2838,3224,2468,2600,3230,3453,3560,3776,5864,4820.0,4400.0,2088,216,1872
1579,12,14,1,1,1,1595,796,783,897,980,839,839,860,1325,1195,1285,2160,1722.0,1547.0,875,90,785
2375,13,14,1,1,1,2546,1405,1287,1778,2039,1774,2024,2258,2481,2298,2594,4551,3572.0,3148.0,1957,296,1661
5309,14,14,1,1,1,4567,2208,2034,2494,2508,2539,3103,3396,3571,3427,4047,8018,6032.0,5164.0,3971,620,3351
1679,15,14,1,1,1,3658,1317,1705,1980,2136,1905,1897,2229,2579,2724,3014,4336,3675.0,3358.0,1322,290,1032
2049,16,14,1,1,1,2416,1019,1237,1346,1186,1236,1304,1341,1747,1512,1848,3179,2514.0,2180.0,1331,336,995
2461,17,14,1,1,1,2539,944,1417,1610,1468,1450,1536,1679,2187,1872,2355,3747,3051.0,2658.0,1392,483,909
596,18,14,1,1,1,820,377,549,639,683,519,626,618,738,859,1140,1306,1223.0,1102.0,166,281,-115
769,19,14,1,1,1,967,439,737,900,949,846,1022,1132,1218,970,1188,1784,1486.0,1314.0,596,218,378
877,20,14,1,1,1,1093,523,596,660,656,695,635,655,770,622,761,1417,1089.0,933.0,656,139,517
1008,21,14,1,1,1,1187,455,425,548,688,468,587,654,727,899,841,1546,1194.0,1095.0,705,-58,763
579,22,14,1,1,1,797,417,638,624,692,573,663,777,675,517,944,1290,1117.0,917.0,346,427,-81
851,1,15,2,1,1,1357,406,900,712,656,680,680,720,820,623,807,1293,1050.0,908.0,486,184,302
509,2,15,2,1,1,572,255,271,184,252,242,468,405,456,394,535,639,587.0,523.0,104,141,-37
494,3,15,2,1,1,624,266,342,266,364,340,407,480,482,477,451,580,516.0,503.0,129,-26,155
1327,4,15,2,1,1,1794,612,1376,1000,1124,1019,1062,1143,1276,969,1288,2146,1717.0,1468.0,858,319,539
856,5,15,2,1,1,933,548,541,447,452,487,585,715,1123,634,781,1105,943.0,840.0,324,147,177
953,6,15,2,1,1,1168,475,554,507,478,422,472,667,840,774,803,1070,936.0,882.0,267,29,238
1329,7,15,2,1,1,1944,957,1035,932,915,988,988,1162,1315,1224,1513,1837,1675.0,1525.0,324,289,35
945,8,15,2,1,1,1214,558,679,602,669,598,604,750,729,770,798,1203,1000.0,924.0,405,28,377
423,9,15,2,1,1,542,134,313,221,266,335,313,351,438,425,536,825,680.0,595.0,289,111,178
179,10,15,2,1,1,218,128,156,79,110,114,93,121,141,135,160,243,202.0,179.0,83,25,58
1820,11,15,2,1,1,2309,1242,1350,1122,1198,1215,1276,1793,1838,1848,1951,2643,2297.0,2147.0,692,103,589
408,12,15,2,1,1,722,233,355,293,295,274,321,334,419,377,424,571,498.0,457.0,147,47,100
1604,13,15,2,1,1,1886,842,1063,923,1024,961,977,1321,1377,1264,1433,1923,1678.0,1540.0,490,169,321
1178,14,15,2,1,1,1577,731,827,723,780,738,834,1010,1081,952,1113,1482,1298.0,1182.0,369,161,208
767,15,15,2,1,1,1114,584,577,432,444,464,536,601,733,722,894,1112,1003.0,909.0,218,172,46
446,16,15,2,1,1,523,233,258,236,284,317,260,295,373,329,377,483,430.0,396.0,106,48,58
487,17,15,2,1,1,747,340,403,317,301,333,339,383,464,438,477,783,630.0,566.0,306,39,267
397,18,15,2,1,1,584,162,321,213,189,158,212,189,235,212,345,456,400.0,338.0,111,133,-22
270,19,15,2,1,1,263,160,216,236,253,279,277,296,261,247,251,310,280.0,269.0,59,4,55
555,20,15,2,1,1,800,413,369,328,342,482,408,414,486,426,491,644,568.0,520.0,153,65,88
719,21,15,2,1,1,789,424,439,293,395,348,388,413,568,617,622,758,690.0,666.0,136,5,131
104,22,15,2,1,1,183,116,156,121,150,115,124,187,159,142,152,169,160.0,154.0,17,10,7
63,1,16,2,1,1,46,35,64,37,32,39,46,46,41,395,67,117,92.0,193.0,50,-328,378
946,2,16,2,1,1,1285,757,1431,1186,1072,971,1395,1426,1254,988,1142,1590,1366.0,1240.0,448,154,294
602,3,16,2,1,1,1314,514,769,698,895,690,744,864,895,802,945,982,964.0,910.0,37,143,-106
300,4,16,2,1,1,945,466,982,803,698,717,716,794,737,477,625,985,805.0,696.0,360,148,212
1470,5,16,2,1,1,2222,1370,2758,2537,2734,2651,2620,2791,2955,1733,2221,3340,2780.0,2431.0,1119,488,631
248,6,16,2,1,1,607,352,581,410,402,479,502,552,488,424,410,575,492.0,470.0,165,-14,179
1903,7,16,2,1,1,4027,2068,3709,3356,3511,2812,3126,3130,3837,3617,3662,4024,3843.0,3768.0,362,45,317
679,8,16,2,1,1,1234,571,1176,933,1057,828,993,1217,1561,1243,1188,1616,1402.0,1349.0,428,-55,483
1196,9,16,2,1,1,1556,627,1889,1775,1785,1654,1766,1963,2010,1906,2111,2398,2254.0,2138.0,287,205,82
440,10,16,2,1,1,493,278,462,403,353,331,405,319,409,384,459,435,447.0,426.0,-24,75,-99
527,11,16,2,1,1,917,541,942,753,875,786,701,745,840,781,777,930,854.0,829.0,153,-4,157
354,12,16,2,1,1,496,261,379,339,330,292,330,358,538,488,482,540,511.0,503.0,58,-6,64
2068,13,16,2,1,1,3740,2309,3367,3025,3349,3221,3102,3388,3910,3483,3233,4206,3720.0,3641.0,973,-250,1223
1570,14,16,2,1,1,2560,1238,2093,1984,2022,1974,2200,2100,2323,1931,2018,2962,2490.0,2304.0,944,87,857
424,15,16,2,1,1,800,384,837,836,827,820,769,777,723,606,634,886,760.0,709.0,252,28,224
483,16,16,2,1,1,841,389,867,611,610,623,595,715,725,585,544,920,732.0,683.0,376,-41,417
1714,17,16,2,1,1,2251,1115,2020,1616,1475,1358,1456,1533,1680,1444,1489,2336,1912.0,1756.0,847,45,802
308,18,16,2,1,1,788,302,657,579,484,487,627,773,710,690,597,622,610.0,636.0,25,-93,118
681,19,16,2,1,1,1349,854,1439,1484,1508,1498,1804,1815,1871,1308,1478,1878,1678.0,1555.0,400,170,230
131,20,16,2,1,1,234,167,284,211,204,370,530,502,347,184,172,247,210.0,201.0,75,-12,87
558,21,16,2,1,1,1113,499,771,729,604,479,874,1106,695,580,634,1051,842.0,755.0,417,54,363
730,22,16,2,1,1,1494,1179,1914,1499,1291,1253,1193,1427,1562,1308,1636,1781,1708.0,1575.0,145,328,-183
1909,1,17,2,1,1,2375,573,2243,2672,2922,2462,1180,1500,2397,1674,2362,3060,2711.0,2365.0,698,688,10
656,2,17,2,1,1,1009,563,707,630,647,551,884,974,1076,1038,1033,1402,1218.0,1158.0,369,-5,374
268,3,17,2,1,1,744,335,525,430,507,344,410,446,541,468,630,827,728.0,642.0,197,162,35
217,4,17,2,1,1,1468,353,2808,1941,2551,971,995,1118,835,516,1494,2145,1820.0,1385.0,651,978,-327
1355,5,17,2,1,1,2462,1405,2143,1834,1543,1533,1662,1864,2707,1708,2119,2450,2284.0,2092.0,331,411,-80
1460,6,17,2,1,1,3082,1494,1764,1722,1828,1799,2028,2809,2863,2529,2927,3132,3030.0,2863.0,205,398,-193
1885,7,17,2,1,1,5502,2478,3115,3589,3471,2715,3147,4018,4409,4129,4087,5401,4744.0,4539.0,1314,-42,1356
692,8,17,2,1,1,2073,779,1146,1022,1337,977,1223,1490,1510,1452,1547,2066,1806.0,1688.0,519,95,424
625,9,17,2,1,1,2669,535,2905,1816,1983,1796,1715,2112,2192,2036,2188,2519,2354.0,2248.0,331,152,179
308,10,17,2,1,1,722,397,549,377,518,379,413,503,589,568,596,616,606.0,593.0,20,28,-8
2143,11,17,2,1,1,5630,3297,3990,3393,3757,3219,3369,4854,5016,4475,5007,5643,5325.0,5042.0,636,532,104
973,12,17,2,1,1,2694,1077,1305,1276,1370,1233,1308,1681,2044,1627,1981,2357,2169.0,1988.0,376,354,22
1723,13,17,2,1,1,4516,1882,2484,2675,3198,2587,2964,3829,3951,3277,3711,5424,4568.0,4137.0,1713,434,1279
2463,14,17,2,1,1,4592,1915,2442,2757,2736,2702,3421,4398,4500,3793,4237,5119,4678.0,4383.0,882,444,438
895,15,17,2,1,1,3120,1321,2050,1853,2092,1953,2021,2513,2777,2324,2401,2755,2578.0,2493.0,354,77,277
1002,16,17,2,1,1,2590,916,1381,1205,1158,1213,1120,1591,1818,1296,1466,1985,1726.0,1582.0,519,170,349
1085,17,17,2,1,1,2791,1083,1689,1645,1561,1517,1583,1906,2187,1670,2078,2533,2306.0,2094.0,455,408,47
440,18,17,2,1,1,1609,446,1142,977,1082,843,1055,1347,1279,1170,1218,1549,1384.0,1312.0,331,48,283
268,19,17,2,1,1,916,394,781,766,859,586,702,806,897,700,869,1098,984.0,889.0,229,169,60
617,20,17,2,1,1,1039,586,936,946,870,1013,987,1230,1171,824,938,1120,1029.0,961.0,182,114,68
631,21,17,2,1,1,1658,688,869,1036,1284,861,1113,1278,1300,1165,1199,1748,1474.0,1371.0,549,34,515
162,22,17,2,1,1,399,210,484,451,421,327,303,404,404,286,466,480,473.0,411.0,14,180,-166
315,1,18,2,1,1,968,300,906,709,759,629,425,535,502,314,574,754,664.0,547.0,180,260,-80
452,2,18,2,1,1,612,389,500,421,595,461,551,450,435,635,692,866,779.0,731.0,174,57,117
427,3,18,2,1,1,712,383,577,507,561,440,380,452,427,495,612,941,776.0,683.0,329,117,212
125,4,18,2,1,1,529,209,482,498,353,301,382,397,346,199,341,546,444.0,362.0,205,142,63
1017,5,18,2,1,1,1515,991,1444,1326,1270,1055,1379,1197,903,838,1187,1812,1500.0,1279.0,625,349,276
741,6,18,2,1,1,1394,887,1184,1065,1021,869,1109,958,734,813,952,1669,1310.0,1145.0,717,139,578
2330,7,18,2,1,1,5127,2475,3780,3634,3404,2787,3450,3299,2451,2995,3812,5496,4654.0,4101.0,1684,817,867
1165,8,18,2,1,1,2427,1042,1482,1678,1725,1270,1462,1588,1052,1126,1234,2626,1930.0,1662.0,1392,108,1284
368,9,18,2,1,1,467,178,510,397,473,460,457,448,529,384,525,1055,790.0,655.0,530,141,389
365,10,18,2,1,1,403,173,461,182,302,352,363,291,255,362,355,448,402.0,388.0,93,-7,100
1167,11,18,2,1,1,1366,941,1639,1304,1178,1368,1353,1085,864,1310,1728,2261,1994.0,1766.0,533,418,115
641,12,18,2,1,1,955,332,492,421,412,315,365,335,301,356,946,847,896.0,716.0,-99,590,-689
1932,13,18,2,1,1,4674,2876,2946,3004,3190,2715,3210,3609,2265,2586,3058,5478,4268.0,3707.0,2420,472,1948
1731,14,18,2,1,1,2819,1336,1920,1867,1905,1469,1701,1452,1141,1472,1941,3092,2516.0,2168.0,1151,469,682
504,15,18,2,1,1,1400,560,1342,916,1100,1016,1000,913,659,638,706,1205,956.0,850.0,499,68,431
298,16,18,2,1,1,677,332,433,470,347,353,277,263,202,272,348,657,502.0,426.0,309,76,233
576,17,18,2,1,1,1213,599,989,827,849,769,962,701,698,568,587,1351,969.0,835.0,764,19,745
215,18,18,2,1,1,500,127,369,321,335,225,356,355,342,307,452,617,534.0,459.0,165,145,20
394,19,18,2,1,1,790,461,979,733,783,589,621,716,684,572,853,1026,940.0,817.0,173,281,-108
353,20,18,2,1,1,587,370,549,493,497,413,558,474,304,408,379,694,536.0,494.0,315,-29,344
754,21,18,2,1,1,916,406,608,683,599,723,667,832,623,693,804,1400,1102.0,966.0,596,111,485
280,22,18,2,1,1,447,551,532,645,383,283,369,508,307,324,496,710,603.0,510.0,214,172,42
339,1,19,2,1,1,317,162,289,246,249,228,201,232,150,148,312,359,336.0,273.0,47,164,-117
409,2,19,2,1,1,523,215,264,283,346,330,388,290,304,344,442,485,464.0,424.0,43,98,-55
519,3,19,2,1,1,445,173,236,276,395,262,398,348,325,432,401,434,418.0,422.0,33,-31,64
1263,4,19,2,1,1,1279,607,1252,1112,1156,1039,990,1183,1150,795,1121,1802,1462.0,1239.0,681,326,355
1390,5,19,2,1,1,985,485,639,702,679,596,623,519,741,610,732,1083,908.0,808.0,351,122,229
667,6,19,2,1,1,594,265,335,339,414,403,381,360,323,440,519,629,574.0,529.0,110,79,31
1861,7,19,2,1,1,1527,694,1162,1362,1499,1162,1256,1311,1391,1370,1666,1642,1654.0,1559.0,-24,296,-320
426,8,19,2,1,1,453,225,381,342,380,264,316,332,330,480,421,414,418.0,438.0,-7,-59,52
727,9,19,2,1,1,752,132,499,400,553,537,509,516,523,704,995,1243,1119.0,981.0,248,291,-43
225,10,19,2,1,1,211,72,100,87,113,102,97,101,156,159,192,214,203.0,188.0,22,33,-11
1336,11,19,2,1,1,1523,733,1051,1024,1236,925,785,871,1280,881,1099,1374,1236.0,1118.0,275,218,57
364,12,19,2,1,1,379,114,198,208,246,191,199,169,178,237,276,329,302.0,281.0,53,39,14
1768,13,19,2,1,1,1612,874,1322,1150,1563,1391,1238,1360,1115,1052,1461,1615,1538.0,1376.0,154,409,-255
1429,14,19,2,1,1,1352,536,792,984,996,913,957,1047,1104,1357,1223,1443,1333.0,1341.0,220,-134,354
742,15,19,2,1,1,764,311,485,482,592,492,475,404,404,512,747,863,805.0,707.0,116,235,-119
558,16,19,2,1,1,493,217,350,350,345,337,298,379,393,374,473,566,520.0,471.0,93,99,-6
519,17,19,2,1,1,508,193,301,261,307,277,273,291,253,248,418,494,456.0,387.0,76,170,-94
404,18,19,2,1,1,492,162,288,229,307,216,229,183,186,285,325,402,364.0,337.0,77,40,37
704,19,19,2,1,1,638,324,566,616,593,769,652,721,569,738,644,1082,863.0,821.0,438,-94,532
433,20,19,2,1,1,313,158,224,260,274,314,254,213,262,251,282,391,336.0,308.0,109,31,78
487,21,19,2,1,1,491,184,273,411,522,312,356,360,419,276,346,497,422.0,373.0,151,70,81
785,22,19,2,1,1,789,427,986,775,794,828,639,929,731,657,664,964,814.0,762.0,300,7,293
815,1,20,1,1,1,1571,568,1144,987,982,1141,897,946,1150,1010,1563,1504,1534.0,1359.0,-59,553,-612
585,2,20,1,1,1,844,407,491,429,522,373,681,595,570,759,692,785,738.0,745.0,93,-67,160
303,3,20,1,1,1,349,174,204,243,365,254,296,333,327,407,342,430,386.0,393.0,88,-65,153
376,4,20,1,1,1,1075,395,672,745,768,998,675,772,925,740,925,1127,1026.0,931.0,202,185,17
1096,5,20,1,1,1,1631,779,913,980,978,903,990,1085,1885,1100,1320,1775,1548.0,1398.0,455,220,235
952,6,20,1,1,1,1305,600,798,764,823,725,769,980,1023,1001,1064,1490,1277.0,1185.0,426,63,363
940,7,20,1,1,1,1420,681,940,1108,1210,1082,1134,1323,1432,1303,1408,1739,1574.0,1483.0,331,105,226
229,8,20,1,1,1,469,235,312,291,326,221,257,295,289,333,332,371,352.0,345.0,39,-1,40
854,9,20,1,1,1,2185,423,1174,995,1269,1114,1097,1195,1320,1463,1644,2216,1930.0,1774.0,572,181,391
218,10,20,1,1,1,412,211,246,212,277,223,187,218,240,280,255,372,314.0,302.0,117,-25,142
1586,11,20,1,1,1,2303,1323,1686,1487,1639,1433,1571,1947,1897,1872,2263,3132,2698.0,2422.0,869,391,478
754,12,20,1,1,1,1219,454,671,722,759,661,681,684,855,798,870,1144,1007.0,937.0,274,72,202
652,13,20,1,1,1,1075,517,776,716,788,622,676,985,861,883,944,1218,1081.0,1015.0,274,61,213
856,14,20,1,1,1,1463,652,810,959,936,866,965,1056,1067,1021,1121,1578,1350.0,1240.0,457,100,357
1749,15,20,1,1,1,3182,1395,1880,1823,1961,1826,1921,2037,2367,2323,2703,3371,3037.0,2799.0,668,380,288
941,16,20,1,1,1,1269,532,746,751,751,798,730,829,920,1033,988,1333,1160.0,1118.0,345,-45,390
1003,17,20,1,1,1,1418,612,798,869,852,770,811,908,1056,973,1081,1561,1321.0,1205.0,480,108,372
667,18,20,1,1,1,1432,407,744,580,799,587,681,684,714,853,905,1102,1004.0,953.0,197,52,145
253,19,20,1,1,1,417,172,302,339,376,332,444,478,491,437,403,555,479.0,465.0,152,-34,186
452,20,20,1,1,1,651,350,388,450,403,448,421,422,477,428,496,740,618.0,555.0,244,68,176
395,21,20,1,1,1,640,275,327,347,397,335,338,351,433,450,479,533,506.0,487.0,54,29,25
213,22,20,1,1,1,352,146,415,369,422,399,362,461,359,320,352,428,390.0,367.0,76,32,44
275,1,21,2,1,1,502,184,494,480,438,464,464,563,552,450,685,688,686.0,608.0,3,235,-232
409,2,21,2,1,1,704,407,551,494,611,509,837,743,640,687,714,1001,858.0,801.0,287,27,260
370,3,21,2,1,1,749,281,409,555,665,393,509,544,557,650,671,789,730.0,703.0,118,21,97
402,4,21,2,1,1,1396,555,1236,1175,1102,1018,1021,1288,1431,1045,1332,1807,1570.0,1395.0,475,287,188
1589,5,21,2,1,1,2380,1439,1972,2107,1866,1748,1887,2009,2921,2017,2913,3590,3252.0,2840.0,677,896,-219
921,6,21,2,1,1,1207,517,1041,1182,1170,1110,1307,1431,1596,1491,1717,1968,1842.0,1725.0,251,226,25
1329,7,21,2,1,1,2790,1121,2092,2449,2486,1895,2003,2387,2615,2547,2776,3299,3038.0,2874.0,523,229,294
401,8,21,2,1,1,831,373,673,634,789,589,641,800,787,813,782,1130,956.0,908.0,348,-31,379
475,9,21,2,1,1,1467,323,1264,996,1286,1093,1029,1303,1438,1702,2171,2397,2284.0,2090.0,226,469,-243
225,10,21,2,1,1,447,161,369,263,323,295,287,282,358,395,493,595,544.0,494.0,102,98,4
1623,11,21,2,1,1,2903,1522,2786,2473,3080,2334,2394,3107,2962,3228,3579,4302,3940.0,3703.0,723,351,372
398,12,21,2,1,1,698,252,491,598,657,503,672,641,755,781,885,1016,950.0,894.0,131,104,27
1565,13,21,2,1,1,2975,1404,2330,2475,2921,2392,2559,2979,2860,2877,2989,3954,3472.0,3273.0,965,112,853
1489,14,21,2,1,1,2415,955,1587,2122,1817,1841,2115,2398,2493,2358,2638,3291,2964.0,2762.0,653,280,373
961,15,21,2,1,1,2040,893,1688,1755,1827,1550,1572,1914,1992,2163,2458,2897,2678.0,2506.0,439,295,144
805,16,21,2,1,1,1338,473,870,703,828,848,789,996,1142,948,1247,1304,1276.0,1166.0,57,299,-242
427,17,21,2,1,1,901,394,710,632,689,696,720,817,950,757,948,1222,1085.0,976.0,274,191,83
385,18,21,2,1,1,813,280,669,569,777,495,680,640,694,837,946,924,935.0,902.0,-22,109,-131
414,19,21,2,1,1,1069,487,985,1021,1093,717,904,1088,1057,1007,1160,1513,1336.0,1227.0,353,153,200
296,20,21,2,1,1,402,214,312,317,246,378,375,374,365,407,493,612,552.0,504.0,119,86,33
404,21,21,2,1,1,832,352,582,607,926,472,701,761,801,945,946,1143,1044.0,1011.0,197,1,196
462,22,21,2,1,1,857,475,987,974,825,774,757,1154,914,753,1190,1198,1194.0,1047.0,8,437,-429
325,1,22,4,1,1,532,350,778,523,603,553,600,670,690,633,790,925,858.0,783.0,135,157,-22
194,2,22,4,1,1,384,244,415,322,387,317,493,447,408,431,527,546,536.0,501.0,19,96,-77
168,3,22,4,1,1,353,150,300,265,350,301,313,341,355,371,359,418,388.0,383.0,59,-12,71
471,4,22,4,1,1,817,426,1017,846,916,826,879,911,1074,915,1162,1615,1388.0,1231.0,453,247,206
445,5,22,4,1,1,707,562,879,706,738,715,745,722,1155,772,961,1167,1064.0,967.0,206,189,17
374,6,22,4,1,1,569,357,675,647,692,656,677,767,841,878,933,1003,968.0,938.0,70,55,15
875,7,22,4,1,1,1583,860,1928,1822,1978,1685,1638,1852,2308,2307,2370,2766,2568.0,2481.0,396,63,333
139,8,22,4,1,1,271,166,314,241,352,275,285,300,313,320,355,484,420.0,386.0,129,35,94
402,9,22,4,1,1,817,342,1042,810,979,912,937,951,992,1092,1209,1464,1336.0,1255.0,255,117,138
118,10,22,4,1,1,263,125,288,186,265,233,260,262,246,259,290,384,337.0,311.0,94,31,63
1057,11,22,4,1,1,1924,1512,2488,1949,2522,2016,2112,2209,2679,2595,2801,3241,3021.0,2879.0,440,206,234
213,12,22,4,1,1,394,200,434,361,405,347,434,393,442,498,481,511,496.0,497.0,30,-17,47
754,13,22,4,1,1,1284,764,1561,1277,1469,1298,1298,1461,1525,1603,1929,2115,2022.0,1882.0,186,326,-140
591,14,22,4,1,1,972,578,1090,1137,1026,959,1096,1283,1383,1309,1461,1740,1600.0,1503.0,279,152,127
818,15,22,4,1,1,1451,1062,1999,1632,1956,1671,1999,1697,1991,2033,2127,2662,2394.0,2274.0,535,94,441
305,16,22,4,1,1,472,314,537,473,508,574,499,596,611,603,616,685,650.0,635.0,69,13,56
256,17,22,4,1,1,503,263,575,412,494,442,503,514,645,501,559,768,664.0,609.0,209,58,151
216,18,22,4,1,1,482,236,512,409,530,373,503,451,397,473,480,608,544.0,520.0,128,7,121
169,19,22,4,1,1,401,246,558,476,514,420,483,505,553,489,516,595,556.0,533.0,79,27,52
69,20,22,4,1,1,153,94,156,120,135,198,189,145,189,159,216,258,237.0,211.0,42,57,-15
185,21,22,4,1,1,384,259,468,393,540,321,402,487,425,510,487,657,572.0,551.0,170,-23,193
157,22,22,4,1,1,285,242,628,493,470,454,420,611,511,443,413,533,473.0,463.0,120,-30,150
76,1,23,1,1,1,305,80,117,123,63,113,83,134,126,104,114,215,164.0,144.0,101,10,91
95,2,23,1,1,1,251,186,114,92,106,89,141,121,133,139,121,182,152.0,147.0,61,-18,79
99,3,23,1,1,1,312,114,123,107,124,111,114,92,121,108,174,205,190.0,162.0,31,66,-35
74,4,23,1,1,1,432,148,234,172,132,149,201,202,250,161,243,439,341.0,281.0,196,82,114
309,5,23,1,1,1,824,509,328,331,262,301,284,317,459,291,297,513,405.0,367.0,216,6,210
578,6,23,1,1,1,1721,870,680,514,529,526,633,733,655,600,692,1047,870.0,780.0,355,92,263
902,7,23,1,1,1,1900,1101,802,922,771,855,1000,1063,1138,1097,1099,1844,1472.0,1347.0,745,2,743
238,8,23,1,1,1,488,211,155,211,195,143,212,261,250,277,308,545,426.0,377.0,237,31,206
126,9,23,1,1,1,375,89,154,162,145,223,291,295,282,277,289,373,331.0,313.0,84,12,72
93,10,23,1,1,1,188,104,97,54,71,100,108,107,108,100,115,162,138.0,126.0,47,15,32
300,11,23,1,1,1,859,502,454,332,411,403,402,461,370,406,397,621,509.0,475.0,224,-9,233
151,12,23,1,1,1,386,200,101,96,91,121,141,112,150,164,143,266,204.0,191.0,123,-21,144
748,13,23,1,1,1,1327,753,620,514,537,455,575,645,742,699,808,1460,1134.0,989.0,652,109,543
524,14,23,1,1,1,1147,528,298,313,364,453,477,544,566,471,617,1100,858.0,729.0,483,146,337
101,15,23,1,1,1,368,143,158,153,145,161,194,181,198,211,191,260,226.0,221.0,69,-20,89
275,16,23,1,1,1,689,242,211,178,180,285,274,266,326,324,313,534,424.0,390.0,221,-11,232
308,17,23,1,1,1,638,234,247,217,180,205,282,273,347,286,335,535,435.0,385.0,200,49,151
60,18,23,1,1,1,177,45,82,56,58,88,101,114,102,89,87,129,108.0,102.0,42,-2,44
149,19,23,1,1,1,514,232,279,252,262,234,252,331,280,278,265,371,318.0,305.0,106,-13,119
168,20,23,1,1,1,518,271,178,190,138,222,247,251,250,189,199,335,267.0,241.0,136,10,126
209,21,23,1,1,1,356,166,118,112,151,113,180,161,167,197,186,360,273.0,248.0,174,-11,185
126,22,23,1,1,1,328,152,215,165,177,206,165,264,248,169,223,312,268.0,235.0,89,54,35
679,1,24,2,1,1,617,279,554,507,485,527,653,687,651,489,558,362,460.0,470.0,-196,69,-265
229,2,24,2,1,1,238,87,174,151,202,185,247,209,201,174,160,155,158.0,163.0,-5,-14,9
106,3,24,2,1,1,92,51,90,76,95,106,108,130,97,99,82,59,70.0,80.0,-23,-17,-6
798,4,24,2,1,1,799,424,733,545,566,646,748,847,831,642,654,521,588.0,606.0,-133,12,-145
703,5,24,2,1,1,559,325,439,421,431,486,460,559,615,471,430,474,452.0,458.0,44,-41,85
338,6,24,2,1,1,285,144,198,252,223,244,244,344,348,248,228,187,208.0,221.0,-41,-20,-21
610,7,24,2,1,1,516,240,412,457,437,443,584,549,525,474,421,353,387.0,416.0,-68,-53,-15
129,8,24,2,1,1,102,58,112,93,114,101,121,154,121,105,117,105,111.0,109.0,-12,12,-24
1207,9,24,2,1,1,1364,384,1124,891,1008,1160,1083,1238,1180,1049,976,1007,992.0,1011.0,31,-73,104
159,10,24,2,1,1,125,68,133,79,114,129,142,161,151,126,138,119,128.0,128.0,-19,12,-31
1735,11,24,2,1,1,1709,960,1400,1291,1323,1469,1509,1821,1585,1270,1186,1077,1132.0,1178.0,-109,-84,-25
242,12,24,2,1,1,204,93,153,158,177,165,198,224,232,164,154,152,153.0,157.0,-2,-10,8
340,13,24,2,1,1,325,118,239,297,312,337,350,330,362,307,254,182,218.0,248.0,-72,-53,-19
320,14,24,2,1,1,355,161,301,358,277,291,353,389,339,239,284,223,254.0,249.0,-61,45,-106
1529,15,24,2,1,1,1444,745,1150,1124,1121,1210,1486,1568,1439,1239,1136,1024,1080.0,1133.0,-112,-103,-9
370,16,24,2,1,1,264,166,276,286,265,300,346,383,407,272,273,274,274.0,273.0,1,1,0
305,17,24,2,1,1,313,113,209,229,207,229,257,270,285,213,205,215,210.0,211.0,10,-8,18
518,18,24,2,1,1,456,187,331,340,375,354,394,437,448,353,321,324,322.0,333.0,3,-32,35
292,19,24,2,1,1,231,150,206,234,226,254,291,346,299,229,207,174,190.0,203.0,-33,-22,-11
267,20,24,2,1,1,275,140,226,204,204,232,259,222,255,197,217,217,217.0,210.0,0,20,-20
285,21,24,2,1,1,270,145,192,213,288,241,238,319,283,263,205,197,201.0,222.0,-8,-58,50
93,22,24,2,1,1,39,46,74,80,87,80,75,119,71,81,63,53,58.0,66.0,-10,-18,8
315,1,25,1,1,1,379,164,397,283,308,272,297,303,281,281,247,225,236.0,251.0,-22,-34,12
164,2,25,1,1,1,201,89,159,143,175,143,190,187,165,167,133,176,154.0,159.0,43,-34,77
86,3,25,1,1,1,103,51,91,82,115,109,112,117,120,96,85,86,86.0,89.0,1,-11,12
323,4,25,1,1,1,484,232,428,353,385,362,331,427,429,308,324,417,370.0,350.0,93,16,77
483,5,25,1,1,1,426,224,376,344,382,380,359,376,389,305,301,337,319.0,314.0,36,-4,40
188,6,25,1,1,1,228,119,169,162,175,187,156,227,205,162,169,174,172.0,168.0,5,7,-2
339,7,25,1,1,1,357,185,290,276,307,309,263,302,292,265,227,253,240.0,248.0,26,-38,64
111,8,25,1,1,1,99,50,77,59,95,91,82,103,99,83,81,91,86.0,85.0,10,-2,12
581,9,25,1,1,1,663,212,629,501,543,522,480,565,575,462,510,512,511.0,495.0,2,48,-46
128,10,25,1,1,1,110,67,86,103,113,124,96,117,108,102,103,109,106.0,105.0,6,1,5
807,11,25,1,1,1,896,478,831,673,752,698,733,823,757,642,661,734,698.0,679.0,73,19,54
165,12,25,1,1,1,153,65,143,134,157,139,120,153,155,115,129,138,134.0,127.0,9,14,-5
203,13,25,1,1,1,244,109,201,188,230,197,195,219,226,184,180,178,179.0,181.0,-2,-4,2
186,14,25,1,1,1,199,105,163,205,180,189,189,186,187,161,189,173,181.0,174.0,-16,28,-44
656,15,25,1,1,1,771,473,696,636,660,565,645,709,620,587,599,595,597.0,594.0,-4,12,-16
270,16,25,1,1,1,287,151,282,230,266,292,242,319,331,219,258,266,262.0,248.0,8,39,-31
210,17,25,1,1,1,244,96,191,206,200,169,164,219,179,160,168,191,180.0,173.0,23,8,15
241,18,25,1,1,1,300,129,246,219,230,256,240,260,259,202,201,205,203.0,203.0,4,-1,5
140,19,25,1,1,1,163,84,157,166,150,154,152,161,165,130,138,128,133.0,132.0,-10,8,-18
131,20,25,1,1,1,167,74,152,134,144,142,148,158,109,123,106,134,120.0,121.0,28,-17,45
159,21,25,1,1,1,190,115,156,163,199,168,161,205,192,172,135,145,140.0,151.0,10,-37,47
68,22,25,1,1,1,57,45,84,72,91,70,67,99,74,50,53,61,57.0,55.0,8,3,5
835,1,26,1,1,1,445,276,461,355,455,551,438,559,478,428,493,474,484.0,465.0,-19,65,-84
310,2,26,1,1,1,146,96,197,123,203,222,190,240,237,204,210,215,212.0,210.0,5,6,-1
139,3,26,1,1,1,75,55,85,62,91,81,74,115,91,72,82,74,78.0,76.0,-8,10,-18
1033,4,26,1,1,1,751,419,597,509,573,717,674,824,853,604,747,817,782.0,723.0,70,143,-73
695,5,26,1,1,1,405,265,377,334,442,494,344,458,388,382,361,382,372.0,375.0,21,-21,42
354,6,26,1,1,1,197,113,164,138,167,188,148,226,228,183,176,177,176.0,179.0,1,-7,8
608,7,26,1,1,1,345,221,286,259,291,346,365,453,344,338,348,336,342.0,341.0,-12,10,-22
165,8,26,1,1,1,100,51,78,95,88,102,105,108,108,84,93,100,96.0,92.0,7,9,-2
1178,9,26,1,1,1,781,299,866,560,678,769,689,886,875,627,766,825,796.0,739.0,59,139,-80
160,10,26,1,1,1,90,44,91,57,97,100,90,105,124,72,100,114,107.0,95.0,14,28,-14
1591,11,26,1,1,1,839,575,787,801,890,962,857,1124,918,791,915,1007,961.0,904.0,92,124,-32
227,12,26,1,1,1,113,57,129,99,112,125,115,140,155,101,129,108,118.0,113.0,-21,28,-49
376,13,26,1,1,1,230,131,173,183,199,229,221,266,200,202,203,219,211.0,208.0,16,1,15
357,14,26,1,1,1,217,145,193,185,185,207,254,276,252,194,283,262,272.0,246.0,-21,89,-110
1436,15,26,1,1,1,742,438,716,641,723,810,824,880,834,733,849,908,878.0,830.0,59,116,-57
436,16,26,1,1,1,251,130,265,212,243,260,260,327,326,230,315,356,336.0,300.0,41,85,-44
302,17,26,1,1,1,158,71,152,121,164,200,157,190,184,143,174,192,183.0,170.0,18,31,-13
500,18,26,1,1,1,250,119,238,208,225,265,234,296,266,197,227,256,242.0,227.0,29,30,-1
304,19,26,1,1,1,233,145,170,172,190,254,215,281,225,176,194,227,210.0,199.0,33,18,15
265,20,26,1,1,1,151,113,138,114,168,164,192,184,176,151,174,194,184.0,173.0,20,23,-3
307,21,26,1,1,1,241,141,184,186,174,206,235,213,228,210,194,216,205.0,207.0,22,-16,38
102,22,26,1,1,1,65,52,69,62,72,97,59,106,77,74,83,85,84.0,81.0,2,9,-7
80,1,27,4,1,1,185,90,185,166,151,149,152,203,190,188,201,262,232.0,217.0,61,13,48
26,2,27,4,1,1,48,23,65,81,86,43,35,60,52,76,100,59,80.0,78.0,-41,24,-65
22,3,27,4,1,1,30,20,44,34,38,23,35,33,31,42,40,37,38.0,40.0,-3,-2,-1
93,4,27,4,1,1,175,106,251,267,259,192,172,203,232,200,230,226,228.0,219.0,-4,30,-34
57,5,27,4,1,1,142,100,155,124,131,94,121,152,216,166,240,223,232.0,210.0,-17,74,-91
57,6,27,4,1,1,64,58,93,91,91,85,90,104,106,110,130,121,126.0,120.0,-9,20,-29
113,7,27,4,1,1,172,97,238,273,264,203,199,232,258,215,231,199,215.0,215.0,-32,16,-48
16,8,27,4,1,1,29,17,30,23,35,28,32,37,31,31,28,33,30.0,31.0,5,-3,8
120,9,27,4,1,1,215,83,239,207,253,209,182,223,290,309,396,384,390.0,363.0,-12,87,-99
20,10,27,4,1,1,32,18,29,21,31,23,25,29,35,34,41,40,40.0,38.0,-1,7,-8
225,11,27,4,1,1,418,314,442,327,438,345,389,471,447,420,635,591,613.0,549.0,-44,215,-259
10,12,27,4,1,1,62,29,37,44,50,31,41,43,50,52,66,85,76.0,68.0,19,14,5
78,13,27,4,1,1,125,87,128,105,161,119,127,130,145,141,166,161,164.0,156.0,-5,25,-30
57,14,27,4,1,1,97,59,126,107,118,88,93,86,118,117,128,163,146.0,136.0,35,11,24
168,15,27,4,1,1,325,270,423,431,415,297,361,382,415,422,523,567,545.0,504.0,44,101,-57
48,16,27,4,1,1,88,58,96,72,86,72,79,106,110,92,120,142,131.0,118.0,22,28,-6
41,17,27,4,1,1,79,38,74,84,62,48,45,64,96,79,112,124,118.0,105.0,12,33,-21
23,18,27,4,1,1,86,35,60,68,83,59,50,84,61,85,108,127,118.0,107.0,19,23,-4
28,19,27,4,1,1,143,51,101,79,77,61,82,88,87,77,106,83,94.0,89.0,-23,29,-52
17,20,27,4,1,1,26,28,40,35,34,28,26,35,47,43,77,67,72.0,62.0,-10,34,-44
41,21,27,4,1,1,70,35,72,77,99,52,57,82,79,83,68,82,75.0,78.0,14,-15,29
18,22,27,4,1,1,13,36,71,63,68,50,44,61,42,40,48,45,46.0,44.0,-3,8,-11
378,1,28,2,1,1,699,285,625,493,512,736,581,360,145,129,306,492,399.0,309.0,186,177,9
140,2,28,2,1,1,272,144,215,224,243,237,221,153,83,75,142,154,148.0,124.0,12,67,-55
121,3,28,2,1,1,156,85,133,133,164,131,165,105,47,48,67,109,88.0,75.0,42,19,23
511,4,28,2,1,1,802,303,713,701,789,881,663,502,321,175,311,576,444.0,354.0,265,136,129
495,5,28,2,1,1,730,397,598,495,600,609,554,488,356,206,340,526,433.0,357.0,186,134,52
304,6,28,2,1,1,402,181,295,315,306,319,309,208,104,111,219,307,263.0,212.0,88,108,-20
406,7,28,2,1,1,609,326,543,643,668,672,573,446,246,241,312,378,345.0,310.0,66,71,-5
94,8,28,2,1,1,168,91,129,126,145,145,138,80,47,46,58,83,70.0,62.0,25,12,13
598,9,28,2,1,1,883,191,803,692,927,973,869,740,398,282,593,912,752.0,596.0,319,311,8
74,10,28,2,1,1,143,51,92,69,104,120,85,95,39,30,50,68,59.0,49.0,18,20,-2
993,11,28,2,1,1,1261,705,1330,1133,1369,1500,1116,610,270,351,609,1028,818.0,663.0,419,258,161
200,12,28,2,1,1,248,111,177,180,188,194,175,130,47,59,107,208,158.0,125.0,101,48,53
342,13,28,2,1,1,460,274,446,396,489,506,429,351,172,141,298,340,319.0,260.0,42,157,-115
290,14,28,2,1,1,440,194,359,443,350,442,406,206,143,136,170,239,204.0,182.0,69,34,35
996,15,28,2,1,1,1571,893,1531,1481,1596,1826,1257,815,643,498,965,1300,1132.0,921.0,335,467,-132
334,16,28,2,1,1,405,186,290,320,331,346,286,253,116,101,212,331,272.0,215.0,119,111,8
284,17,28,2,1,1,423,183,302,305,370,344,325,229,78,92,180,310,245.0,194.0,130,88,42
229,18,28,2,1,1,317,100,249,210,345,285,288,200,69,95,138,176,157.0,136.0,38,43,-5
256,19,28,2,1,1,358,174,359,364,390,459,433,291,193,157,189,261,225.0,202.0,72,32,40
115,20,28,2,1,1,224,111,157,161,172,225,158,135,51,35,76,157,116.0,89.0,81,41,40
223,21,28,2,1,1,337,163,253,275,312,315,249,241,115,96,127,205,166.0,143.0,78,31,47
104,22,28,2,1,1,165,153,325,234,241,211,111,123,58,56,108,145,126.0,103.0,37,52,-15
266,1,29,1,1,1,400,161,390,364,320,327,408,528,494,298,341,507,424.0,382.0,166,43,123
142,2,29,1,1,1,199,126,173,191,127,108,198,213,197,180,169,225,197.0,191.0,56,-11,67
76,3,29,1,1,1,149,83,156,132,135,136,178,178,174,157,121,169,145.0,149.0,48,-36,84
177,4,29,1,1,1,436,187,418,394,364,332,388,450,529,355,417,450,434.0,407.0,33,62,-29
242,5,29,1,1,1,450,292,385,337,371,406,440,533,641,403,433,394,414.0,410.0,-39,30,-69
160,6,29,1,1,1,314,133,230,208,185,223,244,297,328,172,256,310,283.0,246.0,54,84,-30
305,7,29,1,1,1,375,238,402,377,302,378,352,487,582,453,469,507,488.0,476.0,38,16,22
55,8,29,1,1,1,142,77,141,107,116,114,132,168,143,117,124,97,110.0,113.0,-27,7,-34
435,9,29,1,1,1,782,200,616,587,591,684,704,813,867,710,821,895,858.0,809.0,74,111,-37
79,10,29,1,1,1,131,77,129,95,81,120,108,129,137,85,114,124,119.0,108.0,10,29,-19
552,11,29,1,1,1,865,510,885,789,826,854,952,1272,1166,688,937,1154,1046.0,926.0,217,249,-32
106,12,29,1,1,1,192,99,172,121,144,151,183,202,193,186,189,178,184.0,184.0,-11,3,-14
179,13,29,1,1,1,246,170,325,291,244,275,310,427,423,324,327,378,352.0,343.0,51,3,48
156,14,29,1,1,1,284,161,241,351,217,257,301,336,420,237,276,308,292.0,274.0,32,39,-7
550,15,29,1,1,1,894,537,1058,811,816,971,1162,1196,1045,917,1072,1169,1120.0,1053.0,97,155,-58
261,16,29,1,1,1,375,173,366,272,236,352,315,395,429,270,308,378,343.0,319.0,70,38,32
145,17,29,1,1,1,397,132,288,231,235,286,268,360,359,193,226,309,268.0,243.0,83,33,50
168,18,29,1,1,1,310,107,228,247,214,238,244,281,263,253,214,293,254.0,253.0,79,-39,118
86,19,29,1,1,1,201,110,199,192,184,149,191,241,242,174,177,213,195.0,188.0,36,3,33
65,20,29,1,1,1,119,62,91,84,83,135,121,146,128,96,89,130,110.0,105.0,41,-7,48
112,21,29,1,1,1,186,76,153,141,143,148,200,229,215,165,164,174,169.0,168.0,10,-1,11
44,22,29,1,1,1,89,83,190,96,96,121,92,130,140,82,95,85,90.0,87.0,-10,13,-23
538,1,30,1,1,1,616,224,524,428,462,576,421,521,504,402,593,748,670.0,581.0,155,191,-36
263,2,30,1,1,1,351,173,285,234,259,204,306,266,231,316,323,344,334.0,328.0,21,7,14
197,3,30,1,1,1,187,106,139,167,203,169,162,217,201,207,206,200,203.0,204.0,-6,-1,-5
755,4,30,1,1,1,924,395,929,887,986,1008,845,898,731,715,939,1050,994.0,901.0,111,224,-113
624,5,30,1,1,1,821,418,657,632,753,748,554,658,1072,583,560,641,600.0,595.0,81,-23,104
330,6,30,1,1,1,342,151,261,270,316,300,257,346,329,282,331,409,370.0,341.0,78,49,29
659,7,30,1,1,1,603,383,514,607,578,623,481,543,678,438,630,646,638.0,571.0,16,192,-176
120,8,30,1,1,1,162,83,103,127,142,127,114,155,143,139,142,103,122.0,128.0,-39,3,-42
1269,9,30,1,1,1,1584,325,1013,985,1219,1303,1074,1237,1342,1295,1408,1829,1618.0,1511.0,421,113,308
213,10,30,1,1,1,206,70,170,96,158,161,124,125,189,162,142,255,198.0,186.0,113,-20,133
1304,11,30,1,1,1,1186,635,1034,965,1031,1078,842,1106,1255,1040,1108,1430,1269.0,1193.0,322,68,254
282,12,30,1,1,1,311,105,194,206,264,228,177,230,275,218,275,247,261.0,247.0,-28,57,-85
425,13,30,1,1,1,413,205,365,330,420,442,396,476,471,407,417,527,472.0,450.0,110,10,100
442,14,30,1,1,1,511,240,352,404,359,472,400,422,469,405,382,502,442.0,430.0,120,-23,143
938,15,30,1,1,1,1337,585,1059,1028,1051,1251,1000,1181,1241,932,1214,1500,1357.0,1215.0,286,282,4
572,16,30,1,1,1,558,243,406,406,395,467,358,427,529,447,473,526,500.0,482.0,53,26,27
374,17,30,1,1,1,602,204,413,420,443,451,322,451,476,369,391,505,448.0,422.0,114,22,92
335,18,30,1,1,1,426,140,232,234,345,272,282,266,282,298,320,358,339.0,325.0,38,22,16
281,19,30,1,1,1,399,232,362,315,405,340,365,459,418,357,335,454,394.0,382.0,119,-22,141
199,20,30,1,1,1,257,121,206,221,225,291,189,230,259,188,209,244,226.0,214.0,35,21,14
325,21,30,1,1,1,363,168,242,253,346,302,281,312,352,366,242,346,294.0,318.0,104,-124,228
139,22,30,1,1,1,178,130,276,201,264,224,175,240,219,123,190,198,194.0,170.0,8,67,-59
543,1,31,2,1,1,673,306,722,679,634,547,444,607,438,357,513,576,544.0,482.0,63,156,-93
243,2,31,2,1,1,272,151,279,225,250,183,177,213,139,117,236,257,246.0,203.0,21,119,-98
54,3,31,2,1,1,68,26,82,69,87,52,46,43,47,37,60,80,70.0,59.0,20,23,-3
536,4,31,2,1,1,694,262,673,614,681,595,494,449,410,328,585,816,700.0,576.0,231,257,-26
591,5,31,2,1,1,562,275,561,619,591,569,444,445,455,290,447,593,520.0,443.0,146,157,-11
322,6,31,2,1,1,361,174,315,300,376,284,251,265,236,233,275,385,330.0,298.0,110,42,68
468,7,31,2,1,1,484,202,484,554,521,386,382,358,297,285,401,440,420.0,375.0,39,116,-77
57,8,31,2,1,1,61,35,81,62,68,61,45,60,31,30,61,103,82.0,65.0,42,31,11
1274,9,31,2,1,1,1303,316,1135,1224,1221,1023,972,1033,800,773,983,1319,1151.0,1025.0,336,210,126
115,10,31,2,1,1,142,61,151,132,140,110,112,99,93,94,126,167,146.0,129.0,41,32,9
1203,11,31,2,1,1,1221,611,1328,1233,1314,879,894,893,729,862,988,1160,1074.0,1003.0,172,126,46
185,12,31,2,1,1,211,72,178,202,203,160,175,134,144,96,129,200,164.0,142.0,71,33,38
417,13,31,2,1,1,290,131,280,289,334,287,249,266,194,192,281,283,282.0,252.0,2,89,-87
258,14,31,2,1,1,302,144,309,370,322,315,276,272,209,174,237,350,294.0,254.0,113,63,50
1540,15,31,2,1,1,1803,930,1725,1897,1719,1389,1189,1547,1208,929,1465,1724,1594.0,1373.0,259,536,-277
271,16,31,2,1,1,272,118,290,306,263,266,203,235,199,144,218,283,250.0,215.0,65,74,-9
375,17,31,2,1,1,420,181,345,396,354,336,258,251,209,203,255,374,314.0,277.0,119,52,67
352,18,31,2,1,1,336,139,298,266,319,252,323,276,236,214,251,346,298.0,270.0,95,37,58
215,19,31,2,1,1,204,138,306,327,247,205,195,187,133,91,159,186,172.0,145.0,27,68,-41
198,20,31,2,1,1,206,140,246,273,262,227,183,189,132,105,200,253,226.0,186.0,53,95,-42
188,21,31,2,1,1,188,116,215,204,258,182,135,163,159,132,134,174,154.0,147.0,40,2,38
70,22,31,2,1,1,67,38,108,94,88,66,52,57,23,28,58,76,67.0,54.0,18,30,-12
333,1,32,3,1,1,754,130,248,205,249,256,328,379,426,299,501,825,663.0,542.0,324,202,122
1050,2,32,3,1,1,1235,715,584,517,594,552,695,707,913,926,928,1393,1160.0,1082.0,465,2,463
185,3,32,3,1,1,207,80,151,118,129,99,134,132,200,230,272,405,338.0,302.0,133,42,91
178,4,32,3,1,1,920,174,284,352,376,194,240,313,370,330,446,852,649.0,543.0,406,116,290
1063,5,32,3,1,1,1477,971,753,633,599,569,778,755,971,792,934,1509,1222.0,1078.0,575,142,433
1965,6,32,3,1,1,2000,1583,836,765,835,790,1052,1349,1421,1263,1461,2601,2031.0,1775.0,1140,198,942
2858,7,32,3,1,1,3560,2065,1669,1567,2055,1628,2244,2677,2814,2975,3077,5360,4218.0,3804.0,2283,102,2181
701,8,32,3,1,1,629,273,351,377,360,353,542,640,778,791,803,1442,1122.0,1012.0,639,12,627
3465,9,32,3,1,1,6216,1524,3366,2719,3307,2768,3295,4086,5098,5032,5800,8421,7110.0,6418.0,2621,768,1853
2981,10,32,3,1,1,4995,2862,2406,1619,1976,1690,1981,2497,3110,3025,3479,6171,4825.0,4225.0,2692,454,2238
2028,11,32,3,1,1,2589,1515,1369,1121,1352,1272,1577,1829,2045,1978,2153,3757,2955.0,2629.0,1604,175,1429
827,12,32,3,1,1,1019,578,516,412,417,410,598,635,806,703,736,1319,1028.0,919.0,583,33,550
1366,13,32,3,1,1,1562,921,863,830,1060,888,1184,1505,1631,1500,1789,2863,2326.0,2051.0,1074,289,785
6024,14,32,3,1,1,7181,3619,2609,2474,2930,3020,3796,4302,4617,4700,5194,9539,7366.0,6478.0,4345,494,3851
934,15,32,3,1,1,1860,626,867,616,852,799,1096,1291,1435,1528,1653,2646,2150.0,1942.0,993,125,868
1137,16,32,3,1,1,1580,792,578,459,481,488,678,753,891,696,982,1629,1306.0,1102.0,647,286,361
1658,17,32,3,1,1,1663,846,806,812,802,747,984,1113,1544,1234,1513,2352,1932.0,1700.0,839,279,560
453,18,32,3,1,1,897,279,474,380,411,360,626,548,706,724,738,1086,912.0,849.0,348,14,334
408,19,32,3,1,1,494,214,377,398,383,376,528,616,644,644,694,1039,866.0,792.0,345,50,295
324,20,32,3,1,1,745,422,371,270,261,287,297,277,359,279,304,514,409.0,366.0,210,25,185
937,21,32,3,1,1,954,433,412,456,460,358,538,648,785,855,1045,1704,1374.0,1201.0,659,190,469
394,22,32,3,1,1,474,292,439,350,475,475,643,791,839,638,832,1045,938.0,838.0,213,194,19
389,1,33,2,1,1,1329,432,848,740,785,835,1350,1065,2065,1032,1283,1483,1383.0,1266.0,200,251,-51
208,2,33,2,1,1,412,240,292,229,244,208,404,346,402,396,360,567,464.0,441.0,207,-36,243
413,3,33,2,1,1,836,289,446,450,527,415,569,575,712,648,698,789,744.0,712.0,91,50,41
143,4,33,2,1,1,595,219,346,342,374,346,429,397,451,276,389,488,438.0,384.0,99,113,-14
531,5,33,2,1,1,1109,594,746,756,677,695,682,820,1286,786,820,1117,968.0,908.0,297,34,263
385,6,33,2,1,1,676,322,351,363,414,357,477,644,726,594,615,705,660.0,638.0,90,21,69
803,7,33,2,1,1,2189,844,1400,1356,1271,1075,1292,1454,1777,1435,1352,1707,1530.0,1498.0,355,-83,438
131,8,33,2,1,1,439,139,326,295,376,259,310,346,391,347,352,464,408.0,388.0,112,5,107
130,9,33,2,1,1,385,70,223,205,277,296,248,286,326,342,407,475,441.0,408.0,68,65,3
93,10,33,2,1,1,217,114,135,110,154,153,106,135,181,167,158,231,194.0,185.0,73,-9,82
991,11,33,2,1,1,2487,1375,2036,1589,1718,1504,1598,2024,2099,1880,1868,2181,2024.0,1976.0,313,-12,325
251,12,33,2,1,1,719,227,332,338,384,268,290,349,532,430,438,495,466.0,454.0,57,8,49
546,13,33,2,1,1,1190,526,697,668,745,713,769,1026,1153,782,978,1229,1104.0,996.0,251,196,55
508,14,33,2,1,1,1052,432,507,691,656,595,849,951,954,750,835,1053,944.0,879.0,218,85,133
348,15,33,2,1,1,1069,476,727,703,696,655,723,773,920,884,1063,1213,1138.0,1053.0,150,179,-29
200,16,33,2,1,1,473,168,248,264,212,303,273,340,406,336,358,440,399.0,378.0,82,22,60
385,17,33,2,1,1,736,271,375,384,428,388,473,550,688,528,670,749,710.0,649.0,79,142,-63
188,18,33,2,1,1,545,170,319,281,308,207,297,275,314,302,385,408,396.0,365.0,23,83,-60
53,19,33,2,1,1,215,103,162,132,162,151,156,254,246,156,195,210,202.0,187.0,15,39,-24
131,20,33,2,1,1,212,110,142,161,182,218,192,205,240,178,181,295,238.0,218.0,114,3,111
412,21,33,2,1,1,1380,510,777,772,950,666,1062,1276,1109,958,1012,1286,1149.0,1085.0,274,54,220
66,22,33,2,1,1,237,157,262,257,265,200,199,236,256,202,210,228,219.0,213.0,18,8,10
950,1,34,2,1,1,388,191,341,301,229,293,265,342,422,337,524,679,602.0,513.0,155,187,-32
131,2,34,2,1,1,55,23,57,93,77,88,123,129,142,173,215,293,254.0,227.0,78,42,36
60,3,34,2,1,1,44,20,43,68,68,57,63,80,87,94,102,118,110.0,105.0,16,8,8
180,4,34,2,1,1,135,57,160,141,144,157,165,158,241,166,231,280,256.0,226.0,49,65,-16
151,5,34,2,1,1,120,80,119,165,176,134,135,208,419,226,291,404,348.0,307.0,113,65,48
116,6,34,2,1,1,71,32,69,84,82,105,84,146,172,127,176,201,188.0,168.0,25,49,-24
230,7,34,2,1,1,219,87,288,336,249,208,207,253,405,274,383,451,417.0,369.0,68,109,-41
42,8,34,2,1,1,37,21,25,37,54,47,58,68,104,75,85,95,90.0,85.0,10,10,0
104,9,34,2,1,1,126,21,94,95,114,119,105,149,140,175,225,268,246.0,223.0,43,50,-7
30,10,34,2,1,1,41,19,28,27,26,35,28,43,42,39,42,71,56.0,51.0,29,3,26
334,11,34,2,1,1,265,167,319,322,305,326,286,477,566,501,644,669,656.0,605.0,25,143,-118
64,12,34,2,1,1,79,25,53,46,68,55,61,72,97,83,104,86,95.0,91.0,-18,21,-39
140,13,34,2,1,1,119,50,125,133,124,117,113,185,186,192,206,272,239.0,223.0,66,14,52
144,14,34,2,1,1,95,57,78,115,86,115,109,191,156,169,219,319,269.0,236.0,100,50,50
190,15,34,2,1,1,146,62,153,241,174,199,216,262,293,289,400,452,426.0,380.0,52,111,-59
146,16,34,2,1,1,61,17,36,44,55,47,45,58,71,47,81,82,82.0,70.0,1,34,-33
105,17,34,2,1,1,127,44,96,96,123,93,121,118,158,115,135,228,182.0,159.0,93,20,73
77,18,34,2,1,1,85,32,69,44,77,80,72,82,93,107,132,139,136.0,126.0,7,25,-18
42,19,34,2,1,1,39,14,35,39,48,22,42,64,69,52,62,81,72.0,65.0,19,10,9
44,20,34,2,1,1,22,14,28,31,19,68,61,42,66,46,77,87,82.0,70.0,10,31,-21
124,21,34,2,1,1,77,45,125,134,132,92,109,169,208,170,201,238,220.0,203.0,37,31,6
22,22,34,2,1,1,30,14,33,46,45,30,38,60,45,45,56,48,52.0,50.0,-8,11,-19
238,1,35,2,1,1,344,119,239,228,169,138,110,96,130,129,206,317,262.0,217.0,111,77,34
64,2,35,2,1,1,106,51,78,75,180,62,53,48,150,68,61,94,78.0,74.0,33,-7,40
119,3,35,2,1,1,126,54,113,86,107,104,115,80,59,69,77,114,96.0,87.0,37,8,29
488,4,35,2,1,1,391,190,502,679,1478,362,522,549,341,411,466,954,710.0,610.0,488,55,433
493,5,35,2,1,1,670,362,298,337,329,313,287,213,226,219,270,560,415.0,350.0,290,51,239
238,6,35,2,1,1,289,151,173,287,132,112,137,105,226,131,164,192,178.0,162.0,28,33,-5
609,7,35,2,1,1,594,229,452,634,622,583,483,376,451,391,462,714,588.0,522.0,252,71,181
168,8,35,2,1,1,222,106,160,138,173,121,88,87,81,104,152,230,191.0,162.0,78,48,30
1283,9,35,2,1,1,1663,446,1134,1049,1151,1204,796,688,783,887,1988,1893,1940.0,1589.0,-95,1101,-1196
316,10,35,2,1,1,402,172,287,232,292,302,238,333,211,167,204,333,268.0,235.0,129,37,92
785,11,35,2,1,1,829,528,715,817,757,633,614,701,409,489,602,865,734.0,652.0,263,113,150
264,12,35,2,1,1,276,130,160,214,361,199,120,104,272,168,194,280,237.0,214.0,86,26,60
387,13,35,2,1,1,374,156,276,257,299,271,278,358,279,275,250,454,352.0,326.0,204,-25,229
319,14,35,2,1,1,282,134,161,254,201,225,287,201,184,168,191,300,246.0,220.0,109,23,86
577,15,35,2,1,1,747,387,571,611,676,536,359,406,355,572,795,787,791.0,718.0,-8,223,-231
545,16,35,2,1,1,647,280,556,499,394,422,178,222,287,394,374,566,470.0,445.0,192,-20,212
412,17,35,2,1,1,472,189,281,349,524,267,270,181,332,203,423,412,418.0,346.0,-11,220,-231
555,18,35,2,1,1,572,172,320,297,502,255,324,353,331,397,363,562,462.0,441.0,199,-34,233
230,19,35,2,1,1,375,169,322,331,310,263,240,234,219,239,228,340,284.0,269.0,112,-11,123
378,20,35,2,1,1,324,201,377,423,567,467,292,184,281,158,348,846,597.0,451.0,498,190,308
138,21,35,2,1,1,163,51,99,165,127,82,202,64,63,62,99,126,112.0,96.0,27,37,-10
57,22,35,2,1,1,105,67,124,102,107,81,71,56,91,46,89,107,98.0,81.0,18,43,-25
264,1,36,1,1,1,480,172,381,276,268,259,263,265,263,222,276,374,325.0,291.0,98,54,44
403,2,36,1,1,1,456,233,291,288,287,259,444,328,322,420,444,423,434.0,429.0,-21,24,-45
534,3,36,1,1,1,507,191,345,439,598,415,527,467,541,608,505,619,562.0,577.0,114,-103,217
741,4,36,1,1,1,929,334,863,864,925,776,823,803,1019,845,1016,1441,1228.0,1101.0,425,171,254
940,5,36,1,1,1,1262,708,697,804,780,668,723,668,1080,712,743,1078,910.0,844.0,335,31,304
247,6,36,1,1,1,324,148,191,191,212,209,143,177,210,217,212,273,242.0,234.0,61,-5,66
688,7,36,1,1,1,697,229,560,823,816,666,592,643,866,764,681,1011,846.0,819.0,330,-83,413
274,8,36,1,1,1,281,110,206,261,279,232,228,276,283,280,288,348,318.0,305.0,60,8,52
1849,9,36,1,1,1,2451,557,1603,1334,1757,1676,1516,1456,1686,2097,2144,2562,2353.0,2268.0,418,47,371
364,10,36,1,1,1,425,173,357,308,368,312,289,221,333,376,342,443,392.0,387.0,101,-34,135
658,11,36,1,1,1,897,397,732,642,720,594,521,656,670,713,682,857,770.0,751.0,175,-31,206
334,12,36,1,1,1,329,183,215,284,272,228,226,207,304,324,277,382,330.0,328.0,105,-47,152
804,13,36,1,1,1,770,350,512,623,789,655,636,756,829,875,790,1042,916.0,902.0,252,-85,337
654,14,36,1,1,1,563,314,442,561,418,478,457,520,525,514,567,656,612.0,579.0,89,53,36
632,15,36,1,1,1,876,397,692,688,672,696,609,628,658,707,687,970,828.0,788.0,283,-20,303
1429,16,36,1,1,1,1485,607,1019,976,969,1189,812,879,1194,1234,1296,1458,1377.0,1329.0,162,62,100
712,17,36,1,1,1,776,324,451,527,529,432,433,504,586,532,579,879,729.0,663.0,300,47,253
387,18,36,1,1,1,586,200,378,320,437,254,309,324,331,423,388,523,456.0,445.0,135,-35,170
571,19,36,1,1,1,777,379,785,855,952,717,778,859,919,871,786,1105,946.0,921.0,319,-85,404
616,20,36,1,1,1,547,319,482,469,390,863,400,378,452,406,568,732,650.0,569.0,164,162,2
561,21,36,1,1,1,645,204,415,526,586,401,428,429,480,618,464,618,541.0,567.0,154,-154,308
267,22,36,1,1,1,397,172,403,364,391,379,393,463,364,346,348,497,422.0,397.0,149,2,147
68,1,37,2,1,1,202,74,148,107,138,95,119,125,135,111,242,237,240.0,197.0,-5,131,-136
140,2,37,2,1,1,204,101,116,126,123,110,141,143,170,165,182,271,226.0,206.0,89,17,72
78,3,37,2,1,1,185,94,127,130,150,140,118,135,135,144,149,195,172.0,163.0,46,5,41
34,4,37,2,1,1,179,94,161,133,142,156,136,151,163,97,128,205,166.0,143.0,77,31,46
275,5,37,2,1,1,521,440,394,366,331,297,273,290,355,284,276,560,418.0,373.0,284,-8,292
209,6,37,2,1,1,340,185,162,134,155,164,187,210,258,234,289,496,392.0,340.0,207,55,152
241,7,37,2,1,1,523,264,365,376,429,398,297,370,455,430,397,599,498.0,475.0,202,-33,235
67,8,37,2,1,1,218,124,155,134,191,136,138,154,165,187,192,226,209.0,202.0,34,5,29
510,9,37,2,1,1,1448,467,1001,803,902,957,908,969,966,1096,1273,1753,1513.0,1374.0,480,177,303
161,10,37,2,1,1,265,158,173,112,150,145,121,133,163,183,209,314,262.0,235.0,105,26,79
484,11,37,2,1,1,695,533,542,500,626,524,494,659,663,720,808,1176,992.0,901.0,368,88,280
258,12,37,2,1,1,357,227,159,167,200,179,156,182,243,282,281,556,418.0,373.0,275,-1,276
164,13,37,2,1,1,350,201,227,222,334,278,240,275,311,284,290,435,362.0,336.0,145,6,139
252,14,37,2,1,1,499,268,207,216,293,353,273,313,316,283,364,562,463.0,403.0,198,81,117
332,15,37,2,1,1,693,426,580,534,604,578,536,581,660,738,799,1102,950.0,880.0,303,61,242
267,16,37,2,1,1,525,248,298,272,226,274,204,230,271,257,362,526,444.0,382.0,164,105,59
286,17,37,2,1,1,468,212,198,189,225,184,208,271,292,260,313,627,470.0,400.0,314,53,261
185,18,37,2,1,1,448,191,273,232,272,218,246,274,282,315,340,500,420.0,385.0,160,25,135
101,19,37,2,1,1,466,252,378,382,339,300,311,310,311,260,209,299,254.0,256.0,90,-51,141
179,20,37,2,1,1,242,182,208,200,174,215,160,199,165,151,159,317,238.0,209.0,158,8,150
89,21,37,2,1,1,167,74,107,132,119,143,116,126,114,163,141,242,192.0,182.0,101,-22,123
60,22,37,2,1,1,154,91,139,139,154,146,135,155,139,103,121,126,124.0,117.0,5,18,-13
175,1,38,2,1,1,359,125,152,176,401,401,321,346,427,336,1289,571,930.0,732.0,-718,953,-1671
160,2,38,2,1,1,276,106,125,149,202,186,247,218,226,257,285,393,339.0,312.0,108,28,80
236,3,38,2,1,1,439,102,151,182,235,185,198,218,291,326,339,631,485.0,432.0,292,13,279
232,4,38,2,1,1,309,106,458,579,619,663,697,743,797,664,656,980,818.0,767.0,324,-8,332
609,5,38,2,1,1,1085,517,383,511,577,808,786,904,1230,923,1016,1536,1276.0,1158.0,520,93,427
358,6,38,2,1,1,445,168,141,183,258,304,319,476,565,666,550,750,650.0,655.0,200,-116,316
1788,7,38,2,1,1,2478,846,1159,1838,2095,1935,1835,2200,2915,3148,3502,5481,4492.0,4044.0,1979,354,1625
502,8,38,2,1,1,729,276,388,385,544,496,521,585,792,899,919,1474,1196.0,1097.0,555,20,535
5306,9,38,2,1,1,9433,2322,6681,6500,8617,8587,8085,9999,11167,12710,12394,15317,13856.0,13474.0,2923,-316,3239
1195,10,38,2,1,1,1169,509,777,650,933,1046,1010,1186,1639,1709,1789,2693,2241.0,2064.0,904,80,824
1247,11,38,2,1,1,1739,775,917,1039,1356,1362,1273,1726,2274,2226,2622,3296,2959.0,2715.0,674,396,278
857,12,38,2,1,1,712,298,301,380,537,595,606,715,1083,1277,1265,1764,1514.0,1435.0,499,-12,511
1214,13,38,2,1,1,1469,607,575,834,1174,1117,1091,1516,1988,2221,2449,3796,3122.0,2822.0,1347,228,1119
1278,14,38,2,1,1,1652,766,966,1035,851,918,1151,1553,1783,1739,1951,3130,2540.0,2273.0,1179,212,967
700,15,38,2,1,1,775,268,670,888,1084,1050,1140,1443,1709,2001,2019,2088,2054.0,2036.0,69,18,51
736,16,38,2,1,1,786,283,464,568,585,851,689,870,1071,1120,1425,1562,1494.0,1369.0,137,305,-168
1244,17,38,2,1,1,1956,826,1099,1123,1343,1265,1384,1668,1721,1444,1769,3168,2468.0,2127.0,1399,325,1074
769,18,38,2,1,1,1153,324,743,748,1047,978,991,1227,1477,1846,1591,1981,1786.0,1806.0,390,-255,645
1059,19,38,2,1,1,2384,1130,2185,2416,2738,2351,2715,3298,3035,2443,2622,3705,3164.0,2923.0,1083,179,904
333,20,38,2,1,1,216,134,130,208,307,592,510,660,624,494,548,828,688.0,623.0,280,54,226
289,21,38,2,1,1,354,91,148,246,335,408,480,451,462,457,402,722,562.0,527.0,320,-55,375
350,22,38,2,1,1,569,195,290,315,472,426,421,630,651,605,913,1064,988.0,861.0,151,308,-157
250,1,39,1,1,1,295,124,267,256,231,232,275,253,330,234,241,272,256.0,249.0,31,7,24
494,2,39,1,1,1,412,150,218,222,273,237,317,281,288,285,282,383,332.0,317.0,101,-3,104
412,3,39,1,1,1,339,145,261,297,409,278,346,325,397,353,331,374,352.0,353.0,43,-22,65
336,4,39,1,1,1,541,169,385,428,423,454,541,459,651,432,527,798,662.0,586.0,271,95,176
560,5,39,1,1,1,519,255,328,404,345,365,374,356,560,353,364,502,433.0,406.0,138,11,127
378,6,39,1,1,1,480,224,248,311,364,321,347,370,464,369,339,449,394.0,386.0,110,-30,140
1132,7,39,1,1,1,1193,436,794,1159,1092,1036,1063,896,1347,1014,1020,1083,1052.0,1039.0,63,6,57
373,8,39,1,1,1,509,163,407,327,404,319,311,334,462,394,347,454,400.0,398.0,107,-47,154
2859,9,39,1,1,1,3704,894,2297,2056,2432,2474,2478,2391,3040,2810,2842,3119,2980.0,2924.0,277,32,245
376,10,39,1,1,1,369,114,277,228,279,260,273,237,346,287,279,316,298.0,294.0,37,-8,45
1012,11,39,1,1,1,1101,503,864,875,944,898,914,919,1153,908,905,1057,981.0,957.0,152,-3,155
397,12,39,1,1,1,496,183,259,334,387,321,370,350,407,325,334,414,374.0,358.0,80,9,71
797,13,39,1,1,1,689,304,529,645,721,619,623,691,837,696,646,778,712.0,707.0,132,-50,182
954,14,39,1,1,1,1153,524,743,938,870,860,976,801,1165,786,979,1154,1066.0,973.0,175,193,-18
752,15,39,1,1,1,915,336,591,647,679,619,746,631,767,611,709,819,764.0,713.0,110,98,12
1405,16,39,1,1,1,1600,713,1120,1091,1131,1321,1289,1127,1463,1111,1292,1497,1394.0,1300.0,205,181,24
623,17,39,1,1,1,877,371,605,681,762,693,656,726,776,563,649,953,801.0,722.0,304,86,218
627,18,39,1,1,1,851,264,561,623,627,554,655,558,641,586,610,611,610.0,602.0,1,24,-23
758,19,39,1,1,1,870,348,596,668,714,579,727,667,816,696,727,851,789.0,758.0,124,31,93
248,20,39,1,1,1,281,106,151,162,139,215,222,181,222,152,145,208,176.0,168.0,63,-7,70
463,21,39,1,1,1,508,150,307,362,418,335,362,360,429,415,400,482,441.0,432.0,82,-15,97
617,22,39,1,1,1,579,233,643,636,673,545,503,567,621,450,630,549,590.0,543.0,-81,180,-261
114,1,40,1,1,1,278,193,307,268,271,242,256,281,287,238,345,456,400.0,346.0,111,107,4
406,2,40,1,1,1,291,184,287,277,288,270,381,345,327,285,338,442,390.0,355.0,104,53,51
195,3,40,1,1,1,213,130,221,205,287,238,235,267,246,282,331,382,356.0,332.0,51,49,2
121,4,40,1,1,1,270,124,239,243,275,251,253,208,303,262,356,580,468.0,399.0,224,94,130
459,5,40,1,1,1,432,303,495,459,461,461,453,451,636,487,569,804,686.0,620.0,235,82,153
403,6,40,1,1,1,409,276,362,355,346,364,377,400,439,428,489,503,496.0,473.0,14,61,-47
554,7,40,1,1,1,768,424,741,891,877,768,778,692,815,855,912,1164,1038.0,977.0,252,57,195
223,8,40,1,1,1,300,131,274,256,316,230,226,277,310,284,316,428,372.0,343.0,112,32,80
1930,9,40,1,1,1,2724,1092,2312,2006,2367,2317,2288,2219,2478,2450,3345,3730,3538.0,3175.0,385,895,-510
266,10,40,1,1,1,282,164,296,226,316,262,277,270,290,313,377,417,397.0,369.0,40,64,-24
877,11,40,1,1,1,1090,663,1174,1098,1171,1053,1035,1139,1193,1114,1454,1527,1490.0,1365.0,73,340,-267
305,12,40,1,1,1,310,179,286,283,344,324,354,314,340,317,350,507,428.0,391.0,157,33,124
453,13,40,1,1,1,439,276,466,466,575,563,517,521,590,551,574,797,686.0,641.0,223,23,200
630,14,40,1,1,1,622,387,631,701,609,620,657,647,687,548,872,1036,954.0,819.0,164,324,-160
739,15,40,1,1,1,868,560,868,916,952,851,928,863,800,942,1151,1258,1204.0,1117.0,107,209,-102
963,16,40,1,1,1,1097,649,859,860,857,1022,954,876,1065,918,1189,1511,1350.0,1206.0,322,271,51
420,17,40,1,1,1,557,265,432,418,440,412,436,456,456,452,506,737,622.0,565.0,231,54,177
473,18,40,1,1,1,657,320,585,524,634,509,574,525,556,643,734,779,756.0,719.0,45,91,-46
285,19,40,1,1,1,414,229,394,433,415,359,423,434,437,390,480,602,541.0,491.0,122,90,32
185,20,40,1,1,1,180,111,154,208,153,256,232,218,203,186,200,305,252.0,230.0,105,14,91
293,21,40,1,1,1,357,159,255,282,291,238,303,301,293,309,345,496,420.0,383.0,151,36,115
214,22,40,1,1,1,323,238,410,348,422,361,360,329,347,306,404,422,413.0,377.0,18,98,-80
224,1,41,3,1,1,246,127,288,255,249,227,228,228,248,166,277,348,312.0,264.0,71,111,-40
19,2,41,3,1,1,30,18,26,19,19,13,29,23,22,12,22,33,28.0,22.0,11,10,1
21,3,41,3,1,1,19,9,22,31,32,22,34,26,20,16,19,22,20.0,19.0,3,3,0
424,4,41,3,1,1,406,155,342,385,371,412,397,450,433,353,372,511,442.0,412.0,139,19,120
69,5,41,3,1,1,59,28,61,40,41,50,45,33,53,34,42,64,53.0,47.0,22,8,14
83,6,41,3,1,1,66,58,96,94,77,54,58,60,65,52,74,75,74.0,67.0,1,22,-21
430,7,41,3,1,1,346,131,279,291,321,323,323,300,349,309,286,341,314.0,312.0,55,-23,78
105,8,41,3,1,1,118,47,101,97,85,61,83,86,76,58,62,78,70.0,66.0,16,4,12
1009,9,41,3,1,1,1350,320,938,782,929,824,845,827,959,887,972,1235,1104.0,1031.0,263,85,178
34,10,41,3,1,1,37,19,27,25,33,22,15,35,23,23,13,26,20.0,21.0,13,-10,23
397,11,41,3,1,1,384,239,397,361,372,366,390,384,352,323,380,481,430.0,395.0,101,57,44
61,12,41,3,1,1,52,21,43,45,28,35,34,41,44,29,35,37,36.0,34.0,2,6,-4
308,13,41,3,1,1,221,115,209,215,221,251,231,259,229,234,231,316,274.0,260.0,85,-3,88
242,14,41,3,1,1,191,117,183,203,189,186,204,209,192,150,188,209,198.0,182.0,21,38,-17
353,15,41,3,1,1,296,167,351,324,279,263,302,300,252,293,323,375,349.0,330.0,52,30,22
54,16,41,3,1,1,65,33,64,65,48,56,41,58,58,26,64,62,63.0,51.0,-2,38,-40
54,17,41,3,1,1,46,26,45,53,33,37,54,26,47,25,31,44,38.0,33.0,13,6,7
92,18,41,3,1,1,96,36,100,71,65,63,56,64,42,57,83,105,94.0,82.0,22,26,-4
158,19,41,3,1,1,144,88,143,201,173,177,170,176,181,127,153,187,170.0,156.0,34,26,8
22,20,41,3,1,1,20,15,27,25,16,43,25,22,19,17,12,27,20.0,19.0,15,-5,20
61,21,41,3,1,1,22,15,29,33,50,39,32,34,19,25,29,46,38.0,33.0,17,4,13
66,22,41,3,1,1,82,40,94,92,117,107,90,78,77,62,61,65,63.0,63.0,4,-1,5
161,1,42,1,1,1,409,143,279,297,244,231,222,233,237,260,331,369,350.0,320.0,38,71,-33
386,2,42,1,1,1,380,236,312,304,293,280,397,351,388,519,521,651,586.0,564.0,130,2,128
146,3,42,1,1,1,170,96,126,103,173,112,115,149,181,185,190,234,212.0,203.0,44,5,39
210,4,42,1,1,1,405,149,302,248,267,240,223,271,313,223,301,382,342.0,302.0,81,78,3
509,5,42,1,1,1,599,310,417,389,401,386,408,384,645,492,617,839,728.0,649.0,222,125,97
387,6,42,1,1,1,571,255,336,313,328,323,371,429,508,453,504,690,597.0,549.0,186,51,135
444,7,42,1,1,1,685,296,546,625,677,569,603,642,825,774,709,964,836.0,816.0,255,-65,320
175,8,42,1,1,1,358,136,255,277,268,247,194,300,278,277,302,443,372.0,341.0,141,25,116
3229,9,42,1,1,1,5181,1286,3265,2736,3407,3034,2769,3466,3967,4449,4901,5547,5224.0,4966.0,646,452,194
381,10,42,1,1,1,523,241,394,300,323,305,295,375,362,434,458,665,562.0,519.0,207,24,183
690,11,42,1,1,1,1233,551,920,905,886,740,767,910,875,888,974,1139,1056.0,1000.0,165,86,79
381,12,42,1,1,1,493,221,252,298,296,306,326,283,440,408,499,625,562.0,511.0,126,91,35
407,13,42,1,1,1,576,281,454,470,518,437,434,560,591,602,602,830,716.0,678.0,228,0,228
507,14,42,1,1,1,650,307,448,487,451,445,414,574,666,620,614,920,767.0,718.0,306,-6,312
732,15,42,1,1,1,1364,648,939,1038,954,959,917,968,1148,998,1169,1424,1296.0,1197.0,255,171,84
698,16,42,1,1,1,1295,481,744,646,667,730,629,764,987,818,1066,1347,1206.0,1077.0,281,248,33
570,17,42,1,1,1,1022,381,522,540,567,522,526,503,752,630,700,988,844.0,773.0,288,70,218
605,18,42,1,1,1,914,277,559,556,633,509,603,671,676,754,796,1043,920.0,864.0,247,42,205
253,19,42,1,1,1,431,201,457,514,445,435,473,472,553,433,460,600,530.0,498.0,140,27,113
139,20,42,1,1,1,234,124,155,208,157,246,168,172,243,227,222,229,226.0,226.0,7,-5,12
140,21,42,1,1,1,181,60,111,120,179,148,148,164,191,253,229,293,261.0,258.0,64,-24,88
111,22,42,1,1,1,221,126,319,331,309,255,234,372,256,198,199,322,260.0,240.0,123,1,122
264,1,43,2,1,1,359,113,123,139,212,242,279,368,455,354,457,516,486.0,442.0,59,103,-44
206,2,43,2,1,1,154,94,88,54,90,69,134,137,168,236,233,253,243.0,241.0,20,-3,23
219,3,43,2,1,1,249,91,148,111,161,112,170,148,180,212,200,238,219.0,217.0,38,-12,50
601,4,43,2,1,1,1025,279,489,419,541,572,614,704,733,603,754,1094,924.0,817.0,340,151,189
391,5,43,2,1,1,476,287,296,215,215,241,286,280,498,363,489,543,516.0,465.0,54,126,-72
495,6,43,2,1,1,519,244,200,168,222,253,319,361,472,444,568,578,573.0,530.0,10,124,-114
1031,7,43,2,1,1,1082,373,450,449,644,594,653,771,1001,1018,1094,1221,1158.0,1111.0,127,76,51
316,8,43,2,1,1,596,250,187,190,307,319,310,398,381,370,395,605,500.0,457.0,210,25,185
2666,9,43,2,1,1,3205,739,2169,1283,1775,1807,1926,2292,2762,3019,3563,3747,3655.0,3443.0,184,544,-360
193,10,43,2,1,1,150,76,105,85,131,107,105,132,134,146,194,174,184.0,171.0,-20,48,-68
1070,11,43,2,1,1,1333,669,776,574,791,789,884,1139,1155,1292,1491,1524,1508.0,1436.0,33,199,-166
346,12,43,2,1,1,320,139,153,127,135,142,163,206,280,258,340,409,374.0,336.0,69,82,-13
789,13,43,2,1,1,998,454,423,400,560,621,573,819,812,975,971,1119,1045.0,1022.0,148,-4,152
692,14,43,2,1,1,744,364,326,261,356,378,472,519,592,609,805,866,836.0,760.0,61,196,-135
1138,15,43,2,1,1,1482,629,657,569,729,797,1116,1100,1259,1371,1516,1515,1516.0,1467.0,-1,145,-146
749,16,43,2,1,1,830,373,597,355,306,462,346,475,707,729,779,906,842.0,805.0,127,50,77
710,17,43,2,1,1,903,356,437,344,400,350,381,419,626,645,767,839,803.0,750.0,72,122,-50
509,18,43,2,1,1,611,185,292,182,309,251,400,389,434,571,612,638,625.0,607.0,26,41,-15
898,19,43,2,1,1,1187,442,556,678,921,843,1057,1068,1256,1020,1269,1395,1332.0,1228.0,126,249,-123
159,20,43,2,1,1,271,174,192,141,164,243,183,190,183,170,200,213,206.0,194.0,13,30,-17
227,21,43,2,1,1,215,89,158,121,222,212,278,246,251,273,309,371,340.0,318.0,62,36,26
366,22,43,2,1,1,618,230,238,301,459,440,381,659,536,422,639,783,711.0,615.0,144,217,-73
260,1,44,1,1,1,327,94,200,200,179,143,213,231,263,186,304,291,298.0,260.0,-13,118,-131
78,2,44,1,1,1,77,27,35,27,47,40,86,70,45,62,97,95,96.0,85.0,-2,35,-37
35,3,44,1,1,1,50,18,65,39,59,30,34,48,53,57,54,64,59.0,58.0,10,-3,13
435,4,44,1,1,1,533,209,530,530,580,328,387,431,542,458,551,739,645.0,583.0,188,93,95
270,5,44,1,1,1,222,120,157,199,189,198,208,192,406,218,246,296,271.0,253.0,50,28,22
156,6,44,1,1,1,118,55,65,66,77,68,83,102,108,119,125,125,125.0,123.0,0,6,-6
218,7,44,1,1,1,211,101,152,215,226,189,211,236,259,209,228,356,292.0,264.0,128,19,109
47,8,44,1,1,1,42,13,35,31,34,37,39,38,29,27,53,51,52.0,44.0,-2,26,-28
437,9,44,1,1,1,308,85,279,264,290,315,201,283,319,341,442,572,507.0,452.0,130,101,29
44,10,44,1,1,1,46,18,33,39,40,44,25,47,48,35,38,46,42.0,40.0,8,3,5
251,11,44,1,1,1,206,120,177,166,199,160,179,202,235,218,248,301,274.0,256.0,53,30,23
84,12,44,1,1,1,65,47,60,46,67,46,43,63,74,57,75,92,84.0,75.0,17,18,-1
106,13,44,1,1,1,107,47,72,82,94,85,75,106,81,95,123,131,127.0,116.0,8,28,-20
131,14,44,1,1,1,184,70,115,177,146,115,120,133,136,137,144,187,166.0,156.0,43,7,36
149,15,44,1,1,1,134,40,101,105,120,103,117,123,127,129,149,230,190.0,169.0,81,20,61
148,16,44,1,1,1,119,68,95,105,133,83,100,88,128,132,148,184,166.0,155.0,36,16,20
135,17,44,1,1,1,176,67,111,119,132,99,113,129,125,121,157,211,184.0,163.0,54,36,18
108,18,44,1,1,1,125,34,75,68,110,85,91,79,63,93,111,124,118.0,109.0,13,18,-5
69,19,44,1,1,1,78,37,96,78,114,94,86,129,93,93,126,129,128.0,116.0,3,33,-30
125,20,44,1,1,1,102,64,107,106,102,141,124,91,113,105,132,160,146.0,132.0,28,27,1
148,21,44,1,1,1,176,50,104,117,132,93,101,114,118,176,150,182,166.0,169.0,32,-26,58
53,22,44,1,1,1,50,27,72,66,58,77,51,83,64,44,71,77,74.0,64.0,6,27,-21
154,1,45,1,1,1,309,83,137,166,137,100,120,182,195,186,244,388,316.0,273.0,144,58,86
194,2,45,1,1,1,297,123,160,138,155,102,132,175,199,190,214,267,240.0,224.0,53,24,29
127,3,45,1,1,1,216,72,109,113,123,90,86,129,117,180,167,259,213.0,202.0,92,-13,105
71,4,45,1,1,1,414,84,168,157,135,132,124,189,195,143,181,370,276.0,231.0,189,38,151
448,5,45,1,1,1,689,306,341,347,268,235,259,271,451,335,432,691,562.0,486.0,259,97,162
712,6,45,1,1,1,951,409,428,406,511,409,457,615,665,719,699,1253,976.0,890.0,554,-20,574
549,7,45,1,1,1,1052,368,553,712,759,542,525,598,799,850,792,1449,1120.0,1030.0,657,-58,715
153,8,45,1,1,1,310,114,172,156,184,119,112,180,176,226,231,426,328.0,294.0,195,5,190
496,9,45,1,1,1,940,146,505,439,656,557,570,682,810,953,1204,1628,1416.0,1262.0,424,251,173
121,10,45,1,1,1,285,82,128,93,99,74,74,93,96,119,135,240,188.0,165.0,105,16,89
768,11,45,1,1,1,1269,617,835,685,815,558,664,879,928,1050,1083,1908,1496.0,1347.0,825,33,792
453,12,45,1,1,1,612,175,250,275,290,238,256,256,368,358,434,733,584.0,508.0,299,76,223
476,13,45,1,1,1,825,345,481,442,541,372,433,513,576,665,667,1158,912.0,830.0,491,2,489
910,14,45,1,1,1,1294,511,612,706,670,565,604,728,823,894,1006,1883,1444.0,1261.0,877,112,765
744,15,45,1,1,1,1452,570,741,745,772,623,618,806,968,1022,1202,2202,1702.0,1475.0,1000,180,820
443,16,45,1,1,1,552,200,249,254,222,214,224,236,278,353,409,749,579.0,504.0,340,56,284
378,17,45,1,1,1,533,190,262,282,299,206,221,263,352,322,439,744,592.0,502.0,305,117,188
265,18,45,1,1,1,373,106,251,186,224,163,185,197,242,345,391,594,492.0,443.0,203,46,157
75,19,45,1,1,1,244,102,164,167,172,127,118,166,151,176,186,256,221.0,206.0,70,10,60
124,20,45,1,1,1,132,69,103,86,60,103,92,81,101,86,92,172,132.0,117.0,80,6,74
144,21,45,1,1,1,333,120,165,166,180,107,108,126,155,205,212,325,268.0,247.0,113,7,106
43,22,45,1,1,1,158,68,172,142,116,90,66,138,116,107,126,152,139.0,128.0,26,19,7
65,1,46,1,1,1,165,39,67,57,61,83,70,93,94,69,88,96,92.0,84.0,8,19,-11
216,2,46,1,1,1,503,206,157,153,150,145,260,181,192,214,209,182,196.0,202.0,-27,-5,-22
132,3,46,1,1,1,260,111,103,103,189,132,152,130,174,176,130,141,136.0,149.0,11,-46,57
124,4,46,1,1,1,580,162,255,224,215,203,267,229,259,158,186,277,232.0,207.0,91,28,63
350,5,46,1,1,1,787,379,249,251,265,277,338,249,374,267,205,292,248.0,255.0,87,-62,149
513,6,46,1,1,1,964,370,259,261,334,403,369,409,407,332,341,384,362.0,352.0,43,9,34
555,7,46,1,1,1,963,329,460,477,501,534,578,578,669,572,480,596,538.0,549.0,116,-92,208
66,8,46,1,1,1,236,48,88,53,84,72,80,105,82,89,70,67,68.0,75.0,-3,-19,16
62,9,46,1,1,1,560,58,174,189,205,161,153,130,99,91,101,84,92.0,92.0,-17,10,-27
45,10,46,1,1,1,183,68,55,61,65,56,59,47,57,42,39,50,44.0,44.0,11,-3,14
538,11,46,1,1,1,1022,474,501,391,511,498,540,652,534,502,474,569,522.0,515.0,95,-28,123
360,12,46,1,1,1,675,234,206,222,322,296,334,361,423,281,274,309,292.0,288.0,35,-7,42
353,13,46,1,1,1,777,302,326,300,423,331,415,474,378,372,326,383,354.0,360.0,57,-46,103
538,14,46,1,1,1,1084,438,344,433,458,439,537,516,505,471,372,457,414.0,433.0,85,-99,184
388,15,46,1,1,1,1315,474,480,439,481,523,527,619,525,437,429,453,441.0,440.0,24,-8,32
474,16,46,1,1,1,824,291,253,287,274,347,357,348,470,379,317,421,369.0,372.0,104,-62,166
459,17,46,1,1,1,770,263,271,267,285,332,369,394,455,353,348,428,388.0,376.0,80,-5,85
136,18,46,1,1,1,349,89,110,105,117,97,156,140,150,148,127,159,143.0,145.0,32,-21,53
151,19,46,1,1,1,309,139,206,190,224,186,211,236,239,216,174,238,206.0,209.0,64,-42,106
110,20,46,1,1,1,363,173,118,113,119,207,154,160,119,108,151,126,138.0,128.0,-25,43,-68
180,21,46,1,1,1,461,167,172,200,295,195,243,241,219,279,210,288,249.0,259.0,78,-69,147
75,22,46,1,1,1,201,65,155,112,155,119,135,185,126,121,118,156,137.0,132.0,38,-3,41
208,1,47,2,1,1,270,36,140,123,151,184,200,260,330,188,341,384,362.0,304.0,43,153,-110
142,2,47,2,1,1,241,89,97,87,116,115,160,152,177,216,186,206,196.0,203.0,20,-30,50
74,3,47,2,1,1,135,53,68,89,116,92,95,118,103,121,125,115,120.0,120.0,-10,4,-14
253,4,47,2,1,1,872,197,494,429,502,404,587,598,646,461,553,771,662.0,595.0,218,92,126
673,5,47,2,1,1,990,423,370,360,435,525,529,541,770,548,657,933,795.0,713.0,276,109,167
964,6,47,2,1,1,1627,500,410,494,668,812,815,909,849,800,764,993,878.0,852.0,229,-36,265
1011,7,47,2,1,1,1313,526,689,772,912,798,955,1028,1068,979,957,1332,1144.0,1089.0,375,-22,397
128,8,47,2,1,1,297,89,124,155,182,158,166,260,200,213,203,275,239.0,230.0,72,-10,82
767,9,47,2,1,1,1192,150,692,651,912,826,970,1165,1341,1182,1660,1546,1603.0,1463.0,-114,478,-592
186,10,47,2,1,1,341,123,132,118,154,160,138,192,192,181,188,276,232.0,215.0,88,7,81
2094,11,47,2,1,1,2572,1169,1437,1322,1690,1549,1784,2086,2054,2015,2022,2642,2332.0,2226.0,620,7,613
614,12,47,2,1,1,744,225,275,317,446,403,446,466,481,368,453,691,572.0,504.0,238,85,153
530,13,47,2,1,1,1088,433,527,489,571,550,679,797,728,665,667,773,720.0,702.0,106,2,104
1865,14,47,2,1,1,2128,769,741,998,1156,1405,1588,1680,1676,1390,1577,2409,1993.0,1792.0,832,187,645
1022,15,47,2,1,1,2117,826,1017,1000,1198,1267,1405,1649,1572,1696,1832,2222,2027.0,1917.0,390,136,254
605,16,47,2,1,1,804,267,322,336,378,470,475,562,525,475,492,661,576.0,543.0,169,17,152
488,17,47,2,1,1,768,259,348,380,383,445,414,541,561,481,547,698,622.0,575.0,151,66,85
361,18,47,2,1,1,411,124,232,228,311,284,350,418,427,469,556,601,578.0,542.0,45,87,-42
161,19,47,2,1,1,279,111,190,228,287,226,287,309,335,246,211,328,270.0,262.0,117,-35,152
326,20,47,2,1,1,516,254,176,207,287,447,415,439,445,330,373,430,402.0,378.0,57,43,14
349,21,47,2,1,1,542,170,252,248,336,278,349,407,350,449,347,562,454.0,453.0,215,-102,317
69,22,47,2,1,1,154,58,136,101,109,89,128,149,133,82,97,100,98.0,93.0,3,15,-12
32,1,48,2,1,1,53,12,45,21,27,22,13,27,10,4,41,46,44.0,30.0,5,37,-32
142,2,48,2,1,1,388,230,170,165,176,148,181,200,159,126,119,169,144.0,138.0,50,-7,57
278,3,48,2,1,1,995,264,295,260,348,233,350,323,327,297,353,430,392.0,360.0,77,56,21
52,4,48,2,1,1,353,107,230,173,167,151,170,121,96,46,78,112,95.0,79.0,34,32,2
617,5,48,2,1,1,1774,976,914,753,701,834,869,836,723,408,517,641,579.0,522.0,124,109,15
278,6,48,2,1,1,663,352,281,292,330,322,293,261,211,71,198,190,194.0,153.0,-8,127,-135
1763,7,48,2,1,1,4313,1881,1411,1514,1697,1542,1763,1885,1782,1445,1562,2281,1922.0,1763.0,719,117,602
691,8,48,2,1,1,1841,559,695,566,798,670,854,973,842,579,768,886,827.0,744.0,118,189,-71
472,9,48,2,1,1,1492,337,851,657,797,730,793,791,821,619,710,1008,859.0,779.0,298,91,207
251,10,48,2,1,1,505,213,235,139,170,190,169,185,191,132,192,308,250.0,211.0,116,60,56
370,11,48,2,1,1,753,409,368,309,295,297,299,267,195,95,307,309,308.0,237.0,2,212,-210
224,12,48,2,1,1,678,297,223,225,303,258,215,138,145,60,177,182,180.0,140.0,5,117,-112
1468,13,48,2,1,1,4384,2024,1679,1513,1845,1547,1898,2125,1949,1092,1644,1840,1742.0,1525.0,196,552,-356
1101,14,48,2,1,1,2396,1096,746,823,772,817,797,693,546,306,774,911,842.0,664.0,137,468,-331
327,15,48,2,1,1,520,250,257,215,232,213,216,202,149,42,380,352,366.0,258.0,-28,338,-366
211,16,48,2,1,1,366,155,165,159,138,172,121,123,100,46,116,125,120.0,96.0,9,70,-61
230,17,48,2,1,1,522,201,197,204,204,207,195,142,140,74,141,165,153.0,127.0,24,67,-43
204,18,48,2,1,1,407,135,327,238,254,259,254,219,159,110,281,215,248.0,202.0,-66,171,-237
375,19,48,2,1,1,1022,315,497,548,622,615,791,715,654,384,528,619,574.0,510.0,91,144,-53
116,20,48,2,1,1,309,139,127,140,142,167,210,170,119,62,80,104,92.0,82.0,24,18,6
261,21,48,2,1,1,814,279,325,347,415,360,504,331,168,145,214,250,232.0,203.0,36,69,-33
207,22,48,2,1,1,645,228,325,312,349,289,307,328,302,291,350,342,346.0,328.0,-8,59,-67
174,1,49,1,1,1,320,64,143,153,184,190,187,321,371,283,435,596,516.0,438.0,161,152,9
444,2,49,1,1,1,310,120,243,214,293,278,391,368,477,514,538,699,618.0,584.0,161,24,137
221,3,49,1,1,1,283,95,150,144,231,182,278,328,337,354,323,485,404.0,387.0,162,-31,193
309,4,49,1,1,1,781,249,424,446,557,512,616,785,877,636,879,1517,1198.0,1011.0,638,243,395
743,5,49,1,1,1,739,359,385,442,498,519,553,602,1020,712,770,1305,1038.0,929.0,535,58,477
855,6,49,1,1,1,680,254,335,430,556,596,658,834,1066,894,964,1597,1280.0,1152.0,633,70,563
687,7,49,1,1,1,983,380,583,765,851,801,793,998,1278,1160,1107,1740,1424.0,1336.0,633,-53,686
192,8,49,1,1,1,314,106,151,162,214,187,206,301,280,282,301,514,408.0,366.0,213,19,194
542,9,49,1,1,1,1227,149,614,549,687,668,710,890,1382,1240,1586,1899,1742.0,1575.0,313,346,-33
260,10,49,1,1,1,327,107,187,136,186,226,201,232,277,266,309,514,412.0,363.0,205,43,162
939,11,49,1,1,1,1339,523,808,744,993,872,955,1345,1406,1396,1446,2279,1862.0,1707.0,833,50,783
502,12,49,1,1,1,463,121,209,241,288,279,356,409,638,519,571,900,736.0,663.0,329,52,277
708,13,49,1,1,1,867,350,577,540,727,602,725,929,1066,990,1108,1749,1428.0,1282.0,641,118,523
1331,14,49,1,1,1,1112,439,612,886,926,1021,1208,1438,1525,1493,1622,2735,2178.0,1950.0,1113,129,984
1119,15,49,1,1,1,1942,598,832,846,1069,1144,1284,1635,1804,1911,2130,3255,2692.0,2432.0,1125,219,906
597,16,49,1,1,1,472,187,282,287,324,375,419,485,678,560,634,1014,824.0,736.0,380,74,306
498,17,49,1,1,1,548,169,301,351,355,332,374,473,712,546,606,978,792.0,710.0,372,60,312
311,18,49,1,1,1,374,110,226,228,280,250,238,291,406,499,552,782,667.0,611.0,230,53,177
127,19,49,1,1,1,354,117,255,208,243,206,229,283,315,299,258,424,341.0,327.0,166,-41,207
260,20,49,1,1,1,314,131,137,183,177,223,193,277,336,267,309,532,420.0,369.0,223,42,181
315,21,49,1,1,1,440,175,215,218,355,227,253,326,373,472,366,620,493.0,486.0,254,-106,360
80,22,49,1,1,1,221,119,192,157,191,155,137,237,206,170,232,274,253.0,225.0,42,62,-20
369,1,50,4,1,1,377,167,243,160,176,192,187,249,257,239,345,396,370.0,327.0,51,106,-55
203,2,50,4,1,1,439,231,291,200,206,289,300,344,358,406,373,334,354.0,371.0,-39,-33,-6
51,3,50,4,1,1,136,39,69,59,78,58,65,160,123,116,59,90,74.0,88.0,31,-57,88
93,4,50,4,1,1,315,100,199,163,119,141,164,139,203,168,222,242,232.0,211.0,20,54,-34
288,5,50,4,1,1,825,448,557,450,413,455,488,625,731,758,778,781,780.0,772.0,3,20,-17
309,6,50,4,1,1,603,326,450,279,349,370,347,570,630,644,607,661,634.0,637.0,54,-37,91
540,7,50,4,1,1,1125,460,731,616,559,584,576,690,772,807,782,994,888.0,861.0,212,-25,237
88,8,50,4,1,1,255,97,151,126,140,127,162,287,240,200,132,201,166.0,178.0,69,-68,137
331,9,50,4,1,1,789,198,606,453,438,526,486,516,619,721,938,1135,1036.0,931.0,197,217,-20
140,10,50,4,1,1,413,155,278,158,185,230,205,301,268,247,370,403,386.0,340.0,33,123,-90
805,11,50,4,1,1,1936,1070,1579,700,765,791,837,1017,1020,1227,1286,1781,1534.0,1431.0,495,59,436
157,12,50,4,1,1,453,176,320,223,276,230,221,285,391,438,444,431,438.0,438.0,-13,6,-19
391,13,50,4,1,1,1016,455,668,556,558,552,574,734,729,766,589,806,698.0,720.0,217,-177,394
363,14,50,4,1,1,1137,475,738,578,632,668,840,854,777,834,729,896,812.0,820.0,167,-105,272
341,15,50,4,1,1,990,595,865,493,406,443,507,510,573,616,797,1044,920.0,819.0,247,181,66
270,16,50,4,1,1,594,248,391,284,238,303,280,357,375,452,413,461,437.0,442.0,48,-39,87
157,17,50,4,1,1,559,210,341,224,235,250,255,292,394,414,458,478,468.0,450.0,20,44,-24
250,18,50,4,1,1,791,270,489,293,325,290,310,328,339,397,455,593,524.0,482.0,138,58,80
45,19,50,4,1,1,185,84,145,108,118,118,139,151,144,114,136,149,142.0,133.0,13,22,-9
136,20,50,4,1,1,361,176,262,167,239,459,311,410,422,402,422,475,448.0,433.0,53,20,33
194,21,50,4,1,1,511,231,280,319,382,320,375,494,446,595,355,464,410.0,471.0,109,-240,349
40,22,50,4,1,1,172,107,198,154,180,125,146,202,237,176,82,87,84.0,115.0,5,-94,99
371,1,51,2,1,1,641,216,375,266,306,267,258,427,420,355,228,579,404.0,387.0,351,-127,478
215,2,51,2,1,1,375,183,225,152,177,118,180,214,200,244,165,338,252.0,249.0,173,-79,252
41,3,51,2,1,1,80,28,44,26,58,32,43,34,40,41,43,48,46.0,44.0,5,2,3
131,4,51,2,1,1,587,179,327,244,264,181,202,267,304,268,372,383,378.0,341.0,11,104,-93
550,5,51,2,1,1,832,424,488,398,410,336,352,370,632,431,484,820,652.0,578.0,336,53,283
508,6,51,2,1,1,855,330,403,387,411,362,305,443,521,495,362,758,560.0,538.0,396,-133,529
410,7,51,2,1,1,612,256,457,424,368,316,303,357,410,423,383,729,556.0,512.0,346,-40,386
74,8,51,2,1,1,139,52,102,63,71,48,59,51,78,61,91,136,114.0,96.0,45,30,15
1023,9,51,2,1,1,2156,403,1121,875,992,904,879,1153,1298,1305,1034,2232,1633.0,1524.0,1198,-271,1469
208,10,51,2,1,1,407,163,249,172,201,169,192,217,237,215,191,328,260.0,245.0,137,-24,161
1142,11,51,2,1,1,2028,1033,1427,1017,1202,877,845,1153,1190,1239,807,1846,1326.0,1297.0,1039,-432,1471
290,12,51,2,1,1,543,162,249,182,202,165,177,232,306,226,131,436,284.0,264.0,305,-95,400
287,13,51,2,1,1,538,224,327,290,285,257,243,316,360,308,272,475,374.0,352.0,203,-36,239
459,14,51,2,1,1,875,364,491,439,424,404,405,509,554,543,420,747,584.0,570.0,327,-123,450
752,15,51,2,1,1,1484,681,993,723,767,644,614,743,824,856,695,1454,1074.0,1002.0,759,-161,920
312,16,51,2,1,1,549,189,257,224,213,257,205,250,304,278,190,481,336.0,316.0,291,-88,379
324,17,51,2,1,1,592,187,320,299,303,226,226,283,329,289,235,425,330.0,316.0,190,-54,244
508,18,51,2,1,1,954,280,514,351,414,293,354,411,469,472,415,699,557.0,529.0,284,-57,341
66,19,51,2,1,1,186,95,156,120,126,118,94,128,154,125,64,125,94.0,105.0,61,-61,122
310,20,51,2,1,1,531,288,399,316,243,316,279,300,389,322,256,548,402.0,375.0,292,-66,358
170,21,51,2,1,1,321,118,154,172,180,121,162,175,188,226,181,259,220.0,222.0,78,-45,123
61,22,51,2,1,1,93,59,121,105,118,92,95,86,84,67,65,115,90.0,82.0,50,-2,52
415,1,52,1,1,1,427,227,439,284,312,308,315,327,336,292,421,473,447.0,395.0,52,129,-77
500,2,52,1,1,1,464,198,268,226,239,271,381,320,316,363,485,535,510.0,461.0,50,122,-72
273,3,52,1,1,1,225,91,159,124,177,198,210,230,224,233,229,234,232.0,232.0,5,-4,9
534,4,52,1,1,1,617,228,489,359,374,335,454,424,442,429,500,681,590.0,537.0,181,71,110
933,5,52,1,1,1,850,346,509,498,454,508,557,495,659,704,743,849,796.0,765.0,106,39,67
404,6,52,1,1,1,287,177,226,184,207,204,219,249,314,271,334,368,351.0,324.0,34,63,-29
911,7,52,1,1,1,777,316,517,505,542,531,579,617,771,679,776,936,856.0,797.0,160,97,63
213,8,52,1,1,1,182,97,155,129,125,128,113,131,135,142,208,244,226.0,198.0,36,66,-30
1526,9,52,1,1,1,1965,437,1193,876,978,1056,1120,1145,1408,1392,1836,2078,1957.0,1769.0,242,444,-202
323,10,52,1,1,1,379,160,248,190,185,216,203,212,207,208,246,317,282.0,257.0,71,38,33
821,11,52,1,1,1,749,394,578,403,502,513,553,616,611,660,847,820,834.0,776.0,-27,187,-214
297,12,52,1,1,1,289,116,232,156,222,179,206,215,215,187,249,262,256.0,233.0,13,62,-49
758,13,52,1,1,1,549,298,398,396,448,411,475,528,576,625,746,750,748.0,707.0,4,121,-117
826,14,52,1,1,1,754,347,596,488,554,520,548,623,596,604,752,820,786.0,725.0,68,148,-80
550,15,52,1,1,1,679,333,435,299,309,330,357,379,387,524,623,684,654.0,610.0,61,99,-38
481,16,52,1,1,1,373,179,291,252,255,280,268,311,346,310,385,425,405.0,373.0,40,75,-35
505,17,52,1,1,1,471,214,378,270,349,338,350,384,424,364,460,493,476.0,439.0,33,96,-63
400,18,52,1,1,1,456,167,290,209,200,169,259,222,223,268,329,338,334.0,312.0,9,61,-52
249,19,52,1,1,1,333,154,305,230,303,292,281,324,364,303,369,450,410.0,374.0,81,66,15
576,20,52,1,1,1,535,259,424,365,346,440,402,372,406,400,540,575,558.0,505.0,35,140,-105
376,21,52,1,1,1,370,153,276,242,263,225,299,275,293,365,346,404,375.0,372.0,58,-19,77
324,22,52,1,1,1,374,217,363,293,273,325,359,356,331,302,341,410,376.0,351.0,69,39,30
241,1,53,2,1,1,632,139,307,248,310,413,581,617,628,446,636,846,741.0,643.0,210,190,20
290,2,53,2,1,1,337,148,154,145,172,143,197,189,278,304,365,493,429.0,387.0,128,61,67
284,3,53,2,1,1,382,134,111,109,155,125,168,136,222,206,310,562,436.0,359.0,252,104,148
105,4,53,2,1,1,709,188,412,270,321,429,521,473,498,257,444,824,634.0,508.0,380,187,193
983,5,53,2,1,1,1265,770,584,606,603,636,717,777,1042,762,1080,1730,1405.0,1191.0,650,318,332
1186,6,53,2,1,1,1338,744,404,412,563,701,945,973,1078,1023,1260,2243,1752.0,1509.0,983,237,746
1261,7,53,2,1,1,1919,875,851,1042,1265,1160,1176,1294,1622,1536,1637,2998,2318.0,2057.0,1361,101,1260
313,8,53,2,1,1,381,136,144,177,203,154,257,272,308,299,372,645,508.0,439.0,273,73,200
905,9,53,2,1,1,1196,240,608,631,1027,923,1121,1670,1369,1274,1967,3191,2579.0,2144.0,1224,693,531
471,10,53,2,1,1,312,168,141,105,142,190,192,188,232,252,337,697,517.0,429.0,360,85,275
1631,11,53,2,1,1,2659,1526,1242,1231,1592,1724,1702,2067,2163,1918,2283,3836,3060.0,2679.0,1553,365,1188
658,12,53,2,1,1,1035,446,244,251,345,361,411,440,542,547,676,1270,973.0,831.0,594,129,465
950,13,53,2,1,1,1410,574,511,495,710,678,854,909,987,969,1064,2232,1648.0,1422.0,1168,95,1073
1894,14,53,2,1,1,2054,870,634,824,900,1091,1257,1337,1548,1431,1720,3243,2482.0,2131.0,1523,289,1234
574,15,53,2,1,1,1214,628,712,672,814,952,886,1003,1067,1140,1205,1850,1528.0,1398.0,645,65,580
755,16,53,2,1,1,1033,420,379,335,349,502,356,435,576,710,866,1354,1110.0,977.0,488,156,332
938,17,53,2,1,1,1096,420,360,426,538,599,590,709,844,687,982,1756,1369.0,1142.0,774,295,479
462,18,53,2,1,1,498,137,249,221,268,357,422,486,645,645,746,1041,894.0,811.0,295,101,194
181,19,53,2,1,1,298,143,177,163,241,231,300,418,415,275,422,561,492.0,419.0,139,147,-8
557,20,53,2,1,1,669,328,299,375,484,631,758,749,722,571,643,1136,890.0,783.0,493,72,421
639,21,53,2,1,1,771,225,254,261,399,506,811,726,652,682,805,1567,1186.0,1018.0,762,123,639
102,22,53,2,1,1,218,96,119,141,163,123,259,159,164,109,207,305,256.0,207.0,98,98,0
95,1,54,1,1,1,374,59,117,95,90,87,88,90,112,64,139,159,149.0,121.0,20,75,-55
181,2,54,1,1,1,312,150,132,81,108,54,102,103,88,129,116,195,156.0,147.0,79,-13,92
327,3,54,1,1,1,400,166,183,174,223,139,192,148,178,215,227,336,282.0,259.0,109,12,97
99,4,54,1,1,1,382,107,188,157,103,119,110,107,124,113,153,246,200.0,171.0,93,40,53
398,5,54,1,1,1,651,300,263,231,201,164,169,165,260,194,267,387,327.0,283.0,120,73,47
484,6,54,1,1,1,703,331,241,207,206,161,192,228,277,262,301,471,386.0,345.0,170,39,131
723,7,54,1,1,1,1043,418,548,574,604,450,433,565,670,629,591,961,776.0,727.0,370,-38,408
149,8,54,1,1,1,228,58,100,103,114,81,88,106,92,114,133,167,150.0,138.0,34,19,15
97,9,54,1,1,1,480,62,174,156,103,107,99,112,111,142,134,176,155.0,151.0,42,-8,50
66,10,54,1,1,1,169,79,90,53,59,61,36,46,27,44,52,62,57.0,53.0,10,8,2
333,11,54,1,1,1,927,562,420,362,365,291,216,275,222,289,312,450,381.0,350.0,138,23,115
264,12,54,1,1,1,344,157,142,129,162,110,96,123,158,141,164,252,208.0,186.0,88,23,65
362,13,54,1,1,1,582,239,265,258,283,231,209,251,268,281,338,473,406.0,364.0,135,57,78
669,14,54,1,1,1,955,386,456,508,440,420,458,438,436,457,535,679,607.0,557.0,144,78,66
131,15,54,1,1,1,357,157,179,148,165,119,117,144,152,167,161,255,208.0,194.0,94,-6,100
450,16,54,1,1,1,656,209,218,242,217,211,166,169,231,258,278,385,332.0,307.0,107,20,87
857,17,54,1,1,1,943,399,388,395,357,324,322,320,453,378,533,776,654.0,562.0,243,155,88
41,18,54,1,1,1,156,59,87,42,60,45,47,38,50,51,83,65,74.0,66.0,-18,32,-50
109,19,54,1,1,1,207,85,129,125,118,82,101,115,152,128,129,166,148.0,141.0,37,1,36
256,20,54,1,1,1,470,233,209,189,156,162,125,149,157,175,189,306,248.0,223.0,117,14,103
493,21,54,1,1,1,733,248,335,296,319,224,270,298,329,421,381,634,508.0,479.0,253,-40,293
131,22,54,1,1,1,247,155,190,188,152,109,132,165,141,126,204,277,240.0,202.0,73,78,-5
138,1,55,1,1,1,289,99,199,164,165,139,164,176,188,167,211,361,286.0,246.0,150,44,106
406,2,55,1,1,1,676,475,412,328,421,327,407,402,486,521,434,743,588.0,566.0,309,-87,396
304,3,55,1,1,1,614,255,274,265,289,218,256,255,374,366,390,683,536.0,480.0,293,24,269
173,4,55,1,1,1,823,214,434,345,391,298,365,388,458,302,357,675,516.0,445.0,318,55,263
1186,5,55,1,1,1,1806,1086,1383,1313,1243,1067,1135,1222,1530,1137,1318,2057,1688.0,1504.0,739,181,558
574,6,55,1,1,1,1055,371,408,413,407,292,363,463,479,476,493,865,679.0,611.0,372,17,355
723,7,55,1,1,1,1659,712,778,983,935,718,720,875,922,870,894,1538,1216.0,1101.0,644,24,620
417,8,55,1,1,1,671,240,339,383,469,311,358,454,470,495,510,974,742.0,660.0,464,15,449
569,9,55,1,1,1,1131,292,692,629,703,576,557,610,730,702,768,1105,936.0,858.0,337,66,271
260,10,55,1,1,1,418,208,209,154,242,164,182,175,217,208,212,406,309.0,275.0,194,4,190
698,11,55,1,1,1,1289,648,745,631,724,557,652,768,765,828,786,1332,1059.0,982.0,546,-42,588
420,12,55,1,1,1,663,215,235,288,311,262,276,281,350,363,356,774,565.0,498.0,418,-7,425
891,13,55,1,1,1,1473,676,744,724,862,614,693,937,936,974,964,2069,1516.0,1336.0,1105,-10,1115
1026,14,55,1,1,1,1851,610,715,892,850,682,796,900,924,913,934,1916,1425.0,1254.0,982,21,961
370,15,55,1,1,1,979,395,572,541,581,492,491,561,604,663,556,982,769.0,734.0,426,-107,533
401,16,55,1,1,1,716,193,265,278,276,303,276,301,385,300,389,721,555.0,470.0,332,89,243
631,17,55,1,1,1,1172,586,514,623,562,511,551,548,722,567,687,1290,988.0,848.0,603,120,483
180,18,55,1,1,1,341,96,218,190,170,135,152,178,217,240,253,385,319.0,293.0,132,13,119
135,19,55,1,1,1,323,115,237,238,223,208,212,251,209,211,226,330,278.0,256.0,104,15,89
661,20,55,1,1,1,1880,977,800,797,796,935,790,970,909,844,751,1420,1086.0,1005.0,669,-93,762
604,21,55,1,1,1,1164,452,501,575,671,425,496,540,574,623,639,1234,936.0,832.0,595,16,579
76,22,55,1,1,1,184,100,176,124,152,127,131,146,126,126,150,236,193.0,171.0,86,24,62
357,1,56,1,1,1,511,104,239,247,291,237,275,484,500,412,620,805,712.0,612.0,185,208,-23
829,2,56,1,1,1,905,502,481,450,444,342,521,806,851,856,921,1249,1085.0,1009.0,328,65,263
601,3,56,1,1,1,646,262,315,336,322,265,347,507,500,528,675,925,800.0,709.0,250,147,103
437,4,56,1,1,1,1119,300,478,446,455,384,534,743,672,532,779,1421,1100.0,911.0,642,247,395
2183,5,56,1,1,1,2331,1283,1148,1182,899,922,1077,1757,2178,1620,1861,2915,2388.0,2132.0,1054,241,813
1141,6,56,1,1,1,1188,607,365,405,383,373,395,690,798,757,934,1307,1120.0,999.0,373,177,196
1006,7,56,1,1,1,1240,594,611,792,689,593,668,1173,1160,1214,1192,1610,1401.0,1339.0,418,-22,440
406,8,56,1,1,1,527,200,325,308,304,235,316,582,505,511,601,970,786.0,694.0,369,90,279
1203,9,56,1,1,1,1642,304,689,958,928,799,758,1347,1576,1507,1902,2685,2294.0,2031.0,783,395,388
433,10,56,1,1,1,521,257,267,191,230,206,193,394,347,352,440,665,552.0,486.0,225,88,137
1481,11,56,1,1,1,1894,917,887,1007,951,861,1014,1794,1646,1598,1955,2752,2354.0,2102.0,797,357,440
624,12,56,1,1,1,713,304,214,275,281,260,281,443,510,475,511,802,656.0,596.0,291,36,255
970,13,56,1,1,1,1091,551,562,650,653,522,624,985,1009,905,1021,1551,1286.0,1159.0,530,116,414
1928,14,56,1,1,1,1873,946,628,786,747,679,846,1361,1342,1399,1530,2696,2113.0,1875.0,1166,131,1035
704,15,56,1,1,1,1342,458,535,675,710,572,720,1247,1320,1351,1499,2124,1812.0,1658.0,625,148,477
837,16,56,1,1,1,998,363,307,317,322,323,347,614,653,620,794,1252,1023.0,889.0,458,174,284
1657,17,56,1,1,1,1709,749,596,697,623,625,741,1241,1383,1339,1478,2360,1919.0,1726.0,882,139,743
428,18,56,1,1,1,563,132,235,287,264,213,231,425,414,399,601,698,650.0,566.0,97,202,-105
235,19,56,1,1,1,351,130,230,240,206,200,191,375,331,306,361,459,410.0,375.0,98,55,43
1846,20,56,1,1,1,2161,1368,1012,1031,877,1159,994,1592,1671,1487,1581,2727,2154.0,1932.0,1146,94,1052
905,21,56,1,1,1,1023,517,513,636,634,391,538,758,764,827,896,1319,1108.0,1014.0,423,69,354
173,22,56,1,1,1,209,93,173,167,152,156,136,271,219,256,312,397,354.0,322.0,85,56,29
19,1,57,3,1,1,63,42,81,54,48,33,25,37,28,27,30,34,32.0,30.0,4,3,1
1680,2,57,3,1,1,2334,1982,1751,1315,1335,1170,1342,1395,1639,1736,1547,1939,1743.0,1741.0,392,-189,581
54,3,57,3,1,1,78,56,83,96,80,81,79,74,107,93,105,108,106.0,102.0,3,12,-9
106,4,57,3,1,1,409,156,229,233,214,173,229,238,282,198,305,504,404.0,336.0,199,107,92
603,5,57,3,1,1,1034,976,1205,892,875,682,620,742,717,655,773,955,864.0,794.0,182,118,64
216,6,57,3,1,1,378,440,323,285,216,207,172,194,197,214,225,272,248.0,237.0,47,11,36
629,7,57,3,1,1,1070,767,721,695,659,545,644,631,622,551,636,1105,870.0,764.0,469,85,384
166,8,57,3,1,1,194,162,270,155,157,114,131,103,137,118,161,233,197.0,171.0,72,43,29
346,9,57,3,1,1,1381,617,1291,948,890,830,568,627,644,624,713,866,790.0,734.0,153,89,64
92,10,57,3,1,1,156,161,173,97,104,62,69,50,93,63,75,97,86.0,78.0,22,12,10
610,11,57,3,1,1,1028,952,992,724,727,654,653,752,766,763,871,1150,1010.0,928.0,279,108,171
132,12,57,3,1,1,214,205,183,155,161,110,121,107,134,92,117,148,132.0,119.0,31,25,6
537,13,57,3,1,1,874,789,811,606,636,506,529,574,561,554,769,983,876.0,769.0,214,215,-1
922,14,57,3,1,1,2101,1478,1260,1027,934,847,759,825,703,746,952,1314,1133.0,1004.0,362,206,156
312,15,57,3,1,1,867,670,934,557,549,457,405,385,451,456,466,653,560.0,525.0,187,10,177
514,16,57,3,1,1,1027,697,859,536,538,476,513,518,582,592,590,903,746.0,695.0,313,-2,315
405,17,57,3,1,1,727,503,656,598,440,429,353,375,366,327,426,575,500.0,443.0,149,99,50
85,18,57,3,1,1,229,137,270,206,172,148,152,164,156,179,175,195,185.0,183.0,20,-4,24
158,19,57,3,1,1,244,206,331,272,228,230,212,192,216,260,281,370,326.0,304.0,89,21,68
636,20,57,3,1,1,1781,1641,1037,781,700,668,554,592,643,645,706,955,830.0,769.0,249,61,188
195,21,57,3,1,1,474,316,321,306,283,187,180,190,227,209,280,324,302.0,271.0,44,71,-27
35,22,57,3,1,1,99,95,134,124,103,81,47,88,70,59,76,90,83.0,75.0,14,17,-3
60,1,58,2,1,1,314,76,116,114,110,134,139,176,218,159,193,281,237.0,211.0,88,34,54
181,2,58,2,1,1,296,168,124,127,149,132,201,192,241,224,227,356,292.0,269.0,129,3,126
117,3,58,2,1,1,210,74,100,61,89,103,103,63,86,129,183,244,214.0,185.0,61,54,7
105,4,58,2,1,1,935,202,520,398,466,501,463,464,472,326,417,805,611.0,516.0,388,91,297
816,5,58,2,1,1,1096,755,939,830,726,715,739,855,1133,824,910,1456,1183.0,1063.0,546,86,460
251,6,58,2,1,1,562,244,164,160,209,240,323,314,310,267,287,463,375.0,339.0,176,20,156
600,7,58,2,1,1,1235,559,501,593,571,548,646,773,797,679,738,1182,960.0,866.0,444,59,385
192,8,58,2,1,1,399,161,200,167,199,121,199,221,226,243,264,497,380.0,335.0,233,21,212
297,9,58,2,1,1,698,169,374,342,351,384,378,429,596,574,615,869,742.0,686.0,254,41,213
254,10,58,2,1,1,313,160,162,108,140,126,161,139,167,205,233,425,329.0,288.0,192,28,164
461,11,58,2,1,1,1080,492,606,574,521,545,683,706,761,731,749,1017,883.0,832.0,268,18,250
211,12,58,2,1,1,345,142,127,126,110,128,145,145,229,198,198,315,256.0,237.0,117,0,117
754,13,58,2,1,1,1018,635,446,455,480,501,551,690,771,682,755,1430,1092.0,956.0,675,73,602
892,14,58,2,1,1,1880,899,500,524,534,645,779,871,851,876,865,1601,1233.0,1114.0,736,-11,747
174,15,58,2,1,1,520,192,280,246,271,509,410,370,1437,406,420,845,632.0,557.0,425,14,411
134,16,58,2,1,1,324,117,139,112,83,118,124,88,110,128,133,246,190.0,169.0,113,5,108
439,17,58,2,1,1,698,304,398,280,324,325,335,319,439,335,447,756,602.0,513.0,309,112,197
102,18,58,2,1,1,194,47,105,96,92,93,116,102,142,175,166,247,206.0,196.0,81,-9,90
47,19,58,2,1,1,64,41,64,60,48,65,77,81,68,54,102,113,108.0,90.0,11,48,-37
630,20,58,2,1,1,1130,1292,570,694,1791,780,781,1602,764,548,596,1578,1087.0,907.0,982,48,934
498,21,58,2,1,1,678,273,384,352,349,347,435,453,455,455,558,938,748.0,650.0,380,103,277
7,22,58,2,1,1,31,15,20,14,19,35,25,28,17,16,45,45,45.0,35.0,0,29,-29
228,1,59,2,1,1,1323,384,766,615,1911,902,547,590,1049,393,448,746,597.0,529.0,298,55,243
105,2,59,2,1,1,587,278,301,236,299,183,317,301,410,266,224,235,230.0,242.0,11,-42,53
208,3,59,2,1,1,529,177,210,170,205,129,178,248,263,289,273,340,306.0,301.0,67,-16,83
72,4,59,2,1,1,488,156,210,198,2153,193,216,265,2528,156,179,362,270.0,232.0,183,23,160
542,5,59,2,1,1,1979,1198,978,987,918,779,942,1243,1666,730,631,1027,829.0,796.0,396,-99,495
792,6,59,2,1,1,1526,817,521,577,609,647,742,968,961,755,678,1434,1056.0,956.0,756,-77,833
823,7,59,2,1,1,3685,1658,1597,1972,2081,1738,2176,2848,2646,1380,1053,1685,1369.0,1373.0,632,-327,959
321,8,59,2,1,1,805,317,332,357,466,412,468,657,660,386,479,604,542.0,490.0,125,93,32
451,9,59,2,1,1,1424,279,1067,835,808,584,546,819,1623,936,1038,1493,1266.0,1156.0,455,102,353
250,10,59,2,1,1,464,190,289,222,206,200,234,316,360,349,312,543,428.0,401.0,231,-37,268
1205,11,59,2,1,1,3597,2058,2036,1793,2058,1654,1827,2527,2388,1650,1467,2828,2148.0,1982.0,1361,-183,1544
549,12,59,2,1,1,1108,420,401,428,462,351,450,511,752,626,577,1241,909.0,815.0,664,-49,713
602,13,59,2,1,1,1899,890,745,818,940,856,987,1387,1606,840,561,1020,790.0,807.0,459,-279,738
992,14,59,2,1,1,2861,1366,1036,1237,1242,1377,1416,1736,1669,959,1021,1584,1302.0,1188.0,563,62,501
386,15,59,2,1,1,1696,584,854,706,739,693,717,1019,1203,828,859,1272,1066.0,986.0,413,31,382
523,16,59,2,1,1,1580,683,611,623,602,550,430,713,769,691,751,1208,980.0,883.0,457,60,397
508,17,59,2,1,1,1213,489,532,566,595,580,641,816,847,522,619,891,755.0,677.0,272,97,175
173,18,59,2,1,1,379,107,172,152,204,142,221,243,304,268,291,431,361.0,330.0,140,23,117
91,19,59,2,1,1,305,124,182,229,277,157,228,366,291,139,186,225,206.0,183.0,39,47,-8
128,20,59,2,1,1,391,221,210,204,174,226,215,324,310,182,148,242,195.0,191.0,94,-34,128
182,21,59,2,1,1,853,306,391,524,533,558,687,656,661,278,275,432,354.0,328.0,157,-3,160
53,22,59,2,1,1,197,92,110,100,111,89,97,146,137,83,61,140,100.0,95.0,79,-22,101
142,1,60,1,1,1,204,87,149,133,134,134,141,138,161,113,162,163,162.0,146.0,1,49,-48
146,2,60,1,1,1,121,54,107,85,86,94,141,123,111,95,152,131,142.0,126.0,-21,57,-78
83,3,60,1,1,1,81,40,55,64,107,75,84,71,81,97,81,90,86.0,89.0,9,-16,25
88,4,60,1,1,1,130,34,85,87,95,97,119,87,131,79,100,123,112.0,101.0,23,21,2
341,5,60,1,1,1,340,197,228,225,215,255,232,227,447,284,279,330,304.0,298.0,51,-5,56
254,6,60,1,1,1,208,99,134,119,161,145,138,167,182,170,183,198,190.0,184.0,15,13,2
159,7,60,1,1,1,228,84,124,180,157,181,138,136,198,152,160,191,176.0,168.0,31,8,23
41,8,60,1,1,1,57,20,17,25,37,27,30,36,34,32,31,28,30.0,30.0,-3,-1,-2
568,9,60,1,1,1,570,146,429,345,479,470,487,435,593,541,658,638,648.0,612.0,-20,117,-137
297,10,60,1,1,1,262,89,156,161,164,160,151,154,208,163,172,213,192.0,183.0,41,9,32
430,11,60,1,1,1,454,205,341,313,360,325,317,361,402,385,402,439,420.0,409.0,37,17,20
103,12,60,1,1,1,82,37,64,44,75,70,82,64,94,87,76,120,98.0,94.0,44,-11,55
109,13,60,1,1,1,115,39,90,92,88,94,88,102,92,82,85,95,90.0,87.0,10,3,7
130,14,60,1,1,1,151,72,107,141,117,126,120,123,153,141,134,164,149.0,146.0,30,-7,37
466,15,60,1,1,1,433,156,242,287,301,272,322,299,308,339,364,397,380.0,367.0,33,25,8
270,16,60,1,1,1,278,86,162,187,145,190,155,179,232,184,244,236,240.0,221.0,-8,60,-68
519,17,60,1,1,1,375,173,254,290,293,279,299,298,395,308,355,445,400.0,369.0,90,47,43
145,18,60,1,1,1,131,45,88,69,99,64,92,91,93,87,125,99,112.0,104.0,-26,38,-64
89,19,60,1,1,1,141,60,120,97,133,116,136,158,194,115,126,155,140.0,132.0,29,11,18
160,20,60,1,1,1,178,103,110,159,135,304,146,146,203,173,179,214,196.0,189.0,35,6,29
274,21,60,1,1,1,221,88,179,190,260,217,273,229,256,263,252,263,258.0,259.0,11,-11,22
65,22,60,1,1,1,79,36,89,80,70,81,75,75,68,54,66,57,62.0,59.0,-9,12,-21
193,1,1,1,2,0,134,323,266,271,235,260,162,265,228,369,374,305,340.0,349.0,-69,5,-74
194,2,1,1,2,0,227,260,216,308,279,419,246,217,310,402,456,434,445.0,431.0,-22,54,-76
128,3,1,1,2,0,123,206,149,236,164,187,153,157,178,204,219,180,200.0,201.0,-39,15,-54
432,4,1,1,2,0,160,362,404,445,351,322,244,337,371,460,563,468,516.0,497.0,-95,103,-198
253,5,1,1,2,0,311,358,373,360,329,335,345,623,350,453,570,500,535.0,508.0,-70,117,-187
76,6,1,1,2,0,125,152,155,154,138,108,127,159,136,179,226,198,212.0,201.0,-28,47,-75
290,7,1,1,2,0,254,418,482,482,353,339,259,422,394,483,601,468,534.0,517.0,-133,118,-251
146,8,1,1,2,0,126,197,211,250,166,178,189,194,233,215,260,248,254.0,241.0,-12,45,-57
1680,9,1,1,2,0,932,2407,2080,2897,2187,2183,1804,2265,2711,3532,3800,2692,3246.0,3341.0,-1108,268,-1376
248,10,1,1,2,0,224,347,259,363,291,276,249,267,349,472,505,425,465.0,467.0,-80,33,-113
486,11,1,1,2,0,540,791,629,780,561,554,569,631,764,871,1010,800,905.0,894.0,-210,139,-349
78,12,1,1,2,0,86,138,143,167,149,136,95,156,166,204,262,236,249.0,234.0,-26,58,-84
190,13,1,1,2,0,138,237,254,280,252,227,235,225,228,291,305,260,282.0,285.0,-45,14,-59
250,14,1,1,2,0,225,304,394,313,330,384,256,301,351,521,505,405,455.0,477.0,-100,-16,-84
409,15,1,1,2,0,342,504,483,638,453,457,422,545,702,660,865,633,749.0,719.0,-232,205,-437
228,16,1,1,2,0,275,418,368,357,440,329,325,381,447,480,474,497,486.0,484.0,23,-6,29
174,17,1,1,2,0,157,288,266,308,275,250,286,299,327,364,474,347,410.0,395.0,-127,110,-237
181,18,1,1,2,0,150,315,287,307,223,276,226,258,368,331,404,292,348.0,342.0,-112,73,-185
566,19,1,1,2,0,433,807,807,900,645,700,556,721,769,941,997,650,824.0,863.0,-347,56,-403
72,20,1,1,2,0,141,127,106,114,181,131,111,101,120,155,199,115,157.0,156.0,-84,44,-128
219,21,1,1,2,0,116,246,259,414,206,262,204,187,324,393,440,305,372.0,379.0,-135,47,-182
234,22,1,1,2,0,148,482,356,398,288,194,351,302,310,458,461,292,376.0,404.0,-169,3,-172
263,1,2,2,2,0,262,484,342,349,376,356,410,417,271,639,518,268,393.0,475.0,-250,-121,-129
264,2,2,2,2,0,222,275,246,290,259,337,266,368,334,609,519,292,406.0,473.0,-227,-90,-137
149,3,2,2,2,0,125,189,191,270,175,231,216,208,216,370,337,175,256.0,294.0,-162,-33,-129
359,4,2,2,2,0,209,527,412,406,405,459,464,449,231,675,811,368,590.0,618.0,-443,136,-579
560,5,2,2,2,0,504,885,758,701,656,684,758,1227,469,1053,1125,657,891.0,945.0,-468,72,-540
225,6,2,2,2,0,169,202,232,224,252,293,358,325,253,574,507,301,404.0,461.0,-206,-67,-139
729,7,2,2,2,0,445,807,1100,977,862,990,917,1222,876,1567,1574,775,1174.0,1305.0,-799,7,-806
239,8,2,2,2,0,164,299,314,339,253,284,382,372,320,590,571,290,430.0,484.0,-281,-19,-262
4688,9,2,2,2,0,2585,8611,7234,9327,8266,8709,10596,10140,6925,13598,11515,5136,8326.0,10083.0,-6379,-2083,-4296
559,10,2,2,2,0,411,855,658,835,723,792,866,969,642,1386,1258,750,1004.0,1131.0,-508,-128,-380
1635,11,2,2,2,0,1328,2057,1655,2026,1678,1827,2216,2075,1763,3112,2877,1445,2161.0,2478.0,-1432,-235,-1197
311,12,2,2,2,0,167,359,359,396,344,400,420,535,356,595,741,435,588.0,590.0,-306,146,-452
486,13,2,2,2,0,354,516,591,633,520,604,569,722,520,1137,974,498,736.0,870.0,-476,-163,-313
486,14,2,2,2,0,396,544,698,673,695,718,785,808,565,1273,1234,645,940.0,1051.0,-589,-39,-550
1205,15,2,2,2,0,1026,1659,1539,1625,1420,1737,1785,1658,1293,2709,2467,1135,1801.0,2104.0,-1332,-242,-1090
508,16,2,2,2,0,375,804,713,668,835,675,883,908,742,1001,1050,703,876.0,918.0,-347,49,-396
445,17,2,2,2,0,402,678,683,657,625,567,721,958,582,1112,1192,689,940.0,998.0,-503,80,-583
899,18,2,2,2,0,577,1254,1127,1467,1202,1533,1388,1310,817,2205,1578,856,1217.0,1546.0,-722,-627,-95
1306,19,2,2,2,0,783,1838,1870,2279,1544,2253,2301,1915,1064,2892,2161,1110,1636.0,2054.0,-1051,-731,-320
215,20,2,2,2,0,130,218,213,199,327,300,319,331,173,470,398,244,321.0,371.0,-154,-72,-82
260,21,2,2,2,0,138,255,320,486,412,553,492,462,375,582,607,340,474.0,510.0,-267,25,-292
521,22,2,2,2,0,291,946,626,765,687,670,1107,843,480,1076,1018,447,732.0,847.0,-571,-58,-513
101,1,3,1,2,0,77,213,184,219,211,160,159,169,112,163,167,157,162.0,162.0,-10,4,-14
213,2,3,1,2,0,206,253,260,265,254,351,309,270,218,354,350,290,320.0,331.0,-60,-4,-56
174,3,3,1,2,0,91,210,228,261,237,261,246,234,155,184,233,279,256.0,232.0,46,49,-3
387,4,3,1,2,0,257,551,670,627,552,633,554,583,457,611,677,549,613.0,612.0,-128,66,-194
235,5,3,1,2,0,187,348,327,372,413,373,319,387,300,411,434,516,475.0,454.0,82,23,59
83,6,3,1,2,0,64,119,116,119,126,118,108,157,129,128,138,176,157.0,147.0,38,10,28
235,7,3,1,2,0,152,316,317,345,393,358,328,376,327,415,400,420,410.0,412.0,20,-15,35
103,8,3,1,2,0,63,160,161,165,161,170,152,135,111,141,197,179,188.0,172.0,-18,56,-74
1159,9,3,1,2,0,549,1579,1472,1652,1649,1691,1490,1683,1421,1989,1829,1713,1771.0,1844.0,-116,-160,44
121,10,3,1,2,0,109,184,157,187,179,178,141,192,165,181,173,211,192.0,188.0,38,-8,46
296,11,3,1,2,0,218,361,393,413,417,373,340,401,333,437,427,470,448.0,445.0,43,-10,53
55,12,3,1,2,0,40,75,95,119,89,94,84,108,90,107,109,126,118.0,114.0,17,2,15
251,13,3,1,2,0,139,233,302,305,302,324,321,309,274,302,328,389,358.0,340.0,61,26,35
202,14,3,1,2,0,172,259,323,298,340,309,300,327,262,352,337,377,357.0,355.0,40,-15,55
264,15,3,1,2,0,174,327,357,357,351,316,352,336,342,428,424,401,412.0,418.0,-23,-4,-19
189,16,3,1,2,0,130,210,242,242,268,203,201,303,211,267,280,321,300.0,289.0,41,13,28
146,17,3,1,2,0,118,212,237,248,277,255,193,250,211,244,275,284,280.0,268.0,9,31,-22
81,18,3,1,2,0,66,105,124,113,128,123,95,124,106,151,157,167,162.0,158.0,10,6,4
316,19,3,1,2,0,246,417,495,542,501,506,466,488,346,464,567,506,536.0,512.0,-61,103,-164
116,20,3,1,2,0,105,176,130,156,186,166,134,169,138,184,155,213,184.0,184.0,58,-29,87
206,21,3,1,2,0,114,253,239,271,255,273,253,271,195,252,267,297,282.0,272.0,30,15,15
155,22,3,1,2,0,187,216,276,357,324,293,304,239,208,258,336,315,326.0,303.0,-21,78,-99
96,1,4,2,2,0,118,232,238,251,282,229,249,216,166,212,210,117,164.0,180.0,-93,-2,-91
110,2,4,2,2,0,105,163,123,154,116,231,232,256,209,270,308,173,240.0,250.0,-135,38,-173
72,3,4,2,2,0,69,114,106,123,97,118,134,193,128,165,176,89,132.0,143.0,-87,11,-98
109,4,4,2,2,0,190,324,305,237,267,308,309,286,179,246,342,136,239.0,241.0,-206,96,-302
212,5,4,2,2,0,292,452,413,430,414,426,492,712,401,438,436,351,394.0,408.0,-85,-2,-83
151,6,4,2,2,0,191,244,230,261,218,300,368,358,250,325,348,264,306.0,312.0,-84,23,-107
175,7,4,2,2,0,173,389,484,405,407,399,489,606,454,468,556,225,390.0,416.0,-331,88,-419
70,8,4,2,2,0,74,128,130,124,127,123,233,187,181,144,181,92,136.0,139.0,-89,37,-126
1639,9,4,2,2,0,1368,3766,3317,3840,3624,4020,4618,5211,4012,4216,4195,2391,3293.0,3601.0,-1804,-21,-1783
166,10,4,2,2,0,192,344,277,350,329,360,409,444,331,432,386,248,317.0,355.0,-138,-46,-92
651,11,4,2,2,0,507,940,829,888,876,892,1148,1130,943,1033,1154,680,917.0,956.0,-474,121,-595
96,12,4,2,2,0,140,184,170,221,210,194,288,380,260,302,351,208,280.0,287.0,-143,49,-192
284,13,4,2,2,0,191,358,362,423,480,475,550,584,385,397,419,248,334.0,355.0,-171,22,-193
242,14,4,2,2,0,244,376,449,371,468,562,658,673,556,567,651,338,494.0,519.0,-313,84,-397
739,15,4,2,2,0,511,990,1039,1012,1006,1138,1244,1296,1228,1343,1310,747,1028.0,1133.0,-563,-33,-530
226,16,4,2,2,0,282,547,533,457,595,544,655,744,726,677,787,450,618.0,638.0,-337,110,-447
223,17,4,2,2,0,238,482,529,476,494,503,610,619,436,474,674,394,534.0,514.0,-280,200,-480
173,18,4,2,2,0,152,423,426,506,417,546,535,615,563,615,519,231,375.0,455.0,-288,-96,-192
233,19,4,2,2,0,305,554,649,665,803,867,1031,840,522,652,848,213,530.0,571.0,-635,196,-831
85,20,4,2,2,0,100,193,183,200,348,324,316,208,150,157,208,123,166.0,163.0,-85,51,-136
105,21,4,2,2,0,112,192,194,239,237,272,274,262,219,225,317,148,232.0,230.0,-169,92,-261
85,22,4,2,2,0,125,253,261,255,248,232,335,334,222,288,303,90,196.0,227.0,-213,15,-228
177,1,5,3,2,0,138,302,182,202,234,212,256,234,168,249,477,199,338.0,308.0,-278,228,-506
3067,2,5,3,2,0,2559,2705,2130,2397,2353,2868,2565,3307,3096,3216,4503,4785,4644.0,4168.0,282,1287,-1005
451,3,5,3,2,0,257,434,313,361,329,346,368,502,360,520,675,504,590.0,566.0,-171,155,-326
92,4,5,3,2,0,125,304,246,278,163,179,202,242,199,305,514,151,332.0,323.0,-363,209,-572
1537,5,5,3,2,0,1289,1498,1056,1064,1118,1183,1230,1449,1007,1411,1954,1724,1839.0,1696.0,-230,543,-773
1881,6,5,3,2,0,1946,1532,1224,1396,1210,1260,1418,1458,1238,1535,2328,2152,2240.0,2005.0,-176,793,-969
3060,7,5,3,2,0,3478,2813,2653,3587,2963,3398,3600,3519,3268,3907,6576,4483,5530.0,4989.0,-2093,2669,-4762
1361,8,5,3,2,0,1096,1300,1076,1493,1193,1334,1452,1749,1354,1585,2844,2093,2468.0,2174.0,-751,1259,-2010
1579,9,5,3,2,0,794,1712,1309,1820,1577,1457,1550,1999,1555,2007,3029,1611,2320.0,2216.0,-1418,1022,-2440
1836,10,5,3,2,0,2843,2715,1831,2371,1991,2051,2291,2515,2293,2687,4443,3084,3764.0,3405.0,-1359,1756,-3115
2419,11,5,3,2,0,1736,2075,1392,1679,1539,1776,1799,1764,1493,1942,3067,2165,2616.0,2391.0,-902,1125,-2027
922,12,5,3,2,0,1085,1047,877,1066,892,885,890,1111,824,980,1510,1290,1400.0,1260.0,-220,530,-750
3403,13,5,3,2,0,2579,2548,2351,2960,2437,2748,3368,3303,2808,3641,6231,3870,5050.0,4581.0,-2361,2590,-4951
3564,14,5,3,2,0,4158,3545,2891,3967,3302,3413,3591,3584,3821,4668,7650,5825,6738.0,6048.0,-1825,2982,-4807
1629,15,5,3,2,0,1111,1340,943,1216,1213,1206,1016,1295,1112,1294,2062,1260,1661.0,1539.0,-802,768,-1570
1140,16,5,3,2,0,1058,1238,1013,1221,954,900,992,1202,958,1353,2198,1919,2058.0,1823.0,-279,845,-1124
1506,17,5,3,2,0,1476,1924,1609,1715,1491,1500,1678,1773,1354,1770,2693,2364,2528.0,2276.0,-329,923,-1252
650,18,5,3,2,0,399,702,458,576,545,512,565,573,523,688,892,592,742.0,724.0,-300,204,-504
939,19,5,3,2,0,557,1124,894,1170,1034,1023,1010,1135,824,1154,1710,924,1317.0,1263.0,-786,556,-1342
248,20,5,3,2,0,194,204,191,258,225,203,204,284,201,250,357,250,304.0,286.0,-107,107,-214
1105,21,5,3,2,0,1145,1221,1008,1213,1083,1173,1245,1658,1590,1877,3217,2072,2644.0,2389.0,-1145,1340,-2485
518,22,5,3,2,0,458,819,646,736,776,785,835,795,518,816,982,506,744.0,768.0,-476,166,-642
114,1,6,1,2,0,80,202,198,232,330,331,445,555,272,582,623,382,502.0,529.0,-241,41,-282
300,2,6,1,2,0,178,199,246,327,333,428,409,543,553,546,680,484,582.0,570.0,-196,134,-330
317,3,6,1,2,0,321,444,472,638,517,552,645,831,715,836,832,551,692.0,740.0,-281,-4,-277
102,4,6,1,2,0,72,162,260,324,331,345,369,502,362,440,598,212,405.0,417.0,-386,158,-544
671,5,6,1,2,0,607,864,847,961,1004,1032,1165,1460,1050,1385,1850,1223,1536.0,1486.0,-627,465,-1092
717,6,6,1,2,0,758,744,849,934,1047,1058,1409,1565,1256,1491,1666,1515,1590.0,1557.0,-151,175,-326
842,7,6,1,2,0,614,897,1413,1635,1575,1773,2139,2580,2061,2146,2737,1706,2222.0,2196.0,-1031,591,-1622
312,8,6,1,2,0,250,365,433,477,430,532,655,690,724,762,993,533,763.0,763.0,-460,231,-691
2647,9,6,1,2,0,1441,3854,3887,5187,5010,5237,6544,8215,6582,6734,6492,5607,6050.0,6278.0,-885,-242,-643
409,10,6,1,2,0,385,570,472,589,632,639,680,913,743,853,894,799,846.0,849.0,-95,41,-136
1016,11,6,1,2,0,799,1459,1467,1717,1679,1859,2252,2410,2283,2584,2672,1728,2200.0,2328.0,-944,88,-1032
356,12,6,1,2,0,496,549,619,761,704,848,964,1340,1065,1086,1291,1027,1159.0,1135.0,-264,205,-469
1271,13,6,1,2,0,770,1146,1445,1808,1966,2293,2864,3253,2277,2327,2703,2119,2411.0,2383.0,-584,376,-960
1308,14,6,1,2,0,1247,1386,1910,2169,2264,2690,3318,3446,2827,2797,3447,2952,3200.0,3065.0,-495,650,-1145
459,15,6,1,2,0,264,593,721,949,928,974,1151,1369,1262,1632,1972,795,1384.0,1466.0,-1177,340,-1517
597,16,6,1,2,0,799,1011,1012,1027,1207,1181,1412,1938,1686,1663,2151,1566,1858.0,1793.0,-585,488,-1073
844,17,6,1,2,0,832,1249,1396,1570,1605,1889,1918,2573,2247,1966,2770,1651,2210.0,2129.0,-1119,804,-1923
148,18,6,1,2,0,83,172,208,292,259,301,348,390,371,447,476,264,370.0,396.0,-212,29,-241
211,19,6,1,2,0,109,187,283,311,261,323,369,397,317,403,513,241,377.0,386.0,-272,110,-382
328,20,6,1,2,0,312,479,530,585,806,750,810,888,646,803,1149,803,976.0,918.0,-346,346,-692
247,21,6,1,2,0,176,306,358,387,403,502,566,687,665,655,845,620,732.0,707.0,-225,190,-415
306,22,6,1,2,0,218,468,492,550,570,602,652,669,544,740,1032,399,716.0,724.0,-633,292,-925
890,1,7,3,2,0,527,1063,994,1124,945,1154,1068,958,710,977,1212,1265,1238.0,1151.0,53,235,-182
63,2,7,3,2,0,43,70,57,124,99,83,62,79,45,66,119,104,112.0,96.0,-15,53,-68
64,3,7,3,2,0,19,65,50,51,85,56,51,54,43,56,75,86,80.0,72.0,11,19,-8
1114,4,7,3,2,0,361,867,872,926,824,1014,976,1027,677,793,1627,1352,1490.0,1257.0,-275,834,-1109
187,5,7,3,2,0,82,223,166,175,144,210,234,199,102,145,321,208,264.0,225.0,-113,176,-289
175,6,7,3,2,0,96,149,190,155,149,157,167,182,145,176,251,253,252.0,227.0,2,75,-73
649,7,7,3,2,0,335,562,729,614,644,701,698,710,494,739,1047,878,962.0,888.0,-169,308,-477
123,8,7,3,2,0,53,106,96,90,115,93,101,121,83,105,184,165,174.0,151.0,-19,79,-98
448,9,7,3,2,0,183,472,491,557,511,479,453,514,463,571,819,762,790.0,717.0,-57,248,-305
54,10,7,3,2,0,32,56,38,32,27,46,65,36,87,45,96,92,94.0,78.0,-4,51,-55
650,11,7,3,2,0,394,680,808,786,664,704,653,923,563,731,1002,974,988.0,902.0,-28,271,-299
85,12,7,3,2,0,42,55,107,79,54,83,56,89,43,74,97,118,108.0,96.0,21,23,-2
361,13,7,3,2,0,130,229,240,232,241,288,302,284,232,288,493,470,482.0,417.0,-23,205,-228
345,14,7,3,2,0,182,314,390,376,374,353,356,387,282,366,596,517,556.0,493.0,-79,230,-309
424,15,7,3,2,0,262,365,466,382,390,895,578,350,278,533,736,534,635.0,601.0,-202,203,-405
103,16,7,3,2,0,47,93,139,123,130,108,119,115,66,94,173,151,162.0,139.0,-22,79,-101
59,17,7,3,2,0,46,72,140,72,59,68,91,68,60,83,119,101,110.0,101.0,-18,36,-54
106,18,7,3,2,0,35,128,219,92,103,107,123,99,106,97,170,123,146.0,130.0,-47,73,-120
154,19,7,3,2,0,72,139,266,153,169,211,178,184,111,151,300,181,240.0,211.0,-119,149,-268
71,20,7,3,2,0,39,102,106,65,63,75,66,120,43,58,100,60,80.0,73.0,-40,42,-82
179,21,7,3,2,0,81,169,185,153,156,195,228,164,136,164,313,234,274.0,237.0,-79,149,-228
74,22,7,3,2,0,54,90,127,69,65,102,113,130,76,95,177,129,153.0,134.0,-48,82,-130
168,1,8,2,2,0,253,606,561,484,494,547,504,605,431,543,697,325,511.0,522.0,-372,154,-526
25,2,8,2,2,0,100,83,82,70,56,86,60,80,64,106,112,40,76.0,86.0,-72,6,-78
18,3,8,2,2,0,48,55,66,70,55,54,65,50,48,60,75,31,53.0,55.0,-44,15,-59
51,4,8,2,2,0,76,141,177,131,96,96,105,107,59,86,132,40,86.0,86.0,-92,46,-138
117,5,8,2,2,0,195,188,226,211,185,192,194,379,187,278,408,216,312.0,301.0,-192,130,-322
148,6,8,2,2,0,275,330,375,352,304,284,383,452,363,447,587,357,472.0,464.0,-230,140,-370
180,7,8,2,2,0,281,405,655,512,403,384,434,524,437,477,555,320,438.0,451.0,-235,78,-313
23,8,8,2,2,0,28,50,77,84,53,53,40,61,59,55,64,30,47.0,50.0,-34,9,-43
39,9,8,2,2,0,57,219,282,274,225,205,191,284,225,342,408,121,264.0,290.0,-287,66,-353
34,10,8,2,2,0,66,75,77,81,56,48,72,86,66,86,129,68,98.0,94.0,-61,43,-104
628,11,8,2,2,0,974,1119,1203,1261,881,934,1240,1311,1156,1271,1767,893,1330.0,1310.0,-874,496,-1370
92,12,8,2,2,0,118,149,241,252,167,187,201,205,175,224,302,169,236.0,232.0,-133,78,-211
56,13,8,2,2,0,88,169,204,145,156,130,129,149,129,127,215,80,148.0,141.0,-135,88,-223
97,14,8,2,2,0,189,277,347,264,222,222,264,300,257,320,368,183,276.0,290.0,-185,48,-233
309,15,8,2,2,0,633,762,810,793,638,611,791,867,742,941,1163,445,804.0,850.0,-718,222,-940
94,16,8,2,2,0,152,191,266,209,221,204,189,253,233,287,401,211,306.0,300.0,-190,114,-304
83,17,8,2,2,0,160,191,256,228,177,169,202,213,182,259,315,201,258.0,258.0,-114,56,-170
20,18,8,2,2,0,56,96,99,97,66,59,77,86,70,117,145,54,100.0,105.0,-91,28,-119
21,19,8,2,2,0,40,89,169,79,56,94,56,78,81,68,104,28,66.0,67.0,-76,36,-112
20,20,8,2,2,0,39,57,50,37,61,45,63,77,40,57,62,28,45.0,49.0,-34,5,-39
51,21,8,2,2,0,100,108,169,156,96,102,126,137,141,113,177,107,142.0,132.0,-70,64,-134
11,22,8,2,2,0,20,36,50,45,25,30,29,39,29,28,30,11,20.0,23.0,-19,2,-21
540,1,9,1,2,0,511,1006,969,925,835,829,878,839,851,1537,1734,940,1337.0,1404.0,-794,197,-991
288,2,9,1,2,0,360,410,333,370,297,444,406,375,464,639,732,400,566.0,590.0,-332,93,-425
195,3,9,1,2,0,213,302,350,427,288,345,346,426,433,493,573,322,448.0,463.0,-251,80,-331
394,4,9,1,2,0,307,553,585,621,593,551,572,648,532,915,1057,659,858.0,877.0,-398,142,-540
611,5,9,1,2,0,680,747,869,835,754,816,821,1394,1020,1293,1876,1072,1474.0,1414.0,-804,583,-1387
457,6,9,1,2,0,528,678,800,749,648,689,782,938,1018,1287,1597,1015,1306.0,1300.0,-582,310,-892
522,7,9,1,2,0,744,1062,1662,1314,1119,1240,1232,1497,1547,1722,2394,1077,1736.0,1731.0,-1317,672,-1989
248,8,9,1,2,0,222,358,423,462,359,317,365,407,489,581,742,375,558.0,566.0,-367,161,-528
463,9,9,1,2,0,484,919,955,1092,904,1023,986,1197,1508,2163,2594,949,1772.0,1902.0,-1645,431,-2076
210,10,9,1,2,0,202,368,262,320,307,308,261,338,373,502,713,341,527.0,519.0,-372,211,-583
939,11,9,1,2,0,1018,1351,1369,1459,1195,1141,1497,1413,1635,2059,2647,1466,2056.0,2057.0,-1181,588,-1769
397,12,9,1,2,0,383,549,710,757,635,717,687,798,900,1083,1527,753,1140.0,1121.0,-774,444,-1218
404,13,9,1,2,0,449,745,695,817,660,609,745,771,828,1012,1235,691,963.0,979.0,-544,223,-767
589,14,9,1,2,0,672,938,1124,951,899,929,998,1228,1191,1470,2122,1000,1561.0,1531.0,-1122,652,-1774
537,15,9,1,2,0,604,799,913,926,862,813,942,1042,1090,1626,2068,1003,1536.0,1566.0,-1065,442,-1507
485,16,9,1,2,0,552,799,894,947,966,785,977,1135,1284,1519,1632,1025,1328.0,1392.0,-607,113,-720
467,17,9,1,2,0,634,928,1065,1061,902,924,1034,1175,1168,1619,2178,1217,1698.0,1671.0,-961,559,-1520
257,18,9,1,2,0,264,347,323,473,273,417,426,426,568,767,913,522,718.0,734.0,-391,146,-537
172,19,9,1,2,0,195,288,386,363,316,315,365,365,407,443,594,254,424.0,430.0,-340,151,-491
252,20,9,1,2,0,203,303,331,291,407,357,329,386,354,500,762,420,591.0,561.0,-342,262,-604
184,21,9,1,2,0,267,401,396,383,263,316,283,360,444,478,651,365,508.0,498.0,-286,173,-459
121,22,9,1,2,0,123,274,347,288,202,213,233,201,203,289,372,142,257.0,268.0,-230,83,-313
513,1,10,2,2,0,545,1276,1391,1398,1353,1616,1715,1560,1261,1546,1428,635,1032.0,1203.0,-793,-118,-675
167,2,10,2,2,0,240,300,304,335,298,451,462,412,350,412,626,249,438.0,429.0,-377,214,-591
178,3,10,2,2,0,212,323,304,432,328,313,335,434,451,516,701,285,493.0,501.0,-416,185,-601
74,4,10,2,2,0,101,202,284,280,232,247,248,278,174,264,913,106,510.0,428.0,-807,649,-1456
763,5,10,2,2,0,1083,1323,1763,1713,1549,1800,1833,2351,1555,1783,2691,1134,1912.0,1869.0,-1557,908,-2465
968,6,10,2,2,0,1182,1314,1838,2005,1957,2071,2572,2578,2110,2138,2356,1607,1982.0,2034.0,-749,218,-967
1323,7,10,2,2,0,1428,1837,3584,3723,2665,3185,3623,4079,3911,3787,4830,2048,3439.0,3555.0,-2782,1043,-3825
283,8,10,2,2,0,264,390,562,695,612,635,770,774,678,852,1073,317,695.0,747.0,-756,221,-977
488,9,10,2,2,0,393,1288,1748,2151,1841,2105,2230,2219,1912,2435,2500,695,1598.0,1877.0,-1805,65,-1870
293,10,10,2,2,0,309,481,401,605,509,467,597,723,646,783,869,475,672.0,709.0,-394,86,-480
2401,11,10,2,2,0,2924,3351,4265,5237,4119,4343,5439,5089,5170,5016,5865,2657,4261.0,4513.0,-3208,849,-4057
549,12,10,2,2,0,548,685,1136,1339,997,1282,1228,1446,1175,1376,1737,923,1330.0,1345.0,-814,361,-1175
720,13,10,2,2,0,954,1178,1462,1915,1717,1730,2030,2166,1672,1926,2621,900,1760.0,1816.0,-1721,695,-2416
1042,14,10,2,2,0,1210,1347,2464,2148,2124,2569,3033,2794,2644,2874,3243,1683,2463.0,2600.0,-1560,369,-1929
1038,15,10,2,2,0,1398,2016,2464,3027,2635,2644,3079,3258,3003,3295,3490,1289,2390.0,2691.0,-2201,195,-2396
480,16,10,2,2,0,664,796,1212,1354,1346,1388,1694,1779,1500,1547,1624,929,1276.0,1367.0,-695,77,-772
516,17,10,2,2,0,733,970,1484,1556,1388,1464,1556,1793,1457,1585,1952,989,1470.0,1509.0,-963,367,-1330
402,18,10,2,2,0,228,546,695,1147,600,1040,913,859,836,1130,958,546,752.0,878.0,-412,-172,-240
149,19,10,2,2,0,209,435,639,553,466,570,710,667,540,619,821,205,513.0,548.0,-616,202,-818
163,20,10,2,2,0,225,233,248,344,487,446,463,501,422,419,597,296,446.0,437.0,-301,178,-479
242,21,10,2,2,0,258,403,620,717,590,762,830,880,891,912,1151,413,782.0,825.0,-738,239,-977
130,22,10,2,2,0,175,240,355,391,233,247,332,298,250,347,415,118,266.0,293.0,-297,68,-365
27,1,11,2,2,0,38,145,116,132,121,130,170,225,144,225,270,79,174.0,191.0,-191,45,-236
172,2,11,2,2,0,103,104,130,150,124,141,193,215,192,267,384,296,340.0,316.0,-88,117,-205
124,3,11,2,2,0,174,191,134,180,155,165,211,257,237,359,450,248,349.0,352.0,-202,91,-293
74,4,11,2,2,0,72,213,666,671,764,635,596,755,684,938,1287,118,702.0,781.0,-1169,349,-1518
797,5,11,2,2,0,807,671,665,754,743,840,1135,1134,707,1002,2805,1326,2066.0,1711.0,-1479,1803,-3282
436,6,11,2,2,0,626,432,458,431,427,626,807,752,716,977,1443,903,1173.0,1108.0,-540,466,-1006
1009,7,11,2,2,0,1342,1025,1289,1432,1325,1510,2013,2253,1752,2198,3785,1878,2832.0,2620.0,-1907,1587,-3494
248,8,11,2,2,0,270,276,293,383,273,396,591,635,370,1993,2925,603,1764.0,1840.0,-2322,932,-3254
399,9,11,2,2,0,289,994,1031,1203,1183,1216,1851,1526,1065,2044,2419,914,1666.0,1792.0,-1505,375,-1880
303,10,11,2,2,0,276,260,250,385,389,373,565,452,368,493,935,666,800.0,698.0,-269,442,-711
648,11,11,2,2,0,779,828,897,1057,971,1038,1263,1231,1184,1531,2308,910,1609.0,1583.0,-1398,777,-2175
364,12,11,2,2,0,652,459,469,546,479,591,657,831,701,917,1377,999,1188.0,1098.0,-378,460,-838
641,13,11,2,2,0,741,471,479,696,616,754,991,941,754,1144,2067,1110,1588.0,1440.0,-957,923,-1880
888,14,11,2,2,0,1382,887,1161,1258,1321,1528,1922,1491,1090,1965,3560,2272,2916.0,2599.0,-1288,1595,-2883
639,15,11,2,2,0,823,1584,1570,1718,1900,1877,2534,1978,2287,3147,4324,1028,2676.0,2833.0,-3296,1177,-4473
347,16,11,2,2,0,443,424,420,420,475,487,636,528,521,941,1534,1004,1269.0,1160.0,-530,593,-1123
438,17,11,2,2,0,937,896,945,1034,885,1014,1148,1102,762,1142,1719,1133,1426.0,1331.0,-586,577,-1163
268,18,11,2,2,0,190,590,596,665,596,710,861,605,468,762,1967,434,1200.0,1054.0,-1533,1205,-2738
149,19,11,2,2,0,132,202,209,189,242,328,373,319,239,291,520,199,360.0,337.0,-321,229,-550
291,20,11,2,2,0,271,206,305,265,352,383,500,317,253,326,532,432,482.0,430.0,-100,206,-306
422,21,11,2,2,0,421,382,511,669,670,984,1191,1013,830,1010,1651,919,1285.0,1193.0,-732,641,-1373
104,22,11,2,2,0,79,88,79,102,96,114,179,154,114,204,257,135,196.0,199.0,-122,53,-175
40,1,12,2,2,0,23,47,54,61,91,84,82,78,75,125,158,63,110.0,115.0,-95,33,-128
246,2,12,2,2,0,217,206,208,229,212,242,297,409,425,375,535,421,478.0,444.0,-114,160,-274
164,3,12,2,2,0,150,198,157,157,141,155,186,321,287,448,676,363,520.0,496.0,-313,228,-541
74,4,12,2,2,0,72,142,158,142,166,192,229,328,289,360,496,86,291.0,314.0,-410,136,-546
451,5,12,2,2,0,453,466,458,502,542,612,740,894,870,831,1260,724,992.0,938.0,-536,429,-965
272,6,12,2,2,0,266,304,266,327,272,360,423,570,478,510,806,576,691.0,631.0,-230,296,-526
762,7,12,2,2,0,1114,946,977,950,814,1067,1385,1544,1660,1778,2915,1529,2222.0,2074.0,-1386,1137,-2523
366,8,12,2,2,0,225,305,328,438,304,387,526,657,689,668,1092,615,854.0,792.0,-477,424,-901
363,9,12,2,2,0,221,467,644,800,706,726,1003,987,1170,1384,1437,718,1078.0,1180.0,-719,53,-772
233,10,12,2,2,0,206,238,200,244,215,205,275,336,321,463,659,452,556.0,525.0,-207,196,-403
405,11,12,2,2,0,284,374,406,417,417,424,503,619,691,743,1008,543,776.0,765.0,-465,265,-730
247,12,12,2,2,0,325,271,316,324,321,323,384,576,518,577,816,634,725.0,676.0,-182,239,-421
951,13,12,2,2,0,883,734,754,897,796,976,1190,1442,1308,1432,2365,1304,1834.0,1700.0,-1061,933,-1994
717,14,12,2,2,0,751,731,764,796,796,921,1180,1362,1148,1406,2228,1526,1877.0,1720.0,-702,822,-1524
306,15,12,2,2,0,256,491,555,599,497,546,656,656,660,874,1121,438,780.0,811.0,-683,247,-930
255,16,12,2,2,0,284,280,340,316,308,353,445,594,534,655,903,635,769.0,731.0,-268,248,-516
321,17,12,2,2,0,477,571,590,590,570,561,665,852,609,763,1216,773,994.0,917.0,-443,453,-896
153,18,12,2,2,0,95,214,227,185,203,218,279,280,218,239,420,249,334.0,303.0,-171,181,-352
222,19,12,2,2,0,149,240,267,276,253,308,361,450,328,514,641,287,464.0,481.0,-354,127,-481
142,20,12,2,2,0,155,141,187,187,221,263,289,325,272,292,402,296,349.0,330.0,-106,110,-216
410,21,12,2,2,0,388,397,433,446,383,562,667,705,729,755,1158,815,986.0,909.0,-343,403,-746
145,22,12,2,2,0,131,179,118,155,141,189,179,249,176,328,336,166,251.0,277.0,-170,8,-178
102,1,13,1,2,0,130,160,94,156,130,143,149,181,158,314,461,180,320.0,318.0,-281,147,-428
575,2,13,1,2,0,338,404,239,336,248,387,336,447,627,757,1396,1059,1228.0,1071.0,-337,639,-976
270,3,13,1,2,0,137,199,117,165,174,186,216,287,324,527,720,520,620.0,589.0,-200,193,-393
86,4,13,1,2,0,109,157,85,99,100,137,177,237,199,242,487,101,294.0,277.0,-386,245,-631
1194,5,13,1,2,0,901,983,554,759,618,741,845,1263,1243,1605,2433,1860,2146.0,1966.0,-573,828,-1401
720,6,13,1,2,0,660,594,483,561,546,651,840,1069,1269,1370,2298,1440,1869.0,1703.0,-858,928,-1786
1109,7,13,1,2,0,621,625,585,723,768,927,999,1485,1686,2126,3804,2217,3010.0,2716.0,-1587,1678,-3265
404,8,13,1,2,0,232,272,166,255,224,271,379,496,642,748,1215,772,994.0,912.0,-443,467,-910
446,9,13,1,2,0,298,728,449,600,502,550,650,835,848,1467,2021,1040,1530.0,1509.0,-981,554,-1535
330,10,13,1,2,0,174,351,170,257,240,225,284,342,388,511,880,738,809.0,710.0,-142,369,-511
1130,11,13,1,2,0,861,985,648,883,678,762,1001,1116,1451,1816,2525,1540,2032.0,1960.0,-985,709,-1694
377,12,13,1,2,0,504,443,270,410,377,409,440,725,733,889,1320,1015,1168.0,1075.0,-305,431,-736
1126,13,13,1,2,0,623,634,487,781,785,958,1014,1437,1548,2026,3281,1882,2582.0,2396.0,-1399,1255,-2654
1002,14,13,1,2,0,786,582,542,634,719,857,953,1313,1473,1843,2975,2324,2650.0,2381.0,-651,1132,-1783
565,15,13,1,2,0,640,897,591,746,723,731,805,1089,1175,1502,2235,958,1596.0,1565.0,-1277,733,-2010
463,16,13,1,2,0,492,599,444,503,489,505,669,868,924,1339,1557,1148,1352.0,1348.0,-409,218,-627
439,17,13,1,2,0,399,488,309,371,399,407,438,633,772,835,1281,1235,1258.0,1117.0,-46,446,-492
365,18,13,1,2,0,190,303,174,227,178,234,282,307,414,622,877,518,698.0,672.0,-359,255,-614
224,19,13,1,2,0,155,236,155,177,191,236,231,291,296,396,542,311,426.0,416.0,-231,146,-377
274,20,13,1,2,0,252,295,169,207,227,218,259,311,316,419,666,489,578.0,525.0,-177,247,-424
394,21,13,1,2,0,331,283,202,287,271,303,362,519,627,715,1549,1036,1292.0,1100.0,-513,834,-1347
372,22,13,1,2,0,248,377,252,344,319,336,422,442,411,616,998,401,700.0,672.0,-597,382,-979
192,1,14,1,2,0,360,517,534,459,422,464,522,661,472,781,1047,423,735.0,750.0,-624,266,-890
680,2,14,1,2,0,825,894,856,985,706,939,877,1084,1148,1159,1879,1354,1616.0,1464.0,-525,720,-1245
347,3,14,1,2,0,297,457,492,583,433,551,578,725,701,941,1442,814,1128.0,1066.0,-628,501,-1129
176,4,14,1,2,0,297,397,406,411,391,454,496,664,474,569,1295,274,784.0,713.0,-1021,726,-1747
1081,5,14,1,2,0,1779,1779,1892,1614,1306,1417,1488,2289,1556,2162,4188,2540,3364.0,2963.0,-1648,2026,-3674
863,6,14,1,2,0,1365,1104,1361,1443,1295,1412,1803,1996,1889,2073,3650,2495,3072.0,2739.0,-1155,1577,-2732
1356,7,14,1,2,0,1514,1781,2492,2580,2168,2583,2886,3461,3252,3594,6275,3467,4871.0,4445.0,-2808,2681,-5489
357,8,14,1,2,0,293,482,602,630,509,619,652,805,800,914,1576,743,1160.0,1078.0,-833,662,-1495
653,9,14,1,2,0,552,1659,1766,2201,1866,1837,2246,2808,2902,3269,4342,1784,3063.0,3132.0,-2558,1073,-3631
381,10,14,1,2,0,312,603,500,655,477,518,574,670,621,739,1316,892,1104.0,982.0,-424,577,-1001
1760,11,14,1,2,0,2048,2831,2838,3224,2468,2600,3230,3453,3560,3776,5864,3032,4448.0,4224.0,-2832,2088,-4920
453,12,14,1,2,0,796,783,897,980,839,839,860,1325,1195,1285,2160,1579,1870.0,1675.0,-581,875,-1456
1231,13,14,1,2,0,1405,1287,1778,2039,1774,2024,2258,2481,2298,2594,4551,2375,3463.0,3173.0,-2176,1957,-4133
1586,14,14,1,2,0,2208,2034,2494,2508,2539,3103,3396,3571,3427,4047,8018,5309,6664.0,5791.0,-2709,3971,-6680
826,15,14,1,2,0,1317,1705,1980,2136,1905,1897,2229,2579,2724,3014,4336,1679,3008.0,3010.0,-2657,1322,-3979
551,16,14,1,2,0,1019,1237,1346,1186,1236,1304,1341,1747,1512,1848,3179,2049,2614.0,2359.0,-1130,1331,-2461
732,17,14,1,2,0,944,1417,1610,1468,1450,1536,1679,2187,1872,2355,3747,2461,3104.0,2854.0,-1286,1392,-2678
364,18,14,1,2,0,377,549,639,683,519,626,618,738,859,1140,1306,596,951.0,1014.0,-710,166,-876
415,19,14,1,2,0,439,737,900,949,846,1022,1132,1218,970,1188,1784,769,1276.0,1247.0,-1015,596,-1611
373,20,14,1,2,0,523,596,660,656,695,635,655,770,622,761,1417,877,1147.0,1018.0,-540,656,-1196
303,21,14,1,2,0,455,425,548,688,468,587,654,727,899,841,1546,1008,1277.0,1132.0,-538,705,-1243
365,22,14,1,2,0,417,638,624,692,573,663,777,675,517,944,1290,579,934.0,938.0,-711,346,-1057
433,1,15,2,2,0,406,900,712,656,680,680,720,820,623,807,1293,851,1072.0,984.0,-442,486,-928
300,2,15,2,2,0,255,271,184,252,242,468,405,456,394,535,639,509,574.0,561.0,-130,104,-234
276,3,15,2,2,0,266,342,266,364,340,407,480,482,477,451,580,494,537.0,508.0,-86,129,-215
923,4,15,2,2,0,612,1376,1000,1124,1019,1062,1143,1276,969,1288,2146,1327,1736.0,1587.0,-819,858,-1677
454,5,15,2,2,0,548,541,447,452,487,585,715,1123,634,781,1105,856,980.0,914.0,-249,324,-573
364,6,15,2,2,0,475,554,507,478,422,472,667,840,774,803,1070,953,1012.0,942.0,-117,267,-384
778,7,15,2,2,0,957,1035,932,915,988,988,1162,1315,1224,1513,1837,1329,1583.0,1560.0,-508,324,-832
474,8,15,2,2,0,558,679,602,669,598,604,750,729,770,798,1203,945,1074.0,982.0,-258,405,-663
180,9,15,2,2,0,134,313,221,266,335,313,351,438,425,536,825,423,624.0,595.0,-402,289,-691
71,10,15,2,2,0,128,156,79,110,114,93,121,141,135,160,243,179,211.0,194.0,-64,83,-147
1058,11,15,2,2,0,1242,1350,1122,1198,1215,1276,1793,1838,1848,1951,2643,1820,2232.0,2138.0,-823,692,-1515
151,12,15,2,2,0,233,355,293,295,274,321,334,419,377,424,571,408,490.0,468.0,-163,147,-310
884,13,15,2,2,0,842,1063,923,1024,961,977,1321,1377,1264,1433,1923,1604,1764.0,1653.0,-319,490,-809
548,14,15,2,2,0,731,827,723,780,738,834,1010,1081,952,1113,1482,1178,1330.0,1258.0,-304,369,-673
352,15,15,2,2,0,584,577,432,444,464,536,601,733,722,894,1112,767,940.0,924.0,-345,218,-563
164,16,15,2,2,0,233,258,236,284,317,260,295,373,329,377,483,446,464.0,435.0,-37,106,-143
262,17,15,2,2,0,340,403,317,301,333,339,383,464,438,477,783,487,635.0,582.0,-296,306,-602
140,18,15,2,2,0,162,321,213,189,158,212,189,235,212,345,456,397,426.0,399.0,-59,111,-170
165,19,15,2,2,0,160,216,236,253,279,277,296,261,247,251,310,270,290.0,277.0,-40,59,-99
263,20,15,2,2,0,413,369,328,342,482,408,414,486,426,491,644,555,600.0,563.0,-89,153,-242
361,21,15,2,2,0,424,439,293,395,348,388,413,568,617,622,758,719,738.0,700.0,-39,136,-175
79,22,15,2,2,0,116,156,121,150,115,124,187,159,142,152,169,104,136.0,142.0,-65,17,-82
37,1,16,2,2,0,35,64,37,32,39,46,46,41,395,67,117,63,90.0,82.0,-54,50,-104
692,2,16,2,2,0,757,1431,1186,1072,971,1395,1426,1254,988,1142,1590,946,1268.0,1226.0,-644,448,-1092
413,3,16,2,2,0,514,769,698,895,690,744,864,895,802,945,982,602,792.0,843.0,-380,37,-417
271,4,16,2,2,0,466,982,803,698,717,716,794,737,477,625,985,300,642.0,637.0,-685,360,-1045
1639,5,16,2,2,0,1370,2758,2537,2734,2651,2620,2791,2955,1733,2221,3340,1470,2405.0,2344.0,-1870,1119,-2989
260,6,16,2,2,0,352,581,410,402,479,502,552,488,424,410,575,248,412.0,411.0,-327,165,-492
1708,7,16,2,2,0,2068,3709,3356,3511,2812,3126,3130,3837,3617,3662,4024,1903,2964.0,3196.0,-2121,362,-2483
442,8,16,2,2,0,571,1176,933,1057,828,993,1217,1561,1243,1188,1616,679,1148.0,1161.0,-937,428,-1365
1075,9,16,2,2,0,627,1889,1775,1785,1654,1766,1963,2010,1906,2111,2398,1196,1797.0,1902.0,-1202,287,-1489
301,10,16,2,2,0,278,462,403,353,331,405,319,409,384,459,435,440,438.0,445.0,5,-24,29
626,11,16,2,2,0,541,942,753,875,786,701,745,840,781,777,930,527,728.0,745.0,-403,153,-556
189,12,16,2,2,0,261,379,339,330,292,330,358,538,488,482,540,354,447.0,459.0,-186,58,-244
1780,13,16,2,2,0,2309,3367,3025,3349,3221,3102,3388,3910,3483,3233,4206,2068,3137.0,3169.0,-2138,973,-3111
1050,14,16,2,2,0,1238,2093,1984,2022,1974,2200,2100,2323,1931,2018,2962,1570,2266.0,2183.0,-1392,944,-2336
422,15,16,2,2,0,384,837,836,827,820,769,777,723,606,634,886,424,655.0,648.0,-462,252,-714
270,16,16,2,2,0,389,867,611,610,623,595,715,725,585,544,920,483,702.0,649.0,-437,376,-813
653,17,16,2,2,0,1115,2020,1616,1475,1358,1456,1533,1680,1444,1489,2336,1714,2025.0,1846.0,-622,847,-1469
292,18,16,2,2,0,302,657,579,484,487,627,773,710,690,597,622,308,465.0,509.0,-314,25,-339
691,19,16,2,2,0,854,1439,1484,1508,1498,1804,1815,1871,1308,1478,1878,681,1280.0,1346.0,-1197,400,-1597
105,20,16,2,2,0,167,284,211,204,370,530,502,347,184,172,247,131,189.0,183.0,-116,75,-191
384,21,16,2,2,0,499,771,729,604,479,874,1106,695,580,634,1051,558,804.0,748.0,-493,417,-910
952,22,16,2,2,0,1179,1914,1499,1291,1253,1193,1427,1562,1308,1636,1781,730,1256.0,1382.0,-1051,145,-1196
501,1,17,2,2,0,573,2243,2672,2922,2462,1180,1500,2397,1674,2362,3060,1909,2484.0,2444.0,-1151,698,-1849
504,2,17,2,2,0,563,707,630,647,551,884,974,1076,1038,1033,1402,656,1029.0,1030.0,-746,369,-1115
214,3,17,2,2,0,335,525,430,507,344,410,446,541,468,630,827,268,548.0,575.0,-559,197,-756
200,4,17,2,2,0,353,2808,1941,2551,971,995,1118,835,516,1494,2145,217,1181.0,1285.0,-1928,651,-2579
937,5,17,2,2,0,1405,2143,1834,1543,1533,1662,1864,2707,1708,2119,2450,1355,1902.0,1975.0,-1095,331,-1426
775,6,17,2,2,0,1494,1764,1722,1828,1799,2028,2809,2863,2529,2927,3132,1460,2296.0,2506.0,-1672,205,-1877
1225,7,17,2,2,0,2478,3115,3589,3471,2715,3147,4018,4409,4129,4087,5401,1885,3643.0,3791.0,-3516,1314,-4830
491,8,17,2,2,0,779,1146,1022,1337,977,1223,1490,1510,1452,1547,2066,692,1379.0,1435.0,-1374,519,-1893
462,9,17,2,2,0,535,2905,1816,1983,1796,1715,2112,2192,2036,2188,2519,625,1572.0,1777.0,-1894,331,-2225
176,10,17,2,2,0,397,549,377,518,379,413,503,589,568,596,616,308,462.0,507.0,-308,20,-328
1862,11,17,2,2,0,3297,3990,3393,3757,3219,3369,4854,5016,4475,5007,5643,2143,3893.0,4264.0,-3500,636,-4136
442,12,17,2,2,0,1077,1305,1276,1370,1233,1308,1681,2044,1627,1981,2357,973,1665.0,1770.0,-1384,376,-1760
1261,13,17,2,2,0,1882,2484,2675,3198,2587,2964,3829,3951,3277,3711,5424,1723,3574.0,3619.0,-3701,1713,-5414
1238,14,17,2,2,0,1915,2442,2757,2736,2702,3421,4398,4500,3793,4237,5119,2463,3791.0,3940.0,-2656,882,-3538
768,15,17,2,2,0,1321,2050,1853,2092,1953,2021,2513,2777,2324,2401,2755,895,1825.0,2017.0,-1860,354,-2214
357,16,17,2,2,0,916,1381,1205,1158,1213,1120,1591,1818,1296,1466,1985,1002,1494.0,1484.0,-983,519,-1502
531,17,17,2,2,0,1083,1689,1645,1561,1517,1583,1906,2187,1670,2078,2533,1085,1809.0,1899.0,-1448,455,-1903
400,18,17,2,2,0,446,1142,977,1082,843,1055,1347,1279,1170,1218,1549,440,994.0,1069.0,-1109,331,-1440
212,19,17,2,2,0,394,781,766,859,586,702,806,897,700,869,1098,268,683.0,745.0,-830,229,-1059
359,20,17,2,2,0,586,936,946,870,1013,987,1230,1171,824,938,1120,617,868.0,892.0,-503,182,-685
397,21,17,2,2,0,688,869,1036,1284,861,1113,1278,1300,1165,1199,1748,631,1190.0,1193.0,-1117,549,-1666
156,22,17,2,2,0,210,484,451,421,327,303,404,404,286,466,480,162,321.0,369.0,-318,14,-332
362,1,18,2,2,0,300,906,709,759,629,425,535,502,314,574,754,315,534.0,548.0,-439,180,-619
295,2,18,2,2,0,389,500,421,595,461,551,450,435,635,692,866,452,659.0,670.0,-414,174,-588
254,3,18,2,2,0,383,577,507,561,440,380,452,427,495,612,941,427,684.0,660.0,-514,329,-843
89,4,18,2,2,0,209,482,498,353,301,382,397,346,199,341,546,125,336.0,337.0,-421,205,-626
704,5,18,2,2,0,991,1444,1326,1270,1055,1379,1197,903,838,1187,1812,1017,1414.0,1339.0,-795,625,-1420
475,6,18,2,2,0,887,1184,1065,1021,869,1109,958,734,813,952,1669,741,1205.0,1121.0,-928,717,-1645
1515,7,18,2,2,0,2475,3780,3634,3404,2787,3450,3299,2451,2995,3812,5496,2330,3913.0,3879.0,-3166,1684,-4850
641,8,18,2,2,0,1042,1482,1678,1725,1270,1462,1588,1052,1126,1234,2626,1165,1896.0,1675.0,-1461,1392,-2853
255,9,18,2,2,0,178,510,397,473,460,457,448,529,384,525,1055,368,712.0,649.0,-687,530,-1217
155,10,18,2,2,0,173,461,182,302,352,363,291,255,362,355,448,365,406.0,389.0,-83,93,-176
1028,11,18,2,2,0,941,1639,1304,1178,1368,1353,1085,864,1310,1728,2261,1167,1714.0,1719.0,-1094,533,-1627
223,12,18,2,2,0,332,492,421,412,315,365,335,301,356,946,847,641,744.0,811.0,-206,-99,-107
1551,13,18,2,2,0,2876,2946,3004,3190,2715,3210,3609,2265,2586,3058,5478,1932,3705.0,3489.0,-3546,2420,-5966
893,14,18,2,2,0,1336,1920,1867,1905,1469,1701,1452,1141,1472,1941,3092,1731,2412.0,2255.0,-1361,1151,-2512
467,15,18,2,2,0,560,1342,916,1100,1016,1000,913,659,638,706,1205,504,854.0,805.0,-701,499,-1200
154,16,18,2,2,0,332,433,470,347,353,277,263,202,272,348,657,298,478.0,434.0,-359,309,-668
253,17,18,2,2,0,599,989,827,849,769,962,701,698,568,587,1351,576,964.0,838.0,-775,764,-1539
148,18,18,2,2,0,127,369,321,335,225,356,355,342,307,452,617,215,416.0,428.0,-402,165,-567
408,19,18,2,2,0,461,979,733,783,589,621,716,684,572,853,1026,394,710.0,758.0,-632,173,-805
248,20,18,2,2,0,370,549,493,497,413,558,474,304,408,379,694,353,524.0,475.0,-341,315,-656
418,21,18,2,2,0,406,608,683,599,723,667,832,623,693,804,1400,754,1077.0,986.0,-646,596,-1242
266,22,18,2,2,0,551,532,645,383,283,369,508,307,324,496,710,280,495.0,495.0,-430,214,-644
177,1,19,2,2,0,162,289,246,249,228,201,232,150,148,312,359,339,349.0,337.0,-20,47,-67
248,2,19,2,2,0,215,264,283,346,330,388,290,304,344,442,485,409,447.0,445.0,-76,43,-119
319,3,19,2,2,0,173,236,276,395,262,398,348,325,432,401,434,519,476.0,451.0,85,33,52
877,4,19,2,2,0,607,1252,1112,1156,1039,990,1183,1150,795,1121,1802,1263,1532.0,1395.0,-539,681,-1220
565,5,19,2,2,0,485,639,702,679,596,623,519,741,610,732,1083,1390,1236.0,1068.0,307,351,-44
315,6,19,2,2,0,265,335,339,414,403,381,360,323,440,519,629,667,648.0,605.0,38,110,-72
878,7,19,2,2,0,694,1162,1362,1499,1162,1256,1311,1391,1370,1666,1642,1861,1752.0,1723.0,219,-24,243
317,8,19,2,2,0,225,381,342,380,264,316,332,330,480,421,414,426,420.0,420.0,12,-7,19
322,9,19,2,2,0,132,499,400,553,537,509,516,523,704,995,1243,727,985.0,988.0,-516,248,-764
119,10,19,2,2,0,72,100,87,113,102,97,101,156,159,192,214,225,220.0,210.0,11,22,-11
868,11,19,2,2,0,733,1051,1024,1236,925,785,871,1280,881,1099,1374,1336,1355.0,1270.0,-38,275,-313
141,12,19,2,2,0,114,198,208,246,191,199,169,178,237,276,329,364,346.0,323.0,35,53,-18
1165,13,19,2,2,0,874,1322,1150,1563,1391,1238,1360,1115,1052,1461,1615,1768,1692.0,1615.0,153,154,-1
856,14,19,2,2,0,536,792,984,996,913,957,1047,1104,1357,1223,1443,1429,1436.0,1365.0,-14,220,-234
356,15,19,2,2,0,311,485,482,592,492,475,404,404,512,747,863,742,802.0,784.0,-121,116,-237
262,16,19,2,2,0,217,350,350,345,337,298,379,393,374,473,566,558,562.0,532.0,-8,93,-101
230,17,19,2,2,0,193,301,261,307,277,273,291,253,248,418,494,519,506.0,477.0,25,76,-51
188,18,19,2,2,0,162,288,229,307,216,229,183,186,285,325,402,404,403.0,377.0,2,77,-75
546,19,19,2,2,0,324,566,616,593,769,652,721,569,738,644,1082,704,893.0,810.0,-378,438,-816
202,20,19,2,2,0,158,224,260,274,314,254,213,262,251,282,391,433,412.0,369.0,42,109,-67
257,21,19,2,2,0,184,273,411,522,312,356,360,419,276,346,497,487,492.0,443.0,-10,151,-161
666,22,19,2,2,0,427,986,775,794,828,639,929,731,657,664,964,785,874.0,804.0,-179,300,-479
447,1,20,1,2,0,568,1144,987,982,1141,897,946,1150,1010,1563,1504,815,1160.0,1294.0,-689,-59,-630
277,2,20,1,2,0,407,491,429,522,373,681,595,570,759,692,785,585,685.0,687.0,-200,93,-293
110,3,20,1,2,0,174,204,243,365,254,296,333,327,407,342,430,303,366.0,358.0,-127,88,-215
284,4,20,1,2,0,395,672,745,768,998,675,772,925,740,925,1127,376,752.0,809.0,-751,202,-953
562,5,20,1,2,0,779,913,980,978,903,990,1085,1885,1100,1320,1775,1096,1436.0,1397.0,-679,455,-1134
364,6,20,1,2,0,600,798,764,823,725,769,980,1023,1001,1064,1490,952,1221.0,1169.0,-538,426,-964
501,7,20,1,2,0,681,940,1108,1210,1082,1134,1323,1432,1303,1408,1739,940,1340.0,1362.0,-799,331,-1130
113,8,20,1,2,0,235,312,291,326,221,257,295,289,333,332,371,229,300.0,311.0,-142,39,-181
451,9,20,1,2,0,423,1174,995,1269,1114,1097,1195,1320,1463,1644,2216,854,1535.0,1571.0,-1362,572,-1934
114,10,20,1,2,0,211,246,212,277,223,187,218,240,280,255,372,218,295.0,282.0,-154,117,-271
987,11,20,1,2,0,1323,1686,1487,1639,1433,1571,1947,1897,1872,2263,3132,1586,2359.0,2327.0,-1546,869,-2415
284,12,20,1,2,0,454,671,722,759,661,681,684,855,798,870,1144,754,949.0,923.0,-390,274,-664
442,13,20,1,2,0,517,776,716,788,622,676,985,861,883,944,1218,652,935.0,938.0,-566,274,-840
471,14,20,1,2,0,652,810,959,936,866,965,1056,1067,1021,1121,1578,856,1217.0,1185.0,-722,457,-1179
893,15,20,1,2,0,1395,1880,1823,1961,1826,1921,2037,2367,2323,2703,3371,1749,2560.0,2608.0,-1622,668,-2290
363,16,20,1,2,0,532,746,751,751,798,730,829,920,1033,988,1333,941,1137.0,1087.0,-392,345,-737
386,17,20,1,2,0,612,798,869,852,770,811,908,1056,973,1081,1561,1003,1282.0,1215.0,-558,480,-1038
370,18,20,1,2,0,407,744,580,799,587,681,684,714,853,905,1102,667,884.0,891.0,-435,197,-632
188,19,20,1,2,0,172,302,339,376,332,444,478,491,437,403,555,253,404.0,404.0,-302,152,-454
184,20,20,1,2,0,350,388,450,403,448,421,422,477,428,496,740,452,596.0,563.0,-288,244,-532
223,21,20,1,2,0,275,327,347,397,335,338,351,433,450,479,533,395,464.0,469.0,-138,54,-192
219,22,20,1,2,0,146,415,369,422,399,362,461,359,320,352,428,213,320.0,331.0,-215,76,-291
231,1,21,2,2,0,184,494,480,438,464,464,563,552,450,685,688,275,482.0,549.0,-413,3,-416
321,2,21,2,2,0,407,551,494,611,509,837,743,640,687,714,1001,409,705.0,708.0,-592,287,-879
239,3,21,2,2,0,281,409,555,665,393,509,544,557,650,671,789,370,580.0,610.0,-419,118,-537
360,4,21,2,2,0,555,1236,1175,1102,1018,1021,1288,1431,1045,1332,1807,402,1104.0,1180.0,-1405,475,-1880
1106,5,21,2,2,0,1439,1972,2107,1866,1748,1887,2009,2921,2017,2913,3590,1589,2590.0,2697.0,-2001,677,-2678
593,6,21,2,2,0,517,1041,1182,1170,1110,1307,1431,1596,1491,1717,1968,921,1444.0,1535.0,-1047,251,-1298
945,7,21,2,2,0,1121,2092,2449,2486,1895,2003,2387,2615,2547,2776,3299,1329,2314.0,2468.0,-1970,523,-2493
261,8,21,2,2,0,373,673,634,789,589,641,800,787,813,782,1130,401,766.0,771.0,-729,348,-1077
354,9,21,2,2,0,323,1264,996,1286,1093,1029,1303,1438,1702,2171,2397,475,1436.0,1681.0,-1922,226,-2148
179,10,21,2,2,0,161,369,263,323,295,287,282,358,395,493,595,225,410.0,438.0,-370,102,-472
1477,11,21,2,2,0,1522,2786,2473,3080,2334,2394,3107,2962,3228,3579,4302,1623,2962.0,3168.0,-2679,723,-3402
230,12,21,2,2,0,252,491,598,657,503,672,641,755,781,885,1016,398,707.0,766.0,-618,131,-749
1311,13,21,2,2,0,1404,2330,2475,2921,2392,2559,2979,2860,2877,2989,3954,1565,2760.0,2836.0,-2389,965,-3354
872,14,21,2,2,0,955,1587,2122,1817,1841,2115,2398,2493,2358,2638,3291,1489,2390.0,2473.0,-1802,653,-2455
793,15,21,2,2,0,893,1688,1755,1827,1550,1572,1914,1992,2163,2458,2897,961,1929.0,2105.0,-1936,439,-2375
357,16,21,2,2,0,473,870,703,828,848,789,996,1142,948,1247,1304,805,1054.0,1119.0,-499,57,-556
264,17,21,2,2,0,394,710,632,689,696,720,817,950,757,948,1222,427,824.0,866.0,-795,274,-1069
327,18,21,2,2,0,280,669,569,777,495,680,640,694,837,946,924,385,654.0,752.0,-539,-22,-517
423,19,21,2,2,0,487,985,1021,1093,717,904,1088,1057,1007,1160,1513,414,964.0,1029.0,-1099,353,-1452
209,20,21,2,2,0,214,312,317,246,378,375,374,365,407,493,612,296,454.0,467.0,-316,119,-435
239,21,21,2,2,0,352,582,607,926,472,701,761,801,945,946,1143,404,774.0,831.0,-739,197,-936
436,22,21,2,2,0,475,987,974,825,774,757,1154,914,753,1190,1198,462,830.0,950.0,-736,8,-744
455,1,22,4,2,0,350,778,523,603,553,600,670,690,633,790,925,325,625.0,680.0,-600,135,-735
218,2,22,4,2,0,244,415,322,387,317,493,447,408,431,527,546,194,370.0,422.0,-352,19,-371
163,3,22,4,2,0,150,300,265,350,301,313,341,355,371,359,418,168,293.0,315.0,-250,59,-309
523,4,22,4,2,0,426,1017,846,916,826,879,911,1074,915,1162,1615,471,1043.0,1083.0,-1144,453,-1597
516,5,22,4,2,0,562,879,706,738,715,745,722,1155,772,961,1167,445,806.0,858.0,-722,206,-928
418,6,22,4,2,0,357,675,647,692,656,677,767,841,878,933,1003,374,688.0,770.0,-629,70,-699
984,7,22,4,2,0,860,1928,1822,1978,1685,1638,1852,2308,2307,2370,2766,875,1820.0,2004.0,-1891,396,-2287
184,8,22,4,2,0,166,314,241,352,275,285,300,313,320,355,484,139,312.0,326.0,-345,129,-474
402,9,22,4,2,0,342,1042,810,979,912,937,951,992,1092,1209,1464,402,933.0,1025.0,-1062,255,-1317
109,10,22,4,2,0,125,288,186,265,233,260,262,246,259,290,384,118,251.0,264.0,-266,94,-360
1612,11,22,4,2,0,1512,2488,1949,2522,2016,2112,2209,2679,2595,2801,3241,1057,2149.0,2366.0,-2184,440,-2624
176,12,22,4,2,0,200,434,361,405,347,434,393,442,498,481,511,213,362.0,402.0,-298,30,-328
885,13,22,4,2,0,764,1561,1277,1469,1298,1298,1461,1525,1603,1929,2115,754,1434.0,1599.0,-1361,186,-1547
724,14,22,4,2,0,578,1090,1137,1026,959,1096,1283,1383,1309,1461,1740,591,1166.0,1264.0,-1149,279,-1428
1237,15,22,4,2,0,1062,1999,1632,1956,1671,1999,1697,1991,2033,2127,2662,818,1740.0,1869.0,-1844,535,-2379
279,16,22,4,2,0,314,537,473,508,574,499,596,611,603,616,685,305,495.0,535.0,-380,69,-449
278,17,22,4,2,0,263,575,412,494,442,503,514,645,501,559,768,256,512.0,528.0,-512,209,-721
257,18,22,4,2,0,236,512,409,530,373,503,451,397,473,480,608,216,412.0,435.0,-392,128,-520
217,19,22,4,2,0,246,558,476,514,420,483,505,553,489,516,595,169,382.0,427.0,-426,79,-505
99,20,22,4,2,0,94,156,120,135,198,189,145,189,159,216,258,69,164.0,181.0,-189,42,-231
238,21,22,4,2,0,259,468,393,540,321,402,487,425,510,487,657,185,421.0,443.0,-472,170,-642
228,22,22,4,2,0,242,628,493,470,454,420,611,511,443,413,533,157,345.0,368.0,-376,120,-496
41,1,23,1,2,0,80,117,123,63,113,83,134,126,104,114,215,76,146.0,135.0,-139,101,-240
41,2,23,1,2,0,186,114,92,106,89,141,121,133,139,121,182,95,138.0,133.0,-87,61,-148
66,3,23,1,2,0,114,123,107,124,111,114,92,121,108,174,205,99,152.0,159.0,-106,31,-137
40,4,23,1,2,0,148,234,172,132,149,201,202,250,161,243,439,74,256.0,252.0,-365,196,-561
153,5,23,1,2,0,509,328,331,262,301,284,317,459,291,297,513,309,411.0,373.0,-204,216,-420
273,6,23,1,2,0,870,680,514,529,526,633,733,655,600,692,1047,578,812.0,772.0,-469,355,-824
381,7,23,1,2,0,1101,802,922,771,855,1000,1063,1138,1097,1099,1844,902,1373.0,1282.0,-942,745,-1687
158,8,23,1,2,0,211,155,211,195,143,212,261,250,277,308,545,238,392.0,364.0,-307,237,-544
71,9,23,1,2,0,89,154,162,145,223,291,295,282,277,289,373,126,250.0,263.0,-247,84,-331
53,10,23,1,2,0,104,97,54,71,100,108,107,108,100,115,162,93,128.0,123.0,-69,47,-116
168,11,23,1,2,0,502,454,332,411,403,402,461,370,406,397,621,300,460.0,439.0,-321,224,-545
36,12,23,1,2,0,200,101,96,91,121,141,112,150,164,143,266,151,208.0,187.0,-115,123,-238
389,13,23,1,2,0,753,620,514,537,455,575,645,742,699,808,1460,748,1104.0,1005.0,-712,652,-1364
174,14,23,1,2,0,528,298,313,364,453,477,544,566,471,617,1100,524,812.0,747.0,-576,483,-1059
55,15,23,1,2,0,143,158,153,145,161,194,181,198,211,191,260,101,180.0,184.0,-159,69,-228
79,16,23,1,2,0,242,211,178,180,285,274,266,326,324,313,534,275,404.0,374.0,-259,221,-480
119,17,23,1,2,0,234,247,217,180,205,282,273,347,286,335,535,308,422.0,393.0,-227,200,-427
25,18,23,1,2,0,45,82,56,58,88,101,114,102,89,87,129,60,94.0,92.0,-69,42,-111
91,19,23,1,2,0,232,279,252,262,234,252,331,280,278,265,371,149,260.0,262.0,-222,106,-328
84,20,23,1,2,0,271,178,190,138,222,247,251,250,189,199,335,168,252.0,234.0,-167,136,-303
62,21,23,1,2,0,166,118,112,151,113,180,161,167,197,186,360,209,284.0,252.0,-151,174,-325
95,22,23,1,2,0,152,215,165,177,206,165,264,248,169,223,312,126,219.0,220.0,-186,89,-275
494,1,24,2,2,0,279,554,507,485,527,653,687,651,489,558,362,679,520.0,533.0,317,-196,513
130,2,24,2,2,0,87,174,151,202,185,247,209,201,174,160,155,229,192.0,181.0,74,-5,79
63,3,24,2,2,0,51,90,76,95,106,108,130,97,99,82,59,106,82.0,82.0,47,-23,70
532,4,24,2,2,0,424,733,545,566,646,748,847,831,642,654,521,798,660.0,658.0,277,-133,410
394,5,24,2,2,0,325,439,421,431,486,460,559,615,471,430,474,703,588.0,536.0,229,44,185
203,6,24,2,2,0,144,198,252,223,244,244,344,348,248,228,187,338,262.0,251.0,151,-41,192
362,7,24,2,2,0,240,412,457,437,443,584,549,525,474,421,353,610,482.0,461.0,257,-68,325
94,8,24,2,2,0,58,112,93,114,101,121,154,121,105,117,105,129,117.0,117.0,24,-12,36
847,9,24,2,2,0,384,1124,891,1008,1160,1083,1238,1180,1049,976,1007,1207,1107.0,1063.0,200,31,169
102,10,24,2,2,0,68,133,79,114,129,142,161,151,126,138,119,159,139.0,139.0,40,-19,59
1066,11,24,2,2,0,960,1400,1291,1323,1469,1509,1821,1585,1270,1186,1077,1735,1406.0,1333.0,658,-109,767
146,12,24,2,2,0,93,153,158,177,165,198,224,232,164,154,152,242,197.0,183.0,90,-2,92
242,13,24,2,2,0,118,239,297,312,337,350,330,362,307,254,182,340,261.0,259.0,158,-72,230
199,14,24,2,2,0,161,301,358,277,291,353,389,339,239,284,223,320,272.0,276.0,97,-61,158
973,15,24,2,2,0,745,1150,1124,1121,1210,1486,1568,1439,1239,1136,1024,1529,1276.0,1230.0,505,-112,617
238,16,24,2,2,0,166,276,286,265,300,346,383,407,272,273,274,370,322.0,306.0,96,1,95
186,17,24,2,2,0,113,209,229,207,229,257,270,285,213,205,215,305,260.0,242.0,90,10,80
242,18,24,2,2,0,187,331,340,375,354,394,437,448,353,321,324,518,421.0,388.0,194,3,191
205,19,24,2,2,0,150,206,234,226,254,291,346,299,229,207,174,292,233.0,224.0,118,-33,151
199,20,24,2,2,0,140,226,204,204,232,259,222,255,197,217,217,267,242.0,234.0,50,0,50
151,21,24,2,2,0,145,192,213,288,241,238,319,283,263,205,197,285,241.0,229.0,88,-8,96
68,22,24,2,2,0,46,74,80,87,80,75,119,71,81,63,53,93,73.0,70.0,40,-10,50
160,1,25,1,2,0,164,397,283,308,272,297,303,281,281,247,225,315,270.0,262.0,90,-22,112
108,2,25,1,2,0,89,159,143,175,143,190,187,165,167,133,176,164,170.0,158.0,-12,43,-55
62,3,25,1,2,0,51,91,82,115,109,112,117,120,96,85,86,86,86.0,86.0,0,1,-1
190,4,25,1,2,0,232,428,353,385,362,331,427,429,308,324,417,323,370.0,355.0,-94,93,-187
166,5,25,1,2,0,224,376,344,382,380,359,376,389,305,301,337,483,410.0,374.0,146,36,110
119,6,25,1,2,0,119,169,162,175,187,156,227,205,162,169,174,188,181.0,177.0,14,5,9
160,7,25,1,2,0,185,290,276,307,309,263,302,292,265,227,253,339,296.0,273.0,86,26,60
56,8,25,1,2,0,50,77,59,95,91,82,103,99,83,81,91,111,101.0,94.0,20,10,10
314,9,25,1,2,0,212,629,501,543,522,480,565,575,462,510,512,581,546.0,534.0,69,2,67
57,10,25,1,2,0,67,86,103,113,124,96,117,108,102,103,109,128,118.0,113.0,19,6,13
456,11,25,1,2,0,478,831,673,752,698,733,823,757,642,661,734,807,770.0,734.0,73,73,0
79,12,25,1,2,0,65,143,134,157,139,120,153,155,115,129,138,165,152.0,144.0,27,9,18
126,13,25,1,2,0,109,201,188,230,197,195,219,226,184,180,178,203,190.0,187.0,25,-2,27
103,14,25,1,2,0,105,163,205,180,189,189,186,187,161,189,173,186,180.0,183.0,13,-16,29
382,15,25,1,2,0,473,696,636,660,565,645,709,620,587,599,595,656,626.0,617.0,61,-4,65
142,16,25,1,2,0,151,282,230,266,292,242,319,331,219,258,266,270,268.0,265.0,4,8,-4
114,17,25,1,2,0,96,191,206,200,169,164,219,179,160,168,191,210,200.0,190.0,19,23,-4
127,18,25,1,2,0,129,246,219,230,256,240,260,259,202,201,205,241,223.0,216.0,36,4,32
90,19,25,1,2,0,84,157,166,150,154,152,161,165,130,138,128,140,134.0,135.0,12,-10,22
54,20,25,1,2,0,74,152,134,144,142,148,158,109,123,106,134,131,132.0,124.0,-3,28,-31
85,21,25,1,2,0,115,156,163,199,168,161,205,192,172,135,145,159,152.0,146.0,14,10,4
34,22,25,1,2,0,45,84,72,91,70,67,99,74,50,53,61,68,64.0,61.0,7,8,-1
424,1,26,1,2,0,276,461,355,455,551,438,559,478,428,493,474,835,654.0,601.0,361,-19,380
178,2,26,1,2,0,96,197,123,203,222,190,240,237,204,210,215,310,262.0,245.0,95,5,90
87,3,26,1,2,0,55,85,62,91,81,74,115,91,72,82,74,139,106.0,98.0,65,-8,73
648,4,26,1,2,0,419,597,509,573,717,674,824,853,604,747,817,1033,925.0,866.0,216,70,146
383,5,26,1,2,0,265,377,334,442,494,344,458,388,382,361,382,695,538.0,479.0,313,21,292
152,6,26,1,2,0,113,164,138,167,188,148,226,228,183,176,177,354,266.0,236.0,177,1,176
328,7,26,1,2,0,221,286,259,291,346,365,453,344,338,348,336,608,472.0,431.0,272,-12,284
96,8,26,1,2,0,51,78,95,88,102,105,108,108,84,93,100,165,132.0,119.0,65,7,58
690,9,26,1,2,0,299,866,560,678,769,689,886,875,627,766,825,1178,1002.0,923.0,353,59,294
106,10,26,1,2,0,44,91,57,97,100,90,105,124,72,100,114,160,137.0,125.0,46,14,32
766,11,26,1,2,0,575,787,801,890,962,857,1124,918,791,915,1007,1591,1299.0,1171.0,584,92,492
115,12,26,1,2,0,57,129,99,112,125,115,140,155,101,129,108,227,168.0,155.0,119,-21,140
209,13,26,1,2,0,131,173,183,199,229,221,266,200,202,203,219,376,298.0,266.0,157,16,141
201,14,26,1,2,0,145,193,185,185,207,254,276,252,194,283,262,357,310.0,301.0,95,-21,116
623,15,26,1,2,0,438,716,641,723,810,824,880,834,733,849,908,1436,1172.0,1064.0,528,59,469
202,16,26,1,2,0,130,265,212,243,260,260,327,326,230,315,356,436,396.0,369.0,80,41,39
179,17,26,1,2,0,71,152,121,164,200,157,190,184,143,174,192,302,247.0,223.0,110,18,92
212,18,26,1,2,0,119,238,208,225,265,234,296,266,197,227,256,500,378.0,328.0,244,29,215
176,19,26,1,2,0,145,170,172,190,254,215,281,225,176,194,227,304,266.0,242.0,77,33,44
152,20,26,1,2,0,113,138,114,168,164,192,184,176,151,174,194,265,230.0,211.0,71,20,51
140,21,26,1,2,0,141,184,186,174,206,235,213,228,210,194,216,307,262.0,239.0,91,22,69
84,22,26,1,2,0,52,69,62,72,97,59,106,77,74,83,85,102,94.0,90.0,17,2,15
97,1,27,4,2,0,90,185,166,151,149,152,203,190,188,201,262,80,171.0,181.0,-182,61,-243
35,2,27,4,2,0,23,65,81,86,43,35,60,52,76,100,59,26,42.0,62.0,-33,-41,8
17,3,27,4,2,0,20,44,34,38,23,35,33,31,42,40,37,22,30.0,33.0,-15,-3,-12
117,4,27,4,2,0,106,251,267,259,192,172,203,232,200,230,226,93,160.0,183.0,-133,-4,-129
76,5,27,4,2,0,100,155,124,131,94,121,152,216,166,240,223,57,140.0,173.0,-166,-17,-149
59,6,27,4,2,0,58,93,91,91,85,90,104,106,110,130,121,57,89.0,103.0,-64,-9,-55
137,7,27,4,2,0,97,238,273,264,203,199,232,258,215,231,199,113,156.0,181.0,-86,-32,-54
10,8,27,4,2,0,17,30,23,35,28,32,37,31,31,28,33,16,24.0,26.0,-17,5,-22
115,9,27,4,2,0,83,239,207,253,209,182,223,290,309,396,384,120,252.0,300.0,-264,-12,-252
18,10,27,4,2,0,18,29,21,31,23,25,29,35,34,41,40,20,30.0,34.0,-20,-1,-19
325,11,27,4,2,0,314,442,327,438,345,389,471,447,420,635,591,225,408.0,484.0,-366,-44,-322
18,12,27,4,2,0,29,37,44,50,31,41,43,50,52,66,85,10,48.0,54.0,-75,19,-94
99,13,27,4,2,0,87,128,105,161,119,127,130,145,141,166,161,78,120.0,135.0,-83,-5,-78
77,14,27,4,2,0,59,126,107,118,88,93,86,118,117,128,163,57,110.0,116.0,-106,35,-141
290,15,27,4,2,0,270,423,431,415,297,361,382,415,422,523,567,168,368.0,419.0,-399,44,-443
54,16,27,4,2,0,58,96,72,86,72,79,106,110,92,120,142,48,95.0,103.0,-94,22,-116
43,17,27,4,2,0,38,74,84,62,48,45,64,96,79,112,124,41,82.0,92.0,-83,12,-95
28,18,27,4,2,0,35,60,68,83,59,50,84,61,85,108,127,23,75.0,86.0,-104,19,-123
38,19,27,4,2,0,51,101,79,77,61,82,88,87,77,106,83,28,56.0,72.0,-55,-23,-32
20,20,27,4,2,0,28,40,35,34,28,26,35,47,43,77,67,17,42.0,54.0,-50,-10,-40
52,21,27,4,2,0,35,72,77,99,52,57,82,79,83,68,82,41,62.0,64.0,-41,14,-55
18,22,27,4,2,0,36,71,63,68,50,44,61,42,40,48,45,18,32.0,37.0,-27,-3,-24
283,1,28,2,2,0,285,625,493,512,736,581,360,145,129,306,492,378,435.0,392.0,-114,186,-300
101,2,28,2,2,0,144,215,224,243,237,221,153,83,75,142,154,140,147.0,145.0,-14,12,-26
79,3,28,2,2,0,85,133,133,164,131,165,105,47,48,67,109,121,115.0,99.0,12,42,-30
299,4,28,2,2,0,303,713,701,789,881,663,502,321,175,311,576,511,544.0,466.0,-65,265,-330
291,5,28,2,2,0,397,598,495,600,609,554,488,356,206,340,526,495,510.0,454.0,-31,186,-217
148,6,28,2,2,0,181,295,315,306,319,309,208,104,111,219,307,304,306.0,277.0,-3,88,-91
284,7,28,2,2,0,326,543,643,668,672,573,446,246,241,312,378,406,392.0,365.0,28,66,-38
61,8,28,2,2,0,91,129,126,145,145,138,80,47,46,58,83,94,88.0,78.0,11,25,-14
355,9,28,2,2,0,191,803,692,927,973,869,740,398,282,593,912,598,755.0,701.0,-314,319,-633
33,10,28,2,2,0,51,92,69,104,120,85,95,39,30,50,68,74,71.0,64.0,6,18,-12
652,11,28,2,2,0,705,1330,1133,1369,1500,1116,610,270,351,609,1028,993,1010.0,877.0,-35,419,-454
69,12,28,2,2,0,111,177,180,188,194,175,130,47,59,107,208,200,204.0,172.0,-8,101,-109
250,13,28,2,2,0,274,446,396,489,506,429,351,172,141,298,340,342,341.0,327.0,2,42,-40
184,14,28,2,2,0,194,359,443,350,442,406,206,143,136,170,239,290,264.0,233.0,51,69,-18
708,15,28,2,2,0,893,1531,1481,1596,1826,1257,815,643,498,965,1300,996,1148.0,1087.0,-304,335,-639
134,16,28,2,2,0,186,290,320,331,346,286,253,116,101,212,331,334,332.0,292.0,3,119,-116
146,17,28,2,2,0,183,302,305,370,344,325,229,78,92,180,310,284,297.0,258.0,-26,130,-156
97,18,28,2,2,0,100,249,210,345,285,288,200,69,95,138,176,229,202.0,181.0,53,38,15
190,19,28,2,2,0,174,359,364,390,459,433,291,193,157,189,261,256,258.0,235.0,-5,72,-77
82,20,28,2,2,0,111,157,161,172,225,158,135,51,35,76,157,115,136.0,116.0,-42,81,-123
136,21,28,2,2,0,163,253,275,312,315,249,241,115,96,127,205,223,214.0,185.0,18,78,-60
92,22,28,2,2,0,153,325,234,241,211,111,123,58,56,108,145,104,124.0,119.0,-41,37,-78
214,1,29,1,2,0,161,390,364,320,327,408,528,494,298,341,507,266,386.0,371.0,-241,166,-407
99,2,29,1,2,0,126,173,191,127,108,198,213,197,180,169,225,142,184.0,179.0,-83,56,-139
74,3,29,1,2,0,83,156,132,135,136,178,178,174,157,121,169,76,122.0,122.0,-93,48,-141
170,4,29,1,2,0,187,418,394,364,332,388,450,529,355,417,450,177,314.0,348.0,-273,33,-306
224,5,29,1,2,0,292,385,337,371,406,440,533,641,403,433,394,242,318.0,356.0,-152,-39,-113
139,6,29,1,2,0,133,230,208,185,223,244,297,328,172,256,310,160,235.0,242.0,-150,54,-204
251,7,29,1,2,0,238,402,377,302,378,352,487,582,453,469,507,305,406.0,427.0,-202,38,-240
43,8,29,1,2,0,77,141,107,116,114,132,168,143,117,124,97,55,76.0,92.0,-42,-27,-15
271,9,29,1,2,0,200,616,587,591,684,704,813,867,710,821,895,435,665.0,717.0,-460,74,-534
66,10,29,1,2,0,77,129,95,81,120,108,129,137,85,114,124,79,102.0,106.0,-45,10,-55
589,11,29,1,2,0,510,885,789,826,854,952,1272,1166,688,937,1154,552,853.0,881.0,-602,217,-819
91,12,29,1,2,0,99,172,121,144,151,183,202,193,186,189,178,106,142.0,158.0,-72,-11,-61
188,13,29,1,2,0,170,325,291,244,275,310,427,423,324,327,378,179,278.0,295.0,-199,51,-250
143,14,29,1,2,0,161,241,351,217,257,301,336,420,237,276,308,156,232.0,247.0,-152,32,-184
543,15,29,1,2,0,537,1058,811,816,971,1162,1196,1045,917,1072,1169,550,860.0,930.0,-619,97,-716
177,16,29,1,2,0,173,366,272,236,352,315,395,429,270,308,378,261,320.0,316.0,-117,70,-187
129,17,29,1,2,0,132,288,231,235,286,268,360,359,193,226,309,145,227.0,227.0,-164,83,-247
110,18,29,1,2,0,107,228,247,214,238,244,281,263,253,214,293,168,230.0,225.0,-125,79,-204
85,19,29,1,2,0,110,199,192,184,149,191,241,242,174,177,213,86,150.0,159.0,-127,36,-163
59,20,29,1,2,0,62,91,84,83,135,121,146,128,96,89,130,65,98.0,95.0,-65,41,-106
81,21,29,1,2,0,76,153,141,143,148,200,229,215,165,164,174,112,143.0,150.0,-62,10,-72
40,22,29,1,2,0,83,190,96,96,121,92,130,140,82,95,85,44,64.0,75.0,-41,-10,-31
251,1,30,1,2,0,224,524,428,462,576,421,521,504,402,593,748,538,643.0,626.0,-210,155,-365
166,2,30,1,2,0,173,285,234,259,204,306,266,231,316,323,344,263,304.0,310.0,-81,21,-102
109,3,30,1,2,0,106,139,167,203,169,162,217,201,207,206,200,197,198.0,201.0,-3,-6,3
424,4,30,1,2,0,395,929,887,986,1008,845,898,731,715,939,1050,755,902.0,915.0,-295,111,-406
348,5,30,1,2,0,418,657,632,753,748,554,658,1072,583,560,641,624,632.0,608.0,-17,81,-98
200,6,30,1,2,0,151,261,270,316,300,257,346,329,282,331,409,330,370.0,357.0,-79,78,-157
309,7,30,1,2,0,383,514,607,578,623,481,543,678,438,630,646,659,652.0,645.0,13,16,-3
44,8,30,1,2,0,83,103,127,142,127,114,155,143,139,142,103,120,112.0,122.0,17,-39,56
499,9,30,1,2,0,325,1013,985,1219,1303,1074,1237,1342,1295,1408,1829,1269,1549.0,1502.0,-560,421,-981
82,10,30,1,2,0,70,170,96,158,161,124,125,189,162,142,255,213,234.0,203.0,-42,113,-155
649,11,30,1,2,0,635,1034,965,1031,1078,842,1106,1255,1040,1108,1430,1304,1367.0,1281.0,-126,322,-448
85,12,30,1,2,0,105,194,206,264,228,177,230,275,218,275,247,282,264.0,268.0,35,-28,63
254,13,30,1,2,0,205,365,330,420,442,396,476,471,407,417,527,425,476.0,456.0,-102,110,-212
251,14,30,1,2,0,240,352,404,359,472,400,422,469,405,382,502,442,472.0,442.0,-60,120,-180
567,15,30,1,2,0,585,1059,1028,1051,1251,1000,1181,1241,932,1214,1500,938,1219.0,1217.0,-562,286,-848
259,16,30,1,2,0,243,406,406,395,467,358,427,529,447,473,526,572,549.0,524.0,46,53,-7
207,17,30,1,2,0,204,413,420,443,451,322,451,476,369,391,505,374,440.0,423.0,-131,114,-245
144,18,30,1,2,0,140,232,234,345,272,282,266,282,298,320,358,335,346.0,338.0,-23,38,-61
156,19,30,1,2,0,232,362,315,405,340,365,459,418,357,335,454,281,368.0,357.0,-173,119,-292
108,20,30,1,2,0,121,206,221,225,291,189,230,259,188,209,244,199,222.0,217.0,-45,35,-80
174,21,30,1,2,0,168,242,253,346,302,281,312,352,366,242,346,325,336.0,304.0,-21,104,-125
94,22,30,1,2,0,130,276,201,264,224,175,240,219,123,190,198,139,168.0,176.0,-59,8,-67
384,1,31,2,2,0,306,722,679,634,547,444,607,438,357,513,576,543,560.0,544.0,-33,63,-96
199,2,31,2,2,0,151,279,225,250,183,177,213,139,117,236,257,243,250.0,245.0,-14,21,-35
43,3,31,2,2,0,26,82,69,87,52,46,43,47,37,60,80,54,67.0,65.0,-26,20,-46
311,4,31,2,2,0,262,673,614,681,595,494,449,410,328,585,816,536,676.0,646.0,-280,231,-511
337,5,31,2,2,0,275,561,619,591,569,444,445,455,290,447,593,591,592.0,544.0,-2,146,-148
230,6,31,2,2,0,174,315,300,376,284,251,265,236,233,275,385,322,354.0,327.0,-63,110,-173
289,7,31,2,2,0,202,484,554,521,386,382,358,297,285,401,440,468,454.0,436.0,28,39,-11
64,8,31,2,2,0,35,81,62,68,61,45,60,31,30,61,103,57,80.0,74.0,-46,42,-88
618,9,31,2,2,0,316,1135,1224,1221,1023,972,1033,800,773,983,1319,1274,1296.0,1192.0,-45,336,-381
84,10,31,2,2,0,61,151,132,140,110,112,99,93,94,126,167,115,141.0,136.0,-52,41,-93
919,11,31,2,2,0,611,1328,1233,1314,879,894,893,729,862,988,1160,1203,1182.0,1117.0,43,172,-129
89,12,31,2,2,0,72,178,202,203,160,175,134,144,96,129,200,185,192.0,171.0,-15,71,-86
232,13,31,2,2,0,131,280,289,334,287,249,266,194,192,281,283,417,350.0,327.0,134,2,132
224,14,31,2,2,0,144,309,370,322,315,276,272,209,174,237,350,258,304.0,282.0,-92,113,-205
1004,15,31,2,2,0,930,1725,1897,1719,1389,1189,1547,1208,929,1465,1724,1540,1632.0,1576.0,-184,259,-443
143,16,31,2,2,0,118,290,306,263,266,203,235,199,144,218,283,271,277.0,257.0,-12,65,-77
195,17,31,2,2,0,181,345,396,354,336,258,251,209,203,255,374,375,374.0,335.0,1,119,-118
161,18,31,2,2,0,139,298,266,319,252,323,276,236,214,251,346,352,349.0,316.0,6,95,-89
146,19,31,2,2,0,138,306,327,247,205,195,187,133,91,159,186,215,200.0,187.0,29,27,2
131,20,31,2,2,0,140,246,273,262,227,183,189,132,105,200,253,198,226.0,217.0,-55,53,-108
135,21,31,2,2,0,116,215,204,258,182,135,163,159,132,134,174,188,181.0,165.0,14,40,-26
44,22,31,2,2,0,38,108,94,88,66,52,57,23,28,58,76,70,73.0,68.0,-6,18,-24
136,1,32,3,2,0,130,248,205,249,256,328,379,426,299,501,825,333,579.0,553.0,-492,324,-816
634,2,32,3,2,0,715,584,517,594,552,695,707,913,926,928,1393,1050,1222.0,1124.0,-343,465,-808
132,3,32,3,2,0,80,151,118,129,99,134,132,200,230,272,405,185,295.0,287.0,-220,133,-353
127,4,32,3,2,0,174,284,352,376,194,240,313,370,330,446,852,178,515.0,492.0,-674,406,-1080
565,5,32,3,2,0,971,753,633,599,569,778,755,971,792,934,1509,1063,1286.0,1169.0,-446,575,-1021
1072,6,32,3,2,0,1583,836,765,835,790,1052,1349,1421,1263,1461,2601,1965,2283.0,2009.0,-636,1140,-1776
1598,7,32,3,2,0,2065,1669,1567,2055,1628,2244,2677,2814,2975,3077,5360,2858,4109.0,3765.0,-2502,2283,-4785
396,8,32,3,2,0,273,351,377,360,353,542,640,778,791,803,1442,701,1072.0,982.0,-741,639,-1380
1872,9,32,3,2,0,1524,3366,2719,3307,2768,3295,4086,5098,5032,5800,8421,3465,5943.0,5895.0,-4956,2621,-7577
1510,10,32,3,2,0,2862,2406,1619,1976,1690,1981,2497,3110,3025,3479,6171,2981,4576.0,4210.0,-3190,2692,-5882
1542,11,32,3,2,0,1515,1369,1121,1352,1272,1577,1829,2045,1978,2153,3757,2028,2892.0,2646.0,-1729,1604,-3333
443,12,32,3,2,0,578,516,412,417,410,598,635,806,703,736,1319,827,1073.0,961.0,-492,583,-1075
1047,13,32,3,2,0,921,863,830,1060,888,1184,1505,1631,1500,1789,2863,1366,2114.0,2006.0,-1497,1074,-2571
2842,14,32,3,2,0,3619,2609,2474,2930,3020,3796,4302,4617,4700,5194,9539,6024,7782.0,6919.0,-3515,4345,-7860
580,15,32,3,2,0,626,867,616,852,799,1096,1291,1435,1528,1653,2646,934,1790.0,1744.0,-1712,993,-2705
521,16,32,3,2,0,792,578,459,481,488,678,753,891,696,982,1629,1137,1383.0,1249.0,-492,647,-1139
771,17,32,3,2,0,846,806,812,802,747,984,1113,1544,1234,1513,2352,1658,2005.0,1841.0,-694,839,-1533
316,18,32,3,2,0,279,474,380,411,360,626,548,706,724,738,1086,453,770.0,759.0,-633,348,-981
313,19,32,3,2,0,214,377,398,383,376,528,616,644,644,694,1039,408,724.0,714.0,-631,345,-976
210,20,32,3,2,0,422,371,270,261,287,297,277,359,279,304,514,324,419.0,381.0,-190,210,-400
403,21,32,3,2,0,433,412,456,460,358,538,648,785,855,1045,1704,937,1320.0,1229.0,-767,659,-1426
365,22,32,3,2,0,292,439,350,475,475,643,791,839,638,832,1045,394,720.0,757.0,-651,213,-864
338,1,33,2,2,0,432,848,740,785,835,1350,1065,2065,1032,1283,1483,389,936.0,1052.0,-1094,200,-1294
160,2,33,2,2,0,240,292,229,244,208,404,346,402,396,360,567,208,388.0,378.0,-359,207,-566
215,3,33,2,2,0,289,446,450,527,415,569,575,712,648,698,789,413,601.0,633.0,-376,91,-467
102,4,33,2,2,0,219,346,342,374,346,429,397,451,276,389,488,143,316.0,340.0,-345,99,-444
374,5,33,2,2,0,594,746,756,677,695,682,820,1286,786,820,1117,531,824.0,823.0,-586,297,-883
198,6,33,2,2,0,322,351,363,414,357,477,644,726,594,615,705,385,545.0,568.0,-320,90,-410
424,7,33,2,2,0,844,1400,1356,1271,1075,1292,1454,1777,1435,1352,1707,803,1255.0,1287.0,-904,355,-1259
87,8,33,2,2,0,139,326,295,376,259,310,346,391,347,352,464,131,298.0,316.0,-333,112,-445
117,9,33,2,2,0,70,223,205,277,296,248,286,326,342,407,475,130,302.0,337.0,-345,68,-413
43,10,33,2,2,0,114,135,110,154,153,106,135,181,167,158,231,93,162.0,161.0,-138,73,-211
782,11,33,2,2,0,1375,2036,1589,1718,1504,1598,2024,2099,1880,1868,2181,991,1586.0,1680.0,-1190,313,-1503
128,12,33,2,2,0,227,332,338,384,268,290,349,532,430,438,495,251,373.0,395.0,-244,57,-301
360,13,33,2,2,0,526,697,668,745,713,769,1026,1153,782,978,1229,546,888.0,918.0,-683,251,-934
259,14,33,2,2,0,432,507,691,656,595,849,951,954,750,835,1053,508,780.0,799.0,-545,218,-763
291,15,33,2,2,0,476,727,703,696,655,723,773,920,884,1063,1213,348,780.0,875.0,-865,150,-1015
80,16,33,2,2,0,168,248,264,212,303,273,340,406,336,358,440,200,320.0,333.0,-240,82,-322
150,17,33,2,2,0,271,375,384,428,388,473,550,688,528,670,749,385,567.0,601.0,-364,79,-443
136,18,33,2,2,0,170,319,281,308,207,297,275,314,302,385,408,188,298.0,327.0,-220,23,-243
54,19,33,2,2,0,103,162,132,162,151,156,254,246,156,195,210,53,132.0,153.0,-157,15,-172
85,20,33,2,2,0,110,142,161,182,218,192,205,240,178,181,295,131,213.0,202.0,-164,114,-278
280,21,33,2,2,0,510,777,772,950,666,1062,1276,1109,958,1012,1286,412,849.0,903.0,-874,274,-1148
80,22,33,2,2,0,157,262,257,265,200,199,236,256,202,210,228,66,147.0,168.0,-162,18,-180
175,1,34,2,2,0,191,341,301,229,293,265,342,422,337,524,679,950,814.0,718.0,271,155,116
118,2,34,2,2,0,23,57,93,77,88,123,129,142,173,215,293,131,212.0,213.0,-162,78,-240
38,3,34,2,2,0,20,43,68,68,57,63,80,87,94,102,118,60,89.0,93.0,-58,16,-74
87,4,34,2,2,0,57,160,141,144,157,165,158,241,166,231,280,180,230.0,230.0,-100,49,-149
140,5,34,2,2,0,80,119,165,176,134,135,208,419,226,291,404,151,278.0,282.0,-253,113,-366
64,6,34,2,2,0,32,69,84,82,105,84,146,172,127,176,201,116,158.0,164.0,-85,25,-110
146,7,34,2,2,0,87,288,336,249,208,207,253,405,274,383,451,230,340.0,355.0,-221,68,-289
23,8,34,2,2,0,21,25,37,54,47,58,68,104,75,85,95,42,68.0,74.0,-53,10,-63
54,9,34,2,2,0,21,94,95,114,119,105,149,140,175,225,268,104,186.0,199.0,-164,43,-207
28,10,34,2,2,0,19,28,27,26,35,28,43,42,39,42,71,30,50.0,48.0,-41,29,-70
279,11,34,2,2,0,167,319,322,305,326,286,477,566,501,644,669,334,502.0,549.0,-335,25,-360
32,12,34,2,2,0,25,53,46,68,55,61,72,97,83,104,86,64,75.0,85.0,-22,-18,-4
97,13,34,2,2,0,50,125,133,124,117,113,185,186,192,206,272,140,206.0,206.0,-132,66,-198
90,14,34,2,2,0,57,78,115,86,115,109,191,156,169,219,319,144,232.0,227.0,-175,100,-275
120,15,34,2,2,0,62,153,241,174,199,216,262,293,289,400,452,190,321.0,347.0,-262,52,-314
33,16,34,2,2,0,17,36,44,55,47,45,58,71,47,81,82,146,114.0,103.0,64,1,63
59,17,34,2,2,0,44,96,96,123,93,121,118,158,115,135,228,105,166.0,156.0,-123,93,-216
43,18,34,2,2,0,32,69,44,77,80,72,82,93,107,132,139,77,108.0,116.0,-62,7,-69
40,19,34,2,2,0,14,35,39,48,22,42,64,69,52,62,81,42,62.0,62.0,-39,19,-58
31,20,34,2,2,0,14,28,31,19,68,61,42,66,46,77,87,44,66.0,69.0,-43,10,-53
83,21,34,2,2,0,45,125,134,132,92,109,169,208,170,201,238,124,181.0,188.0,-114,37,-151
17,22,34,2,2,0,14,33,46,45,30,38,60,45,45,56,48,22,35.0,42.0,-26,-8,-18
124,1,35,2,2,0,119,239,228,169,138,110,96,130,129,206,317,238,278.0,254.0,-79,111,-190
55,2,35,2,2,0,51,78,75,180,62,53,48,150,68,61,94,64,79.0,73.0,-30,33,-63
58,3,35,2,2,0,54,113,86,107,104,115,80,59,69,77,114,119,116.0,103.0,5,37,-32
303,4,35,2,2,0,190,502,679,1478,362,522,549,341,411,466,954,488,721.0,636.0,-466,488,-954
212,5,35,2,2,0,362,298,337,329,313,287,213,226,219,270,560,493,526.0,441.0,-67,290,-357
108,6,35,2,2,0,151,173,287,132,112,137,105,226,131,164,192,238,215.0,198.0,46,28,18
352,7,35,2,2,0,229,452,634,622,583,483,376,451,391,462,714,609,662.0,595.0,-105,252,-357
75,8,35,2,2,0,106,160,138,173,121,88,87,81,104,152,230,168,199.0,183.0,-62,78,-140
554,9,35,2,2,0,446,1134,1049,1151,1204,796,688,783,887,1988,1893,1283,1588.0,1721.0,-610,-95,-515
132,10,35,2,2,0,172,287,232,292,302,238,333,211,167,204,333,316,324.0,284.0,-17,129,-146
520,11,35,2,2,0,528,715,817,757,633,614,701,409,489,602,865,785,825.0,751.0,-80,263,-343
100,12,35,2,2,0,130,160,214,361,199,120,104,272,168,194,280,264,272.0,246.0,-16,86,-102
248,13,35,2,2,0,156,276,257,299,271,278,358,279,275,250,454,387,420.0,364.0,-67,204,-271
141,14,35,2,2,0,134,161,254,201,225,287,201,184,168,191,300,319,310.0,270.0,19,109,-90
391,15,35,2,2,0,387,571,611,676,536,359,406,355,572,795,787,577,682.0,720.0,-210,-8,-202
193,16,35,2,2,0,280,556,499,394,422,178,222,287,394,374,566,545,556.0,495.0,-21,192,-213
410,17,35,2,2,0,189,281,349,524,267,270,181,332,203,423,412,412,412.0,416.0,0,-11,11
242,18,35,2,2,0,172,320,297,502,255,324,353,331,397,363,562,555,558.0,493.0,-7,199,-206
163,19,35,2,2,0,169,322,331,310,263,240,234,219,239,228,340,230,285.0,266.0,-110,112,-222
203,20,35,2,2,0,201,377,423,567,467,292,184,281,158,348,846,378,612.0,524.0,-468,498,-966
68,21,35,2,2,0,51,99,165,127,82,202,64,63,62,99,126,138,132.0,121.0,12,27,-15
72,22,35,2,2,0,67,124,102,107,81,71,56,91,46,89,107,57,82.0,84.0,-50,18,-68
140,1,36,1,2,0,172,381,276,268,259,263,265,263,222,276,374,264,319.0,305.0,-110,98,-208
246,2,36,1,2,0,233,291,288,287,259,444,328,322,420,444,423,403,413.0,423.0,-20,-21,1
251,3,36,1,2,0,191,345,439,598,415,527,467,541,608,505,619,534,576.0,553.0,-85,114,-199
459,4,36,1,2,0,334,863,864,925,776,823,803,1019,845,1016,1441,741,1091.0,1066.0,-700,425,-1125
507,5,36,1,2,0,708,697,804,780,668,723,668,1080,712,743,1078,940,1009.0,920.0,-138,335,-473
107,6,36,1,2,0,148,191,191,212,209,143,177,210,217,212,273,247,260.0,244.0,-26,61,-87
350,7,36,1,2,0,229,560,823,816,666,592,643,866,764,681,1011,688,850.0,793.0,-323,330,-653
115,8,36,1,2,0,110,206,261,279,232,228,276,283,280,288,348,274,311.0,303.0,-74,60,-134
777,9,36,1,2,0,557,1603,1334,1757,1676,1516,1456,1686,2097,2144,2562,1849,2206.0,2185.0,-713,418,-1131
194,10,36,1,2,0,173,357,308,368,312,289,221,333,376,342,443,364,404.0,383.0,-79,101,-180
425,11,36,1,2,0,397,732,642,720,594,521,656,670,713,682,857,658,758.0,732.0,-199,175,-374
121,12,36,1,2,0,183,215,284,272,228,226,207,304,324,277,382,334,358.0,331.0,-48,105,-153
407,13,36,1,2,0,350,512,623,789,655,636,756,829,875,790,1042,804,923.0,879.0,-238,252,-490
303,14,36,1,2,0,314,442,561,418,478,457,520,525,514,567,656,654,655.0,626.0,-2,89,-91
338,15,36,1,2,0,397,692,688,672,696,609,628,658,707,687,970,632,801.0,763.0,-338,283,-621
526,16,36,1,2,0,607,1019,976,969,1189,812,879,1194,1234,1296,1458,1429,1444.0,1394.0,-29,162,-191
262,17,36,1,2,0,324,451,527,529,432,433,504,586,532,579,879,712,796.0,723.0,-167,300,-467
223,18,36,1,2,0,200,378,320,437,254,309,324,331,423,388,523,387,455.0,433.0,-136,135,-271
424,19,36,1,2,0,379,785,855,952,717,778,859,919,871,786,1105,571,838.0,821.0,-534,319,-853
327,20,36,1,2,0,319,482,469,390,863,400,378,452,406,568,732,616,674.0,639.0,-116,164,-280
288,21,36,1,2,0,204,415,526,586,401,428,429,480,618,464,618,561,590.0,548.0,-57,154,-211
165,22,36,1,2,0,172,403,364,391,379,393,463,364,346,348,497,267,382.0,371.0,-230,149,-379
37,1,37,2,2,0,74,148,107,138,95,119,125,135,111,242,237,68,152.0,182.0,-169,-5,-164
100,2,37,2,2,0,101,116,126,123,110,141,143,170,165,182,271,140,206.0,198.0,-131,89,-220
54,3,37,2,2,0,94,127,130,150,140,118,135,135,144,149,195,78,136.0,141.0,-117,46,-163
44,4,37,2,2,0,94,161,133,142,156,136,151,163,97,128,205,34,120.0,122.0,-171,77,-248
186,5,37,2,2,0,440,394,366,331,297,273,290,355,284,276,560,275,418.0,370.0,-285,284,-569
109,6,37,2,2,0,185,162,134,155,164,187,210,258,234,289,496,209,352.0,331.0,-287,207,-494
156,7,37,2,2,0,264,365,376,429,398,297,370,455,430,397,599,241,420.0,412.0,-358,202,-560
52,8,37,2,2,0,124,155,134,191,136,138,154,165,187,192,226,67,146.0,162.0,-159,34,-193
290,9,37,2,2,0,467,1001,803,902,957,908,969,966,1096,1273,1753,510,1132.0,1179.0,-1243,480,-1723
76,10,37,2,2,0,158,173,112,150,145,121,133,163,183,209,314,161,238.0,228.0,-153,105,-258
399,11,37,2,2,0,533,542,500,626,524,494,659,663,720,808,1176,484,830.0,823.0,-692,368,-1060
99,12,37,2,2,0,227,159,167,200,179,156,182,243,282,281,556,258,407.0,365.0,-298,275,-573
126,13,37,2,2,0,201,227,222,334,278,240,275,311,284,290,435,164,300.0,296.0,-271,145,-416
130,14,37,2,2,0,268,207,216,293,353,273,313,316,283,364,562,252,407.0,393.0,-310,198,-508
255,15,37,2,2,0,426,580,534,604,578,536,581,660,738,799,1102,332,717.0,744.0,-770,303,-1073
110,16,37,2,2,0,248,298,272,226,274,204,230,271,257,362,526,267,396.0,385.0,-259,164,-423
115,17,37,2,2,0,212,198,189,225,184,208,271,292,260,313,627,286,456.0,409.0,-341,314,-655
128,18,37,2,2,0,191,273,232,272,218,246,274,282,315,340,500,185,342.0,342.0,-315,160,-475
86,19,37,2,2,0,252,378,382,339,300,311,310,311,260,209,299,101,200.0,203.0,-198,90,-288
87,20,37,2,2,0,182,208,200,174,215,160,199,165,151,159,317,179,248.0,218.0,-138,158,-296
58,21,37,2,2,0,74,107,132,119,143,116,126,114,163,141,242,89,166.0,157.0,-153,101,-254
44,22,37,2,2,0,91,139,139,154,146,135,155,139,103,121,126,60,93.0,102.0,-66,5,-71
135,1,38,2,2,0,125,152,176,401,401,321,346,427,336,1289,571,175,373.0,678.0,-396,-718,322
154,2,38,2,2,0,106,125,149,202,186,247,218,226,257,285,393,160,276.0,279.0,-233,108,-341
164,3,38,2,2,0,102,151,182,235,185,198,218,291,326,339,631,236,434.0,402.0,-395,292,-687
253,4,38,2,2,0,106,458,579,619,663,697,743,797,664,656,980,232,606.0,623.0,-748,324,-1072
478,5,38,2,2,0,517,383,511,577,808,786,904,1230,923,1016,1536,609,1072.0,1054.0,-927,520,-1447
257,6,38,2,2,0,168,141,183,258,304,319,476,565,666,550,750,358,554.0,553.0,-392,200,-592
1203,7,38,2,2,0,846,1159,1838,2095,1935,1835,2200,2915,3148,3502,5481,1788,3634.0,3590.0,-3693,1979,-5672
371,8,38,2,2,0,276,388,385,544,496,521,585,792,899,919,1474,502,988.0,965.0,-972,555,-1527
3718,9,38,2,2,0,2322,6681,6500,8617,8587,8085,9999,11167,12710,12394,15317,5306,10312.0,11006.0,-10011,2923,-12934
777,10,38,2,2,0,509,777,650,933,1046,1010,1186,1639,1709,1789,2693,1195,1944.0,1892.0,-1498,904,-2402
1529,11,38,2,2,0,775,917,1039,1356,1362,1273,1726,2274,2226,2622,3296,1247,2272.0,2388.0,-2049,674,-2723
484,12,38,2,2,0,298,301,380,537,595,606,715,1083,1277,1265,1764,857,1310.0,1295.0,-907,499,-1406
995,13,38,2,2,0,607,575,834,1174,1117,1091,1516,1988,2221,2449,3796,1214,2505.0,2486.0,-2582,1347,-3929
848,14,38,2,2,0,766,966,1035,851,918,1151,1553,1783,1739,1951,3130,1278,2204.0,2120.0,-1852,1179,-3031
801,15,38,2,2,0,268,670,888,1084,1050,1140,1443,1709,2001,2019,2088,700,1394.0,1602.0,-1388,69,-1457
376,16,38,2,2,0,283,464,568,585,851,689,870,1071,1120,1425,1562,736,1149.0,1241.0,-826,137,-963
677,17,38,2,2,0,826,1099,1123,1343,1265,1384,1668,1721,1444,1769,3168,1244,2206.0,2060.0,-1924,1399,-3323
598,18,38,2,2,0,324,743,748,1047,978,991,1227,1477,1846,1591,1981,769,1375.0,1447.0,-1212,390,-1602
1132,19,38,2,2,0,1130,2185,2416,2738,2351,2715,3298,3035,2443,2622,3705,1059,2382.0,2462.0,-2646,1083,-3729
235,20,38,2,2,0,134,130,208,307,592,510,660,624,494,548,828,333,580.0,570.0,-495,280,-775
175,21,38,2,2,0,91,148,246,335,408,480,451,462,457,402,722,289,506.0,471.0,-433,320,-753
347,22,38,2,2,0,195,290,315,472,426,421,630,651,605,913,1064,350,707.0,776.0,-714,151,-865
161,1,39,1,2,0,124,267,256,231,232,275,253,330,234,241,272,250,261.0,254.0,-22,31,-53
162,2,39,1,2,0,150,218,222,273,237,317,281,288,285,282,383,494,438.0,386.0,111,101,10
213,3,39,1,2,0,145,261,297,409,278,346,325,397,353,331,374,412,393.0,372.0,38,43,-5
255,4,39,1,2,0,169,385,428,423,454,541,459,651,432,527,798,336,567.0,554.0,-462,271,-733
198,5,39,1,2,0,255,328,404,345,365,374,356,560,353,364,502,560,531.0,475.0,58,138,-80
228,6,39,1,2,0,224,248,311,364,321,347,370,464,369,339,449,378,414.0,389.0,-71,110,-181
648,7,39,1,2,0,436,794,1159,1092,1036,1063,896,1347,1014,1020,1083,1132,1108.0,1078.0,49,63,-14
276,8,39,1,2,0,163,407,327,404,319,311,334,462,394,347,454,373,414.0,391.0,-81,107,-188
1337,9,39,1,2,0,894,2297,2056,2432,2474,2478,2391,3040,2810,2842,3119,2859,2989.0,2940.0,-260,277,-537
154,10,39,1,2,0,114,277,228,279,260,273,237,346,287,279,316,376,346.0,324.0,60,37,23
579,11,39,1,2,0,503,864,875,944,898,914,919,1153,908,905,1057,1012,1034.0,991.0,-45,152,-197
195,12,39,1,2,0,183,259,334,387,321,370,350,407,325,334,414,397,406.0,382.0,-17,80,-97
602,13,39,1,2,0,304,529,645,721,619,623,691,837,696,646,778,797,788.0,740.0,19,132,-113
596,14,39,1,2,0,524,743,938,870,860,976,801,1165,786,979,1154,954,1054.0,1029.0,-200,175,-375
388,15,39,1,2,0,336,591,647,679,619,746,631,767,611,709,819,752,786.0,760.0,-67,110,-177
549,16,39,1,2,0,713,1120,1091,1131,1321,1289,1127,1463,1111,1292,1497,1405,1451.0,1398.0,-92,205,-297
341,17,39,1,2,0,371,605,681,762,693,656,726,776,563,649,953,623,788.0,742.0,-330,304,-634
347,18,39,1,2,0,264,561,623,627,554,655,558,641,586,610,611,627,619.0,616.0,16,1,15
485,19,39,1,2,0,348,596,668,714,579,727,667,816,696,727,851,758,804.0,779.0,-93,124,-217
87,20,39,1,2,0,106,151,162,139,215,222,181,222,152,145,208,248,228.0,200.0,40,63,-23
229,21,39,1,2,0,150,307,362,418,335,362,360,429,415,400,482,463,472.0,448.0,-19,82,-101
346,22,39,1,2,0,233,643,636,673,545,503,567,621,450,630,549,617,583.0,599.0,68,-81,149
153,1,40,1,2,0,193,307,268,271,242,256,281,287,238,345,456,114,285.0,305.0,-342,111,-453
203,2,40,1,2,0,184,287,277,288,270,381,345,327,285,338,442,406,424.0,395.0,-36,104,-140
193,3,40,1,2,0,130,221,205,287,238,235,267,246,282,331,382,195,288.0,303.0,-187,51,-238
115,4,40,1,2,0,124,239,243,275,251,253,208,303,262,356,580,121,350.0,352.0,-459,224,-683
234,5,40,1,2,0,303,495,459,461,461,453,451,636,487,569,804,459,632.0,611.0,-345,235,-580
244,6,40,1,2,0,276,362,355,346,364,377,400,439,428,489,503,403,453.0,465.0,-100,14,-114
505,7,40,1,2,0,424,741,891,877,768,778,692,815,855,912,1164,554,859.0,877.0,-610,252,-862
193,8,40,1,2,0,131,274,256,316,230,226,277,310,284,316,428,223,326.0,322.0,-205,112,-317
1262,9,40,1,2,0,1092,2312,2006,2367,2317,2288,2219,2478,2450,3345,3730,1930,2830.0,3002.0,-1800,385,-2185
187,10,40,1,2,0,164,296,226,316,262,277,270,290,313,377,417,266,342.0,353.0,-151,40,-191
754,11,40,1,2,0,663,1174,1098,1171,1053,1035,1139,1193,1114,1454,1527,877,1202.0,1286.0,-650,73,-723
161,12,40,1,2,0,179,286,283,344,324,354,314,340,317,350,507,305,406.0,387.0,-202,157,-359
434,13,40,1,2,0,276,466,466,575,563,517,521,590,551,574,797,453,625.0,608.0,-344,223,-567
391,14,40,1,2,0,387,631,701,609,620,657,647,687,548,872,1036,630,833.0,846.0,-406,164,-570
529,15,40,1,2,0,560,868,916,952,851,928,863,800,942,1151,1258,739,998.0,1049.0,-519,107,-626
454,16,40,1,2,0,649,859,860,857,1022,954,876,1065,918,1189,1511,963,1237.0,1221.0,-548,322,-870
189,17,40,1,2,0,265,432,418,440,412,436,456,456,452,506,737,420,578.0,554.0,-317,231,-548
353,18,40,1,2,0,320,585,524,634,509,574,525,556,643,734,779,473,626.0,662.0,-306,45,-351
241,19,40,1,2,0,229,394,433,415,359,423,434,437,390,480,602,285,444.0,456.0,-317,122,-439
95,20,40,1,2,0,111,154,208,153,256,232,218,203,186,200,305,185,245.0,230.0,-120,105,-225
157,21,40,1,2,0,159,255,282,291,238,303,301,293,309,345,496,293,394.0,378.0,-203,151,-354
206,22,40,1,2,0,238,410,348,422,361,360,329,347,306,404,422,214,318.0,347.0,-208,18,-226
140,1,41,3,2,0,127,288,255,249,227,228,228,248,166,277,348,224,286.0,283.0,-124,71,-195
19,2,41,3,2,0,18,26,19,19,13,29,23,22,12,22,33,19,26.0,25.0,-14,11,-25
19,3,41,3,2,0,9,22,31,32,22,34,26,20,16,19,22,21,22.0,21.0,-1,3,-4
244,4,41,3,2,0,155,342,385,371,412,397,450,433,353,372,511,424,468.0,436.0,-87,139,-226
42,5,41,3,2,0,28,61,40,41,50,45,33,53,34,42,64,69,66.0,58.0,5,22,-17
59,6,41,3,2,0,58,96,94,77,54,58,60,65,52,74,75,83,79.0,77.0,8,1,7
189,7,41,3,2,0,131,279,291,321,323,323,300,349,309,286,341,430,386.0,352.0,89,55,34
64,8,41,3,2,0,47,101,97,85,61,83,86,76,58,62,78,105,92.0,82.0,27,16,11
443,9,41,3,2,0,320,938,782,929,824,845,827,959,887,972,1235,1009,1122.0,1072.0,-226,263,-489
17,10,41,3,2,0,19,27,25,33,22,15,35,23,23,13,26,34,30.0,24.0,8,13,-5
258,11,41,3,2,0,239,397,361,372,366,390,384,352,323,380,481,397,439.0,419.0,-84,101,-185
16,12,41,3,2,0,21,43,45,28,35,34,41,44,29,35,37,61,49.0,44.0,24,2,22
172,13,41,3,2,0,115,209,215,221,251,231,259,229,234,231,316,308,312.0,285.0,-8,85,-93
134,14,41,3,2,0,117,183,203,189,186,204,209,192,150,188,209,242,226.0,213.0,33,21,12
222,15,41,3,2,0,167,351,324,279,263,302,300,252,293,323,375,353,364.0,350.0,-22,52,-74
47,16,41,3,2,0,33,64,65,48,56,41,58,58,26,64,62,54,58.0,60.0,-8,-2,-6
26,17,41,3,2,0,26,45,53,33,37,54,26,47,25,31,44,54,49.0,43.0,10,13,-3
41,18,41,3,2,0,36,100,71,65,63,56,64,42,57,83,105,92,98.0,93.0,-13,22,-35
103,19,41,3,2,0,88,143,201,173,177,170,176,181,127,153,187,158,172.0,166.0,-29,34,-63
12,20,41,3,2,0,15,27,25,16,43,25,22,19,17,12,27,22,24.0,20.0,-5,15,-20
16,21,41,3,2,0,15,29,33,50,39,32,34,19,25,29,46,61,54.0,45.0,15,17,-2
41,22,41,3,2,0,40,94,92,117,107,90,78,77,62,61,65,66,66.0,64.0,1,4,-3
142,1,42,1,2,0,143,279,297,244,231,222,233,237,260,331,369,161,265.0,287.0,-208,38,-246
202,2,42,1,2,0,236,312,304,293,280,397,351,388,519,521,651,386,518.0,519.0,-265,130,-395
90,3,42,1,2,0,96,126,103,173,112,115,149,181,185,190,234,146,190.0,190.0,-88,44,-132
141,4,42,1,2,0,149,302,248,267,240,223,271,313,223,301,382,210,296.0,298.0,-172,81,-253
240,5,42,1,2,0,310,417,389,401,386,408,384,645,492,617,839,509,674.0,655.0,-330,222,-552
163,6,42,1,2,0,255,336,313,328,323,371,429,508,453,504,690,387,538.0,527.0,-303,186,-489
303,7,42,1,2,0,296,546,625,677,569,603,642,825,774,709,964,444,704.0,706.0,-520,255,-775
132,8,42,1,2,0,136,255,277,268,247,194,300,278,277,302,443,175,309.0,307.0,-268,141,-409
1517,9,42,1,2,0,1286,3265,2736,3407,3034,2769,3466,3967,4449,4901,5547,3229,4388.0,4559.0,-2318,646,-2964
181,10,42,1,2,0,241,394,300,323,305,295,375,362,434,458,665,381,523.0,501.0,-284,207,-491
508,11,42,1,2,0,551,920,905,886,740,767,910,875,888,974,1139,690,914.0,934.0,-449,165,-614
184,12,42,1,2,0,221,252,298,296,306,326,283,440,408,499,625,381,503.0,502.0,-244,126,-370
320,13,42,1,2,0,281,454,470,518,437,434,560,591,602,602,830,407,618.0,613.0,-423,228,-651
247,14,42,1,2,0,307,448,487,451,445,414,574,666,620,614,920,507,714.0,680.0,-413,306,-719
558,15,42,1,2,0,648,939,1038,954,959,917,968,1148,998,1169,1424,732,1078.0,1108.0,-692,255,-947
270,16,42,1,2,0,481,744,646,667,730,629,764,987,818,1066,1347,698,1022.0,1037.0,-649,281,-930
203,17,42,1,2,0,381,522,540,567,522,526,503,752,630,700,988,570,779.0,753.0,-418,288,-706
368,18,42,1,2,0,277,559,556,633,509,603,671,676,754,796,1043,605,824.0,815.0,-438,247,-685
193,19,42,1,2,0,201,457,514,445,435,473,472,553,433,460,600,253,426.0,438.0,-347,140,-487
105,20,42,1,2,0,124,155,208,157,246,168,172,243,227,222,229,139,184.0,197.0,-90,7,-97
96,21,42,1,2,0,60,111,120,179,148,148,164,191,253,229,293,140,216.0,221.0,-153,64,-217
123,22,42,1,2,0,126,319,331,309,255,234,372,256,198,199,322,111,216.0,211.0,-211,123,-334
193,1,43,2,2,0,113,123,139,212,242,279,368,455,354,457,516,264,390.0,412.0,-252,59,-311
111,2,43,2,2,0,94,88,54,90,69,134,137,168,236,233,253,206,230.0,231.0,-47,20,-67
114,3,43,2,2,0,91,148,111,161,112,170,148,180,212,200,238,219,228.0,219.0,-19,38,-57
390,4,43,2,2,0,279,489,419,541,572,614,704,733,603,754,1094,601,848.0,816.0,-493,340,-833
237,5,43,2,2,0,287,296,215,215,241,286,280,498,363,489,543,391,467.0,474.0,-152,54,-206
153,6,43,2,2,0,244,200,168,222,253,319,361,472,444,568,578,495,536.0,547.0,-83,10,-93
476,7,43,2,2,0,373,450,449,644,594,653,771,1001,1018,1094,1221,1031,1126.0,1115.0,-190,127,-317
221,8,43,2,2,0,250,187,190,307,319,310,398,381,370,395,605,316,460.0,439.0,-289,210,-499
1125,9,43,2,2,0,739,2169,1283,1775,1807,1926,2292,2762,3019,3563,3747,2666,3206.0,3325.0,-1081,184,-1265
92,10,43,2,2,0,76,105,85,131,107,105,132,134,146,194,174,193,184.0,187.0,19,-20,39
552,11,43,2,2,0,669,776,574,791,789,884,1139,1155,1292,1491,1524,1070,1297.0,1362.0,-454,33,-487
81,12,43,2,2,0,139,153,127,135,142,163,206,280,258,340,409,346,378.0,365.0,-63,69,-132
422,13,43,2,2,0,454,423,400,560,621,573,819,812,975,971,1119,789,954.0,960.0,-330,148,-478
326,14,43,2,2,0,364,326,261,356,378,472,519,592,609,805,866,692,779.0,788.0,-174,61,-235
549,15,43,2,2,0,629,657,569,729,797,1116,1100,1259,1371,1516,1515,1138,1326.0,1390.0,-377,-1,-376
253,16,43,2,2,0,373,597,355,306,462,346,475,707,729,779,906,749,828.0,811.0,-157,127,-284
238,17,43,2,2,0,356,437,344,400,350,381,419,626,645,767,839,710,774.0,772.0,-129,72,-201
288,18,43,2,2,0,185,292,182,309,251,400,389,434,571,612,638,509,574.0,586.0,-129,26,-155
506,19,43,2,2,0,442,556,678,921,843,1057,1068,1256,1020,1269,1395,898,1146.0,1187.0,-497,126,-623
106,20,43,2,2,0,174,192,141,164,243,183,190,183,170,200,213,159,186.0,191.0,-54,13,-67
159,21,43,2,2,0,89,158,121,222,212,278,246,251,273,309,371,227,299.0,302.0,-144,62,-206
217,22,43,2,2,0,230,238,301,459,440,381,659,536,422,639,783,366,574.0,596.0,-417,144,-561
125,1,44,1,2,0,94,200,200,179,143,213,231,263,186,304,291,260,276.0,285.0,-31,-13,-18
48,2,44,1,2,0,27,35,27,47,40,86,70,45,62,97,95,78,86.0,90.0,-17,-2,-15
18,3,44,1,2,0,18,65,39,59,30,34,48,53,57,54,64,35,50.0,51.0,-29,10,-39
233,4,44,1,2,0,209,530,530,580,328,387,431,542,458,551,739,435,587.0,575.0,-304,188,-492
133,5,44,1,2,0,120,157,199,189,198,208,192,406,218,246,296,270,283.0,271.0,-26,50,-76
59,6,44,1,2,0,55,65,66,77,68,83,102,108,119,125,125,156,140.0,135.0,31,0,31
112,7,44,1,2,0,101,152,215,226,189,211,236,259,209,228,356,218,287.0,267.0,-138,128,-266
21,8,44,1,2,0,13,35,31,34,37,39,38,29,27,53,51,47,49.0,50.0,-4,-2,-2
152,9,44,1,2,0,85,279,264,290,315,201,283,319,341,442,572,437,504.0,484.0,-135,130,-265
34,10,44,1,2,0,18,33,39,40,44,25,47,48,35,38,46,44,45.0,43.0,-2,8,-10
138,11,44,1,2,0,120,177,166,199,160,179,202,235,218,248,301,251,276.0,267.0,-50,53,-103
32,12,44,1,2,0,47,60,46,67,46,43,63,74,57,75,92,84,88.0,84.0,-8,17,-25
79,13,44,1,2,0,47,72,82,94,85,75,106,81,95,123,131,106,118.0,120.0,-25,8,-33
57,14,44,1,2,0,70,115,177,146,115,120,133,136,137,144,187,131,159.0,154.0,-56,43,-99
78,15,44,1,2,0,40,101,105,120,103,117,123,127,129,149,230,149,190.0,176.0,-81,81,-162
61,16,44,1,2,0,68,95,105,133,83,100,88,128,132,148,184,148,166.0,160.0,-36,36,-72
74,17,44,1,2,0,67,111,119,132,99,113,129,125,121,157,211,135,173.0,168.0,-76,54,-130
57,18,44,1,2,0,34,75,68,110,85,91,79,63,93,111,124,108,116.0,114.0,-16,13,-29
51,19,44,1,2,0,37,96,78,114,94,86,129,93,93,126,129,69,99.0,108.0,-60,3,-63
77,20,44,1,2,0,64,107,106,102,141,124,91,113,105,132,160,125,142.0,139.0,-35,28,-63
77,21,44,1,2,0,50,104,117,132,93,101,114,118,176,150,182,148,165.0,160.0,-34,32,-66
34,22,44,1,2,0,27,72,66,58,77,51,83,64,44,71,77,53,65.0,67.0,-24,6,-30
85,1,45,1,2,0,83,137,166,137,100,120,182,195,186,244,388,154,271.0,262.0,-234,144,-378
91,2,45,1,2,0,123,160,138,155,102,132,175,199,190,214,267,194,230.0,225.0,-73,53,-126
62,3,45,1,2,0,72,109,113,123,90,86,129,117,180,167,259,127,193.0,184.0,-132,92,-224
41,4,45,1,2,0,84,168,157,135,132,124,189,195,143,181,370,71,220.0,207.0,-299,189,-488
194,5,45,1,2,0,306,341,347,268,235,259,271,451,335,432,691,448,570.0,524.0,-243,259,-502
250,6,45,1,2,0,409,428,406,511,409,457,615,665,719,699,1253,712,982.0,888.0,-541,554,-1095
320,7,45,1,2,0,368,553,712,759,542,525,598,799,850,792,1449,549,999.0,930.0,-900,657,-1557
81,8,45,1,2,0,114,172,156,184,119,112,180,176,226,231,426,153,290.0,270.0,-273,195,-468
168,9,45,1,2,0,146,505,439,656,557,570,682,810,953,1204,1628,496,1062.0,1109.0,-1132,424,-1556
56,10,45,1,2,0,82,128,93,99,74,74,93,96,119,135,240,121,180.0,165.0,-119,105,-224
543,11,45,1,2,0,617,835,685,815,558,664,879,928,1050,1083,1908,768,1338.0,1253.0,-1140,825,-1965
153,12,45,1,2,0,175,250,275,290,238,256,256,368,358,434,733,453,593.0,540.0,-280,299,-579
272,13,45,1,2,0,345,481,442,541,372,433,513,576,665,667,1158,476,817.0,767.0,-682,491,-1173
372,14,45,1,2,0,511,612,706,670,565,604,728,823,894,1006,1883,910,1396.0,1266.0,-973,877,-1850
430,15,45,1,2,0,570,741,745,772,623,618,806,968,1022,1202,2202,744,1473.0,1383.0,-1458,1000,-2458
143,16,45,1,2,0,200,249,254,222,214,224,236,278,353,409,749,443,596.0,534.0,-306,340,-646
131,17,45,1,2,0,190,262,282,299,206,221,263,352,322,439,744,378,561.0,520.0,-366,305,-671
149,18,45,1,2,0,106,251,186,224,163,185,197,242,345,391,594,265,430.0,417.0,-329,203,-532
62,19,45,1,2,0,102,164,167,172,127,118,166,151,176,186,256,75,166.0,172.0,-181,70,-251
38,20,45,1,2,0,69,103,86,60,103,92,81,101,86,92,172,124,148.0,129.0,-48,80,-128
79,21,45,1,2,0,120,165,166,180,107,108,126,155,205,212,325,144,234.0,227.0,-181,113,-294
36,22,45,1,2,0,68,172,142,116,90,66,138,116,107,126,152,43,98.0,107.0,-109,26,-135
19,1,46,1,2,0,39,67,57,61,83,70,93,94,69,88,96,65,80.0,83.0,-31,8,-39
75,2,46,1,2,0,206,157,153,150,145,260,181,192,214,209,182,216,199.0,202.0,34,-27,61
46,3,46,1,2,0,111,103,103,189,132,152,130,174,176,130,141,132,136.0,134.0,-9,11,-20
81,4,46,1,2,0,162,255,224,215,203,267,229,259,158,186,277,124,200.0,196.0,-153,91,-244
117,5,46,1,2,0,379,249,251,265,277,338,249,374,267,205,292,350,321.0,282.0,58,87,-29
121,6,46,1,2,0,370,259,261,334,403,369,409,407,332,341,384,513,448.0,413.0,129,43,86
214,7,46,1,2,0,329,460,477,501,534,578,578,669,572,480,596,555,576.0,544.0,-41,116,-157
26,8,46,1,2,0,48,88,53,84,72,80,105,82,89,70,67,66,66.0,68.0,-1,-3,2
19,9,46,1,2,0,58,174,189,205,161,153,130,99,91,101,84,62,73.0,82.0,-22,-17,-5
14,10,46,1,2,0,68,55,61,65,56,59,47,57,42,39,50,45,48.0,45.0,-5,11,-16
214,11,46,1,2,0,474,501,391,511,498,540,652,534,502,474,569,538,554.0,527.0,-31,95,-126
94,12,46,1,2,0,234,206,222,322,296,334,361,423,281,274,309,360,334.0,314.0,51,35,16
154,13,46,1,2,0,302,326,300,423,331,415,474,378,372,326,383,353,368.0,354.0,-30,57,-87
139,14,46,1,2,0,438,344,433,458,439,537,516,505,471,372,457,538,498.0,456.0,81,85,-4
129,15,46,1,2,0,474,480,439,481,523,527,619,525,437,429,453,388,420.0,423.0,-65,24,-89
120,16,46,1,2,0,291,253,287,274,347,357,348,470,379,317,421,474,448.0,404.0,53,104,-51
95,17,46,1,2,0,263,271,267,285,332,369,394,455,353,348,428,459,444.0,412.0,31,80,-49
38,18,46,1,2,0,89,110,105,117,97,156,140,150,148,127,159,136,148.0,141.0,-23,32,-55
59,19,46,1,2,0,139,206,190,224,186,211,236,239,216,174,238,151,194.0,188.0,-87,64,-151
41,20,46,1,2,0,173,118,113,119,207,154,160,119,108,151,126,110,118.0,129.0,-16,-25,9
80,21,46,1,2,0,167,172,200,295,195,243,241,219,279,210,288,180,234.0,226.0,-108,78,-186
46,22,46,1,2,0,65,155,112,155,119,135,185,126,121,118,156,75,116.0,116.0,-81,38,-119
78,1,47,2,2,0,36,140,123,151,184,200,260,330,188,341,384,208,296.0,311.0,-176,43,-219
56,2,47,2,2,0,89,97,87,116,115,160,152,177,216,186,206,142,174.0,178.0,-64,20,-84
44,3,47,2,2,0,53,68,89,116,92,95,118,103,121,125,115,74,94.0,105.0,-41,-10,-31
139,4,47,2,2,0,197,494,429,502,404,587,598,646,461,553,771,253,512.0,526.0,-518,218,-736
263,5,47,2,2,0,423,370,360,435,525,529,541,770,548,657,933,673,803.0,754.0,-260,276,-536
338,6,47,2,2,0,500,410,494,668,812,815,909,849,800,764,993,964,978.0,907.0,-29,229,-258
383,7,47,2,2,0,526,689,772,912,798,955,1028,1068,979,957,1332,1011,1172.0,1100.0,-321,375,-696
67,8,47,2,2,0,89,124,155,182,158,166,260,200,213,203,275,128,202.0,202.0,-147,72,-219
278,9,47,2,2,0,150,692,651,912,826,970,1165,1341,1182,1660,1546,767,1156.0,1324.0,-779,-114,-665
86,10,47,2,2,0,123,132,118,154,160,138,192,192,181,188,276,186,231.0,217.0,-90,88,-178
991,11,47,2,2,0,1169,1437,1322,1690,1549,1784,2086,2054,2015,2022,2642,2094,2368.0,2253.0,-548,620,-1168
157,12,47,2,2,0,225,275,317,446,403,446,466,481,368,453,691,614,652.0,586.0,-77,238,-315
290,13,47,2,2,0,433,527,489,571,550,679,797,728,665,667,773,530,652.0,657.0,-243,106,-349
640,14,47,2,2,0,769,741,998,1156,1405,1588,1680,1676,1390,1577,2409,1865,2137.0,1950.0,-544,832,-1376
501,15,47,2,2,0,826,1017,1000,1198,1267,1405,1649,1572,1696,1832,2222,1022,1622.0,1692.0,-1200,390,-1590
178,16,47,2,2,0,267,322,336,378,470,475,562,525,475,492,661,605,633.0,586.0,-56,169,-225
170,17,47,2,2,0,259,348,380,383,445,414,541,561,481,547,698,488,593.0,578.0,-210,151,-361
197,18,47,2,2,0,124,232,228,311,284,350,418,427,469,556,601,361,481.0,506.0,-240,45,-285
100,19,47,2,2,0,111,190,228,287,226,287,309,335,246,211,328,161,244.0,233.0,-167,117,-284
140,20,47,2,2,0,254,176,207,287,447,415,439,445,330,373,430,326,378.0,376.0,-104,57,-161
119,21,47,2,2,0,170,252,248,336,278,349,407,350,449,347,562,349,456.0,419.0,-213,215,-428
37,22,47,2,2,0,58,136,101,109,89,128,149,133,82,97,100,69,84.0,89.0,-31,3,-34
19,1,48,2,2,0,12,45,21,27,22,13,27,10,4,41,46,32,39.0,40.0,-14,5,-19
104,2,48,2,2,0,230,170,165,176,148,181,200,159,126,119,169,142,156.0,143.0,-27,50,-77
168,3,48,2,2,0,264,295,260,348,233,350,323,327,297,353,430,278,354.0,354.0,-152,77,-229
38,4,48,2,2,0,107,230,173,167,151,170,121,96,46,78,112,52,82.0,81.0,-60,34,-94
336,5,48,2,2,0,976,914,753,701,834,869,836,723,408,517,641,617,629.0,592.0,-24,124,-148
146,6,48,2,2,0,352,281,292,330,322,293,261,211,71,198,190,278,234.0,222.0,88,-8,96
885,7,48,2,2,0,1881,1411,1514,1697,1542,1763,1885,1782,1445,1562,2281,1763,2022.0,1869.0,-518,719,-1237
295,8,48,2,2,0,559,695,566,798,670,854,973,842,579,768,886,691,788.0,782.0,-195,118,-313
229,9,48,2,2,0,337,851,657,797,730,793,791,821,619,710,1008,472,740.0,730.0,-536,298,-834
110,10,48,2,2,0,213,235,139,170,190,169,185,191,132,192,308,251,280.0,250.0,-57,116,-173
299,11,48,2,2,0,409,368,309,295,297,299,267,195,95,307,309,370,340.0,329.0,61,2,59
84,12,48,2,2,0,297,223,225,303,258,215,138,145,60,177,182,224,203.0,194.0,42,5,37
940,13,48,2,2,0,2024,1679,1513,1845,1547,1898,2125,1949,1092,1644,1840,1468,1654.0,1651.0,-372,196,-568
433,14,48,2,2,0,1096,746,823,772,817,797,693,546,306,774,911,1101,1006.0,929.0,190,137,53
197,15,48,2,2,0,250,257,215,232,213,216,202,149,42,380,352,327,340.0,353.0,-25,-28,3
58,16,48,2,2,0,155,165,159,138,172,121,123,100,46,116,125,211,168.0,151.0,86,9,77
105,17,48,2,2,0,201,197,204,204,207,195,142,140,74,141,165,230,198.0,179.0,65,24,41
105,18,48,2,2,0,135,327,238,254,259,254,219,159,110,281,215,204,210.0,233.0,-11,-66,55
317,19,48,2,2,0,315,497,548,622,615,791,715,654,384,528,619,375,497.0,507.0,-244,91,-335
61,20,48,2,2,0,139,127,140,142,167,210,170,119,62,80,104,116,110.0,100.0,12,24,-12
108,21,48,2,2,0,279,325,347,415,360,504,331,168,145,214,250,261,256.0,242.0,11,36,-25
144,22,48,2,2,0,228,325,312,349,289,307,328,302,291,350,342,207,274.0,300.0,-135,-8,-127
80,1,49,1,2,0,64,143,153,184,190,187,321,371,283,435,596,174,385.0,402.0,-422,161,-583
236,2,49,1,2,0,120,243,214,293,278,391,368,477,514,538,699,444,572.0,560.0,-255,161,-416
94,3,49,1,2,0,95,150,144,231,182,278,328,337,354,323,485,221,353.0,343.0,-264,162,-426
174,4,49,1,2,0,249,424,446,557,512,616,785,877,636,879,1517,309,913.0,902.0,-1208,638,-1846
339,5,49,1,2,0,359,385,442,498,519,553,602,1020,712,770,1305,743,1024.0,939.0,-562,535,-1097
344,6,49,1,2,0,254,335,430,556,596,658,834,1066,894,964,1597,855,1226.0,1139.0,-742,633,-1375
383,7,49,1,2,0,380,583,765,851,801,793,998,1278,1160,1107,1740,687,1214.0,1178.0,-1053,633,-1686
100,8,49,1,2,0,106,151,162,214,187,206,301,280,282,301,514,192,353.0,336.0,-322,213,-535
186,9,49,1,2,0,149,614,549,687,668,710,890,1382,1240,1586,1899,542,1220.0,1342.0,-1357,313,-1670
96,10,49,1,2,0,107,187,136,186,226,201,232,277,266,309,514,260,387.0,361.0,-254,205,-459
574,11,49,1,2,0,523,808,744,993,872,955,1345,1406,1396,1446,2279,939,1609.0,1555.0,-1340,833,-2173
180,12,49,1,2,0,121,209,241,288,279,356,409,638,519,571,900,502,701.0,658.0,-398,329,-727
414,13,49,1,2,0,350,577,540,727,602,725,929,1066,990,1108,1749,708,1228.0,1188.0,-1041,641,-1682
509,14,49,1,2,0,439,612,886,926,1021,1208,1438,1525,1493,1622,2735,1331,2033.0,1896.0,-1404,1113,-2517
581,15,49,1,2,0,598,832,846,1069,1144,1284,1635,1804,1911,2130,3255,1119,2187.0,2168.0,-2136,1125,-3261
202,16,49,1,2,0,187,282,287,324,375,419,485,678,560,634,1014,597,806.0,748.0,-417,380,-797
212,17,49,1,2,0,169,301,351,355,332,374,473,712,546,606,978,498,738.0,694.0,-480,372,-852
141,18,49,1,2,0,110,226,228,280,250,238,291,406,499,552,782,311,546.0,548.0,-471,230,-701
80,19,49,1,2,0,117,255,208,243,206,229,283,315,299,258,424,127,276.0,270.0,-297,166,-463
104,20,49,1,2,0,131,137,183,177,223,193,277,336,267,309,532,260,396.0,367.0,-272,223,-495
130,21,49,1,2,0,175,215,218,355,227,253,326,373,472,366,620,315,468.0,434.0,-305,254,-559
52,22,49,1,2,0,119,192,157,191,155,137,237,206,170,232,274,80,177.0,195.0,-194,42,-236
177,1,50,4,2,0,167,243,160,176,192,187,249,257,239,345,396,369,382.0,370.0,-27,51,-78
134,2,50,4,2,0,231,291,200,206,289,300,344,358,406,373,334,203,268.0,303.0,-131,-39,-92
29,3,50,4,2,0,39,69,59,78,58,65,160,123,116,59,90,51,70.0,67.0,-39,31,-70
60,4,50,4,2,0,100,199,163,119,141,164,139,203,168,222,242,93,168.0,186.0,-149,20,-169
239,5,50,4,2,0,448,557,450,413,455,488,625,731,758,778,781,288,534.0,616.0,-493,3,-496
266,6,50,4,2,0,326,450,279,349,370,347,570,630,644,607,661,309,485.0,526.0,-352,54,-406
419,7,50,4,2,0,460,731,616,559,584,576,690,772,807,782,994,540,767.0,772.0,-454,212,-666
44,8,50,4,2,0,97,151,126,140,127,162,287,240,200,132,201,88,144.0,140.0,-113,69,-182
231,9,50,4,2,0,198,606,453,438,526,486,516,619,721,938,1135,331,733.0,801.0,-804,197,-1001
92,10,50,4,2,0,155,278,158,185,230,205,301,268,247,370,403,140,272.0,304.0,-263,33,-296
710,11,50,4,2,0,1070,1579,700,765,791,837,1017,1020,1227,1286,1781,805,1293.0,1291.0,-976,495,-1471
97,12,50,4,2,0,176,320,223,276,230,221,285,391,438,444,431,157,294.0,344.0,-274,-13,-261
375,13,50,4,2,0,455,668,556,558,552,574,734,729,766,589,806,391,598.0,595.0,-415,217,-632
334,14,50,4,2,0,475,738,578,632,668,840,854,777,834,729,896,363,630.0,663.0,-533,167,-700
386,15,50,4,2,0,595,865,493,406,443,507,510,573,616,797,1044,341,692.0,727.0,-703,247,-950
123,16,50,4,2,0,248,391,284,238,303,280,357,375,452,413,461,270,366.0,381.0,-191,48,-239
99,17,50,4,2,0,210,341,224,235,250,255,292,394,414,458,478,157,318.0,364.0,-321,20,-341
154,18,50,4,2,0,270,489,293,325,290,310,328,339,397,455,593,250,422.0,433.0,-343,138,-481
36,19,50,4,2,0,84,145,108,118,118,139,151,144,114,136,149,45,97.0,110.0,-104,13,-117
124,20,50,4,2,0,176,262,167,239,459,311,410,422,402,422,475,136,306.0,344.0,-339,53,-392
145,21,50,4,2,0,231,280,319,382,320,375,494,446,595,355,464,194,329.0,338.0,-270,109,-379
47,22,50,4,2,0,107,198,154,180,125,146,202,237,176,82,87,40,64.0,70.0,-47,5,-52
131,1,51,2,2,0,216,375,266,306,267,258,427,420,355,228,579,371,475.0,393.0,-208,351,-559
134,2,51,2,2,0,183,225,152,177,118,180,214,200,244,165,338,215,276.0,239.0,-123,173,-296
28,3,51,2,2,0,28,44,26,58,32,43,34,40,41,43,48,41,44.0,44.0,-7,5,-12
61,4,51,2,2,0,179,327,244,264,181,202,267,304,268,372,383,131,257.0,295.0,-252,11,-263
286,5,51,2,2,0,424,488,398,410,336,352,370,632,431,484,820,550,685.0,618.0,-270,336,-606
322,6,51,2,2,0,330,403,387,411,362,305,443,521,495,362,758,508,633.0,543.0,-250,396,-646
227,7,51,2,2,0,256,457,424,368,316,303,357,410,423,383,729,410,570.0,507.0,-319,346,-665
57,8,51,2,2,0,52,102,63,71,48,59,51,78,61,91,136,74,105.0,100.0,-62,45,-107
444,9,51,2,2,0,403,1121,875,992,904,879,1153,1298,1305,1034,2232,1023,1628.0,1430.0,-1209,1198,-2407
107,10,51,2,2,0,163,249,172,201,169,192,217,237,215,191,328,208,268.0,242.0,-120,137,-257
747,11,51,2,2,0,1033,1427,1017,1202,877,845,1153,1190,1239,807,1846,1142,1494.0,1265.0,-704,1039,-1743
111,12,51,2,2,0,162,249,182,202,165,177,232,306,226,131,436,290,363.0,286.0,-146,305,-451
194,13,51,2,2,0,224,327,290,285,257,243,316,360,308,272,475,287,381.0,345.0,-188,203,-391
249,14,51,2,2,0,364,491,439,424,404,405,509,554,543,420,747,459,603.0,542.0,-288,327,-615
503,15,51,2,2,0,681,993,723,767,644,614,743,824,856,695,1454,752,1103.0,967.0,-702,759,-1461
158,16,51,2,2,0,189,257,224,213,257,205,250,304,278,190,481,312,396.0,328.0,-169,291,-460
139,17,51,2,2,0,187,320,299,303,226,226,283,329,289,235,425,324,374.0,328.0,-101,190,-291
260,18,51,2,2,0,280,514,351,414,293,354,411,469,472,415,699,508,604.0,541.0,-191,284,-475
52,19,51,2,2,0,95,156,120,126,118,94,128,154,125,64,125,66,96.0,85.0,-59,61,-120
185,20,51,2,2,0,288,399,316,243,316,279,300,389,322,256,548,310,429.0,371.0,-238,292,-530
96,21,51,2,2,0,118,154,172,180,121,162,175,188,226,181,259,170,214.0,203.0,-89,78,-167
52,22,51,2,2,0,59,121,105,118,92,95,86,84,67,65,115,61,88.0,80.0,-54,50,-104
199,1,52,1,2,0,227,439,284,312,308,315,327,336,292,421,473,415,444.0,436.0,-58,52,-110
259,2,52,1,2,0,198,268,226,239,271,381,320,316,363,485,535,500,518.0,507.0,-35,50,-85
129,3,52,1,2,0,91,159,124,177,198,210,230,224,233,229,234,273,254.0,245.0,39,5,34
295,4,52,1,2,0,228,489,359,374,335,454,424,442,429,500,681,534,608.0,572.0,-147,181,-328
442,5,52,1,2,0,346,509,498,454,508,557,495,659,704,743,849,933,891.0,842.0,84,106,-22
198,6,52,1,2,0,177,226,184,207,204,219,249,314,271,334,368,404,386.0,369.0,36,34,2
376,7,52,1,2,0,316,517,505,542,531,579,617,771,679,776,936,911,924.0,874.0,-25,160,-185
113,8,52,1,2,0,97,155,129,125,128,113,131,135,142,208,244,213,228.0,222.0,-31,36,-67
521,9,52,1,2,0,437,1193,876,978,1056,1120,1145,1408,1392,1836,2078,1526,1802.0,1813.0,-552,242,-794
145,10,52,1,2,0,160,248,190,185,216,203,212,207,208,246,317,323,320.0,295.0,6,71,-65
461,11,52,1,2,0,394,578,403,502,513,553,616,611,660,847,820,821,820.0,829.0,1,-27,28
113,12,52,1,2,0,116,232,156,222,179,206,215,215,187,249,262,297,280.0,269.0,35,13,22
431,13,52,1,2,0,298,398,396,448,411,475,528,576,625,746,750,758,754.0,751.0,8,4,4
447,14,52,1,2,0,347,596,488,554,520,548,623,596,604,752,820,826,823.0,799.0,6,68,-62
252,15,52,1,2,0,333,435,299,309,330,357,379,387,524,623,684,550,617.0,619.0,-134,61,-195
197,16,52,1,2,0,179,291,252,255,280,268,311,346,310,385,425,481,453.0,430.0,56,40,16
239,17,52,1,2,0,214,378,270,349,338,350,384,424,364,460,493,505,499.0,486.0,12,33,-21
163,18,52,1,2,0,167,290,209,200,169,259,222,223,268,329,338,400,369.0,356.0,62,9,53
117,19,52,1,2,0,154,305,230,303,292,281,324,364,303,369,450,249,350.0,356.0,-201,81,-282
284,20,52,1,2,0,259,424,365,346,440,402,372,406,400,540,575,576,576.0,564.0,1,35,-34
178,21,52,1,2,0,153,276,242,263,225,299,275,293,365,346,404,376,390.0,375.0,-28,58,-86
206,22,52,1,2,0,217,363,293,273,325,359,356,331,302,341,410,324,367.0,358.0,-86,69,-155
179,1,53,2,2,0,139,307,248,310,413,581,617,628,446,636,846,241,544.0,574.0,-605,210,-815
145,2,53,2,2,0,148,154,145,172,143,197,189,278,304,365,493,290,392.0,383.0,-203,128,-331
123,3,53,2,2,0,134,111,109,155,125,168,136,222,206,310,562,284,423.0,385.0,-278,252,-530
71,4,53,2,2,0,188,412,270,321,429,521,473,498,257,444,824,105,464.0,458.0,-719,380,-1099
504,5,53,2,2,0,770,584,606,603,636,717,777,1042,762,1080,1730,983,1356.0,1264.0,-747,650,-1397
528,6,53,2,2,0,744,404,412,563,701,945,973,1078,1023,1260,2243,1186,1714.0,1563.0,-1057,983,-2040
553,7,53,2,2,0,875,851,1042,1265,1160,1176,1294,1622,1536,1637,2998,1261,2130.0,1965.0,-1737,1361,-3098
178,8,53,2,2,0,136,144,177,203,154,257,272,308,299,372,645,313,479.0,443.0,-332,273,-605
337,9,53,2,2,0,240,608,631,1027,923,1121,1670,1369,1274,1967,3191,905,2048.0,2021.0,-2286,1224,-3510
179,10,53,2,2,0,168,141,105,142,190,192,188,232,252,337,697,471,584.0,502.0,-226,360,-586
972,11,53,2,2,0,1526,1242,1231,1592,1724,1702,2067,2163,1918,2283,3836,1631,2734.0,2583.0,-2205,1553,-3758
229,12,53,2,2,0,446,244,251,345,361,411,440,542,547,676,1270,658,964.0,868.0,-612,594,-1206
551,13,53,2,2,0,574,511,495,710,678,854,909,987,969,1064,2232,950,1591.0,1415.0,-1282,1168,-2450
828,14,53,2,2,0,870,634,824,900,1091,1257,1337,1548,1431,1720,3243,1894,2568.0,2286.0,-1349,1523,-2872
328,15,53,2,2,0,628,712,672,814,952,886,1003,1067,1140,1205,1850,574,1212.0,1210.0,-1276,645,-1921
244,16,53,2,2,0,420,379,335,349,502,356,435,576,710,866,1354,755,1054.0,992.0,-599,488,-1087
322,17,53,2,2,0,420,360,426,538,599,590,709,844,687,982,1756,938,1347.0,1225.0,-818,774,-1592
182,18,53,2,2,0,137,249,221,268,357,422,486,645,645,746,1041,462,752.0,750.0,-579,295,-874
92,19,53,2,2,0,143,177,163,241,231,300,418,415,275,422,561,181,371.0,388.0,-380,139,-519
231,20,53,2,2,0,328,299,375,484,631,758,749,722,571,643,1136,557,846.0,779.0,-579,493,-1072
298,21,53,2,2,0,225,254,261,399,506,811,726,652,682,805,1567,639,1103.0,1004.0,-928,762,-1690
62,22,53,2,2,0,96,119,141,163,123,259,159,164,109,207,305,102,204.0,205.0,-203,98,-301
31,1,54,1,2,0,59,117,95,90,87,88,90,112,64,139,159,95,127.0,131.0,-64,20,-84
91,2,54,1,2,0,150,132,81,108,54,102,103,88,129,116,195,181,188.0,164.0,-14,79,-93
113,3,54,1,2,0,166,183,174,223,139,192,148,178,215,227,336,327,332.0,297.0,-9,109,-118
35,4,54,1,2,0,107,188,157,103,119,110,107,124,113,153,246,99,172.0,166.0,-147,93,-240
155,5,54,1,2,0,300,263,231,201,164,169,165,260,194,267,387,398,392.0,351.0,11,120,-109
121,6,54,1,2,0,331,241,207,206,161,192,228,277,262,301,471,484,478.0,419.0,13,170,-157
263,7,54,1,2,0,418,548,574,604,450,433,565,670,629,591,961,723,842.0,758.0,-238,370,-608
66,8,54,1,2,0,58,100,103,114,81,88,106,92,114,133,167,149,158.0,150.0,-18,34,-52
19,9,54,1,2,0,62,174,156,103,107,99,112,111,142,134,176,97,136.0,136.0,-79,42,-121
20,10,54,1,2,0,79,90,53,59,61,36,46,27,44,52,62,66,64.0,60.0,4,10,-6
168,11,54,1,2,0,562,420,362,365,291,216,275,222,289,312,450,333,392.0,365.0,-117,138,-255
69,12,54,1,2,0,157,142,129,162,110,96,123,158,141,164,252,264,258.0,227.0,12,88,-76
182,13,54,1,2,0,239,265,258,283,231,209,251,268,281,338,473,362,418.0,391.0,-111,135,-246
213,14,54,1,2,0,386,456,508,440,420,458,438,436,457,535,679,669,674.0,628.0,-10,144,-154
59,15,54,1,2,0,157,179,148,165,119,117,144,152,167,161,255,131,193.0,182.0,-124,94,-218
105,16,54,1,2,0,209,218,242,217,211,166,169,231,258,278,385,450,418.0,371.0,65,107,-42
222,17,54,1,2,0,399,388,395,357,324,322,320,453,378,533,776,857,816.0,722.0,81,243,-162
21,18,54,1,2,0,59,87,42,60,45,47,38,50,51,83,65,41,53.0,63.0,-24,-18,-6
50,19,54,1,2,0,85,129,125,118,82,101,115,152,128,129,166,109,138.0,135.0,-57,37,-94
58,20,54,1,2,0,233,209,189,156,162,125,149,157,175,189,306,256,281.0,250.0,-50,117,-167
193,21,54,1,2,0,248,335,296,319,224,270,298,329,421,381,634,493,564.0,503.0,-141,253,-394
70,22,54,1,2,0,155,190,188,152,109,132,165,141,126,204,277,131,204.0,204.0,-146,73,-219
71,1,55,1,2,0,99,199,164,165,139,164,176,188,167,211,361,138,250.0,237.0,-223,150,-373
299,2,55,1,2,0,475,412,328,421,327,407,402,486,521,434,743,406,574.0,528.0,-337,309,-646
135,3,55,1,2,0,255,274,265,289,218,256,255,374,366,390,683,304,494.0,459.0,-379,293,-672
56,4,55,1,2,0,214,434,345,391,298,365,388,458,302,357,675,173,424.0,402.0,-502,318,-820
681,5,55,1,2,0,1086,1383,1313,1243,1067,1135,1222,1530,1137,1318,2057,1186,1622.0,1520.0,-871,739,-1610
194,6,55,1,2,0,371,408,413,407,292,363,463,479,476,493,865,574,720.0,644.0,-291,372,-663
282,7,55,1,2,0,712,778,983,935,718,720,875,922,870,894,1538,723,1130.0,1052.0,-815,644,-1459
214,8,55,1,2,0,240,339,383,469,311,358,454,470,495,510,974,417,696.0,634.0,-557,464,-1021
259,9,55,1,2,0,292,692,629,703,576,557,610,730,702,768,1105,569,837.0,814.0,-536,337,-873
101,10,55,1,2,0,208,209,154,242,164,182,175,217,208,212,406,260,333.0,293.0,-146,194,-340
402,11,55,1,2,0,648,745,631,724,557,652,768,765,828,786,1332,698,1015.0,939.0,-634,546,-1180
110,12,55,1,2,0,215,235,288,311,262,276,281,350,363,356,774,420,597.0,517.0,-354,418,-772
397,13,55,1,2,0,676,744,724,862,614,693,937,936,974,964,2069,891,1480.0,1308.0,-1178,1105,-2283
330,14,55,1,2,0,610,715,892,850,682,796,900,924,913,934,1916,1026,1471.0,1292.0,-890,982,-1872
195,15,55,1,2,0,395,572,541,581,492,491,561,604,663,556,982,370,676.0,636.0,-612,426,-1038
105,16,55,1,2,0,193,265,278,276,303,276,301,385,300,389,721,401,561.0,504.0,-320,332,-652
205,17,55,1,2,0,586,514,623,562,511,551,548,722,567,687,1290,631,960.0,869.0,-659,603,-1262
95,18,55,1,2,0,96,218,190,170,135,152,178,217,240,253,385,180,282.0,273.0,-205,132,-337
104,19,55,1,2,0,115,237,238,223,208,212,251,209,211,226,330,135,232.0,230.0,-195,104,-299
420,20,55,1,2,0,977,800,797,796,935,790,970,909,844,751,1420,661,1040.0,944.0,-759,669,-1428
184,21,55,1,2,0,452,501,575,671,425,496,540,574,623,639,1234,604,919.0,826.0,-630,595,-1225
111,22,55,1,2,0,100,176,124,152,127,131,146,126,126,150,236,76,156.0,154.0,-160,86,-246
95,1,56,1,2,0,104,239,247,291,237,275,484,500,412,620,805,357,581.0,594.0,-448,185,-633
418,2,56,1,2,0,502,481,450,444,342,521,806,851,856,921,1249,829,1039.0,1000.0,-420,328,-748
288,3,56,1,2,0,262,315,336,322,265,347,507,500,528,675,925,601,763.0,734.0,-324,250,-574
212,4,56,1,2,0,300,478,446,455,384,534,743,672,532,779,1421,437,929.0,879.0,-984,642,-1626
903,5,56,1,2,0,1283,1148,1182,899,922,1077,1757,2178,1620,1861,2915,2183,2549.0,2320.0,-732,1054,-1786
304,6,56,1,2,0,607,365,405,383,373,395,690,798,757,934,1307,1141,1224.0,1127.0,-166,373,-539
389,7,56,1,2,0,594,611,792,689,593,668,1173,1160,1214,1192,1610,1006,1308.0,1269.0,-604,418,-1022
198,8,56,1,2,0,200,325,308,304,235,316,582,505,511,601,970,406,688.0,659.0,-564,369,-933
341,9,56,1,2,0,304,689,958,928,799,758,1347,1576,1507,1902,2685,1203,1944.0,1930.0,-1482,783,-2265
149,10,56,1,2,0,257,267,191,230,206,193,394,347,352,440,665,433,549.0,513.0,-232,225,-457
650,11,56,1,2,0,917,887,1007,951,861,1014,1794,1646,1598,1955,2752,1481,2116.0,2063.0,-1271,797,-2068
159,12,56,1,2,0,304,214,275,281,260,281,443,510,475,511,802,624,713.0,646.0,-178,291,-469
478,13,56,1,2,0,551,562,650,653,522,624,985,1009,905,1021,1551,970,1260.0,1181.0,-581,530,-1111
502,14,56,1,2,0,946,628,786,747,679,846,1361,1342,1399,1530,2696,1928,2312.0,2051.0,-768,1166,-1934
292,15,56,1,2,0,458,535,675,710,572,720,1247,1320,1351,1499,2124,704,1414.0,1442.0,-1420,625,-2045
201,16,56,1,2,0,363,307,317,322,323,347,614,653,620,794,1252,837,1044.0,961.0,-415,458,-873
503,17,56,1,2,0,749,596,697,623,625,741,1241,1383,1339,1478,2360,1657,2008.0,1832.0,-703,882,-1585
129,18,56,1,2,0,132,235,287,264,213,231,425,414,399,601,698,428,563.0,576.0,-270,97,-367
125,19,56,1,2,0,130,230,240,206,200,191,375,331,306,361,459,235,347.0,352.0,-224,98,-322
758,20,56,1,2,0,1368,1012,1031,877,1159,994,1592,1671,1487,1581,2727,1846,2286.0,2051.0,-881,1146,-2027
333,21,56,1,2,0,517,513,636,634,391,538,758,764,827,896,1319,905,1112.0,1040.0,-414,423,-837
117,22,56,1,2,0,93,173,167,152,156,136,271,219,256,312,397,173,285.0,294.0,-224,85,-309
29,1,57,3,2,0,42,81,54,48,33,25,37,28,27,30,34,19,26.0,28.0,-15,4,-19
1190,2,57,3,2,0,1982,1751,1315,1335,1170,1342,1395,1639,1736,1547,1939,1680,1810.0,1722.0,-259,392,-651
78,3,57,3,2,0,56,83,96,80,81,79,74,107,93,105,108,54,81.0,89.0,-54,3,-57
118,4,57,3,2,0,156,229,233,214,173,229,238,282,198,305,504,106,305.0,305.0,-398,199,-597
645,5,57,3,2,0,976,1205,892,875,682,620,742,717,655,773,955,603,779.0,777.0,-352,182,-534
223,6,57,3,2,0,440,323,285,216,207,172,194,197,214,225,272,216,244.0,238.0,-56,47,-103
541,7,57,3,2,0,767,721,695,659,545,644,631,622,551,636,1105,629,867.0,790.0,-476,469,-945
115,8,57,3,2,0,162,270,155,157,114,131,103,137,118,161,233,166,200.0,187.0,-67,72,-139
505,9,57,3,2,0,617,1291,948,890,830,568,627,644,624,713,866,346,606.0,642.0,-520,153,-673
50,10,57,3,2,0,161,173,97,104,62,69,50,93,63,75,97,92,94.0,88.0,-5,22,-27
843,11,57,3,2,0,952,992,724,727,654,653,752,766,763,871,1150,610,880.0,877.0,-540,279,-819
89,12,57,3,2,0,205,183,155,161,110,121,107,134,92,117,148,132,140.0,132.0,-16,31,-47
616,13,57,3,2,0,789,811,606,636,506,529,574,561,554,769,983,537,760.0,763.0,-446,214,-660
778,14,57,3,2,0,1478,1260,1027,934,847,759,825,703,746,952,1314,922,1118.0,1063.0,-392,362,-754
498,15,57,3,2,0,670,934,557,549,457,405,385,451,456,466,653,312,482.0,477.0,-341,187,-528
438,16,57,3,2,0,697,859,536,538,476,513,518,582,592,590,903,514,708.0,669.0,-389,313,-702
314,17,57,3,2,0,503,656,598,440,429,353,375,366,327,426,575,405,490.0,469.0,-170,149,-319
140,18,57,3,2,0,137,270,206,172,148,152,164,156,179,175,195,85,140.0,152.0,-110,20,-130
187,19,57,3,2,0,206,331,272,228,230,212,192,216,260,281,370,158,264.0,270.0,-212,89,-301
643,20,57,3,2,0,1641,1037,781,700,668,554,592,643,645,706,955,636,796.0,766.0,-319,249,-568
155,21,57,3,2,0,316,321,306,283,187,180,190,227,209,280,324,195,260.0,266.0,-129,44,-173
48,22,57,3,2,0,95,134,124,103,81,47,88,70,59,76,90,35,62.0,67.0,-55,14,-69
52,1,58,2,2,0,76,116,114,110,134,139,176,218,159,193,281,60,170.0,178.0,-221,88,-309
119,2,58,2,2,0,168,124,127,149,132,201,192,241,224,227,356,181,268.0,255.0,-175,129,-304
67,3,58,2,2,0,74,100,61,89,103,103,63,86,129,183,244,117,180.0,181.0,-127,61,-188
52,4,58,2,2,0,202,520,398,466,501,463,464,472,326,417,805,105,455.0,442.0,-700,388,-1088
454,5,58,2,2,0,755,939,830,726,715,739,855,1133,824,910,1456,816,1136.0,1061.0,-640,546,-1186
96,6,58,2,2,0,244,164,160,209,240,323,314,310,267,287,463,251,357.0,334.0,-212,176,-388
283,7,58,2,2,0,559,501,593,571,548,646,773,797,679,738,1182,600,891.0,840.0,-582,444,-1026
96,8,58,2,2,0,161,200,167,199,121,199,221,226,243,264,497,192,344.0,318.0,-305,233,-538
127,9,58,2,2,0,169,374,342,351,384,378,429,596,574,615,869,297,583.0,594.0,-572,254,-826
71,10,58,2,2,0,160,162,108,140,126,161,139,167,205,233,425,254,340.0,304.0,-171,192,-363
270,11,58,2,2,0,492,606,574,521,545,683,706,761,731,749,1017,461,739.0,742.0,-556,268,-824
60,12,58,2,2,0,142,127,126,110,128,145,145,229,198,198,315,211,263.0,241.0,-104,117,-221
390,13,58,2,2,0,635,446,455,480,501,551,690,771,682,755,1430,754,1092.0,980.0,-676,675,-1351
268,14,58,2,2,0,899,500,524,534,645,779,871,851,876,865,1601,892,1246.0,1119.0,-709,736,-1445
81,15,58,2,2,0,192,280,246,271,509,410,370,1437,406,420,845,174,510.0,480.0,-671,425,-1096
39,16,58,2,2,0,117,139,112,83,118,124,88,110,128,133,246,134,190.0,171.0,-112,113,-225
130,17,58,2,2,0,304,398,280,324,325,335,319,439,335,447,756,439,598.0,547.0,-317,309,-626
51,18,58,2,2,0,47,105,96,92,93,116,102,142,175,166,247,102,174.0,172.0,-145,81,-226
21,19,58,2,2,0,41,64,60,48,65,77,81,68,54,102,113,47,80.0,87.0,-66,11,-77
283,20,58,2,2,0,1292,570,694,1791,780,781,1602,764,548,596,1578,630,1104.0,935.0,-948,982,-1930
189,21,58,2,2,0,273,384,352,349,347,435,453,455,455,558,938,498,718.0,665.0,-440,380,-820
10,22,58,2,2,0,15,20,14,19,35,25,28,17,16,45,45,7,26.0,32.0,-38,0,-38
125,1,59,2,2,0,384,766,615,1911,902,547,590,1049,393,448,746,228,487.0,474.0,-518,298,-816
67,2,59,2,2,0,278,301,236,299,183,317,301,410,266,224,235,105,170.0,188.0,-130,11,-141
63,3,59,2,2,0,177,210,170,205,129,178,248,263,289,273,340,208,274.0,274.0,-132,67,-199
29,4,59,2,2,0,156,210,198,2153,193,216,265,2528,156,179,362,72,217.0,204.0,-290,183,-473
251,5,59,2,2,0,1198,978,987,918,779,942,1243,1666,730,631,1027,542,784.0,733.0,-485,396,-881
244,6,59,2,2,0,817,521,577,609,647,742,968,961,755,678,1434,792,1113.0,968.0,-642,756,-1398
326,7,59,2,2,0,1658,1597,1972,2081,1738,2176,2848,2646,1380,1053,1685,823,1254.0,1187.0,-862,632,-1494
126,8,59,2,2,0,317,332,357,466,412,468,657,660,386,479,604,321,462.0,468.0,-283,125,-408
130,9,59,2,2,0,279,1067,835,808,584,546,819,1623,936,1038,1493,451,972.0,994.0,-1042,455,-1497
76,10,59,2,2,0,190,289,222,206,200,234,316,360,349,312,543,250,396.0,368.0,-293,231,-524
656,11,59,2,2,0,2058,2036,1793,2058,1654,1827,2527,2388,1650,1467,2828,1205,2016.0,1833.0,-1623,1361,-2984
138,12,59,2,2,0,420,401,428,462,351,450,511,752,626,577,1241,549,895.0,789.0,-692,664,-1356
249,13,59,2,2,0,890,745,818,940,856,987,1387,1606,840,561,1020,602,811.0,728.0,-418,459,-877
320,14,59,2,2,0,1366,1036,1237,1242,1377,1416,1736,1669,959,1021,1584,992,1288.0,1199.0,-592,563,-1155
193,15,59,2,2,0,584,854,706,739,693,717,1019,1203,828,859,1272,386,829.0,839.0,-886,413,-1299
161,16,59,2,2,0,683,611,623,602,550,430,713,769,691,751,1208,523,866.0,827.0,-685,457,-1142
132,17,59,2,2,0,489,532,566,595,580,641,816,847,522,619,891,508,700.0,673.0,-383,272,-655
74,18,59,2,2,0,107,172,152,204,142,221,243,304,268,291,431,173,302.0,298.0,-258,140,-398
51,19,59,2,2,0,124,182,229,277,157,228,366,291,139,186,225,91,158.0,167.0,-134,39,-173
33,20,59,2,2,0,221,210,204,174,226,215,324,310,182,148,242,128,185.0,173.0,-114,94,-208
64,21,59,2,2,0,306,391,524,533,558,687,656,661,278,275,432,182,307.0,296.0,-250,157,-407
29,22,59,2,2,0,92,110,100,111,89,97,146,137,83,61,140,53,96.0,85.0,-87,79,-166
84,1,60,1,2,0,87,149,133,134,134,141,138,161,113,162,163,142,152.0,156.0,-21,1,-22
84,2,60,1,2,0,54,107,85,86,94,141,123,111,95,152,131,146,138.0,143.0,15,-21,36
41,3,60,1,2,0,40,55,64,107,75,84,71,81,97,81,90,83,86.0,85.0,-7,9,-16
65,4,60,1,2,0,34,85,87,95,97,119,87,131,79,100,123,88,106.0,104.0,-35,23,-58
184,5,60,1,2,0,197,228,225,215,255,232,227,447,284,279,330,341,336.0,317.0,11,51,-40
107,6,60,1,2,0,99,134,119,161,145,138,167,182,170,183,198,254,226.0,212.0,56,15,41
74,7,60,1,2,0,84,124,180,157,181,138,136,198,152,160,191,159,175.0,170.0,-32,31,-63
25,8,60,1,2,0,20,17,25,37,27,30,36,34,32,31,28,41,34.0,33.0,13,-3,16
264,9,60,1,2,0,146,429,345,479,470,487,435,593,541,658,638,568,603.0,621.0,-70,-20,-50
121,10,60,1,2,0,89,156,161,164,160,151,154,208,163,172,213,297,255.0,227.0,84,41,43
213,11,60,1,2,0,205,341,313,360,325,317,361,402,385,402,439,430,434.0,424.0,-9,37,-46
50,12,60,1,2,0,37,64,44,75,70,82,64,94,87,76,120,103,112.0,100.0,-17,44,-61
50,13,60,1,2,0,39,90,92,88,94,88,102,92,82,85,95,109,102.0,96.0,14,10,4
78,14,60,1,2,0,72,107,141,117,126,120,123,153,141,134,164,130,147.0,143.0,-34,30,-64
185,15,60,1,2,0,156,242,287,301,272,322,299,308,339,364,397,466,432.0,409.0,69,33,36
129,16,60,1,2,0,86,162,187,145,190,155,179,232,184,244,236,270,253.0,250.0,34,-8,42
215,17,60,1,2,0,173,254,290,293,279,299,298,395,308,355,445,519,482.0,440.0,74,90,-16
57,18,60,1,2,0,45,88,69,99,64,92,91,93,87,125,99,145,122.0,123.0,46,-26,72
59,19,60,1,2,0,60,120,97,133,116,136,158,194,115,126,155,89,122.0,123.0,-66,29,-95
89,20,60,1,2,0,103,110,159,135,304,146,146,203,173,179,214,160,187.0,184.0,-54,35,-89
154,21,60,1,2,0,88,179,190,260,217,273,229,256,263,252,263,274,268.0,263.0,11,11,0
35,22,60,1,2,0,36,89,80,70,81,75,75,68,54,66,57,65,61.0,63.0,8,-9,17
309,1,1,1,3,0,323,266,271,235,260,162,265,228,369,374,305,193,249.0,291.0,-112,-69,-43
302,2,1,1,3,0,260,216,308,279,419,246,217,310,402,456,434,194,314.0,361.0,-240,-22,-218
201,3,1,1,3,0,206,149,236,164,187,153,157,178,204,219,180,128,154.0,176.0,-52,-39,-13
472,4,1,1,3,0,362,404,445,351,322,244,337,371,460,563,468,432,450.0,488.0,-36,-95,59
378,5,1,1,3,0,358,373,360,329,335,345,623,350,453,570,500,253,376.0,441.0,-247,-70,-177
132,6,1,1,3,0,152,155,154,138,108,127,159,136,179,226,198,76,137.0,167.0,-122,-28,-94
412,7,1,1,3,0,418,482,482,353,339,259,422,394,483,601,468,290,379.0,453.0,-178,-133,-45
249,8,1,1,3,0,197,211,250,166,178,189,194,233,215,260,248,146,197.0,218.0,-102,-12,-90
2958,9,1,1,3,0,2407,2080,2897,2187,2183,1804,2265,2711,3532,3800,2692,1680,2186.0,2724.0,-1012,-1108,96
383,10,1,1,3,0,347,259,363,291,276,249,267,349,472,505,425,248,336.0,393.0,-177,-80,-97
817,11,1,1,3,0,791,629,780,561,554,569,631,764,871,1010,800,486,643.0,765.0,-314,-210,-104
191,12,1,1,3,0,138,143,167,149,136,95,156,166,204,262,236,78,157.0,192.0,-158,-26,-132
297,13,1,1,3,0,237,254,280,252,227,235,225,228,291,305,260,190,225.0,252.0,-70,-45,-25
355,14,1,1,3,0,304,394,313,330,384,256,301,351,521,505,405,250,328.0,387.0,-155,-100,-55
621,15,1,1,3,0,504,483,638,453,457,422,545,702,660,865,633,409,521.0,636.0,-224,-232,8
445,16,1,1,3,0,418,368,357,440,329,325,381,447,480,474,497,228,362.0,400.0,-269,23,-292
297,17,1,1,3,0,288,266,308,275,250,286,299,327,364,474,347,174,260.0,332.0,-173,-127,-46
307,18,1,1,3,0,315,287,307,223,276,226,258,368,331,404,292,181,236.0,292.0,-111,-112,1
775,19,1,1,3,0,807,807,900,645,700,556,721,769,941,997,650,566,608.0,738.0,-84,-347,263
126,20,1,1,3,0,127,106,114,181,131,111,101,120,155,199,115,72,94.0,129.0,-43,-84,41
295,21,1,1,3,0,246,259,414,206,262,204,187,324,393,440,305,219,262.0,321.0,-86,-135,49
401,22,1,1,3,0,482,356,398,288,194,351,302,310,458,461,292,234,263.0,329.0,-58,-169,111
442,1,2,2,3,0,484,342,349,376,356,410,417,271,639,518,268,263,266.0,350.0,-5,-250,245
403,2,2,2,3,0,275,246,290,259,337,266,368,334,609,519,292,264,278.0,358.0,-28,-227,199
316,3,2,2,3,0,189,191,270,175,231,216,208,216,370,337,175,149,162.0,220.0,-26,-162,136
470,4,2,2,3,0,527,412,406,405,459,464,449,231,675,811,368,359,364.0,513.0,-9,-443,434
806,5,2,2,3,0,885,758,701,656,684,758,1227,469,1053,1125,657,560,608.0,781.0,-97,-468,371
317,6,2,2,3,0,202,232,224,252,293,358,325,253,574,507,301,225,263.0,344.0,-76,-206,130
1060,7,2,2,3,0,807,1100,977,862,990,917,1222,876,1567,1574,775,729,752.0,1026.0,-46,-799,753
407,8,2,2,3,0,299,314,339,253,284,382,372,320,590,571,290,239,264.0,367.0,-51,-281,230
10371,9,2,2,3,0,8611,7234,9327,8266,8709,10596,10140,6925,13598,11515,5136,4688,4912.0,7113.0,-448,-6379,5931
1074,10,2,2,3,0,855,658,835,723,792,866,969,642,1386,1258,750,559,654.0,856.0,-191,-508,317
2184,11,2,2,3,0,2057,1655,2026,1678,1827,2216,2075,1763,3112,2877,1445,1635,1540.0,1986.0,190,-1432,1622
545,12,2,2,3,0,359,359,396,344,400,420,535,356,595,741,435,311,373.0,496.0,-124,-306,182
847,13,2,2,3,0,516,591,633,520,604,569,722,520,1137,974,498,486,492.0,653.0,-12,-476,464
968,14,2,2,3,0,544,698,673,695,718,785,808,565,1273,1234,645,486,566.0,788.0,-159,-589,430
1969,15,2,2,3,0,1659,1539,1625,1420,1737,1785,1658,1293,2709,2467,1135,1205,1170.0,1602.0,70,-1332,1402
734,16,2,2,3,0,804,713,668,835,675,883,908,742,1001,1050,703,508,606.0,754.0,-195,-347,152
769,17,2,2,3,0,678,683,657,625,567,721,958,582,1112,1192,689,445,567.0,775.0,-244,-503,259
1607,18,2,2,3,0,1254,1127,1467,1202,1533,1388,1310,817,2205,1578,856,899,878.0,1111.0,43,-722,765
1905,19,2,2,3,0,1838,1870,2279,1544,2253,2301,1915,1064,2892,2161,1110,1306,1208.0,1526.0,196,-1051,1247
285,20,2,2,3,0,218,213,199,327,300,319,331,173,470,398,244,215,230.0,286.0,-29,-154,125
369,21,2,2,3,0,255,320,486,412,553,492,462,375,582,607,340,260,300.0,402.0,-80,-267,187
1186,22,2,2,3,0,946,626,765,687,670,1107,843,480,1076,1018,447,521,484.0,662.0,74,-571,645
187,1,3,1,3,0,213,184,219,211,160,159,169,112,163,167,157,101,129.0,142.0,-56,-10,-46
293,2,3,1,3,0,253,260,265,254,351,309,270,218,354,350,290,213,252.0,284.0,-77,-60,-17
228,3,3,1,3,0,210,228,261,237,261,246,234,155,184,233,279,174,226.0,229.0,-105,46,-151
627,4,3,1,3,0,551,670,627,552,633,554,583,457,611,677,549,387,468.0,538.0,-162,-128,-34
377,5,3,1,3,0,348,327,372,413,373,319,387,300,411,434,516,235,376.0,395.0,-281,82,-363
127,6,3,1,3,0,119,116,119,126,118,108,157,129,128,138,176,83,130.0,132.0,-93,38,-131
353,7,3,1,3,0,316,317,345,393,358,328,376,327,415,400,420,235,328.0,352.0,-185,20,-205
189,8,3,1,3,0,160,161,165,161,170,152,135,111,141,197,179,103,141.0,160.0,-76,-18,-58
1738,9,3,1,3,0,1579,1472,1652,1649,1691,1490,1683,1421,1989,1829,1713,1159,1436.0,1567.0,-554,-116,-438
197,10,3,1,3,0,184,157,187,179,178,141,192,165,181,173,211,121,166.0,168.0,-90,38,-128
446,11,3,1,3,0,361,393,413,417,373,340,401,333,437,427,470,296,383.0,398.0,-174,43,-217
113,12,3,1,3,0,75,95,119,89,94,84,108,90,107,109,126,55,90.0,97.0,-71,17,-88
371,13,3,1,3,0,233,302,305,302,324,321,309,274,302,328,389,251,320.0,323.0,-138,61,-199
331,14,3,1,3,0,259,323,298,340,309,300,327,262,352,337,377,202,290.0,305.0,-175,40,-215
349,15,3,1,3,0,327,357,357,351,316,352,336,342,428,424,401,264,332.0,363.0,-137,-23,-114
271,16,3,1,3,0,210,242,242,268,203,201,303,211,267,280,321,189,255.0,263.0,-132,41,-173
275,17,3,1,3,0,212,237,248,277,255,193,250,211,244,275,284,146,215.0,235.0,-138,9,-147
107,18,3,1,3,0,105,124,113,128,123,95,124,106,151,157,167,81,124.0,135.0,-86,10,-96
529,19,3,1,3,0,417,495,542,501,506,466,488,346,464,567,506,316,411.0,463.0,-190,-61,-129
188,20,3,1,3,0,176,130,156,186,166,134,169,138,184,155,213,116,164.0,161.0,-97,58,-155
288,21,3,1,3,0,253,239,271,255,273,253,271,195,252,267,297,206,252.0,257.0,-91,30,-121
306,22,3,1,3,0,216,276,357,324,293,304,239,208,258,336,315,155,235.0,269.0,-160,-21,-139
135,1,4,2,3,0,232,238,251,282,229,249,216,166,212,210,117,96,106.0,141.0,-21,-93,72
159,2,4,2,3,0,163,123,154,116,231,232,256,209,270,308,173,110,142.0,197.0,-63,-135,72
136,3,4,2,3,0,114,106,123,97,118,134,193,128,165,176,89,72,80.0,112.0,-17,-87,70
179,4,4,2,3,0,324,305,237,267,308,309,286,179,246,342,136,109,122.0,196.0,-27,-206,179
361,5,4,2,3,0,452,413,430,414,426,492,712,401,438,436,351,212,282.0,333.0,-139,-85,-54
204,6,4,2,3,0,244,230,261,218,300,368,358,250,325,348,264,151,208.0,254.0,-113,-84,-29
357,7,4,2,3,0,389,484,405,407,399,489,606,454,468,556,225,175,200.0,319.0,-50,-331,281
148,8,4,2,3,0,128,130,124,127,123,233,187,181,144,181,92,70,81.0,114.0,-22,-89,67
3992,9,4,2,3,0,3766,3317,3840,3624,4020,4618,5211,4012,4216,4195,2391,1639,2015.0,2742.0,-752,-1804,1052
443,10,4,2,3,0,344,277,350,329,360,409,444,331,432,386,248,166,207.0,267.0,-82,-138,56
982,11,4,2,3,0,940,829,888,876,892,1148,1130,943,1033,1154,680,651,666.0,828.0,-29,-474,445
254,12,4,2,3,0,184,170,221,210,194,288,380,260,302,351,208,96,152.0,218.0,-112,-143,31
584,13,4,2,3,0,358,362,423,480,475,550,584,385,397,419,248,284,266.0,317.0,36,-171,207
578,14,4,2,3,0,376,449,371,468,562,658,673,556,567,651,338,242,290.0,410.0,-96,-313,217
1438,15,4,2,3,0,990,1039,1012,1006,1138,1244,1296,1228,1343,1310,747,739,743.0,932.0,-8,-563,555
461,16,4,2,3,0,547,533,457,595,544,655,744,726,677,787,450,226,338.0,488.0,-224,-337,113
436,17,4,2,3,0,482,529,476,494,503,610,619,436,474,674,394,223,308.0,430.0,-171,-280,109
535,18,4,2,3,0,423,426,506,417,546,535,615,563,615,519,231,173,202.0,308.0,-58,-288,230
610,19,4,2,3,0,554,649,665,803,867,1031,840,522,652,848,213,233,223.0,431.0,20,-635,655
166,20,4,2,3,0,193,183,200,348,324,316,208,150,157,208,123,85,104.0,139.0,-38,-85,47
202,21,4,2,3,0,192,194,239,237,272,274,262,219,225,317,148,105,126.0,190.0,-43,-169,126
233,22,4,2,3,0,253,261,255,248,232,335,334,222,288,303,90,85,88.0,159.0,-5,-213,208
267,1,5,3,3,0,302,182,202,234,212,256,234,168,249,477,199,177,188.0,284.0,-22,-278,256
2754,2,5,3,3,0,2705,2130,2397,2353,2868,2565,3307,3096,3216,4503,4785,3067,3926.0,4118.0,-1718,282,-2000
680,3,5,3,3,0,434,313,361,329,346,368,502,360,520,675,504,451,478.0,543.0,-53,-171,118
197,4,5,3,3,0,304,246,278,163,179,202,242,199,305,514,151,92,122.0,252.0,-59,-363,304
1481,5,5,3,3,0,1498,1056,1064,1118,1183,1230,1449,1007,1411,1954,1724,1537,1630.0,1738.0,-187,-230,43
1518,6,5,3,3,0,1532,1224,1396,1210,1260,1418,1458,1238,1535,2328,2152,1881,2016.0,2120.0,-271,-176,-95
2839,7,5,3,3,0,2813,2653,3587,2963,3398,3600,3519,3268,3907,6576,4483,3060,3772.0,4706.0,-1423,-2093,670
1353,8,5,3,3,0,1300,1076,1493,1193,1334,1452,1749,1354,1585,2844,2093,1361,1727.0,2099.0,-732,-751,19
2180,9,5,3,3,0,1712,1309,1820,1577,1457,1550,1999,1555,2007,3029,1611,1579,1595.0,2073.0,-32,-1418,1386
2310,10,5,3,3,0,2715,1831,2371,1991,2051,2291,2515,2293,2687,4443,3084,1836,2460.0,3121.0,-1248,-1359,111
2029,11,5,3,3,0,2075,1392,1679,1539,1776,1799,1764,1493,1942,3067,2165,2419,2292.0,2550.0,254,-902,1156
875,12,5,3,3,0,1047,877,1066,892,885,890,1111,824,980,1510,1290,922,1106.0,1241.0,-368,-220,-148
2945,13,5,3,3,0,2548,2351,2960,2437,2748,3368,3303,2808,3641,6231,3870,3403,3636.0,4501.0,-467,-2361,1894
3197,14,5,3,3,0,3545,2891,3967,3302,3413,3591,3584,3821,4668,7650,5825,3564,4694.0,5680.0,-2261,-1825,-436
1592,15,5,3,3,0,1340,943,1216,1213,1206,1016,1295,1112,1294,2062,1260,1629,1444.0,1650.0,369,-802,1171
1262,16,5,3,3,0,1238,1013,1221,954,900,992,1202,958,1353,2198,1919,1140,1530.0,1752.0,-779,-279,-500
1541,17,5,3,3,0,1924,1609,1715,1491,1500,1678,1773,1354,1770,2693,2364,1506,1935.0,2188.0,-858,-329,-529
741,18,5,3,3,0,702,458,576,545,512,565,573,523,688,892,592,650,621.0,711.0,58,-300,358
1322,19,5,3,3,0,1124,894,1170,1034,1023,1010,1135,824,1154,1710,924,939,932.0,1191.0,15,-786,801
235,20,5,3,3,0,204,191,258,225,203,204,284,201,250,357,250,248,249.0,285.0,-2,-107,105
1314,21,5,3,3,0,1221,1008,1213,1083,1173,1245,1658,1590,1877,3217,2072,1105,1588.0,2131.0,-967,-1145,178
806,22,5,3,3,0,819,646,736,776,785,835,795,518,816,982,506,518,512.0,669.0,12,-476,488
351,1,6,1,3,0,202,198,232,330,331,445,555,272,582,623,382,114,248.0,373.0,-268,-241,-27
452,2,6,1,3,0,199,246,327,333,428,409,543,553,546,680,484,300,392.0,488.0,-184,-196,12
489,3,6,1,3,0,444,472,638,517,552,645,831,715,836,832,551,317,434.0,567.0,-234,-281,47
180,4,6,1,3,0,162,260,324,331,345,369,502,362,440,598,212,102,157.0,304.0,-110,-386,276
850,5,6,1,3,0,864,847,961,1004,1032,1165,1460,1050,1385,1850,1223,671,947.0,1248.0,-552,-627,75
1018,6,6,1,3,0,744,849,934,1047,1058,1409,1565,1256,1491,1666,1515,717,1116.0,1299.0,-798,-151,-647
1734,7,6,1,3,0,897,1413,1635,1575,1773,2139,2580,2061,2146,2737,1706,842,1274.0,1762.0,-864,-1031,167
595,8,6,1,3,0,365,433,477,430,532,655,690,724,762,993,533,312,422.0,613.0,-221,-460,239
5713,9,6,1,3,0,3854,3887,5187,5010,5237,6544,8215,6582,6734,6492,5607,2647,4127.0,4915.0,-2960,-885,-2075
719,10,6,1,3,0,570,472,589,632,639,680,913,743,853,894,799,409,604.0,701.0,-390,-95,-295
1729,11,6,1,3,0,1459,1467,1717,1679,1859,2252,2410,2283,2584,2672,1728,1016,1372.0,1805.0,-712,-944,232
690,12,6,1,3,0,549,619,761,704,848,964,1340,1065,1086,1291,1027,356,692.0,891.0,-671,-264,-407
2126,13,6,1,3,0,1146,1445,1808,1966,2293,2864,3253,2277,2327,2703,2119,1271,1695.0,2031.0,-848,-584,-264
2514,14,6,1,3,0,1386,1910,2169,2264,2690,3318,3446,2827,2797,3447,2952,1308,2130.0,2569.0,-1644,-495,-1149
876,15,6,1,3,0,593,721,949,928,974,1151,1369,1262,1632,1972,795,459,627.0,1075.0,-336,-1177,841
1095,16,6,1,3,0,1011,1012,1027,1207,1181,1412,1938,1686,1663,2151,1566,597,1082.0,1438.0,-969,-585,-384
1487,17,6,1,3,0,1249,1396,1570,1605,1889,1918,2573,2247,1966,2770,1651,844,1248.0,1755.0,-807,-1119,312
314,18,6,1,3,0,172,208,292,259,301,348,390,371,447,476,264,148,206.0,296.0,-116,-212,96
360,19,6,1,3,0,187,283,311,261,323,369,397,317,403,513,241,211,226.0,322.0,-30,-272,242
472,20,6,1,3,0,479,530,585,806,750,810,888,646,803,1149,803,328,566.0,760.0,-475,-346,-129
468,21,6,1,3,0,306,358,387,403,502,566,687,665,655,845,620,247,434.0,571.0,-373,-225,-148
506,22,6,1,3,0,468,492,550,570,602,652,669,544,740,1032,399,306,352.0,579.0,-93,-633,540
1247,1,7,3,3,0,1063,994,1124,945,1154,1068,958,710,977,1212,1265,890,1078.0,1122.0,-375,53,-428
214,2,7,3,3,0,70,57,124,99,83,62,79,45,66,119,104,63,84.0,95.0,-41,-15,-26
154,3,7,3,3,0,65,50,51,85,56,51,54,43,56,75,86,64,75.0,75.0,-22,11,-33
1508,4,7,3,3,0,867,872,926,824,1014,976,1027,677,793,1627,1352,1114,1233.0,1364.0,-238,-275,37
254,5,7,3,3,0,223,166,175,144,210,234,199,102,145,321,208,187,198.0,239.0,-21,-113,92
322,6,7,3,3,0,149,190,155,149,157,167,182,145,176,251,253,175,214.0,226.0,-78,2,-80
1303,7,7,3,3,0,562,729,614,644,701,698,710,494,739,1047,878,649,764.0,858.0,-229,-169,-60
244,8,7,3,3,0,106,96,90,115,93,101,121,83,105,184,165,123,144.0,157.0,-42,-19,-23
944,9,7,3,3,0,472,491,557,511,479,453,514,463,571,819,762,448,605.0,676.0,-314,-57,-257
103,10,7,3,3,0,56,38,32,27,46,65,36,87,45,96,92,54,73.0,81.0,-38,-4,-34
1188,11,7,3,3,0,680,808,786,664,704,653,923,563,731,1002,974,650,812.0,875.0,-324,-28,-296
164,12,7,3,3,0,55,107,79,54,83,56,89,43,74,97,118,85,102.0,100.0,-33,21,-54
599,13,7,3,3,0,229,240,232,241,288,302,284,232,288,493,470,361,416.0,441.0,-109,-23,-86
763,14,7,3,3,0,314,390,376,374,353,356,387,282,366,596,517,345,431.0,486.0,-172,-79,-93
754,15,7,3,3,0,365,466,382,390,895,578,350,278,533,736,534,424,479.0,565.0,-110,-202,92
240,16,7,3,3,0,93,139,123,130,108,119,115,66,94,173,151,103,127.0,142.0,-48,-22,-26
203,17,7,3,3,0,72,140,72,59,68,91,68,60,83,119,101,59,80.0,93.0,-42,-18,-24
206,18,7,3,3,0,128,219,92,103,107,123,99,106,97,170,123,106,114.0,133.0,-17,-47,30
357,19,7,3,3,0,139,266,153,169,211,178,184,111,151,300,181,154,168.0,212.0,-27,-119,92
130,20,7,3,3,0,102,106,65,63,75,66,120,43,58,100,60,71,66.0,77.0,11,-40,51
320,21,7,3,3,0,169,185,153,156,195,228,164,136,164,313,234,179,206.0,242.0,-55,-79,24
323,22,7,3,3,0,90,127,69,65,102,113,130,76,95,177,129,74,102.0,127.0,-55,-48,-7
288,1,8,2,3,0,606,561,484,494,547,504,605,431,543,697,325,168,246.0,397.0,-157,-372,215
38,2,8,2,3,0,83,82,70,56,86,60,80,64,106,112,40,25,32.0,59.0,-15,-72,57
29,3,8,2,3,0,55,66,70,55,54,65,50,48,60,75,31,18,24.0,41.0,-13,-44,31
59,4,8,2,3,0,141,177,131,96,96,105,107,59,86,132,40,51,46.0,74.0,11,-92,103
192,5,8,2,3,0,188,226,211,185,192,194,379,187,278,408,216,117,166.0,247.0,-99,-192,93
207,6,8,2,3,0,330,375,352,304,284,383,452,363,447,587,357,148,252.0,364.0,-209,-230,21
373,7,8,2,3,0,405,655,512,403,384,434,524,437,477,555,320,180,250.0,352.0,-140,-235,95
28,8,8,2,3,0,50,77,84,53,53,40,61,59,55,64,30,23,26.0,39.0,-7,-34,27
166,9,8,2,3,0,219,282,274,225,205,191,284,225,342,408,121,39,80.0,189.0,-82,-287,205
47,10,8,2,3,0,75,77,81,56,48,72,86,66,86,129,68,34,51.0,77.0,-34,-61,27
788,11,8,2,3,0,1119,1203,1261,881,934,1240,1311,1156,1271,1767,893,628,760.0,1096.0,-265,-874,609
161,12,8,2,3,0,149,241,252,167,187,201,205,175,224,302,169,92,130.0,188.0,-77,-133,56
93,13,8,2,3,0,169,204,145,156,130,129,149,129,127,215,80,56,68.0,117.0,-24,-135,111
185,14,8,2,3,0,277,347,264,222,222,264,300,257,320,368,183,97,140.0,216.0,-86,-185,99
478,15,8,2,3,0,762,810,793,638,611,791,867,742,941,1163,445,309,377.0,639.0,-136,-718,582
172,16,8,2,3,0,191,266,209,221,204,189,253,233,287,401,211,94,152.0,235.0,-117,-190,73
173,17,8,2,3,0,191,256,228,177,169,202,213,182,259,315,201,83,142.0,200.0,-118,-114,-4
51,18,8,2,3,0,96,99,97,66,59,77,86,70,117,145,54,20,37.0,73.0,-34,-91,57
52,19,8,2,3,0,89,169,79,56,94,56,78,81,68,104,28,21,24.0,51.0,-7,-76,69
37,20,8,2,3,0,57,50,37,61,45,63,77,40,57,62,28,20,24.0,37.0,-8,-34,26
78,21,8,2,3,0,108,169,156,96,102,126,137,141,113,177,107,51,79.0,112.0,-56,-70,14
8,22,8,2,3,0,36,50,45,25,30,29,39,29,28,30,11,11,11.0,17.0,0,-19,19
957,1,9,1,3,0,1006,969,925,835,829,878,839,851,1537,1734,940,540,740.0,1071.0,-400,-794,394
346,2,9,1,3,0,410,333,370,297,444,406,375,464,639,732,400,288,344.0,473.0,-112,-332,220
323,3,9,1,3,0,302,350,427,288,345,346,426,433,493,573,322,195,258.0,363.0,-127,-251,124
601,4,9,1,3,0,553,585,621,593,551,572,648,532,915,1057,659,394,526.0,703.0,-265,-398,133
873,5,9,1,3,0,747,869,835,754,816,821,1394,1020,1293,1876,1072,611,842.0,1186.0,-461,-804,343
773,6,9,1,3,0,678,800,749,648,689,782,938,1018,1287,1597,1015,457,736.0,1023.0,-558,-582,24
1253,7,9,1,3,0,1062,1662,1314,1119,1240,1232,1497,1547,1722,2394,1077,522,800.0,1331.0,-555,-1317,762
450,8,9,1,3,0,358,423,462,359,317,365,407,489,581,742,375,248,312.0,455.0,-127,-367,240
1024,9,9,1,3,0,919,955,1092,904,1023,986,1197,1508,2163,2594,949,463,706.0,1335.0,-486,-1645,1159
322,10,9,1,3,0,368,262,320,307,308,261,338,373,502,713,341,210,276.0,421.0,-131,-372,241
1519,11,9,1,3,0,1351,1369,1459,1195,1141,1497,1413,1635,2059,2647,1466,939,1202.0,1684.0,-527,-1181,654
757,12,9,1,3,0,549,710,757,635,717,687,798,900,1083,1527,753,397,575.0,892.0,-356,-774,418
655,13,9,1,3,0,745,695,817,660,609,745,771,828,1012,1235,691,404,548.0,777.0,-287,-544,257
1119,14,9,1,3,0,938,1124,951,899,929,998,1228,1191,1470,2122,1000,589,794.0,1237.0,-411,-1122,711
978,15,9,1,3,0,799,913,926,862,813,942,1042,1090,1626,2068,1003,537,770.0,1203.0,-466,-1065,599
1058,16,9,1,3,0,799,894,947,966,785,977,1135,1284,1519,1632,1025,485,755.0,1047.0,-540,-607,67
1068,17,9,1,3,0,928,1065,1061,902,924,1034,1175,1168,1619,2178,1217,467,842.0,1287.0,-750,-961,211
433,18,9,1,3,0,347,323,473,273,417,426,426,568,767,913,522,257,390.0,564.0,-265,-391,126
277,19,9,1,3,0,288,386,363,316,315,365,365,407,443,594,254,172,213.0,340.0,-82,-340,258
342,20,9,1,3,0,303,331,291,407,357,329,386,354,500,762,420,252,336.0,478.0,-168,-342,174
306,21,9,1,3,0,401,396,383,263,316,283,360,444,478,651,365,184,274.0,400.0,-181,-286,105
207,22,9,1,3,0,274,347,288,202,213,233,201,203,289,372,142,121,132.0,212.0,-21,-230,209
975,1,10,2,3,0,1276,1391,1398,1353,1616,1715,1560,1261,1546,1428,635,513,574.0,859.0,-122,-793,671
333,2,10,2,3,0,300,304,335,298,451,462,412,350,412,626,249,167,208.0,347.0,-82,-377,295
320,3,10,2,3,0,323,304,432,328,313,335,434,451,516,701,285,178,232.0,388.0,-107,-416,309
113,4,10,2,3,0,202,284,280,232,247,248,278,174,264,913,106,74,90.0,364.0,-32,-807,775
1522,5,10,2,3,0,1323,1763,1713,1549,1800,1833,2351,1555,1783,2691,1134,763,948.0,1529.0,-371,-1557,1186
1908,6,10,2,3,0,1314,1838,2005,1957,2071,2572,2578,2110,2138,2356,1607,968,1288.0,1644.0,-639,-749,110
3138,7,10,2,3,0,1837,3584,3723,2665,3185,3623,4079,3911,3787,4830,2048,1323,1686.0,2734.0,-725,-2782,2057
629,8,10,2,3,0,390,562,695,612,635,770,774,678,852,1073,317,283,300.0,558.0,-34,-756,722
1495,9,10,2,3,0,1288,1748,2151,1841,2105,2230,2219,1912,2435,2500,695,488,592.0,1228.0,-207,-1805,1598
738,10,10,2,3,0,481,401,605,509,467,597,723,646,783,869,475,293,384.0,546.0,-182,-394,212
4119,11,10,2,3,0,3351,4265,5237,4119,4343,5439,5089,5170,5016,5865,2657,2401,2529.0,3641.0,-256,-3208,2952
1502,12,10,2,3,0,685,1136,1339,997,1282,1228,1446,1175,1376,1737,923,549,736.0,1070.0,-374,-814,440
1379,13,10,2,3,0,1178,1462,1915,1717,1730,2030,2166,1672,1926,2621,900,720,810.0,1414.0,-180,-1721,1541
2558,14,10,2,3,0,1347,2464,2148,2124,2569,3033,2794,2644,2874,3243,1683,1042,1362.0,1989.0,-641,-1560,919
1965,15,10,2,3,0,2016,2464,3027,2635,2644,3079,3258,3003,3295,3490,1289,1038,1164.0,1939.0,-251,-2201,1950
1234,16,10,2,3,0,796,1212,1354,1346,1388,1694,1779,1500,1547,1624,929,480,704.0,1011.0,-449,-695,246
1513,17,10,2,3,0,970,1484,1556,1388,1464,1556,1793,1457,1585,1952,989,516,752.0,1152.0,-473,-963,490
859,18,10,2,3,0,546,695,1147,600,1040,913,859,836,1130,958,546,402,474.0,635.0,-144,-412,268
446,19,10,2,3,0,435,639,553,466,570,710,667,540,619,821,205,149,177.0,392.0,-56,-616,560
296,20,10,2,3,0,233,248,344,487,446,463,501,422,419,597,296,163,230.0,352.0,-133,-301,168
475,21,10,2,3,0,403,620,717,590,762,830,880,891,912,1151,413,242,328.0,602.0,-171,-738,567
301,22,10,2,3,0,240,355,391,233,247,332,298,250,347,415,118,130,124.0,221.0,12,-297,309
45,1,11,2,3,0,145,116,132,121,130,170,225,144,225,270,79,27,53.0,125.0,-52,-191,139
285,2,11,2,3,0,104,130,150,124,141,193,215,192,267,384,296,172,234.0,284.0,-124,-88,-36
211,3,11,2,3,0,191,134,180,155,165,211,257,237,359,450,248,124,186.0,274.0,-124,-202,78
556,4,11,2,3,0,213,666,671,764,635,596,755,684,938,1287,118,74,96.0,493.0,-44,-1169,1125
891,5,11,2,3,0,671,665,754,743,840,1135,1134,707,1002,2805,1326,797,1062.0,1643.0,-529,-1479,950
535,6,11,2,3,0,432,458,431,427,626,807,752,716,977,1443,903,436,670.0,927.0,-467,-540,73
1343,7,11,2,3,0,1025,1289,1432,1325,1510,2013,2253,1752,2198,3785,1878,1009,1444.0,2224.0,-869,-1907,1038
417,8,11,2,3,0,276,293,383,273,396,591,635,370,1993,2925,603,248,426.0,1259.0,-355,-2322,1967
1078,9,11,2,3,0,994,1031,1203,1183,1216,1851,1526,1065,2044,2419,914,399,656.0,1244.0,-515,-1505,990
492,10,11,2,3,0,260,250,385,389,373,565,452,368,493,935,666,303,484.0,635.0,-363,-269,-94
752,11,11,2,3,0,828,897,1057,971,1038,1263,1231,1184,1531,2308,910,648,779.0,1289.0,-262,-1398,1136
509,12,11,2,3,0,459,469,546,479,591,657,831,701,917,1377,999,364,682.0,913.0,-635,-378,-257
741,13,11,2,3,0,471,479,696,616,754,991,941,754,1144,2067,1110,641,876.0,1273.0,-469,-957,488
1199,14,11,2,3,0,887,1161,1258,1321,1528,1922,1491,1090,1965,3560,2272,888,1580.0,2240.0,-1384,-1288,-96
1114,15,11,2,3,0,1584,1570,1718,1900,1877,2534,1978,2287,3147,4324,1028,639,834.0,1997.0,-389,-3296,2907
476,16,11,2,3,0,424,420,420,475,487,636,528,521,941,1534,1004,347,676.0,962.0,-657,-530,-127
685,17,11,2,3,0,896,945,1034,885,1014,1148,1102,762,1142,1719,1133,438,786.0,1097.0,-695,-586,-109
656,18,11,2,3,0,590,596,665,596,710,861,605,468,762,1967,434,268,351.0,890.0,-166,-1533,1367
205,19,11,2,3,0,202,209,189,242,328,373,319,239,291,520,199,149,174.0,289.0,-50,-321,271
409,20,11,2,3,0,206,305,265,352,383,500,317,253,326,532,432,291,362.0,418.0,-141,-100,-41
609,21,11,2,3,0,382,511,669,670,984,1191,1013,830,1010,1651,919,422,670.0,997.0,-497,-732,235
114,22,11,2,3,0,88,79,102,96,114,179,154,114,204,257,135,104,120.0,165.0,-31,-122,91
60,1,12,2,3,0,47,54,61,91,84,82,78,75,125,158,63,40,52.0,87.0,-23,-95,72
288,2,12,2,3,0,206,208,229,212,242,297,409,425,375,535,421,246,334.0,401.0,-175,-114,-61
250,3,12,2,3,0,198,157,157,141,155,186,321,287,448,676,363,164,264.0,401.0,-199,-313,114
109,4,12,2,3,0,142,158,142,166,192,229,328,289,360,496,86,74,80.0,219.0,-12,-410,398
621,5,12,2,3,0,466,458,502,542,612,740,894,870,831,1260,724,451,588.0,812.0,-273,-536,263
358,6,12,2,3,0,304,266,327,272,360,423,570,478,510,806,576,272,424.0,551.0,-304,-230,-74
977,7,12,2,3,0,946,977,950,814,1067,1385,1544,1660,1778,2915,1529,762,1146.0,1735.0,-767,-1386,619
578,8,12,2,3,0,305,328,438,304,387,526,657,689,668,1092,615,366,490.0,691.0,-249,-477,228
821,9,12,2,3,0,467,644,800,706,726,1003,987,1170,1384,1437,718,363,540.0,839.0,-355,-719,364
370,10,12,2,3,0,238,200,244,215,205,275,336,321,463,659,452,233,342.0,448.0,-219,-207,-12
518,11,12,2,3,0,374,406,417,417,424,503,619,691,743,1008,543,405,474.0,652.0,-138,-465,327
323,12,12,2,3,0,271,316,324,321,323,384,576,518,577,816,634,247,440.0,566.0,-387,-182,-205
1023,13,12,2,3,0,734,754,897,796,976,1190,1442,1308,1432,2365,1304,951,1128.0,1540.0,-353,-1061,708
888,14,12,2,3,0,731,764,796,796,921,1180,1362,1148,1406,2228,1526,717,1122.0,1490.0,-809,-702,-107
511,15,12,2,3,0,491,555,599,497,546,656,656,660,874,1121,438,306,372.0,622.0,-132,-683,551
364,16,12,2,3,0,280,340,316,308,353,445,594,534,655,903,635,255,445.0,598.0,-380,-268,-112
479,17,12,2,3,0,571,590,590,570,561,665,852,609,763,1216,773,321,547.0,770.0,-452,-443,-9
274,18,12,2,3,0,214,227,185,203,218,279,280,218,239,420,249,153,201.0,274.0,-96,-171,75
321,19,12,2,3,0,240,267,276,253,308,361,450,328,514,641,287,222,254.0,383.0,-65,-354,289
238,20,12,2,3,0,141,187,187,221,263,289,325,272,292,402,296,142,219.0,280.0,-154,-106,-48
484,21,12,2,3,0,397,433,446,383,562,667,705,729,755,1158,815,410,612.0,794.0,-405,-343,-62
205,22,12,2,3,0,179,118,155,141,189,179,249,176,328,336,166,145,156.0,216.0,-21,-170,149
190,1,13,1,3,0,160,94,156,130,143,149,181,158,314,461,180,102,141.0,248.0,-78,-281,203
778,2,13,1,3,0,404,239,336,248,387,336,447,627,757,1396,1059,575,817.0,1010.0,-484,-337,-147
473,3,13,1,3,0,199,117,165,174,186,216,287,324,527,720,520,270,395.0,503.0,-250,-200,-50
162,4,13,1,3,0,157,85,99,100,137,177,237,199,242,487,101,86,94.0,225.0,-15,-386,371
1302,5,13,1,3,0,983,554,759,618,741,845,1263,1243,1605,2433,1860,1194,1527.0,1829.0,-666,-573,-93
878,6,13,1,3,0,594,483,561,546,651,840,1069,1269,1370,2298,1440,720,1080.0,1486.0,-720,-858,138
1504,7,13,1,3,0,625,585,723,768,927,999,1485,1686,2126,3804,2217,1109,1663.0,2377.0,-1108,-1587,479
591,8,13,1,3,0,272,166,255,224,271,379,496,642,748,1215,772,404,588.0,797.0,-368,-443,75
977,9,13,1,3,0,728,449,600,502,550,650,835,848,1467,2021,1040,446,743.0,1169.0,-594,-981,387
660,10,13,1,3,0,351,170,257,240,225,284,342,388,511,880,738,330,534.0,649.0,-408,-142,-266
1441,11,13,1,3,0,985,648,883,678,762,1001,1116,1451,1816,2525,1540,1130,1335.0,1732.0,-410,-985,575
598,12,13,1,3,0,443,270,410,377,409,440,725,733,889,1320,1015,377,696.0,904.0,-638,-305,-333
1456,13,13,1,3,0,634,487,781,785,958,1014,1437,1548,2026,3281,1882,1126,1504.0,2096.0,-756,-1399,643
1413,14,13,1,3,0,582,542,634,719,857,953,1313,1473,1843,2975,2324,1002,1663.0,2100.0,-1322,-651,-671
880,15,13,1,3,0,897,591,746,723,731,805,1089,1175,1502,2235,958,565,762.0,1253.0,-393,-1277,884
782,16,13,1,3,0,599,444,503,489,505,669,868,924,1339,1557,1148,463,806.0,1056.0,-685,-409,-276
733,17,13,1,3,0,488,309,371,399,407,438,633,772,835,1281,1235,439,837.0,985.0,-796,-46,-750
529,18,13,1,3,0,303,174,227,178,234,282,307,414,622,877,518,365,442.0,587.0,-153,-359,206
349,19,13,1,3,0,236,155,177,191,236,231,291,296,396,542,311,224,268.0,359.0,-87,-231,144
346,20,13,1,3,0,295,169,207,227,218,259,311,316,419,666,489,274,382.0,476.0,-215,-177,-38
463,21,13,1,3,0,283,202,287,271,303,362,519,627,715,1549,1036,394,715.0,993.0,-642,-513,-129
684,22,13,1,3,0,377,252,344,319,336,422,442,411,616,998,401,372,386.0,590.0,-29,-597,568
279,1,14,1,3,0,517,534,459,422,464,522,661,472,781,1047,423,192,308.0,554.0,-231,-624,393
631,2,14,1,3,0,894,856,985,706,939,877,1084,1148,1159,1879,1354,680,1017.0,1304.0,-674,-525,-149
566,3,14,1,3,0,457,492,583,433,551,578,725,701,941,1442,814,347,580.0,868.0,-467,-628,161
281,4,14,1,3,0,397,406,411,391,454,496,664,474,569,1295,274,176,225.0,582.0,-98,-1021,923
1111,5,14,1,3,0,1779,1892,1614,1306,1417,1488,2289,1556,2162,4188,2540,1081,1810.0,2603.0,-1459,-1648,189
893,6,14,1,3,0,1104,1361,1443,1295,1412,1803,1996,1889,2073,3650,2495,863,1679.0,2336.0,-1632,-1155,-477
2002,7,14,1,3,0,1781,2492,2580,2168,2583,2886,3461,3252,3594,6275,3467,1356,2412.0,3699.0,-2111,-2808,697
500,8,14,1,3,0,482,602,630,509,619,652,805,800,914,1576,743,357,550.0,892.0,-386,-833,447
1364,9,14,1,3,0,1659,1766,2201,1866,1837,2246,2808,2902,3269,4342,1784,653,1218.0,2260.0,-1131,-2558,1427
556,10,14,1,3,0,603,500,655,477,518,574,670,621,739,1316,892,381,636.0,863.0,-511,-424,-87
2316,11,14,1,3,0,2831,2838,3224,2468,2600,3230,3453,3560,3776,5864,3032,1760,2396.0,3552.0,-1272,-2832,1560
603,12,14,1,3,0,783,897,980,839,839,860,1325,1195,1285,2160,1579,453,1016.0,1397.0,-1126,-581,-545
1427,13,14,1,3,0,1287,1778,2039,1774,2024,2258,2481,2298,2594,4551,2375,1231,1803.0,2719.0,-1144,-2176,1032
1915,14,14,1,3,0,2034,2494,2508,2539,3103,3396,3571,3427,4047,8018,5309,1586,3448.0,4971.0,-3723,-2709,-1014
1161,15,14,1,3,0,1705,1980,2136,1905,1897,2229,2579,2724,3014,4336,1679,826,1252.0,2280.0,-853,-2657,1804
906,16,14,1,3,0,1237,1346,1186,1236,1304,1341,1747,1512,1848,3179,2049,551,1300.0,1926.0,-1498,-1130,-368
1157,17,14,1,3,0,1417,1610,1468,1450,1536,1679,2187,1872,2355,3747,2461,732,1596.0,2313.0,-1729,-1286,-443
463,18,14,1,3,0,549,639,683,519,626,618,738,859,1140,1306,596,364,480.0,755.0,-232,-710,478
765,19,14,1,3,0,737,900,949,846,1022,1132,1218,970,1188,1784,769,415,592.0,989.0,-354,-1015,661
399,20,14,1,3,0,596,660,656,695,635,655,770,622,761,1417,877,373,625.0,889.0,-504,-540,36
361,21,14,1,3,0,425,548,688,468,587,654,727,899,841,1546,1008,303,656.0,952.0,-705,-538,-167
604,22,14,1,3,0,638,624,692,573,663,777,675,517,944,1290,579,365,472.0,745.0,-214,-711,497
764,1,15,2,3,0,900,712,656,680,680,720,820,623,807,1293,851,433,642.0,859.0,-418,-442,24
415,2,15,2,3,0,271,184,252,242,468,405,456,394,535,639,509,300,404.0,483.0,-209,-130,-79
556,3,15,2,3,0,342,266,364,340,407,480,482,477,451,580,494,276,385.0,450.0,-218,-86,-132
1308,4,15,2,3,0,1376,1000,1124,1019,1062,1143,1276,969,1288,2146,1327,923,1125.0,1465.0,-404,-819,415
680,5,15,2,3,0,541,447,452,487,585,715,1123,634,781,1105,856,454,655.0,805.0,-402,-249,-153
644,6,15,2,3,0,554,507,478,422,472,667,840,774,803,1070,953,364,658.0,796.0,-589,-117,-472
1244,7,15,2,3,0,1035,932,915,988,988,1162,1315,1224,1513,1837,1329,778,1054.0,1315.0,-551,-508,-43
746,8,15,2,3,0,679,602,669,598,604,750,729,770,798,1203,945,474,710.0,874.0,-471,-258,-213
427,9,15,2,3,0,313,221,266,335,313,351,438,425,536,825,423,180,302.0,476.0,-243,-402,159
140,10,15,2,3,0,156,79,110,114,93,121,141,135,160,243,179,71,125.0,164.0,-108,-64,-44
1565,11,15,2,3,0,1350,1122,1198,1215,1276,1793,1838,1848,1951,2643,1820,1058,1439.0,1840.0,-762,-823,61
325,12,15,2,3,0,355,293,295,274,321,334,419,377,424,571,408,151,280.0,377.0,-257,-163,-94
1377,13,15,2,3,0,1063,923,1024,961,977,1321,1377,1264,1433,1923,1604,884,1244.0,1470.0,-720,-319,-401
1003,14,15,2,3,0,827,723,780,738,834,1010,1081,952,1113,1482,1178,548,863.0,1069.0,-630,-304,-326
679,15,15,2,3,0,577,432,444,464,536,601,733,722,894,1112,767,352,560.0,744.0,-415,-345,-70
271,16,15,2,3,0,258,236,284,317,260,295,373,329,377,483,446,164,305.0,364.0,-282,-37,-245
452,17,15,2,3,0,403,317,301,333,339,383,464,438,477,783,487,262,374.0,511.0,-225,-296,71
227,18,15,2,3,0,321,213,189,158,212,189,235,212,345,456,397,140,268.0,331.0,-257,-59,-198
356,19,15,2,3,0,216,236,253,279,277,296,261,247,251,310,270,165,218.0,248.0,-105,-40,-65
408,20,15,2,3,0,369,328,342,482,408,414,486,426,491,644,555,263,409.0,487.0,-292,-89,-203
603,21,15,2,3,0,439,293,395,348,388,413,568,617,622,758,719,361,540.0,613.0,-358,-39,-319
149,22,15,2,3,0,156,121,150,115,124,187,159,142,152,169,104,79,92.0,117.0,-25,-65,40
86,1,16,2,3,0,64,37,32,39,46,46,41,395,67,117,63,37,50.0,72.0,-26,-54,28
1035,2,16,2,3,0,1431,1186,1072,971,1395,1426,1254,988,1142,1590,946,692,819.0,1076.0,-254,-644,390
714,3,16,2,3,0,769,698,895,690,744,864,895,802,945,982,602,413,508.0,666.0,-189,-380,191
404,4,16,2,3,0,982,803,698,717,716,794,737,477,625,985,300,271,286.0,519.0,-29,-685,656
3175,5,16,2,3,0,2758,2537,2734,2651,2620,2791,2955,1733,2221,3340,1470,1639,1554.0,2150.0,169,-1870,2039
384,6,16,2,3,0,581,410,402,479,502,552,488,424,410,575,248,260,254.0,361.0,12,-327,339
2748,7,16,2,3,0,3709,3356,3511,2812,3126,3130,3837,3617,3662,4024,1903,1708,1806.0,2545.0,-195,-2121,1926
672,8,16,2,3,0,1176,933,1057,828,993,1217,1561,1243,1188,1616,679,442,560.0,912.0,-237,-937,700
2249,9,16,2,3,0,1889,1775,1785,1654,1766,1963,2010,1906,2111,2398,1196,1075,1136.0,1556.0,-121,-1202,1081
449,10,16,2,3,0,462,403,353,331,405,319,409,384,459,435,440,301,370.0,392.0,-139,5,-144
655,11,16,2,3,0,942,753,875,786,701,745,840,781,777,930,527,626,576.0,694.0,99,-403,502
356,12,16,2,3,0,379,339,330,292,330,358,538,488,482,540,354,189,272.0,361.0,-165,-186,21
2633,13,16,2,3,0,3367,3025,3349,3221,3102,3388,3910,3483,3233,4206,2068,1780,1924.0,2685.0,-288,-2138,1850
1823,14,16,2,3,0,2093,1984,2022,1974,2200,2100,2323,1931,2018,2962,1570,1050,1310.0,1861.0,-520,-1392,872
628,15,16,2,3,0,837,836,827,820,769,777,723,606,634,886,424,422,423.0,577.0,-2,-462,460
442,16,16,2,3,0,867,611,610,623,595,715,725,585,544,920,483,270,376.0,558.0,-213,-437,224
1232,17,16,2,3,0,2020,1616,1475,1358,1456,1533,1680,1444,1489,2336,1714,653,1184.0,1568.0,-1061,-622,-439
460,18,16,2,3,0,657,579,484,487,627,773,710,690,597,622,308,292,300.0,407.0,-16,-314,298
1319,19,16,2,3,0,1439,1484,1508,1498,1804,1815,1871,1308,1478,1878,681,691,686.0,1083.0,10,-1197,1207
125,20,16,2,3,0,284,211,204,370,530,502,347,184,172,247,131,105,118.0,161.0,-26,-116,90
605,21,16,2,3,0,771,729,604,479,874,1106,695,580,634,1051,558,384,471.0,664.0,-174,-493,319
1556,22,16,2,3,0,1914,1499,1291,1253,1193,1427,1562,1308,1636,1781,730,952,841.0,1154.0,222,-1051,1273
2672,1,17,2,3,0,2243,2672,2922,2462,1180,1500,2397,1674,2362,3060,1909,501,1205.0,1823.0,-1408,-1151,-257
651,2,17,2,3,0,707,630,647,551,884,974,1076,1038,1033,1402,656,504,580.0,854.0,-152,-746,594
376,3,17,2,3,0,525,430,507,344,410,446,541,468,630,827,268,214,241.0,436.0,-54,-559,505
2331,4,17,2,3,0,2808,1941,2551,971,995,1118,835,516,1494,2145,217,200,208.0,854.0,-17,-1928,1911
1478,5,17,2,3,0,2143,1834,1543,1533,1662,1864,2707,1708,2119,2450,1355,937,1146.0,1581.0,-418,-1095,677
1436,6,17,2,3,0,1764,1722,1828,1799,2028,2809,2863,2529,2927,3132,1460,775,1118.0,1789.0,-685,-1672,987
2010,7,17,2,3,0,3115,3589,3471,2715,3147,4018,4409,4129,4087,5401,1885,1225,1555.0,2837.0,-660,-3516,2856
877,8,17,2,3,0,1146,1022,1337,977,1223,1490,1510,1452,1547,2066,692,491,592.0,1083.0,-201,-1374,1173
1475,9,17,2,3,0,2905,1816,1983,1796,1715,2112,2192,2036,2188,2519,625,462,544.0,1202.0,-163,-1894,1731
366,10,17,2,3,0,549,377,518,379,413,503,589,568,596,616,308,176,242.0,367.0,-132,-308,176
2644,11,17,2,3,0,3990,3393,3757,3219,3369,4854,5016,4475,5007,5643,2143,1862,2002.0,3216.0,-281,-3500,3219
916,12,17,2,3,0,1305,1276,1370,1233,1308,1681,2044,1627,1981,2357,973,442,708.0,1257.0,-531,-1384,853
2043,13,17,2,3,0,2484,2675,3198,2587,2964,3829,3951,3277,3711,5424,1723,1261,1492.0,2803.0,-462,-3701,3239
2429,14,17,2,3,0,2442,2757,2736,2702,3421,4398,4500,3793,4237,5119,2463,1238,1850.0,2940.0,-1225,-2656,1431
1359,15,17,2,3,0,2050,1853,2092,1953,2021,2513,2777,2324,2401,2755,895,768,832.0,1473.0,-127,-1860,1733
841,16,17,2,3,0,1381,1205,1158,1213,1120,1591,1818,1296,1466,1985,1002,357,680.0,1115.0,-645,-983,338
1104,17,17,2,3,0,1689,1645,1561,1517,1583,1906,2187,1670,2078,2533,1085,531,808.0,1383.0,-554,-1448,894
775,18,17,2,3,0,1142,977,1082,843,1055,1347,1279,1170,1218,1549,440,400,420.0,796.0,-40,-1109,1069
386,19,17,2,3,0,781,766,859,586,702,806,897,700,869,1098,268,212,240.0,526.0,-56,-830,774
603,20,17,2,3,0,936,946,870,1013,987,1230,1171,824,938,1120,617,359,488.0,699.0,-258,-503,245
661,21,17,2,3,0,869,1036,1284,861,1113,1278,1300,1165,1199,1748,631,397,514.0,925.0,-234,-1117,883
276,22,17,2,3,0,484,451,421,327,303,404,404,286,466,480,162,156,159.0,266.0,-6,-318,312
767,1,18,2,3,0,906,709,759,629,425,535,502,314,574,754,315,362,338.0,477.0,47,-439,486
448,2,18,2,3,0,500,421,595,461,551,450,435,635,692,866,452,295,374.0,538.0,-157,-414,257
591,3,18,2,3,0,577,507,561,440,380,452,427,495,612,941,427,254,340.0,541.0,-173,-514,341
159,4,18,2,3,0,482,498,353,301,382,397,346,199,341,546,125,89,107.0,253.0,-36,-421,385
1344,5,18,2,3,0,1444,1326,1270,1055,1379,1197,903,838,1187,1812,1017,704,860.0,1178.0,-313,-795,482
869,6,18,2,3,0,1184,1065,1021,869,1109,958,734,813,952,1669,741,475,608.0,962.0,-266,-928,662
2865,7,18,2,3,0,3780,3634,3404,2787,3450,3299,2451,2995,3812,5496,2330,1515,1922.0,3114.0,-815,-3166,2351
1247,8,18,2,3,0,1482,1678,1725,1270,1462,1588,1052,1126,1234,2626,1165,641,903.0,1477.0,-524,-1461,937
433,9,18,2,3,0,510,397,473,460,457,448,529,384,525,1055,368,255,312.0,559.0,-113,-687,574
240,10,18,2,3,0,461,182,302,352,363,291,255,362,355,448,365,155,260.0,323.0,-210,-83,-127
1507,11,18,2,3,0,1639,1304,1178,1368,1353,1085,864,1310,1728,2261,1167,1028,1098.0,1485.0,-139,-1094,955
316,12,18,2,3,0,492,421,412,315,365,335,301,356,946,847,641,223,432.0,570.0,-418,-206,-212
2981,13,18,2,3,0,2946,3004,3190,2715,3210,3609,2265,2586,3058,5478,1932,1551,1742.0,2987.0,-381,-3546,3165
1695,14,18,2,3,0,1920,1867,1905,1469,1701,1452,1141,1472,1941,3092,1731,893,1312.0,1905.0,-838,-1361,523
741,15,18,2,3,0,1342,916,1100,1016,1000,913,659,638,706,1205,504,467,486.0,725.0,-37,-701,664
273,16,18,2,3,0,433,470,347,353,277,263,202,272,348,657,298,154,226.0,370.0,-144,-359,215
448,17,18,2,3,0,989,827,849,769,962,701,698,568,587,1351,576,253,414.0,727.0,-323,-775,452
255,18,18,2,3,0,369,321,335,225,356,355,342,307,452,617,215,148,182.0,327.0,-67,-402,335
768,19,18,2,3,0,979,733,783,589,621,716,684,572,853,1026,394,408,401.0,609.0,14,-632,646
346,20,18,2,3,0,549,493,497,413,558,474,304,408,379,694,353,248,300.0,432.0,-105,-341,236
791,21,18,2,3,0,608,683,599,723,667,832,623,693,804,1400,754,418,586.0,857.0,-336,-646,310
503,22,18,2,3,0,532,645,383,283,369,508,307,324,496,710,280,266,273.0,419.0,-14,-430,416
321,1,19,2,3,0,289,246,249,228,201,232,150,148,312,359,339,177,258.0,292.0,-162,-20,-142
357,2,19,2,3,0,264,283,346,330,388,290,304,344,442,485,409,248,328.0,381.0,-161,-76,-85
522,3,19,2,3,0,236,276,395,262,398,348,325,432,401,434,519,319,419.0,424.0,-200,85,-285
1267,4,19,2,3,0,1252,1112,1156,1039,990,1183,1150,795,1121,1802,1263,877,1070.0,1314.0,-386,-539,153
951,5,19,2,3,0,639,702,679,596,623,519,741,610,732,1083,1390,565,978.0,1013.0,-825,307,-1132
471,6,19,2,3,0,335,339,414,403,381,360,323,440,519,629,667,315,491.0,537.0,-352,38,-390
1578,7,19,2,3,0,1162,1362,1499,1162,1256,1311,1391,1370,1666,1642,1861,878,1370.0,1460.0,-983,219,-1202
451,8,19,2,3,0,381,342,380,264,316,332,330,480,421,414,426,317,372.0,386.0,-109,12,-121
827,9,19,2,3,0,499,400,553,537,509,516,523,704,995,1243,727,322,524.0,764.0,-405,-516,111
204,10,19,2,3,0,100,87,113,102,97,101,156,159,192,214,225,119,172.0,186.0,-106,11,-117
1301,11,19,2,3,0,1051,1024,1236,925,785,871,1280,881,1099,1374,1336,868,1102.0,1193.0,-468,-38,-430
291,12,19,2,3,0,198,208,246,191,199,169,178,237,276,329,364,141,252.0,278.0,-223,35,-258
1697,13,19,2,3,0,1322,1150,1563,1391,1238,1360,1115,1052,1461,1615,1768,1165,1466.0,1516.0,-603,153,-756
1325,14,19,2,3,0,792,984,996,913,957,1047,1104,1357,1223,1443,1429,856,1142.0,1243.0,-573,-14,-559
707,15,19,2,3,0,485,482,592,492,475,404,404,512,747,863,742,356,549.0,654.0,-386,-121,-265
443,16,19,2,3,0,350,350,345,337,298,379,393,374,473,566,558,262,410.0,462.0,-296,-8,-288
424,17,19,2,3,0,301,261,307,277,273,291,253,248,418,494,519,230,374.0,414.0,-289,25,-314
330,18,19,2,3,0,288,229,307,216,229,183,186,285,325,402,404,188,296.0,331.0,-216,2,-218
870,19,19,2,3,0,566,616,593,769,652,721,569,738,644,1082,704,546,625.0,777.0,-158,-378,220
335,20,19,2,3,0,224,260,274,314,254,213,262,251,282,391,433,202,318.0,342.0,-231,42,-273
378,21,19,2,3,0,273,411,522,312,356,360,419,276,346,497,487,257,372.0,414.0,-230,-10,-220
1198,22,19,2,3,0,986,775,794,828,639,929,731,657,664,964,785,666,726.0,805.0,-119,-179,60
731,1,20,1,3,0,1144,987,982,1141,897,946,1150,1010,1563,1504,815,447,631.0,922.0,-368,-689,321
403,2,20,1,3,0,491,429,522,373,681,595,570,759,692,785,585,277,431.0,549.0,-308,-200,-108
229,3,20,1,3,0,204,243,365,254,296,333,327,407,342,430,303,110,206.0,281.0,-193,-127,-66
427,4,20,1,3,0,672,745,768,998,675,772,925,740,925,1127,376,284,330.0,596.0,-92,-751,659
764,5,20,1,3,0,913,980,978,903,990,1085,1885,1100,1320,1775,1096,562,829.0,1144.0,-534,-679,145
600,6,20,1,3,0,798,764,823,725,769,980,1023,1001,1064,1490,952,364,658.0,935.0,-588,-538,-50
805,7,20,1,3,0,940,1108,1210,1082,1134,1323,1432,1303,1408,1739,940,501,720.0,1060.0,-439,-799,360
151,8,20,1,3,0,312,291,326,221,257,295,289,333,332,371,229,113,171.0,238.0,-116,-142,26
986,9,20,1,3,0,1174,995,1269,1114,1097,1195,1320,1463,1644,2216,854,451,652.0,1174.0,-403,-1362,959
237,10,20,1,3,0,246,212,277,223,187,218,240,280,255,372,218,114,166.0,235.0,-104,-154,50
1345,11,20,1,3,0,1686,1487,1639,1433,1571,1947,1897,1872,2263,3132,1586,987,1286.0,1902.0,-599,-1546,947
498,12,20,1,3,0,671,722,759,661,681,684,855,798,870,1144,754,284,519.0,727.0,-470,-390,-80
599,13,20,1,3,0,776,716,788,622,676,985,861,883,944,1218,652,442,547.0,771.0,-210,-566,356
700,14,20,1,3,0,810,959,936,866,965,1056,1067,1021,1121,1578,856,471,664.0,968.0,-385,-722,337
1369,15,20,1,3,0,1880,1823,1961,1826,1921,2037,2367,2323,2703,3371,1749,893,1321.0,2004.0,-856,-1622,766
579,16,20,1,3,0,746,751,751,798,730,829,920,1033,988,1333,941,363,652.0,879.0,-578,-392,-186
716,17,20,1,3,0,798,869,852,770,811,908,1056,973,1081,1561,1003,386,694.0,983.0,-617,-558,-59
551,18,20,1,3,0,744,580,799,587,681,684,714,853,905,1102,667,370,518.0,713.0,-297,-435,138
258,19,20,1,3,0,302,339,376,332,444,478,491,437,403,555,253,188,220.0,332.0,-65,-302,237
293,20,20,1,3,0,388,450,403,448,421,422,477,428,496,740,452,184,318.0,459.0,-268,-288,20
292,21,20,1,3,0,327,347,397,335,338,351,433,450,479,533,395,223,309.0,384.0,-172,-138,-34
281,22,20,1,3,0,415,369,422,399,362,461,359,320,352,428,213,219,216.0,287.0,6,-215,221
396,1,21,2,3,0,494,480,438,464,464,563,552,450,685,688,275,231,253.0,398.0,-44,-413,369
443,2,21,2,3,0,551,494,611,509,837,743,640,687,714,1001,409,321,365.0,577.0,-88,-592,504
440,3,21,2,3,0,409,555,665,393,509,544,557,650,671,789,370,239,304.0,466.0,-131,-419,288
619,4,21,2,3,0,1236,1175,1102,1018,1021,1288,1431,1045,1332,1807,402,360,381.0,856.0,-42,-1405,1363
1523,5,21,2,3,0,1972,2107,1866,1748,1887,2009,2921,2017,2913,3590,1589,1106,1348.0,2095.0,-483,-2001,1518
995,6,21,2,3,0,1041,1182,1170,1110,1307,1431,1596,1491,1717,1968,921,593,757.0,1161.0,-328,-1047,719
1856,7,21,2,3,0,2092,2449,2486,1895,2003,2387,2615,2547,2776,3299,1329,945,1137.0,1858.0,-384,-1970,1586
510,8,21,2,3,0,673,634,789,589,641,800,787,813,782,1130,401,261,331.0,597.0,-140,-729,589
1081,9,21,2,3,0,1264,996,1286,1093,1029,1303,1438,1702,2171,2397,475,354,414.0,1075.0,-121,-1922,1801
348,10,21,2,3,0,369,263,323,295,287,282,358,395,493,595,225,179,202.0,333.0,-46,-370,324
2234,11,21,2,3,0,2786,2473,3080,2334,2394,3107,2962,3228,3579,4302,1623,1477,1550.0,2467.0,-146,-2679,2533
537,12,21,2,3,0,491,598,657,503,672,641,755,781,885,1016,398,230,314.0,548.0,-168,-618,450
2239,13,21,2,3,0,2330,2475,2921,2392,2559,2979,2860,2877,2989,3954,1565,1311,1438.0,2277.0,-254,-2389,2135
1684,14,21,2,3,0,1587,2122,1817,1841,2115,2398,2493,2358,2638,3291,1489,872,1180.0,1884.0,-617,-1802,1185
1491,15,21,2,3,0,1688,1755,1827,1550,1572,1914,1992,2163,2458,2897,961,793,877.0,1550.0,-168,-1936,1768
634,16,21,2,3,0,870,703,828,848,789,996,1142,948,1247,1304,805,357,581.0,822.0,-448,-499,51
565,17,21,2,3,0,710,632,689,696,720,817,950,757,948,1222,427,264,346.0,638.0,-163,-795,632
518,18,21,2,3,0,669,569,777,495,680,640,694,837,946,924,385,327,356.0,545.0,-58,-539,481
828,19,21,2,3,0,985,1021,1093,717,904,1088,1057,1007,1160,1513,414,423,418.0,783.0,9,-1099,1108
288,20,21,2,3,0,312,317,246,378,375,374,365,407,493,612,296,209,252.0,372.0,-87,-316,229
410,21,21,2,3,0,582,607,926,472,701,761,801,945,946,1143,404,239,322.0,595.0,-165,-739,574
1058,22,21,2,3,0,987,974,825,774,757,1154,914,753,1190,1198,462,436,449.0,699.0,-26,-736,710
653,1,22,4,3,0,778,523,603,553,600,670,690,633,790,925,325,455,390.0,568.0,130,-600,730
317,2,22,4,3,0,415,322,387,317,493,447,408,431,527,546,194,218,206.0,319.0,24,-352,376
287,3,22,4,3,0,300,265,350,301,313,341,355,371,359,418,168,163,166.0,250.0,-5,-250,245
831,4,22,4,3,0,1017,846,916,826,879,911,1074,915,1162,1615,471,523,497.0,870.0,52,-1144,1196
738,5,22,4,3,0,879,706,738,715,745,722,1155,772,961,1167,445,516,480.0,709.0,71,-722,793
658,6,22,4,3,0,675,647,692,656,677,767,841,878,933,1003,374,418,396.0,598.0,44,-629,673
1739,7,22,4,3,0,1928,1822,1978,1685,1638,1852,2308,2307,2370,2766,875,984,930.0,1542.0,109,-1891,2000
247,8,22,4,3,0,314,241,352,275,285,300,313,320,355,484,139,184,162.0,269.0,45,-345,390
896,9,22,4,3,0,1042,810,979,912,937,951,992,1092,1209,1464,402,402,402.0,756.0,0,-1062,1062
224,10,22,4,3,0,288,186,265,233,260,262,246,259,290,384,118,109,114.0,204.0,-9,-266,257
2234,11,22,4,3,0,2488,1949,2522,2016,2112,2209,2679,2595,2801,3241,1057,1612,1334.0,1970.0,555,-2184,2739
385,12,22,4,3,0,434,361,405,347,434,393,442,498,481,511,213,176,194.0,300.0,-37,-298,261
1533,13,22,4,3,0,1561,1277,1469,1298,1298,1461,1525,1603,1929,2115,754,885,820.0,1251.0,131,-1361,1492
1200,14,22,4,3,0,1090,1137,1026,959,1096,1283,1383,1309,1461,1740,591,724,658.0,1018.0,133,-1149,1282
1764,15,22,4,3,0,1999,1632,1956,1671,1999,1697,1991,2033,2127,2662,818,1237,1028.0,1572.0,419,-1844,2263
470,16,22,4,3,0,537,473,508,574,499,596,611,603,616,685,305,279,292.0,423.0,-26,-380,354
497,17,22,4,3,0,575,412,494,442,503,514,645,501,559,768,256,278,267.0,434.0,22,-512,534
389,18,22,4,3,0,512,409,530,373,503,451,397,473,480,608,216,257,236.0,360.0,41,-392,433
412,19,22,4,3,0,558,476,514,420,483,505,553,489,516,595,169,217,193.0,327.0,48,-426,474
133,20,22,4,3,0,156,120,135,198,189,145,189,159,216,258,69,99,84.0,142.0,30,-189,219
361,21,22,4,3,0,468,393,540,321,402,487,425,510,487,657,185,238,212.0,360.0,53,-472,525
535,22,22,4,3,0,628,493,470,454,420,611,511,443,413,533,157,228,192.0,306.0,71,-376,447
45,1,23,1,3,0,117,123,63,113,83,134,126,104,114,215,76,41,58.0,111.0,-35,-139,104
34,2,23,1,3,0,114,92,106,89,141,121,133,139,121,182,95,41,68.0,106.0,-54,-87,33
95,3,23,1,3,0,123,107,124,111,114,92,121,108,174,205,99,66,82.0,123.0,-33,-106,73
54,4,23,1,3,0,234,172,132,149,201,202,250,161,243,439,74,40,57.0,184.0,-34,-365,331
136,5,23,1,3,0,328,331,262,301,284,317,459,291,297,513,309,153,231.0,325.0,-156,-204,48
312,6,23,1,3,0,680,514,529,526,633,733,655,600,692,1047,578,273,426.0,633.0,-305,-469,164
538,7,23,1,3,0,802,922,771,855,1000,1063,1138,1097,1099,1844,902,381,642.0,1042.0,-521,-942,421
237,8,23,1,3,0,155,211,195,143,212,261,250,277,308,545,238,158,198.0,314.0,-80,-307,227
118,9,23,1,3,0,154,162,145,223,291,295,282,277,289,373,126,71,98.0,190.0,-55,-247,192
69,10,23,1,3,0,97,54,71,100,108,107,108,100,115,162,93,53,73.0,103.0,-40,-69,29
197,11,23,1,3,0,454,332,411,403,402,461,370,406,397,621,300,168,234.0,363.0,-132,-321,189
61,12,23,1,3,0,101,96,91,121,141,112,150,164,143,266,151,36,94.0,151.0,-115,-115,0
430,13,23,1,3,0,620,514,537,455,575,645,742,699,808,1460,748,389,568.0,866.0,-359,-712,353
251,14,23,1,3,0,298,313,364,453,477,544,566,471,617,1100,524,174,349.0,599.0,-350,-576,226
63,15,23,1,3,0,158,153,145,161,194,181,198,211,191,260,101,55,78.0,139.0,-46,-159,113
103,16,23,1,3,0,211,178,180,285,274,266,326,324,313,534,275,79,177.0,296.0,-196,-259,63
163,17,23,1,3,0,247,217,180,205,282,273,347,286,335,535,308,119,214.0,321.0,-189,-227,38
51,18,23,1,3,0,82,56,58,88,101,114,102,89,87,129,60,25,42.0,71.0,-35,-69,34
133,19,23,1,3,0,279,252,262,234,252,331,280,278,265,371,149,91,120.0,204.0,-58,-222,164
69,20,23,1,3,0,178,190,138,222,247,251,250,189,199,335,168,84,126.0,196.0,-84,-167,83
83,21,23,1,3,0,118,112,151,113,180,161,167,197,186,360,209,62,136.0,210.0,-147,-151,4
154,22,23,1,3,0,215,165,177,206,165,264,248,169,223,312,126,95,110.0,178.0,-31,-186,155
731,1,24,2,3,0,554,507,485,527,653,687,651,489,558,362,679,494,586.0,512.0,-185,317,-502
223,2,24,2,3,0,174,151,202,185,247,209,201,174,160,155,229,130,180.0,171.0,-99,74,-173
136,3,24,2,3,0,90,76,95,106,108,130,97,99,82,59,106,63,84.0,76.0,-43,47,-90
838,4,24,2,3,0,733,545,566,646,748,847,831,642,654,521,798,532,665.0,617.0,-266,277,-543
653,5,24,2,3,0,439,421,431,486,460,559,615,471,430,474,703,394,548.0,524.0,-309,229,-538
372,6,24,2,3,0,198,252,223,244,244,344,348,248,228,187,338,203,270.0,243.0,-135,151,-286
607,7,24,2,3,0,412,457,437,443,584,549,525,474,421,353,610,362,486.0,442.0,-248,257,-505
160,8,24,2,3,0,112,93,114,101,121,154,121,105,117,105,129,94,112.0,109.0,-35,24,-59
1361,9,24,2,3,0,1124,891,1008,1160,1083,1238,1180,1049,976,1007,1207,847,1027.0,1020.0,-360,200,-560
172,10,24,2,3,0,133,79,114,129,142,161,151,126,138,119,159,102,130.0,127.0,-57,40,-97
1713,11,24,2,3,0,1400,1291,1323,1469,1509,1821,1585,1270,1186,1077,1735,1066,1400.0,1293.0,-669,658,-1327
291,12,24,2,3,0,153,158,177,165,198,224,232,164,154,152,242,146,194.0,180.0,-96,90,-186
360,13,24,2,3,0,239,297,312,337,350,330,362,307,254,182,340,242,291.0,255.0,-98,158,-256
311,14,24,2,3,0,301,358,277,291,353,389,339,239,284,223,320,199,260.0,247.0,-121,97,-218
1602,15,24,2,3,0,1150,1124,1121,1210,1486,1568,1439,1239,1136,1024,1529,973,1251.0,1175.0,-556,505,-1061
369,16,24,2,3,0,276,286,265,300,346,383,407,272,273,274,370,238,304.0,294.0,-132,96,-228
346,17,24,2,3,0,209,229,207,229,257,270,285,213,205,215,305,186,246.0,235.0,-119,90,-209
572,18,24,2,3,0,331,340,375,354,394,437,448,353,321,324,518,242,380.0,361.0,-276,194,-470
321,19,24,2,3,0,206,234,226,254,291,346,299,229,207,174,292,205,248.0,224.0,-87,118,-205
277,20,24,2,3,0,226,204,204,232,259,222,255,197,217,217,267,199,233.0,228.0,-68,50,-118
281,21,24,2,3,0,192,213,288,241,238,319,283,263,205,197,285,151,218.0,211.0,-134,88,-222
133,22,24,2,3,0,74,80,87,80,75,119,71,81,63,53,93,68,80.0,71.0,-25,40,-65
297,1,25,1,3,0,397,283,308,272,297,303,281,281,247,225,315,160,238.0,233.0,-155,90,-245
164,2,25,1,3,0,159,143,175,143,190,187,165,167,133,176,164,108,136.0,149.0,-56,-12,-44
103,3,25,1,3,0,91,82,115,109,112,117,120,96,85,86,86,62,74.0,78.0,-24,0,-24
356,4,25,1,3,0,428,353,385,362,331,427,429,308,324,417,323,190,256.0,310.0,-133,-94,-39
411,5,25,1,3,0,376,344,382,380,359,376,389,305,301,337,483,166,324.0,329.0,-317,146,-463
173,6,25,1,3,0,169,162,175,187,156,227,205,162,169,174,188,119,154.0,160.0,-69,14,-83
306,7,25,1,3,0,290,276,307,309,263,302,292,265,227,253,339,160,250.0,251.0,-179,86,-265
97,8,25,1,3,0,77,59,95,91,82,103,99,83,81,91,111,56,84.0,86.0,-55,20,-75
531,9,25,1,3,0,629,501,543,522,480,565,575,462,510,512,581,314,448.0,469.0,-267,69,-336
103,10,25,1,3,0,86,103,113,124,96,117,108,102,103,109,128,57,92.0,98.0,-71,19,-90
741,11,25,1,3,0,831,673,752,698,733,823,757,642,661,734,807,456,632.0,666.0,-351,73,-424
158,12,25,1,3,0,143,134,157,139,120,153,155,115,129,138,165,79,122.0,127.0,-86,27,-113
201,13,25,1,3,0,201,188,230,197,195,219,226,184,180,178,203,126,164.0,169.0,-77,25,-102
191,14,25,1,3,0,163,205,180,189,189,186,187,161,189,173,186,103,144.0,154.0,-83,13,-96
738,15,25,1,3,0,696,636,660,565,645,709,620,587,599,595,656,382,519.0,544.0,-274,61,-335
257,16,25,1,3,0,282,230,266,292,242,319,331,219,258,266,270,142,206.0,226.0,-128,4,-132
205,17,25,1,3,0,191,206,200,169,164,219,179,160,168,191,210,114,162.0,172.0,-96,19,-115
267,18,25,1,3,0,246,219,230,256,240,260,259,202,201,205,241,127,184.0,191.0,-114,36,-150
113,19,25,1,3,0,157,166,150,154,152,161,165,130,138,128,140,90,115.0,119.0,-50,12,-62
117,20,25,1,3,0,152,134,144,142,148,158,109,123,106,134,131,54,92.0,106.0,-77,-3,-74
142,21,25,1,3,0,156,163,199,168,161,205,192,172,135,145,159,85,122.0,130.0,-74,14,-88
78,22,25,1,3,0,84,72,91,70,67,99,74,50,53,61,68,34,51.0,54.0,-34,7,-41
592,1,26,1,3,0,461,355,455,551,438,559,478,428,493,474,835,424,630.0,578.0,-411,361,-772
234,2,26,1,3,0,197,123,203,222,190,240,237,204,210,215,310,178,244.0,234.0,-132,95,-227
116,3,26,1,3,0,85,62,91,81,74,115,91,72,82,74,139,87,113.0,100.0,-52,65,-117
841,4,26,1,3,0,597,509,573,717,674,824,853,604,747,817,1033,648,840.0,833.0,-385,216,-601
524,5,26,1,3,0,377,334,442,494,344,458,388,382,361,382,695,383,539.0,487.0,-312,313,-625
225,6,26,1,3,0,164,138,167,188,148,226,228,183,176,177,354,152,253.0,228.0,-202,177,-379
530,7,26,1,3,0,286,259,291,346,365,453,344,338,348,336,608,328,468.0,424.0,-280,272,-552
130,8,26,1,3,0,78,95,88,102,105,108,108,84,93,100,165,96,130.0,120.0,-69,65,-134
1101,9,26,1,3,0,866,560,678,769,689,886,875,627,766,825,1178,690,934.0,898.0,-488,353,-841
163,10,26,1,3,0,91,57,97,100,90,105,124,72,100,114,160,106,133.0,127.0,-54,46,-100
1115,11,26,1,3,0,787,801,890,962,857,1124,918,791,915,1007,1591,766,1178.0,1121.0,-825,584,-1409
167,12,26,1,3,0,129,99,112,125,115,140,155,101,129,108,227,115,171.0,150.0,-112,119,-231
316,13,26,1,3,0,173,183,199,229,221,266,200,202,203,219,376,209,292.0,268.0,-167,157,-324
287,14,26,1,3,0,193,185,185,207,254,276,252,194,283,262,357,201,279.0,273.0,-156,95,-251
970,15,26,1,3,0,716,641,723,810,824,880,834,733,849,908,1436,623,1030.0,989.0,-813,528,-1341
366,16,26,1,3,0,265,212,243,260,260,327,326,230,315,356,436,202,319.0,331.0,-234,80,-314
246,17,26,1,3,0,152,121,164,200,157,190,184,143,174,192,302,179,240.0,224.0,-123,110,-233
338,18,26,1,3,0,238,208,225,265,234,296,266,197,227,256,500,212,356.0,323.0,-288,244,-532
286,19,26,1,3,0,170,172,190,254,215,281,225,176,194,227,304,176,240.0,236.0,-128,77,-205
205,20,26,1,3,0,138,114,168,164,192,184,176,151,174,194,265,152,208.0,204.0,-113,71,-184
222,21,26,1,3,0,184,186,174,206,235,213,228,210,194,216,307,140,224.0,221.0,-167,91,-258
125,22,26,1,3,0,69,62,72,97,59,106,77,74,83,85,102,84,93.0,90.0,-18,17,-35
160,1,27,4,3,0,185,166,151,149,152,203,190,188,201,262,80,97,88.0,146.0,17,-182,199
34,2,27,4,3,0,65,81,86,43,35,60,52,76,100,59,26,35,30.0,40.0,9,-33,42
26,3,27,4,3,0,44,34,38,23,35,33,31,42,40,37,22,17,20.0,25.0,-5,-15,10
153,4,27,4,3,0,251,267,259,192,172,203,232,200,230,226,93,117,105.0,145.0,24,-133,157
90,5,27,4,3,0,155,124,131,94,121,152,216,166,240,223,57,76,66.0,119.0,19,-166,185
72,6,27,4,3,0,93,91,91,85,90,104,106,110,130,121,57,59,58.0,79.0,2,-64,66
218,7,27,4,3,0,238,273,264,203,199,232,258,215,231,199,113,137,125.0,150.0,24,-86,110
28,8,27,4,3,0,30,23,35,28,32,37,31,31,28,33,16,10,13.0,20.0,-6,-17,11
231,9,27,4,3,0,239,207,253,209,182,223,290,309,396,384,120,115,118.0,206.0,-5,-264,259
18,10,27,4,3,0,29,21,31,23,25,29,35,34,41,40,20,18,19.0,26.0,-2,-20,18
414,11,27,4,3,0,442,327,438,345,389,471,447,420,635,591,225,325,275.0,380.0,100,-366,466
37,12,27,4,3,0,37,44,50,31,41,43,50,52,66,85,10,18,14.0,38.0,8,-75,83
131,13,27,4,3,0,128,105,161,119,127,130,145,141,166,161,78,99,88.0,113.0,21,-83,104
90,14,27,4,3,0,126,107,118,88,93,86,118,117,128,163,57,77,67.0,99.0,20,-106,126
344,15,27,4,3,0,423,431,415,297,361,382,415,422,523,567,168,290,229.0,342.0,122,-399,521
76,16,27,4,3,0,96,72,86,72,79,106,110,92,120,142,48,54,51.0,81.0,6,-94,100
61,17,27,4,3,0,74,84,62,48,45,64,96,79,112,124,41,43,42.0,69.0,2,-83,85
50,18,27,4,3,0,60,68,83,59,50,84,61,85,108,127,23,28,26.0,59.0,5,-104,109
67,19,27,4,3,0,101,79,77,61,82,88,87,77,106,83,28,38,33.0,50.0,10,-55,65
19,20,27,4,3,0,40,35,34,28,26,35,47,43,77,67,17,20,18.0,35.0,3,-50,53
48,21,27,4,3,0,72,77,99,52,57,82,79,83,68,82,41,52,46.0,58.0,11,-41,52
48,22,27,4,3,0,71,63,68,50,44,61,42,40,48,45,18,18,18.0,27.0,0,-27,27
374,1,28,2,3,0,625,493,512,736,581,360,145,129,306,492,378,283,330.0,384.0,-95,-114,19
145,2,28,2,3,0,215,224,243,237,221,153,83,75,142,154,140,101,120.0,132.0,-39,-14,-25
109,3,28,2,3,0,133,133,164,131,165,105,47,48,67,109,121,79,100.0,103.0,-42,12,-54
438,4,28,2,3,0,713,701,789,881,663,502,321,175,311,576,511,299,405.0,462.0,-212,-65,-147
361,5,28,2,3,0,598,495,600,609,554,488,356,206,340,526,495,291,393.0,437.0,-204,-31,-173
259,6,28,2,3,0,295,315,306,319,309,208,104,111,219,307,304,148,226.0,253.0,-156,-3,-153
400,7,28,2,3,0,543,643,668,672,573,446,246,241,312,378,406,284,345.0,356.0,-122,28,-150
99,8,28,2,3,0,129,126,145,145,138,80,47,46,58,83,94,61,78.0,79.0,-33,11,-44
607,9,28,2,3,0,803,692,927,973,869,740,398,282,593,912,598,355,476.0,622.0,-243,-314,71
77,10,28,2,3,0,92,69,104,120,85,95,39,30,50,68,74,33,54.0,58.0,-41,6,-47
891,11,28,2,3,0,1330,1133,1369,1500,1116,610,270,351,609,1028,993,652,822.0,891.0,-341,-35,-306
151,12,28,2,3,0,177,180,188,194,175,130,47,59,107,208,200,69,134.0,159.0,-131,-8,-123
323,13,28,2,3,0,446,396,489,506,429,351,172,141,298,340,342,250,296.0,311.0,-92,2,-94
293,14,28,2,3,0,359,443,350,442,406,206,143,136,170,239,290,184,237.0,238.0,-106,51,-157
969,15,28,2,3,0,1531,1481,1596,1826,1257,815,643,498,965,1300,996,708,852.0,1001.0,-288,-304,16
250,16,28,2,3,0,290,320,331,346,286,253,116,101,212,331,334,134,234.0,266.0,-200,3,-203
251,17,28,2,3,0,302,305,370,344,325,229,78,92,180,310,284,146,215.0,247.0,-138,-26,-112
153,18,28,2,3,0,249,210,345,285,288,200,69,95,138,176,229,97,163.0,167.0,-132,53,-185
274,19,28,2,3,0,359,364,390,459,433,291,193,157,189,261,256,190,223.0,236.0,-66,-5,-61
120,20,28,2,3,0,157,161,172,225,158,135,51,35,76,157,115,82,98.0,118.0,-33,-42,9
166,21,28,2,3,0,253,275,312,315,249,241,115,96,127,205,223,136,180.0,188.0,-87,18,-105
153,22,28,2,3,0,325,234,241,211,111,123,58,56,108,145,104,92,98.0,114.0,-12,-41,29
347,1,29,1,3,0,390,364,320,327,408,528,494,298,341,507,266,214,240.0,329.0,-52,-241,189
142,2,29,1,3,0,173,191,127,108,198,213,197,180,169,225,142,99,120.0,155.0,-43,-83,40
105,3,29,1,3,0,156,132,135,136,178,178,174,157,121,169,76,74,75.0,106.0,-2,-93,91
259,4,29,1,3,0,418,394,364,332,388,450,529,355,417,450,177,170,174.0,266.0,-7,-273,266
324,5,29,1,3,0,385,337,371,406,440,533,641,403,433,394,242,224,233.0,287.0,-18,-152,134
211,6,29,1,3,0,230,208,185,223,244,297,328,172,256,310,160,139,150.0,203.0,-21,-150,129
332,7,29,1,3,0,402,377,302,378,352,487,582,453,469,507,305,251,278.0,354.0,-54,-202,148
101,8,29,1,3,0,141,107,116,114,132,168,143,117,124,97,55,43,49.0,65.0,-12,-42,30
630,9,29,1,3,0,616,587,591,684,704,813,867,710,821,895,435,271,353.0,534.0,-164,-460,296
108,10,29,1,3,0,129,95,81,120,108,129,137,85,114,124,79,66,72.0,90.0,-13,-45,32
835,11,29,1,3,0,885,789,826,854,952,1272,1166,688,937,1154,552,589,570.0,765.0,37,-602,639
145,12,29,1,3,0,172,121,144,151,183,202,193,186,189,178,106,91,98.0,125.0,-15,-72,57
251,13,29,1,3,0,325,291,244,275,310,427,423,324,327,378,179,188,184.0,248.0,9,-199,208
260,14,29,1,3,0,241,351,217,257,301,336,420,237,276,308,156,143,150.0,202.0,-13,-152,139
759,15,29,1,3,0,1058,811,816,971,1162,1196,1045,917,1072,1169,550,543,546.0,754.0,-7,-619,612
285,16,29,1,3,0,366,272,236,352,315,395,429,270,308,378,261,177,219.0,272.0,-84,-117,33
251,17,29,1,3,0,288,231,235,286,268,360,359,193,226,309,145,129,137.0,194.0,-16,-164,148
183,18,29,1,3,0,228,247,214,238,244,281,263,253,214,293,168,110,139.0,190.0,-58,-125,67
121,19,29,1,3,0,199,192,184,149,191,241,242,174,177,213,86,85,86.0,128.0,-1,-127,126
92,20,29,1,3,0,91,84,83,135,121,146,128,96,89,130,65,59,62.0,85.0,-6,-65,59
131,21,29,1,3,0,153,141,143,148,200,229,215,165,164,174,112,81,96.0,122.0,-31,-62,31
74,22,29,1,3,0,190,96,96,121,92,130,140,82,95,85,44,40,42.0,56.0,-4,-41,37
456,1,30,1,3,0,524,428,462,576,421,521,504,402,593,748,538,251,394.0,512.0,-287,-210,-77
191,2,30,1,3,0,285,234,259,204,306,266,231,316,323,344,263,166,214.0,258.0,-97,-81,-16
152,3,30,1,3,0,139,167,203,169,162,217,201,207,206,200,197,109,153.0,169.0,-88,-3,-85
693,4,30,1,3,0,929,887,986,1008,845,898,731,715,939,1050,755,424,590.0,743.0,-331,-295,-36
443,5,30,1,3,0,657,632,753,748,554,658,1072,583,560,641,624,348,486.0,538.0,-276,-17,-259
229,6,30,1,3,0,261,270,316,300,257,346,329,282,331,409,330,200,265.0,313.0,-130,-79,-51
458,7,30,1,3,0,514,607,578,623,481,543,678,438,630,646,659,309,484.0,538.0,-350,13,-363
90,8,30,1,3,0,103,127,142,127,114,155,143,139,142,103,120,44,82.0,89.0,-76,17,-93
1006,9,30,1,3,0,1013,985,1219,1303,1074,1237,1342,1295,1408,1829,1269,499,884.0,1199.0,-770,-560,-210
152,10,30,1,3,0,170,96,158,161,124,125,189,162,142,255,213,82,148.0,183.0,-131,-42,-89
954,11,30,1,3,0,1034,965,1031,1078,842,1106,1255,1040,1108,1430,1304,649,976.0,1128.0,-655,-126,-529
186,12,30,1,3,0,194,206,264,228,177,230,275,218,275,247,282,85,184.0,205.0,-197,35,-232
337,13,30,1,3,0,365,330,420,442,396,476,471,407,417,527,425,254,340.0,402.0,-171,-102,-69
354,14,30,1,3,0,352,404,359,472,400,422,469,405,382,502,442,251,346.0,398.0,-191,-60,-131
836,15,30,1,3,0,1059,1028,1051,1251,1000,1181,1241,932,1214,1500,938,567,752.0,1002.0,-371,-562,191
428,16,30,1,3,0,406,406,395,467,358,427,529,447,473,526,572,259,416.0,452.0,-313,46,-359
342,17,30,1,3,0,413,420,443,451,322,451,476,369,391,505,374,207,290.0,362.0,-167,-131,-36
206,18,30,1,3,0,232,234,345,272,282,266,282,298,320,358,335,144,240.0,279.0,-191,-23,-168
268,19,30,1,3,0,362,315,405,340,365,459,418,357,335,454,281,156,218.0,297.0,-125,-173,48
153,20,30,1,3,0,206,221,225,291,189,230,259,188,209,244,199,108,154.0,184.0,-91,-45,-46
210,21,30,1,3,0,242,253,346,302,281,312,352,366,242,346,325,174,250.0,282.0,-151,-21,-130
144,22,30,1,3,0,276,201,264,224,175,240,219,123,190,198,139,94,116.0,144.0,-45,-59,14
696,1,31,2,3,0,722,679,634,547,444,607,438,357,513,576,543,384,464.0,501.0,-159,-33,-126
312,2,31,2,3,0,279,225,250,183,177,213,139,117,236,257,243,199,221.0,233.0,-44,-14,-30
84,3,31,2,3,0,82,69,87,52,46,43,47,37,60,80,54,43,48.0,59.0,-11,-26,15
688,4,31,2,3,0,673,614,681,595,494,449,410,328,585,816,536,311,424.0,554.0,-225,-280,55
640,5,31,2,3,0,561,619,591,569,444,445,455,290,447,593,591,337,464.0,507.0,-254,-2,-252
435,6,31,2,3,0,315,300,376,284,251,265,236,233,275,385,322,230,276.0,312.0,-92,-63,-29
622,7,31,2,3,0,484,554,521,386,382,358,297,285,401,440,468,289,378.0,399.0,-179,28,-207
78,8,31,2,3,0,81,62,68,61,45,60,31,30,61,103,57,64,60.0,75.0,7,-46,53
1449,9,31,2,3,0,1135,1224,1221,1023,972,1033,800,773,983,1319,1274,618,946.0,1070.0,-656,-45,-611
164,10,31,2,3,0,151,132,140,110,112,99,93,94,126,167,115,84,100.0,122.0,-31,-52,21
1681,11,31,2,3,0,1328,1233,1314,879,894,893,729,862,988,1160,1203,919,1061.0,1094.0,-284,43,-327
224,12,31,2,3,0,178,202,203,160,175,134,144,96,129,200,185,89,137.0,158.0,-96,-15,-81
460,13,31,2,3,0,280,289,334,287,249,266,194,192,281,283,417,232,324.0,311.0,-185,134,-319
388,14,31,2,3,0,309,370,322,315,276,272,209,174,237,350,258,224,241.0,277.0,-34,-92,58
2273,15,31,2,3,0,1725,1897,1719,1389,1189,1547,1208,929,1465,1724,1540,1004,1272.0,1423.0,-536,-184,-352
325,16,31,2,3,0,290,306,263,266,203,235,199,144,218,283,271,143,207.0,232.0,-128,-12,-116
380,17,31,2,3,0,345,396,354,336,258,251,209,203,255,374,375,195,285.0,315.0,-180,1,-181
369,18,31,2,3,0,298,266,319,252,323,276,236,214,251,346,352,161,256.0,286.0,-191,6,-197
225,19,31,2,3,0,306,327,247,205,195,187,133,91,159,186,215,146,180.0,182.0,-69,29,-98
290,20,31,2,3,0,246,273,262,227,183,189,132,105,200,253,198,131,164.0,194.0,-67,-55,-12
235,21,31,2,3,0,215,204,258,182,135,163,159,132,134,174,188,135,162.0,166.0,-53,14,-67
104,22,31,2,3,0,108,94,88,66,52,57,23,28,58,76,70,44,57.0,63.0,-26,-6,-20
253,1,32,3,3,0,248,205,249,256,328,379,426,299,501,825,333,136,234.0,431.0,-197,-492,295
598,2,32,3,3,0,584,517,594,552,695,707,913,926,928,1393,1050,634,842.0,1026.0,-416,-343,-73
207,3,32,3,3,0,151,118,129,99,134,132,200,230,272,405,185,132,158.0,241.0,-53,-220,167
199,4,32,3,3,0,284,352,376,194,240,313,370,330,446,852,178,127,152.0,386.0,-51,-674,623
512,5,32,3,3,0,753,633,599,569,778,755,971,792,934,1509,1063,565,814.0,1046.0,-498,-446,-52
936,6,32,3,3,0,836,765,835,790,1052,1349,1421,1263,1461,2601,1965,1072,1518.0,1879.0,-893,-636,-257
1729,7,32,3,3,0,1669,1567,2055,1628,2244,2677,2814,2975,3077,5360,2858,1598,2228.0,3272.0,-1260,-2502,1242
447,8,32,3,3,0,351,377,360,353,542,640,778,791,803,1442,701,396,548.0,846.0,-305,-741,436
3263,9,32,3,3,0,3366,2719,3307,2768,3295,4086,5098,5032,5800,8421,3465,1872,2668.0,4586.0,-1593,-4956,3363
1845,10,32,3,3,0,2406,1619,1976,1690,1981,2497,3110,3025,3479,6171,2981,1510,2246.0,3554.0,-1471,-3190,1719
1465,11,32,3,3,0,1369,1121,1352,1272,1577,1829,2045,1978,2153,3757,2028,1542,1785.0,2442.0,-486,-1729,1243
434,12,32,3,3,0,516,412,417,410,598,635,806,703,736,1319,827,443,635.0,863.0,-384,-492,108
1021,13,32,3,3,0,863,830,1060,888,1184,1505,1631,1500,1789,2863,1366,1047,1206.0,1759.0,-319,-1497,1178
2528,14,32,3,3,0,2609,2474,2930,3020,3796,4302,4617,4700,5194,9539,6024,2842,4433.0,6135.0,-3182,-3515,333
745,15,32,3,3,0,867,616,852,799,1096,1291,1435,1528,1653,2646,934,580,757.0,1387.0,-354,-1712,1358
524,16,32,3,3,0,578,459,481,488,678,753,891,696,982,1629,1137,521,829.0,1096.0,-616,-492,-124
808,17,32,3,3,0,806,812,802,747,984,1113,1544,1234,1513,2352,1658,771,1214.0,1594.0,-887,-694,-193
456,18,32,3,3,0,474,380,411,360,626,548,706,724,738,1086,453,316,384.0,618.0,-137,-633,496
505,19,32,3,3,0,377,398,383,376,528,616,644,644,694,1039,408,313,360.0,587.0,-95,-631,536
169,20,32,3,3,0,371,270,261,287,297,277,359,279,304,514,324,210,267.0,349.0,-114,-190,76
499,21,32,3,3,0,412,456,460,358,538,648,785,855,1045,1704,937,403,670.0,1015.0,-534,-767,233
562,22,32,3,3,0,439,350,475,475,643,791,839,638,832,1045,394,365,380.0,601.0,-29,-651,622
505,1,33,2,3,0,848,740,785,835,1350,1065,2065,1032,1283,1483,389,338,364.0,737.0,-51,-1094,1043
208,2,33,2,3,0,292,229,244,208,404,346,402,396,360,567,208,160,184.0,312.0,-48,-359,311
340,3,33,2,3,0,446,450,527,415,569,575,712,648,698,789,413,215,314.0,472.0,-198,-376,178
126,4,33,2,3,0,346,342,374,346,429,397,451,276,389,488,143,102,122.0,244.0,-41,-345,304
577,5,33,2,3,0,746,756,677,695,682,820,1286,786,820,1117,531,374,452.0,674.0,-157,-586,429
241,6,33,2,3,0,351,363,414,357,477,644,726,594,615,705,385,198,292.0,429.0,-187,-320,133
738,7,33,2,3,0,1400,1356,1271,1075,1292,1454,1777,1435,1352,1707,803,424,614.0,978.0,-379,-904,525
174,8,33,2,3,0,326,295,376,259,310,346,391,347,352,464,131,87,109.0,227.0,-44,-333,289
221,9,33,2,3,0,223,205,277,296,248,286,326,342,407,475,130,117,124.0,241.0,-13,-345,332
77,10,33,2,3,0,135,110,154,153,106,135,181,167,158,231,93,43,68.0,122.0,-50,-138,88
1094,11,33,2,3,0,2036,1589,1718,1504,1598,2024,2099,1880,1868,2181,991,782,886.0,1318.0,-209,-1190,981
183,12,33,2,3,0,332,338,384,268,290,349,532,430,438,495,251,128,190.0,291.0,-123,-244,121
592,13,33,2,3,0,697,668,745,713,769,1026,1153,782,978,1229,546,360,453.0,712.0,-186,-683,497
492,14,33,2,3,0,507,691,656,595,849,951,954,750,835,1053,508,259,384.0,607.0,-249,-545,296
556,15,33,2,3,0,727,703,696,655,723,773,920,884,1063,1213,348,291,320.0,617.0,-57,-865,808
136,16,33,2,3,0,248,264,212,303,273,340,406,336,358,440,200,80,140.0,240.0,-120,-240,120
254,17,33,2,3,0,375,384,428,388,473,550,688,528,670,749,385,150,268.0,428.0,-235,-364,129
178,18,33,2,3,0,319,281,308,207,297,275,314,302,385,408,188,136,162.0,244.0,-52,-220,168
81,19,33,2,3,0,162,132,162,151,156,254,246,156,195,210,53,54,54.0,106.0,1,-157,158
113,20,33,2,3,0,142,161,182,218,192,205,240,178,181,295,131,85,108.0,170.0,-46,-164,118
531,21,33,2,3,0,777,772,950,666,1062,1276,1109,958,1012,1286,412,280,346.0,659.0,-132,-874,742
160,22,33,2,3,0,262,257,265,200,199,236,256,202,210,228,66,80,73.0,125.0,14,-162,176
263,1,34,2,3,0,341,301,229,293,265,342,422,337,524,679,950,175,562.0,601.0,-775,271,-1046
135,2,34,2,3,0,57,93,77,88,123,129,142,173,215,293,131,118,124.0,181.0,-13,-162,149
63,3,34,2,3,0,43,68,68,57,63,80,87,94,102,118,60,38,49.0,72.0,-22,-58,36
167,4,34,2,3,0,160,141,144,157,165,158,241,166,231,280,180,87,134.0,182.0,-93,-100,7
210,5,34,2,3,0,119,165,176,134,135,208,419,226,291,404,151,140,146.0,232.0,-11,-253,242
85,6,34,2,3,0,69,84,82,105,84,146,172,127,176,201,116,64,90.0,127.0,-52,-85,33
276,7,34,2,3,0,288,336,249,208,207,253,405,274,383,451,230,146,188.0,276.0,-84,-221,137
68,8,34,2,3,0,25,37,54,47,58,68,104,75,85,95,42,23,32.0,53.0,-19,-53,34
144,9,34,2,3,0,94,95,114,119,105,149,140,175,225,268,104,54,79.0,142.0,-50,-164,114
32,10,34,2,3,0,28,27,26,35,28,43,42,39,42,71,30,28,29.0,43.0,-2,-41,39
388,11,34,2,3,0,319,322,305,326,286,477,566,501,644,669,334,279,306.0,427.0,-55,-335,280
40,12,34,2,3,0,53,46,68,55,61,72,97,83,104,86,64,32,48.0,61.0,-32,-22,-10
162,13,34,2,3,0,125,133,124,117,113,185,186,192,206,272,140,97,118.0,170.0,-43,-132,89
156,14,34,2,3,0,78,115,86,115,109,191,156,169,219,319,144,90,117.0,184.0,-54,-175,121
235,15,34,2,3,0,153,241,174,199,216,262,293,289,400,452,190,120,155.0,254.0,-70,-262,192
61,16,34,2,3,0,36,44,55,47,45,58,71,47,81,82,146,33,90.0,87.0,-113,64,-177
115,17,34,2,3,0,96,96,123,93,121,118,158,115,135,228,105,59,82.0,131.0,-46,-123,77
64,18,34,2,3,0,69,44,77,80,72,82,93,107,132,139,77,43,60.0,86.0,-34,-62,28
28,19,34,2,3,0,35,39,48,22,42,64,69,52,62,81,42,40,41.0,54.0,-2,-39,37
56,20,34,2,3,0,28,31,19,68,61,42,66,46,77,87,44,31,38.0,54.0,-13,-43,30
169,21,34,2,3,0,125,134,132,92,109,169,208,170,201,238,124,83,104.0,148.0,-41,-114,73
60,22,34,2,3,0,33,46,45,30,38,60,45,45,56,48,22,17,20.0,29.0,-5,-26,21
175,1,35,2,3,0,239,228,169,138,110,96,130,129,206,317,238,124,181.0,226.0,-114,-79,-35
50,2,35,2,3,0,78,75,180,62,53,48,150,68,61,94,64,55,60.0,71.0,-9,-30,21
88,3,35,2,3,0,113,86,107,104,115,80,59,69,77,114,119,58,88.0,97.0,-61,5,-66
463,4,35,2,3,0,502,679,1478,362,522,549,341,411,466,954,488,303,396.0,582.0,-185,-466,281
308,5,35,2,3,0,298,337,329,313,287,213,226,219,270,560,493,212,352.0,422.0,-281,-67,-214
126,6,35,2,3,0,173,287,132,112,137,105,226,131,164,192,238,108,173.0,179.0,-130,46,-176
736,7,35,2,3,0,452,634,622,583,483,376,451,391,462,714,609,352,480.0,558.0,-257,-105,-152
152,8,35,2,3,0,160,138,173,121,88,87,81,104,152,230,168,75,122.0,158.0,-93,-62,-31
1157,9,35,2,3,0,1134,1049,1151,1204,796,688,783,887,1988,1893,1283,554,918.0,1243.0,-729,-610,-119
218,10,35,2,3,0,287,232,292,302,238,333,211,167,204,333,316,132,224.0,260.0,-184,-17,-167
701,11,35,2,3,0,715,817,757,633,614,701,409,489,602,865,785,520,652.0,723.0,-265,-80,-185
195,12,35,2,3,0,160,214,361,199,120,104,272,168,194,280,264,100,182.0,215.0,-164,-16,-148
489,13,35,2,3,0,276,257,299,271,278,358,279,275,250,454,387,248,318.0,363.0,-139,-67,-72
195,14,35,2,3,0,161,254,201,225,287,201,184,168,191,300,319,141,230.0,253.0,-178,19,-197
567,15,35,2,3,0,571,611,676,536,359,406,355,572,795,787,577,391,484.0,585.0,-186,-210,24
390,16,35,2,3,0,556,499,394,422,178,222,287,394,374,566,545,193,369.0,435.0,-352,-21,-331
531,17,35,2,3,0,281,349,524,267,270,181,332,203,423,412,412,410,411.0,411.0,-2,0,-2
485,18,35,2,3,0,320,297,502,255,324,353,331,397,363,562,555,242,398.0,453.0,-313,-7,-306
328,19,35,2,3,0,322,331,310,263,240,234,219,239,228,340,230,163,196.0,244.0,-67,-110,43
261,20,35,2,3,0,377,423,567,467,292,184,281,158,348,846,378,203,290.0,476.0,-175,-468,293
103,21,35,2,3,0,99,165,127,82,202,64,63,62,99,126,138,68,103.0,111.0,-70,12,-82
88,22,35,2,3,0,124,102,107,81,71,56,91,46,89,107,57,72,64.0,79.0,15,-50,65
173,1,36,1,3,0,381,276,268,259,263,265,263,222,276,374,264,140,202.0,259.0,-124,-110,-14
278,2,36,1,3,0,291,288,287,259,444,328,322,420,444,423,403,246,324.0,357.0,-157,-20,-137
398,3,36,1,3,0,345,439,598,415,527,467,541,608,505,619,534,251,392.0,468.0,-283,-85,-198
672,4,36,1,3,0,863,864,925,776,823,803,1019,845,1016,1441,741,459,600.0,880.0,-282,-700,418
616,5,36,1,3,0,697,804,780,668,723,668,1080,712,743,1078,940,507,724.0,842.0,-433,-138,-295
152,6,36,1,3,0,191,191,212,209,143,177,210,217,212,273,247,107,177.0,209.0,-140,-26,-114
548,7,36,1,3,0,560,823,816,666,592,643,866,764,681,1011,688,350,519.0,683.0,-338,-323,-15
219,8,36,1,3,0,206,261,279,232,228,276,283,280,288,348,274,115,194.0,246.0,-159,-74,-85
1549,9,36,1,3,0,1603,1334,1757,1676,1516,1456,1686,2097,2144,2562,1849,777,1313.0,1729.0,-1072,-713,-359
278,10,36,1,3,0,357,308,368,312,289,221,333,376,342,443,364,194,279.0,334.0,-170,-79,-91
546,11,36,1,3,0,732,642,720,594,521,656,670,713,682,857,658,425,542.0,647.0,-233,-199,-34
180,12,36,1,3,0,215,284,272,228,226,207,304,324,277,382,334,121,228.0,279.0,-213,-48,-165
572,13,36,1,3,0,512,623,789,655,636,756,829,875,790,1042,804,407,606.0,751.0,-397,-238,-159
427,14,36,1,3,0,442,561,418,478,457,520,525,514,567,656,654,303,478.0,538.0,-351,-2,-349
464,15,36,1,3,0,692,688,672,696,609,628,658,707,687,970,632,338,485.0,647.0,-294,-338,44
890,16,36,1,3,0,1019,976,969,1189,812,879,1194,1234,1296,1458,1429,526,978.0,1138.0,-903,-29,-874
444,17,36,1,3,0,451,527,529,432,433,504,586,532,579,879,712,262,487.0,618.0,-450,-167,-283
336,18,36,1,3,0,378,320,437,254,309,324,331,423,388,523,387,223,305.0,378.0,-164,-136,-28
658,19,36,1,3,0,785,855,952,717,778,859,919,871,786,1105,571,424,498.0,700.0,-147,-534,387
364,20,36,1,3,0,482,469,390,863,400,378,452,406,568,732,616,327,472.0,558.0,-289,-116,-173
381,21,36,1,3,0,415,526,586,401,428,429,480,618,464,618,561,288,424.0,489.0,-273,-57,-216
333,22,36,1,3,0,403,364,391,379,393,463,364,346,348,497,267,165,216.0,310.0,-102,-230,128
61,1,37,2,3,0,148,107,138,95,119,125,135,111,242,237,68,37,52.0,114.0,-31,-169,138
100,2,37,2,3,0,116,126,123,110,141,143,170,165,182,271,140,100,120.0,170.0,-40,-131,91
74,3,37,2,3,0,127,130,150,140,118,135,135,144,149,195,78,54,66.0,109.0,-24,-117,93
59,4,37,2,3,0,161,133,142,156,136,151,163,97,128,205,34,44,39.0,94.0,10,-171,181
178,5,37,2,3,0,394,366,331,297,273,290,355,284,276,560,275,186,230.0,340.0,-89,-285,196
109,6,37,2,3,0,162,134,155,164,187,210,258,234,289,496,209,109,159.0,271.0,-100,-287,187
188,7,37,2,3,0,365,376,429,398,297,370,455,430,397,599,241,156,198.0,332.0,-85,-358,273
65,8,37,2,3,0,155,134,191,136,138,154,165,187,192,226,67,52,60.0,115.0,-15,-159,144
467,9,37,2,3,0,1001,803,902,957,908,969,966,1096,1273,1753,510,290,400.0,851.0,-220,-1243,1023
113,10,37,2,3,0,173,112,150,145,121,133,163,183,209,314,161,76,118.0,184.0,-85,-153,68
360,11,37,2,3,0,542,500,626,524,494,659,663,720,808,1176,484,399,442.0,686.0,-85,-692,607
139,12,37,2,3,0,159,167,200,179,156,182,243,282,281,556,258,99,178.0,304.0,-159,-298,139
133,13,37,2,3,0,227,222,334,278,240,275,311,284,290,435,164,126,145.0,242.0,-38,-271,233
136,14,37,2,3,0,207,216,293,353,273,313,316,283,364,562,252,130,191.0,315.0,-122,-310,188
331,15,37,2,3,0,580,534,604,578,536,581,660,738,799,1102,332,255,294.0,563.0,-77,-770,693
92,16,37,2,3,0,298,272,226,274,204,230,271,257,362,526,267,110,188.0,301.0,-157,-259,102
133,17,37,2,3,0,198,189,225,184,208,271,292,260,313,627,286,115,200.0,343.0,-171,-341,170
160,18,37,2,3,0,273,232,272,218,246,274,282,315,340,500,185,128,156.0,271.0,-57,-315,258
133,19,37,2,3,0,378,382,339,300,311,310,311,260,209,299,101,86,94.0,162.0,-15,-198,183
70,20,37,2,3,0,208,200,174,215,160,199,165,151,159,317,179,87,133.0,194.0,-92,-138,46
62,21,37,2,3,0,107,132,119,143,116,126,114,163,141,242,89,58,74.0,130.0,-31,-153,122
65,22,37,2,3,0,139,139,154,146,135,155,139,103,121,126,60,44,52.0,77.0,-16,-66,50
300,1,38,2,3,0,152,176,401,401,321,346,427,336,1289,571,175,135,155.0,294.0,-40,-396,356
201,2,38,2,3,0,125,149,202,186,247,218,226,257,285,393,160,154,157.0,236.0,-6,-233,227
278,3,38,2,3,0,151,182,235,185,198,218,291,326,339,631,236,164,200.0,344.0,-72,-395,323
315,4,38,2,3,0,458,579,619,663,697,743,797,664,656,980,232,253,242.0,488.0,21,-748,769
708,5,38,2,3,0,383,511,577,808,786,904,1230,923,1016,1536,609,478,544.0,874.0,-131,-927,796
522,6,38,2,3,0,141,183,258,304,319,476,565,666,550,750,358,257,308.0,455.0,-101,-392,291
1635,7,38,2,3,0,1159,1838,2095,1935,1835,2200,2915,3148,3502,5481,1788,1203,1496.0,2824.0,-585,-3693,3108
567,8,38,2,3,0,388,385,544,496,521,585,792,899,919,1474,502,371,436.0,782.0,-131,-972,841
8079,9,38,2,3,0,6681,6500,8617,8587,8085,9999,11167,12710,12394,15317,5306,3718,4512.0,8114.0,-1588,-10011,8423
1366,10,38,2,3,0,777,650,933,1046,1010,1186,1639,1709,1789,2693,1195,777,986.0,1555.0,-418,-1498,1080
2148,11,38,2,3,0,917,1039,1356,1362,1273,1726,2274,2226,2622,3296,1247,1529,1388.0,2024.0,282,-2049,2331
797,12,38,2,3,0,301,380,537,595,606,715,1083,1277,1265,1764,857,484,670.0,1035.0,-373,-907,534
1259,13,38,2,3,0,575,834,1174,1117,1091,1516,1988,2221,2449,3796,1214,995,1104.0,2002.0,-219,-2582,2363
1290,14,38,2,3,0,966,1035,851,918,1151,1553,1783,1739,1951,3130,1278,848,1063.0,1752.0,-430,-1852,1422
1246,15,38,2,3,0,670,888,1084,1050,1140,1443,1709,2001,2019,2088,700,801,750.0,1196.0,101,-1388,1489
772,16,38,2,3,0,464,568,585,851,689,870,1071,1120,1425,1562,736,376,556.0,891.0,-360,-826,466
1105,17,38,2,3,0,1099,1123,1343,1265,1384,1668,1721,1444,1769,3168,1244,677,960.0,1696.0,-567,-1924,1357
1058,18,38,2,3,0,743,748,1047,978,991,1227,1477,1846,1591,1981,769,598,684.0,1116.0,-171,-1212,1041
1642,19,38,2,3,0,2185,2416,2738,2351,2715,3298,3035,2443,2622,3705,1059,1132,1096.0,1965.0,73,-2646,2719
331,20,38,2,3,0,130,208,307,592,510,660,624,494,548,828,333,235,284.0,465.0,-98,-495,397
287,21,38,2,3,0,148,246,335,408,480,451,462,457,402,722,289,175,232.0,395.0,-114,-433,319
604,22,38,2,3,0,290,315,472,426,421,630,651,605,913,1064,350,347,348.0,587.0,-3,-714,711
224,1,39,1,3,0,267,256,231,232,275,253,330,234,241,272,250,161,206.0,228.0,-89,-22,-67
297,2,39,1,3,0,218,222,273,237,317,281,288,285,282,383,494,162,328.0,346.0,-332,111,-443
364,3,39,1,3,0,261,297,409,278,346,325,397,353,331,374,412,213,312.0,333.0,-199,38,-237
324,4,39,1,3,0,385,428,423,454,541,459,651,432,527,798,336,255,296.0,463.0,-81,-462,381
280,5,39,1,3,0,328,404,345,365,374,356,560,353,364,502,560,198,379.0,420.0,-362,58,-420
339,6,39,1,3,0,248,311,364,321,347,370,464,369,339,449,378,228,303.0,352.0,-150,-71,-79
948,7,39,1,3,0,794,1159,1092,1036,1063,896,1347,1014,1020,1083,1132,648,890.0,954.0,-484,49,-533
370,8,39,1,3,0,407,327,404,319,311,334,462,394,347,454,373,276,324.0,368.0,-97,-81,-16
2735,9,39,1,3,0,2297,2056,2432,2474,2478,2391,3040,2810,2842,3119,2859,1337,2098.0,2438.0,-1522,-260,-1262
306,10,39,1,3,0,277,228,279,260,273,237,346,287,279,316,376,154,265.0,282.0,-222,60,-282
905,11,39,1,3,0,864,875,944,898,914,919,1153,908,905,1057,1012,579,796.0,883.0,-433,-45,-388
355,12,39,1,3,0,259,334,387,321,370,350,407,325,334,414,397,195,296.0,335.0,-202,-17,-185
842,13,39,1,3,0,529,645,721,619,623,691,837,696,646,778,797,602,700.0,726.0,-195,19,-214
986,14,39,1,3,0,743,938,870,860,976,801,1165,786,979,1154,954,596,775.0,901.0,-358,-200,-158
650,15,39,1,3,0,591,647,679,619,746,631,767,611,709,819,752,388,570.0,653.0,-364,-67,-297
1164,16,39,1,3,0,1120,1091,1131,1321,1289,1127,1463,1111,1292,1497,1405,549,977.0,1150.0,-856,-92,-764
556,17,39,1,3,0,605,681,762,693,656,726,776,563,649,953,623,341,482.0,639.0,-282,-330,48
556,18,39,1,3,0,561,623,627,554,655,558,641,586,610,611,627,347,487.0,528.0,-280,16,-296
709,19,39,1,3,0,596,668,714,579,727,667,816,696,727,851,758,485,622.0,698.0,-273,-93,-180
111,20,39,1,3,0,151,162,139,215,222,181,222,152,145,208,248,87,168.0,181.0,-161,40,-201
331,21,39,1,3,0,307,362,418,335,362,360,429,415,400,482,463,229,346.0,391.0,-234,-19,-215
607,22,39,1,3,0,643,636,673,545,503,567,621,450,630,549,617,346,482.0,504.0,-271,68,-339
205,1,40,1,3,0,307,268,271,242,256,281,287,238,345,456,114,153,134.0,241.0,39,-342,381
364,2,40,1,3,0,287,277,288,270,381,345,327,285,338,442,406,203,304.0,350.0,-203,-36,-167
311,3,40,1,3,0,221,205,287,238,235,267,246,282,331,382,195,193,194.0,257.0,-2,-187,185
186,4,40,1,3,0,239,243,275,251,253,208,303,262,356,580,121,115,118.0,272.0,-6,-459,453
390,5,40,1,3,0,495,459,461,461,453,451,636,487,569,804,459,234,346.0,499.0,-225,-345,120
376,6,40,1,3,0,362,355,346,364,377,400,439,428,489,503,403,244,324.0,383.0,-159,-100,-59
703,7,40,1,3,0,741,891,877,768,778,692,815,855,912,1164,554,505,530.0,741.0,-49,-610,561
301,8,40,1,3,0,274,256,316,230,226,277,310,284,316,428,223,193,208.0,281.0,-30,-205,175
2615,9,40,1,3,0,2312,2006,2367,2317,2288,2219,2478,2450,3345,3730,1930,1262,1596.0,2307.0,-668,-1800,1132
309,10,40,1,3,0,296,226,316,262,277,270,290,313,377,417,266,187,226.0,290.0,-79,-151,72
1069,11,40,1,3,0,1174,1098,1171,1053,1035,1139,1193,1114,1454,1527,877,754,816.0,1053.0,-123,-650,527
323,12,40,1,3,0,286,283,344,324,354,314,340,317,350,507,305,161,233.0,324.0,-144,-202,58
572,13,40,1,3,0,466,466,575,563,517,521,590,551,574,797,453,434,444.0,561.0,-19,-344,325
702,14,40,1,3,0,631,701,609,620,657,647,687,548,872,1036,630,391,510.0,686.0,-239,-406,167
861,15,40,1,3,0,868,916,952,851,928,863,800,942,1151,1258,739,529,634.0,842.0,-210,-519,309
719,16,40,1,3,0,859,860,857,1022,954,876,1065,918,1189,1511,963,454,708.0,976.0,-509,-548,39
443,17,40,1,3,0,432,418,440,412,436,456,456,452,506,737,420,189,304.0,449.0,-231,-317,86
640,18,40,1,3,0,585,524,634,509,574,525,556,643,734,779,473,353,413.0,535.0,-120,-306,186
431,19,40,1,3,0,394,433,415,359,423,434,437,390,480,602,285,241,263.0,376.0,-44,-317,273
179,20,40,1,3,0,154,208,153,256,232,218,203,186,200,305,185,95,140.0,195.0,-90,-120,30
234,21,40,1,3,0,255,282,291,238,303,301,293,309,345,496,293,157,225.0,315.0,-136,-203,67
322,22,40,1,3,0,410,348,422,361,360,329,347,306,404,422,214,206,210.0,281.0,-8,-208,200
212,1,41,3,3,0,288,255,249,227,228,228,248,166,277,348,224,140,182.0,237.0,-84,-124,40
18,2,41,3,3,0,26,19,19,13,29,23,22,12,22,33,19,19,19.0,24.0,0,-14,14
29,3,41,3,3,0,22,31,32,22,34,26,20,16,19,22,21,19,20.0,21.0,-2,-1,-1
378,4,41,3,3,0,342,385,371,412,397,450,433,353,372,511,424,244,334.0,393.0,-180,-87,-93
47,5,41,3,3,0,61,40,41,50,45,33,53,34,42,64,69,42,56.0,58.0,-27,5,-32
59,6,41,3,3,0,96,94,77,54,58,60,65,52,74,75,83,59,71.0,72.0,-24,8,-32
295,7,41,3,3,0,279,291,321,323,323,300,349,309,286,341,430,189,310.0,320.0,-241,89,-330
83,8,41,3,3,0,101,97,85,61,83,86,76,58,62,78,105,64,84.0,82.0,-41,27,-68
848,9,41,3,3,0,938,782,929,824,845,827,959,887,972,1235,1009,443,726.0,896.0,-566,-226,-340
20,10,41,3,3,0,27,25,33,22,15,35,23,23,13,26,34,17,26.0,26.0,-17,8,-25
351,11,41,3,3,0,397,361,372,366,390,384,352,323,380,481,397,258,328.0,379.0,-139,-84,-55
26,12,41,3,3,0,43,45,28,35,34,41,44,29,35,37,61,16,38.0,38.0,-45,24,-69
236,13,41,3,3,0,209,215,221,251,231,259,229,234,231,316,308,172,240.0,265.0,-136,-8,-128
155,14,41,3,3,0,183,203,189,186,204,209,192,150,188,209,242,134,188.0,195.0,-108,33,-141
270,15,41,3,3,0,351,324,279,263,302,300,252,293,323,375,353,222,288.0,317.0,-131,-22,-109
52,16,41,3,3,0,64,65,48,56,41,58,58,26,64,62,54,47,50.0,54.0,-7,-8,1
27,17,41,3,3,0,45,53,33,37,54,26,47,25,31,44,54,26,40.0,41.0,-28,10,-38
56,18,41,3,3,0,100,71,65,63,56,64,42,57,83,105,92,41,66.0,79.0,-51,-13,-38
124,19,41,3,3,0,143,201,173,177,170,176,181,127,153,187,158,103,130.0,149.0,-55,-29,-26
27,20,41,3,3,0,27,25,16,43,25,22,19,17,12,27,22,12,17.0,20.0,-10,-5,-5
38,21,41,3,3,0,29,33,50,39,32,34,19,25,29,46,61,16,38.0,41.0,-45,15,-60
61,22,41,3,3,0,94,92,117,107,90,78,77,62,61,65,66,41,54.0,57.0,-25,1,-26
190,1,42,1,3,0,279,297,244,231,222,233,237,260,331,369,161,142,152.0,224.0,-19,-208,189
309,2,42,1,3,0,312,304,293,280,397,351,388,519,521,651,386,202,294.0,413.0,-184,-265,81
139,3,42,1,3,0,126,103,173,112,115,149,181,185,190,234,146,90,118.0,157.0,-56,-88,32
181,4,42,1,3,0,302,248,267,240,223,271,313,223,301,382,210,141,176.0,244.0,-69,-172,103
360,5,42,1,3,0,417,389,401,386,408,384,645,492,617,839,509,240,374.0,529.0,-269,-330,61
254,6,42,1,3,0,336,313,328,323,371,429,508,453,504,690,387,163,275.0,413.0,-224,-303,79
464,7,42,1,3,0,546,625,677,569,603,642,825,774,709,964,444,303,374.0,570.0,-141,-520,379
238,8,42,1,3,0,255,277,268,247,194,300,278,277,302,443,175,132,154.0,250.0,-43,-268,225
2906,9,42,1,3,0,3265,2736,3407,3034,2769,3466,3967,4449,4901,5547,3229,1517,2373.0,3431.0,-1712,-2318,606
321,10,42,1,3,0,394,300,323,305,295,375,362,434,458,665,381,181,281.0,409.0,-200,-284,84
722,11,42,1,3,0,920,905,886,740,767,910,875,888,974,1139,690,508,599.0,779.0,-182,-449,267
276,12,42,1,3,0,252,298,296,306,326,283,440,408,499,625,381,184,282.0,397.0,-197,-244,47
433,13,42,1,3,0,454,470,518,437,434,560,591,602,602,830,407,320,364.0,519.0,-87,-423,336
499,14,42,1,3,0,448,487,451,445,414,574,666,620,614,920,507,247,377.0,558.0,-260,-413,153
806,15,42,1,3,0,939,1038,954,959,917,968,1148,998,1169,1424,732,558,645.0,905.0,-174,-692,518
511,16,42,1,3,0,744,646,667,730,629,764,987,818,1066,1347,698,270,484.0,772.0,-428,-649,221
418,17,42,1,3,0,522,540,567,522,526,503,752,630,700,988,570,203,386.0,587.0,-367,-418,51
580,18,42,1,3,0,559,556,633,509,603,671,676,754,796,1043,605,368,486.0,672.0,-237,-438,201
341,19,42,1,3,0,457,514,445,435,473,472,553,433,460,600,253,193,223.0,349.0,-60,-347,287
116,20,42,1,3,0,155,208,157,246,168,172,243,227,222,229,139,105,122.0,158.0,-34,-90,56
140,21,42,1,3,0,111,120,179,148,148,164,191,253,229,293,140,96,118.0,176.0,-44,-153,109
264,22,42,1,3,0,319,331,309,255,234,372,256,198,199,322,111,123,117.0,185.0,12,-211,223
369,1,43,2,3,0,123,139,212,242,279,368,455,354,457,516,264,193,228.0,324.0,-71,-252,181
144,2,43,2,3,0,88,54,90,69,134,137,168,236,233,253,206,111,158.0,190.0,-95,-47,-48
172,3,43,2,3,0,148,111,161,112,170,148,180,212,200,238,219,114,166.0,190.0,-105,-19,-86
482,4,43,2,3,0,489,419,541,572,614,704,733,603,754,1094,601,390,496.0,695.0,-211,-493,282
325,5,43,2,3,0,296,215,215,241,286,280,498,363,489,543,391,237,314.0,390.0,-154,-152,-2
185,6,43,2,3,0,200,168,222,253,319,361,472,444,568,578,495,153,324.0,409.0,-342,-83,-259
846,7,43,2,3,0,450,449,644,594,653,771,1001,1018,1094,1221,1031,476,754.0,909.0,-555,-190,-365
369,8,43,2,3,0,187,190,307,319,310,398,381,370,395,605,316,221,268.0,381.0,-95,-289,194
2377,9,43,2,3,0,2169,1283,1775,1807,1926,2292,2762,3019,3563,3747,2666,1125,1896.0,2513.0,-1541,-1081,-460
119,10,43,2,3,0,105,85,131,107,105,132,134,146,194,174,193,92,142.0,153.0,-101,19,-120
1008,11,43,2,3,0,776,574,791,789,884,1139,1155,1292,1491,1524,1070,552,811.0,1049.0,-518,-454,-64
166,12,43,2,3,0,153,127,135,142,163,206,280,258,340,409,346,81,214.0,279.0,-265,-63,-202
734,13,43,2,3,0,423,400,560,621,573,819,812,975,971,1119,789,422,606.0,777.0,-367,-330,-37
488,14,43,2,3,0,326,261,356,378,472,519,592,609,805,866,692,326,509.0,628.0,-366,-174,-192
969,15,43,2,3,0,657,569,729,797,1116,1100,1259,1371,1516,1515,1138,549,844.0,1067.0,-589,-377,-212
446,16,43,2,3,0,597,355,306,462,346,475,707,729,779,906,749,253,501.0,636.0,-496,-157,-339
437,17,43,2,3,0,437,344,400,350,381,419,626,645,767,839,710,238,474.0,596.0,-472,-129,-343
542,18,43,2,3,0,292,182,309,251,400,389,434,571,612,638,509,288,398.0,478.0,-221,-129,-92
962,19,43,2,3,0,556,678,921,843,1057,1068,1256,1020,1269,1395,898,506,702.0,933.0,-392,-497,105
164,20,43,2,3,0,192,141,164,243,183,190,183,170,200,213,159,106,132.0,159.0,-53,-54,1
225,21,43,2,3,0,158,121,222,212,278,246,251,273,309,371,227,159,193.0,252.0,-68,-144,76
537,22,43,2,3,0,238,301,459,440,381,659,536,422,639,783,366,217,292.0,455.0,-149,-417,268
252,1,44,1,3,0,200,200,179,143,213,231,263,186,304,291,260,125,192.0,225.0,-135,-31,-104
59,2,44,1,3,0,35,27,47,40,86,70,45,62,97,95,78,48,63.0,74.0,-30,-17,-13
51,3,44,1,3,0,65,39,59,30,34,48,53,57,54,64,35,18,26.0,39.0,-17,-29,12
445,4,44,1,3,0,530,530,580,328,387,431,542,458,551,739,435,233,334.0,469.0,-202,-304,102
178,5,44,1,3,0,157,199,189,198,208,192,406,218,246,296,270,133,202.0,233.0,-137,-26,-111
89,6,44,1,3,0,65,66,77,68,83,102,108,119,125,125,156,59,108.0,113.0,-97,31,-128
223,7,44,1,3,0,152,215,226,189,211,236,259,209,228,356,218,112,165.0,229.0,-106,-138,32
35,8,44,1,3,0,35,31,34,37,39,38,29,27,53,51,47,21,34.0,40.0,-26,-4,-22
310,9,44,1,3,0,279,264,290,315,201,283,319,341,442,572,437,152,294.0,387.0,-285,-135,-150
25,10,44,1,3,0,33,39,40,44,25,47,48,35,38,46,44,34,39.0,41.0,-10,-2,-8
200,11,44,1,3,0,177,166,199,160,179,202,235,218,248,301,251,138,194.0,230.0,-113,-50,-63
51,12,44,1,3,0,60,46,67,46,43,63,74,57,75,92,84,32,58.0,69.0,-52,-8,-44
112,13,44,1,3,0,72,82,94,85,75,106,81,95,123,131,106,79,92.0,105.0,-27,-25,-2
111,14,44,1,3,0,115,177,146,115,120,133,136,137,144,187,131,57,94.0,125.0,-74,-56,-18
139,15,44,1,3,0,101,105,120,103,117,123,127,129,149,230,149,78,114.0,152.0,-71,-81,10
111,16,44,1,3,0,95,105,133,83,100,88,128,132,148,184,148,61,104.0,131.0,-87,-36,-51
132,17,44,1,3,0,111,119,132,99,113,129,125,121,157,211,135,74,104.0,140.0,-61,-76,15
77,18,44,1,3,0,75,68,110,85,91,79,63,93,111,124,108,57,82.0,96.0,-51,-16,-35
75,19,44,1,3,0,96,78,114,94,86,129,93,93,126,129,69,51,60.0,83.0,-18,-60,42
112,20,44,1,3,0,107,106,102,141,124,91,113,105,132,160,125,77,101.0,121.0,-48,-35,-13
137,21,44,1,3,0,104,117,132,93,101,114,118,176,150,182,148,77,112.0,136.0,-71,-34,-37
68,22,44,1,3,0,72,66,58,77,51,83,64,44,71,77,53,34,44.0,55.0,-19,-24,5
126,1,45,1,3,0,137,166,137,100,120,182,195,186,244,388,154,85,120.0,209.0,-69,-234,165
60,2,45,1,3,0,160,138,155,102,132,175,199,190,214,267,194,91,142.0,184.0,-103,-73,-30
61,3,45,1,3,0,109,113,123,90,86,129,117,180,167,259,127,62,94.0,149.0,-65,-132,67
51,4,45,1,3,0,168,157,135,132,124,189,195,143,181,370,71,41,56.0,161.0,-30,-299,269
129,5,45,1,3,0,341,347,268,235,259,271,451,335,432,691,448,194,321.0,444.0,-254,-243,-11
227,6,45,1,3,0,428,406,511,409,457,615,665,719,699,1253,712,250,481.0,738.0,-462,-541,79
297,7,45,1,3,0,553,712,759,542,525,598,799,850,792,1449,549,320,434.0,773.0,-229,-900,671
103,8,45,1,3,0,172,156,184,119,112,180,176,226,231,426,153,81,117.0,220.0,-72,-273,201
342,9,45,1,3,0,505,439,656,557,570,682,810,953,1204,1628,496,168,332.0,764.0,-328,-1132,804
54,10,45,1,3,0,128,93,99,74,74,93,96,119,135,240,121,56,88.0,139.0,-65,-119,54
404,11,45,1,3,0,835,685,815,558,664,879,928,1050,1083,1908,768,543,656.0,1073.0,-225,-1140,915
150,12,45,1,3,0,250,275,290,238,256,256,368,358,434,733,453,153,303.0,446.0,-300,-280,-20
257,13,45,1,3,0,481,442,541,372,433,513,576,665,667,1158,476,272,374.0,635.0,-204,-682,478
312,14,45,1,3,0,612,706,670,565,604,728,823,894,1006,1883,910,372,641.0,1055.0,-538,-973,435
386,15,45,1,3,0,741,745,772,623,618,806,968,1022,1202,2202,744,430,587.0,1125.0,-314,-1458,1144
138,16,45,1,3,0,249,254,222,214,224,236,278,353,409,749,443,143,293.0,445.0,-300,-306,6
137,17,45,1,3,0,262,282,299,206,221,263,352,322,439,744,378,131,254.0,418.0,-247,-366,119
173,18,45,1,3,0,251,186,224,163,185,197,242,345,391,594,265,149,207.0,336.0,-116,-329,213
80,19,45,1,3,0,164,167,172,127,118,166,151,176,186,256,75,62,68.0,131.0,-13,-181,168
29,20,45,1,3,0,103,86,60,103,92,81,101,86,92,172,124,38,81.0,111.0,-86,-48,-38
70,21,45,1,3,0,165,166,180,107,108,126,155,205,212,325,144,79,112.0,183.0,-65,-181,116
52,22,45,1,3,0,172,142,116,90,66,138,116,107,126,152,43,36,40.0,77.0,-7,-109,102
37,1,46,1,3,0,67,57,61,83,70,93,94,69,88,96,65,19,42.0,60.0,-46,-31,-15
82,2,46,1,3,0,157,153,150,145,260,181,192,214,209,182,216,75,146.0,158.0,-141,34,-175
66,3,46,1,3,0,103,103,189,132,152,130,174,176,130,141,132,46,89.0,106.0,-86,-9,-77
65,4,46,1,3,0,255,224,215,203,267,229,259,158,186,277,124,81,102.0,161.0,-43,-153,110
93,5,46,1,3,0,249,251,265,277,338,249,374,267,205,292,350,117,234.0,253.0,-233,58,-291
108,6,46,1,3,0,259,261,334,403,369,409,407,332,341,384,513,121,317.0,339.0,-392,129,-521
153,7,46,1,3,0,460,477,501,534,578,578,669,572,480,596,555,214,384.0,455.0,-341,-41,-300
12,8,46,1,3,0,88,53,84,72,80,105,82,89,70,67,66,26,46.0,53.0,-40,-1,-39
63,9,46,1,3,0,174,189,205,161,153,130,99,91,101,84,62,19,40.0,55.0,-43,-22,-21
26,10,46,1,3,0,55,61,65,56,59,47,57,42,39,50,45,14,30.0,36.0,-31,-5,-26
216,11,46,1,3,0,501,391,511,498,540,652,534,502,474,569,538,214,376.0,440.0,-324,-31,-293
101,12,46,1,3,0,206,222,322,296,334,361,423,281,274,309,360,94,227.0,254.0,-266,51,-317
150,13,46,1,3,0,326,300,423,331,415,474,378,372,326,383,353,154,254.0,297.0,-199,-30,-169
100,14,46,1,3,0,344,433,458,439,537,516,505,471,372,457,538,139,338.0,378.0,-399,81,-480
152,15,46,1,3,0,480,439,481,523,527,619,525,437,429,453,388,129,258.0,323.0,-259,-65,-194
139,16,46,1,3,0,253,287,274,347,357,348,470,379,317,421,474,120,297.0,338.0,-354,53,-407
148,17,46,1,3,0,271,267,285,332,369,394,455,353,348,428,459,95,277.0,327.0,-364,31,-395
44,18,46,1,3,0,110,105,117,97,156,140,150,148,127,159,136,38,87.0,111.0,-98,-23,-75
93,19,46,1,3,0,206,190,224,186,211,236,239,216,174,238,151,59,105.0,149.0,-92,-87,-5
27,20,46,1,3,0,118,113,119,207,154,160,119,108,151,126,110,41,76.0,92.0,-69,-16,-53
67,21,46,1,3,0,172,200,295,195,243,241,219,279,210,288,180,80,130.0,183.0,-100,-108,8
57,22,46,1,3,0,155,112,155,119,135,185,126,121,118,156,75,46,60.0,92.0,-29,-81,52
136,1,47,2,3,0,140,123,151,184,200,260,330,188,341,384,208,78,143.0,223.0,-130,-176,46
68,2,47,2,3,0,97,87,116,115,160,152,177,216,186,206,142,56,99.0,135.0,-86,-64,-22
45,3,47,2,3,0,68,89,116,92,95,118,103,121,125,115,74,44,59.0,78.0,-30,-41,11
206,4,47,2,3,0,494,429,502,404,587,598,646,461,553,771,253,139,196.0,388.0,-114,-518,404
243,5,47,2,3,0,370,360,435,525,529,541,770,548,657,933,673,263,468.0,623.0,-410,-260,-150
340,6,47,2,3,0,410,494,668,812,815,909,849,800,764,993,964,338,651.0,765.0,-626,-29,-597
430,7,47,2,3,0,689,772,912,798,955,1028,1068,979,957,1332,1011,383,697.0,909.0,-628,-321,-307
102,8,47,2,3,0,124,155,182,158,166,260,200,213,203,275,128,67,98.0,157.0,-61,-147,86
638,9,47,2,3,0,692,651,912,826,970,1165,1341,1182,1660,1546,767,278,522.0,864.0,-489,-779,290
105,10,47,2,3,0,132,118,154,160,138,192,192,181,188,276,186,86,136.0,183.0,-100,-90,-10
984,11,47,2,3,0,1437,1322,1690,1549,1784,2086,2054,2015,2022,2642,2094,991,1542.0,1909.0,-1103,-548,-555
211,12,47,2,3,0,275,317,446,403,446,466,481,368,453,691,614,157,386.0,487.0,-457,-77,-380
330,13,47,2,3,0,527,489,571,550,679,797,728,665,667,773,530,290,410.0,531.0,-240,-243,3
650,14,47,2,3,0,741,998,1156,1405,1588,1680,1676,1390,1577,2409,1865,640,1252.0,1638.0,-1225,-544,-681
663,15,47,2,3,0,1017,1000,1198,1267,1405,1649,1572,1696,1832,2222,1022,501,762.0,1248.0,-521,-1200,679
211,16,47,2,3,0,322,336,378,470,475,562,525,475,492,661,605,178,392.0,481.0,-427,-56,-371
228,17,47,2,3,0,348,380,383,445,414,541,561,481,547,698,488,170,329.0,452.0,-318,-210,-108
246,18,47,2,3,0,232,228,311,284,350,418,427,469,556,601,361,197,279.0,386.0,-164,-240,76
120,19,47,2,3,0,190,228,287,226,287,309,335,246,211,328,161,100,130.0,196.0,-61,-167,106
158,20,47,2,3,0,176,207,287,447,415,439,445,330,373,430,326,140,233.0,299.0,-186,-104,-82
145,21,47,2,3,0,252,248,336,278,349,407,350,449,347,562,349,119,234.0,343.0,-230,-213,-17
53,22,47,2,3,0,136,101,109,89,128,149,133,82,97,100,69,37,53.0,69.0,-32,-31,-1
54,1,48,2,3,0,45,21,27,22,13,27,10,4,41,46,32,19,26.0,32.0,-13,-14,1
91,2,48,2,3,0,170,165,176,148,181,200,159,126,119,169,142,104,123.0,138.0,-38,-27,-11
258,3,48,2,3,0,295,260,348,233,350,323,327,297,353,430,278,168,223.0,292.0,-110,-152,42
30,4,48,2,3,0,230,173,167,151,170,121,96,46,78,112,52,38,45.0,67.0,-14,-60,46
250,5,48,2,3,0,914,753,701,834,869,836,723,408,517,641,617,336,476.0,531.0,-281,-24,-257
119,6,48,2,3,0,281,292,330,322,293,261,211,71,198,190,278,146,212.0,205.0,-132,88,-220
746,7,48,2,3,0,1411,1514,1697,1542,1763,1885,1782,1445,1562,2281,1763,885,1324.0,1643.0,-878,-518,-360
401,8,48,2,3,0,695,566,798,670,854,973,842,579,768,886,691,295,493.0,624.0,-396,-195,-201
471,9,48,2,3,0,851,657,797,730,793,791,821,619,710,1008,472,229,350.0,570.0,-243,-536,293
119,10,48,2,3,0,235,139,170,190,169,185,191,132,192,308,251,110,180.0,223.0,-141,-57,-84
211,11,48,2,3,0,368,309,295,297,299,267,195,95,307,309,370,299,334.0,326.0,-71,61,-132
107,12,48,2,3,0,223,225,303,258,215,138,145,60,177,182,224,84,154.0,163.0,-140,42,-182
941,13,48,2,3,0,1679,1513,1845,1547,1898,2125,1949,1092,1644,1840,1468,940,1204.0,1416.0,-528,-372,-156
362,14,48,2,3,0,746,823,772,817,797,693,546,306,774,911,1101,433,767.0,815.0,-668,190,-858
195,15,48,2,3,0,257,215,232,213,216,202,149,42,380,352,327,197,262.0,292.0,-130,-25,-105
65,16,48,2,3,0,165,159,138,172,121,123,100,46,116,125,211,58,134.0,131.0,-153,86,-239
87,17,48,2,3,0,197,204,204,207,195,142,140,74,141,165,230,105,168.0,167.0,-125,65,-190
130,18,48,2,3,0,327,238,254,259,254,219,159,110,281,215,204,105,154.0,175.0,-99,-11,-88
409,19,48,2,3,0,497,548,622,615,791,715,654,384,528,619,375,317,346.0,437.0,-58,-244,186
54,20,48,2,3,0,127,140,142,167,210,170,119,62,80,104,116,61,88.0,94.0,-55,12,-67
136,21,48,2,3,0,325,347,415,360,504,331,168,145,214,250,261,108,184.0,206.0,-153,11,-164
192,22,48,2,3,0,325,312,349,289,307,328,302,291,350,342,207,144,176.0,231.0,-63,-135,72
151,1,49,1,3,0,143,153,184,190,187,321,371,283,435,596,174,80,127.0,283.0,-94,-422,328
185,2,49,1,3,0,243,214,293,278,391,368,477,514,538,699,444,236,340.0,460.0,-208,-255,47
125,3,49,1,3,0,150,144,231,182,278,328,337,354,323,485,221,94,158.0,267.0,-127,-264,137
289,4,49,1,3,0,424,446,557,512,616,785,877,636,879,1517,309,174,242.0,667.0,-135,-1208,1073
285,5,49,1,3,0,385,442,498,519,553,602,1020,712,770,1305,743,339,541.0,796.0,-404,-562,158
344,6,49,1,3,0,335,430,556,596,658,834,1066,894,964,1597,855,344,600.0,932.0,-511,-742,231
327,7,49,1,3,0,583,765,851,801,793,998,1278,1160,1107,1740,687,383,535.0,937.0,-304,-1053,749
117,8,49,1,3,0,151,162,214,187,206,301,280,282,301,514,192,100,146.0,269.0,-92,-322,230
403,9,49,1,3,0,614,549,687,668,710,890,1382,1240,1586,1899,542,186,364.0,876.0,-356,-1357,1001
110,10,49,1,3,0,187,136,186,226,201,232,277,266,309,514,260,96,178.0,290.0,-164,-254,90
593,11,49,1,3,0,808,744,993,872,955,1345,1406,1396,1446,2279,939,574,756.0,1264.0,-365,-1340,975
199,12,49,1,3,0,209,241,288,279,356,409,638,519,571,900,502,180,341.0,527.0,-322,-398,76
412,13,49,1,3,0,577,540,727,602,725,929,1066,990,1108,1749,708,414,561.0,957.0,-294,-1041,747
557,14,49,1,3,0,612,886,926,1021,1208,1438,1525,1493,1622,2735,1331,509,920.0,1525.0,-822,-1404,582
616,15,49,1,3,0,832,846,1069,1144,1284,1635,1804,1911,2130,3255,1119,581,850.0,1652.0,-538,-2136,1598
210,16,49,1,3,0,282,287,324,375,419,485,678,560,634,1014,597,202,400.0,604.0,-395,-417,22
209,17,49,1,3,0,301,351,355,332,374,473,712,546,606,978,498,212,355.0,563.0,-286,-480,194
184,18,49,1,3,0,226,228,280,250,238,291,406,499,552,782,311,141,226.0,411.0,-170,-471,301
97,19,49,1,3,0,255,208,243,206,229,283,315,299,258,424,127,80,104.0,210.0,-47,-297,250
78,20,49,1,3,0,137,183,177,223,193,277,336,267,309,532,260,104,182.0,299.0,-156,-272,116
154,21,49,1,3,0,215,218,355,227,253,326,373,472,366,620,315,130,222.0,355.0,-185,-305,120
66,22,49,1,3,0,192,157,191,155,137,237,206,170,232,274,80,52,66.0,135.0,-28,-194,166
174,1,50,4,3,0,243,160,176,192,187,249,257,239,345,396,369,177,273.0,314.0,-192,-27,-165
207,2,50,4,3,0,291,200,206,289,300,344,358,406,373,334,203,134,168.0,224.0,-69,-131,62
42,3,50,4,3,0,69,59,78,58,65,160,123,116,59,90,51,29,40.0,57.0,-22,-39,17
87,4,50,4,3,0,199,163,119,141,164,139,203,168,222,242,93,60,76.0,132.0,-33,-149,116
321,5,50,4,3,0,557,450,413,455,488,625,731,758,778,781,288,239,264.0,436.0,-49,-493,444
301,6,50,4,3,0,450,279,349,370,347,570,630,644,607,661,309,266,288.0,412.0,-43,-352,309
572,7,50,4,3,0,731,616,559,584,576,690,772,807,782,994,540,419,480.0,651.0,-121,-454,333
87,8,50,4,3,0,151,126,140,127,162,287,240,200,132,201,88,44,66.0,111.0,-44,-113,69
477,9,50,4,3,0,606,453,438,526,486,516,619,721,938,1135,331,231,281.0,566.0,-100,-804,704
140,10,50,4,3,0,278,158,185,230,205,301,268,247,370,403,140,92,116.0,212.0,-48,-263,215
885,11,50,4,3,0,1579,700,765,791,837,1017,1020,1227,1286,1781,805,710,758.0,1099.0,-95,-976,881
173,12,50,4,3,0,320,223,276,230,221,285,391,438,444,431,157,97,127.0,228.0,-60,-274,214
484,13,50,4,3,0,668,556,558,552,574,734,729,766,589,806,391,375,383.0,524.0,-16,-415,399
528,14,50,4,3,0,738,578,632,668,840,854,777,834,729,896,363,334,348.0,531.0,-29,-533,504
475,15,50,4,3,0,865,493,406,443,507,510,573,616,797,1044,341,386,364.0,590.0,45,-703,748
194,16,50,4,3,0,391,284,238,303,280,357,375,452,413,461,270,123,196.0,285.0,-147,-191,44
182,17,50,4,3,0,341,224,235,250,255,292,394,414,458,478,157,99,128.0,245.0,-58,-321,263
266,18,50,4,3,0,489,293,325,290,310,328,339,397,455,593,250,154,202.0,332.0,-96,-343,247
75,19,50,4,3,0,145,108,118,118,139,151,144,114,136,149,45,36,40.0,77.0,-9,-104,95
148,20,50,4,3,0,262,167,239,459,311,410,422,402,422,475,136,124,130.0,245.0,-12,-339,327
188,21,50,4,3,0,280,319,382,320,375,494,446,595,355,464,194,145,170.0,268.0,-49,-270,221
82,22,50,4,3,0,198,154,180,125,146,202,237,176,82,87,40,47,44.0,58.0,7,-47,54
288,1,51,2,3,0,375,266,306,267,258,427,420,355,228,579,371,131,251.0,360.0,-240,-208,-32
179,2,51,2,3,0,225,152,177,118,180,214,200,244,165,338,215,134,174.0,229.0,-81,-123,42
59,3,51,2,3,0,44,26,58,32,43,34,40,41,43,48,41,28,34.0,39.0,-13,-7,-6
110,4,51,2,3,0,327,244,264,181,202,267,304,268,372,383,131,61,96.0,192.0,-70,-252,182
428,5,51,2,3,0,488,398,410,336,352,370,632,431,484,820,550,286,418.0,552.0,-264,-270,6
432,6,51,2,3,0,403,387,411,362,305,443,521,495,362,758,508,322,415.0,529.0,-186,-250,64
320,7,51,2,3,0,457,424,368,316,303,357,410,423,383,729,410,227,318.0,455.0,-183,-319,136
53,8,51,2,3,0,102,63,71,48,59,51,78,61,91,136,74,57,66.0,89.0,-17,-62,45
1072,9,51,2,3,0,1121,875,992,904,879,1153,1298,1305,1034,2232,1023,444,734.0,1233.0,-579,-1209,630
160,10,51,2,3,0,249,172,201,169,192,217,237,215,191,328,208,107,158.0,214.0,-101,-120,19
1023,11,51,2,3,0,1427,1017,1202,877,845,1153,1190,1239,807,1846,1142,747,944.0,1245.0,-395,-704,309
237,12,51,2,3,0,249,182,202,165,177,232,306,226,131,436,290,111,200.0,279.0,-179,-146,-33
265,13,51,2,3,0,327,290,285,257,243,316,360,308,272,475,287,194,240.0,319.0,-93,-188,95
457,14,51,2,3,0,491,439,424,404,405,509,554,543,420,747,459,249,354.0,485.0,-210,-288,78
780,15,51,2,3,0,993,723,767,644,614,743,824,856,695,1454,752,503,628.0,903.0,-249,-702,453
246,16,51,2,3,0,257,224,213,257,205,250,304,278,190,481,312,158,235.0,317.0,-154,-169,15
263,17,51,2,3,0,320,299,303,226,226,283,329,289,235,425,324,139,232.0,296.0,-185,-101,-84
395,18,51,2,3,0,514,351,414,293,354,411,469,472,415,699,508,260,384.0,489.0,-248,-191,-57
82,19,51,2,3,0,156,120,126,118,94,128,154,125,64,125,66,52,59.0,81.0,-14,-59,45
288,20,51,2,3,0,399,316,243,316,279,300,389,322,256,548,310,185,248.0,348.0,-125,-238,113
124,21,51,2,3,0,154,172,180,121,162,175,188,226,181,259,170,96,133.0,175.0,-74,-89,15
76,22,51,2,3,0,121,105,118,92,95,86,84,67,65,115,61,52,56.0,76.0,-9,-54,45
338,1,52,1,3,0,439,284,312,308,315,327,336,292,421,473,415,199,307.0,362.0,-216,-58,-158
353,2,52,1,3,0,268,226,239,271,381,320,316,363,485,535,500,259,380.0,431.0,-241,-35,-206
208,3,52,1,3,0,159,124,177,198,210,230,224,233,229,234,273,129,201.0,212.0,-144,39,-183
402,4,52,1,3,0,489,359,374,335,454,424,442,429,500,681,534,295,414.0,503.0,-239,-147,-92
540,5,52,1,3,0,509,498,454,508,557,495,659,704,743,849,933,442,688.0,741.0,-491,84,-575
210,6,52,1,3,0,226,184,207,204,219,249,314,271,334,368,404,198,301.0,323.0,-206,36,-242
595,7,52,1,3,0,517,505,542,531,579,617,771,679,776,936,911,376,644.0,741.0,-535,-25,-510
141,8,52,1,3,0,155,129,125,128,113,131,135,142,208,244,213,113,163.0,190.0,-100,-31,-69
1068,9,52,1,3,0,1193,876,978,1056,1120,1145,1408,1392,1836,2078,1526,521,1024.0,1375.0,-1005,-552,-453
236,10,52,1,3,0,248,190,185,216,203,212,207,208,246,317,323,145,234.0,262.0,-178,6,-184
589,11,52,1,3,0,578,403,502,513,553,616,611,660,847,820,821,461,641.0,701.0,-360,1,-361
164,12,52,1,3,0,232,156,222,179,206,215,215,187,249,262,297,113,205.0,224.0,-184,35,-219
483,13,52,1,3,0,398,396,448,411,475,528,576,625,746,750,758,431,594.0,646.0,-327,8,-335
615,14,52,1,3,0,596,488,554,520,548,623,596,604,752,820,826,447,636.0,698.0,-379,6,-385
401,15,52,1,3,0,435,299,309,330,357,379,387,524,623,684,550,252,401.0,495.0,-298,-134,-164
299,16,52,1,3,0,291,252,255,280,268,311,346,310,385,425,481,197,339.0,368.0,-284,56,-340
383,17,52,1,3,0,378,270,349,338,350,384,424,364,460,493,505,239,372.0,412.0,-266,12,-278
217,18,52,1,3,0,290,209,200,169,259,222,223,268,329,338,400,163,282.0,300.0,-237,62,-299
274,19,52,1,3,0,305,230,303,292,281,324,364,303,369,450,249,117,183.0,272.0,-132,-201,69
403,20,52,1,3,0,424,365,346,440,402,372,406,400,540,575,576,284,430.0,478.0,-292,1,-293
272,21,52,1,3,0,276,242,263,225,299,275,293,365,346,404,376,178,277.0,319.0,-198,-28,-170
341,22,52,1,3,0,363,293,273,325,359,356,331,302,341,410,324,206,265.0,313.0,-118,-86,-32
180,1,53,2,3,0,307,248,310,413,581,617,628,446,636,846,241,179,210.0,422.0,-62,-605,543
117,2,53,2,3,0,154,145,172,143,197,189,278,304,365,493,290,145,218.0,309.0,-145,-203,58
119,3,53,2,3,0,111,109,155,125,168,136,222,206,310,562,284,123,204.0,323.0,-161,-278,117
55,4,53,2,3,0,412,270,321,429,521,473,498,257,444,824,105,71,88.0,333.0,-34,-719,685
400,5,53,2,3,0,584,606,603,636,717,777,1042,762,1080,1730,983,504,744.0,1072.0,-479,-747,268
593,6,53,2,3,0,404,412,563,701,945,973,1078,1023,1260,2243,1186,528,857.0,1319.0,-658,-1057,399
503,7,53,2,3,0,851,1042,1265,1160,1176,1294,1622,1536,1637,2998,1261,553,907.0,1604.0,-708,-1737,1029
140,8,53,2,3,0,144,177,203,154,257,272,308,299,372,645,313,178,246.0,379.0,-135,-332,197
855,9,53,2,3,0,608,631,1027,923,1121,1670,1369,1274,1967,3191,905,337,621.0,1478.0,-568,-2286,1718
227,10,53,2,3,0,141,105,142,190,192,188,232,252,337,697,471,179,325.0,449.0,-292,-226,-66
777,11,53,2,3,0,1242,1231,1592,1724,1702,2067,2163,1918,2283,3836,1631,972,1302.0,2146.0,-659,-2205,1546
229,12,53,2,3,0,244,251,345,361,411,440,542,547,676,1270,658,229,444.0,719.0,-429,-612,183
442,13,53,2,3,0,511,495,710,678,854,909,987,969,1064,2232,950,551,750.0,1244.0,-399,-1282,883
807,14,53,2,3,0,634,824,900,1091,1257,1337,1548,1431,1720,3243,1894,828,1361.0,1988.0,-1066,-1349,283
328,15,53,2,3,0,712,672,814,952,886,1003,1067,1140,1205,1850,574,328,451.0,917.0,-246,-1276,1030
256,16,53,2,3,0,379,335,349,502,356,435,576,710,866,1354,755,244,500.0,784.0,-511,-599,88
403,17,53,2,3,0,360,426,538,599,590,709,844,687,982,1756,938,322,630.0,1005.0,-616,-818,202
250,18,53,2,3,0,249,221,268,357,422,486,645,645,746,1041,462,182,322.0,562.0,-280,-579,299
144,19,53,2,3,0,177,163,241,231,300,418,415,275,422,561,181,92,136.0,278.0,-89,-380,291
195,20,53,2,3,0,299,375,484,631,758,749,722,571,643,1136,557,231,394.0,641.0,-326,-579,253
275,21,53,2,3,0,254,261,399,506,811,726,652,682,805,1567,639,298,468.0,835.0,-341,-928,587
72,22,53,2,3,0,119,141,163,123,259,159,164,109,207,305,102,62,82.0,156.0,-40,-203,163
32,1,54,1,3,0,117,95,90,87,88,90,112,64,139,159,95,31,63.0,95.0,-64,-64,0
58,2,54,1,3,0,132,81,108,54,102,103,88,129,116,195,181,91,136.0,156.0,-90,-14,-76
110,3,54,1,3,0,183,174,223,139,192,148,178,215,227,336,327,113,220.0,259.0,-214,-9,-205
29,4,54,1,3,0,188,157,103,119,110,107,124,113,153,246,99,35,67.0,127.0,-64,-147,83
108,5,54,1,3,0,263,231,201,164,169,165,260,194,267,387,398,155,276.0,313.0,-243,11,-254
103,6,54,1,3,0,241,207,206,161,192,228,277,262,301,471,484,121,302.0,359.0,-363,13,-376
300,7,54,1,3,0,548,574,604,450,433,565,670,629,591,961,723,263,493.0,649.0,-460,-238,-222
59,8,54,1,3,0,100,103,114,81,88,106,92,114,133,167,149,66,108.0,127.0,-83,-18,-65
44,9,54,1,3,0,174,156,103,107,99,112,111,142,134,176,97,19,58.0,97.0,-78,-79,1
31,10,54,1,3,0,90,53,59,61,36,46,27,44,52,62,66,20,43.0,49.0,-46,4,-50
137,11,54,1,3,0,420,362,365,291,216,275,222,289,312,450,333,168,250.0,317.0,-165,-117,-48
58,12,54,1,3,0,142,129,162,110,96,123,158,141,164,252,264,69,166.0,195.0,-195,12,-207
165,13,54,1,3,0,265,258,283,231,209,251,268,281,338,473,362,182,272.0,339.0,-180,-111,-69
223,14,54,1,3,0,456,508,440,420,458,438,436,457,535,679,669,213,441.0,520.0,-456,-10,-446
54,15,54,1,3,0,179,148,165,119,117,144,152,167,161,255,131,59,95.0,148.0,-72,-124,52
110,16,54,1,3,0,218,242,217,211,166,169,231,258,278,385,450,105,278.0,313.0,-345,65,-410
262,17,54,1,3,0,388,395,357,324,322,320,453,378,533,776,857,222,540.0,618.0,-635,81,-716
20,18,54,1,3,0,87,42,60,45,47,38,50,51,83,65,41,21,31.0,42.0,-20,-24,4
66,19,54,1,3,0,129,125,118,82,101,115,152,128,129,166,109,50,80.0,108.0,-59,-57,-2
77,20,54,1,3,0,209,189,156,162,125,149,157,175,189,306,256,58,157.0,207.0,-198,-50,-148
190,21,54,1,3,0,335,296,319,224,270,298,329,421,381,634,493,193,343.0,440.0,-300,-141,-159
96,22,54,1,3,0,190,188,152,109,132,165,141,126,204,277,131,70,100.0,159.0,-61,-146,85
95,1,55,1,3,0,199,164,165,139,164,176,188,167,211,361,138,71,104.0,190.0,-67,-223,156
256,2,55,1,3,0,412,328,421,327,407,402,486,521,434,743,406,299,352.0,483.0,-107,-337,230
211,3,55,1,3,0,274,265,289,218,256,255,374,366,390,683,304,135,220.0,374.0,-169,-379,210
121,4,55,1,3,0,434,345,391,298,365,388,458,302,357,675,173,56,114.0,301.0,-117,-502,385
782,5,55,1,3,0,1383,1313,1243,1067,1135,1222,1530,1137,1318,2057,1186,681,934.0,1308.0,-505,-871,366
213,6,55,1,3,0,408,413,407,292,363,463,479,476,493,865,574,194,384.0,544.0,-380,-291,-89
412,7,55,1,3,0,778,983,935,718,720,875,922,870,894,1538,723,282,502.0,848.0,-441,-815,374
254,8,55,1,3,0,339,383,469,311,358,454,470,495,510,974,417,214,316.0,535.0,-203,-557,354
493,9,55,1,3,0,692,629,703,576,557,610,730,702,768,1105,569,259,414.0,644.0,-310,-536,226
165,10,55,1,3,0,209,154,242,164,182,175,217,208,212,406,260,101,180.0,256.0,-159,-146,-13
409,11,55,1,3,0,745,631,724,557,652,768,765,828,786,1332,698,402,550.0,811.0,-296,-634,338
193,12,55,1,3,0,235,288,311,262,276,281,350,363,356,774,420,110,265.0,435.0,-310,-354,44
516,13,55,1,3,0,744,724,862,614,693,937,936,974,964,2069,891,397,644.0,1119.0,-494,-1178,684
387,14,55,1,3,0,715,892,850,682,796,900,924,913,934,1916,1026,330,678.0,1091.0,-696,-890,194
281,15,55,1,3,0,572,541,581,492,491,561,604,663,556,982,370,195,282.0,516.0,-175,-612,437
159,16,55,1,3,0,265,278,276,303,276,301,385,300,389,721,401,105,253.0,409.0,-296,-320,24
298,17,55,1,3,0,514,623,562,511,551,548,722,567,687,1290,631,205,418.0,709.0,-426,-659,233
138,18,55,1,3,0,218,190,170,135,152,178,217,240,253,385,180,95,138.0,220.0,-85,-205,120
181,19,55,1,3,0,237,238,223,208,212,251,209,211,226,330,135,104,120.0,190.0,-31,-195,164
464,20,55,1,3,0,800,797,796,935,790,970,909,844,751,1420,661,420,540.0,834.0,-241,-759,518
336,21,55,1,3,0,501,575,671,425,496,540,574,623,639,1234,604,184,394.0,674.0,-420,-630,210
111,22,55,1,3,0,176,124,152,127,131,146,126,126,150,236,76,111,94.0,141.0,35,-160,195
198,1,56,1,3,0,239,247,291,237,275,484,500,412,620,805,357,95,226.0,419.0,-262,-448,186
522,2,56,1,3,0,481,450,444,342,521,806,851,856,921,1249,829,418,624.0,832.0,-411,-420,9
415,3,56,1,3,0,315,336,322,265,347,507,500,528,675,925,601,288,444.0,605.0,-313,-324,11
313,4,56,1,3,0,478,446,455,384,534,743,672,532,779,1421,437,212,324.0,690.0,-225,-984,759
1084,5,56,1,3,0,1148,1182,899,922,1077,1757,2178,1620,1861,2915,2183,903,1543.0,2000.0,-1280,-732,-548
330,6,56,1,3,0,365,405,383,373,395,690,798,757,934,1307,1141,304,722.0,917.0,-837,-166,-671
569,7,56,1,3,0,611,792,689,593,668,1173,1160,1214,1192,1610,1006,389,698.0,1002.0,-617,-604,-13
368,8,56,1,3,0,325,308,304,235,316,582,505,511,601,970,406,198,302.0,525.0,-208,-564,356
825,9,56,1,3,0,689,958,928,799,758,1347,1576,1507,1902,2685,1203,341,772.0,1410.0,-862,-1482,620
235,10,56,1,3,0,267,191,230,206,193,394,347,352,440,665,433,149,291.0,416.0,-284,-232,-52
861,11,56,1,3,0,887,1007,951,861,1014,1794,1646,1598,1955,2752,1481,650,1066.0,1628.0,-831,-1271,440
229,12,56,1,3,0,214,275,281,260,281,443,510,475,511,802,624,159,392.0,528.0,-465,-178,-287
608,13,56,1,3,0,562,650,653,522,624,985,1009,905,1021,1551,970,478,724.0,1000.0,-492,-581,89
672,14,56,1,3,0,628,786,747,679,846,1361,1342,1399,1530,2696,1928,502,1215.0,1709.0,-1426,-768,-658
530,15,56,1,3,0,535,675,710,572,720,1247,1320,1351,1499,2124,704,292,498.0,1040.0,-412,-1420,1008
313,16,56,1,3,0,307,317,322,323,347,614,653,620,794,1252,837,201,519.0,763.0,-636,-415,-221
671,17,56,1,3,0,596,697,623,625,741,1241,1383,1339,1478,2360,1657,503,1080.0,1507.0,-1154,-703,-451
211,18,56,1,3,0,235,287,264,213,231,425,414,399,601,698,428,129,278.0,418.0,-299,-270,-29
226,19,56,1,3,0,230,240,206,200,191,375,331,306,361,459,235,125,180.0,273.0,-110,-224,114
896,20,56,1,3,0,1012,1031,877,1159,994,1592,1671,1487,1581,2727,1846,758,1302.0,1777.0,-1088,-881,-207
426,21,56,1,3,0,513,636,634,391,538,758,764,827,896,1319,905,333,619.0,852.0,-572,-414,-158
199,22,56,1,3,0,173,167,152,156,136,271,219,256,312,397,173,117,145.0,229.0,-56,-224,168
28,1,57,3,3,0,81,54,48,33,25,37,28,27,30,34,19,29,24.0,27.0,10,-15,25
1187,2,57,3,3,0,1751,1315,1335,1170,1342,1395,1639,1736,1547,1939,1680,1190,1435.0,1603.0,-490,-259,-231
117,3,57,3,3,0,83,96,80,81,79,74,107,93,105,108,54,78,66.0,80.0,24,-54,78
157,4,57,3,3,0,229,233,214,173,229,238,282,198,305,504,106,118,112.0,243.0,12,-398,410
678,5,57,3,3,0,1205,892,875,682,620,742,717,655,773,955,603,645,624.0,734.0,42,-352,394
191,6,57,3,3,0,323,285,216,207,172,194,197,214,225,272,216,223,220.0,237.0,7,-56,63
513,7,57,3,3,0,721,695,659,545,644,631,622,551,636,1105,629,541,585.0,758.0,-88,-476,388
127,8,57,3,3,0,270,155,157,114,131,103,137,118,161,233,166,115,140.0,171.0,-51,-67,16
757,9,57,3,3,0,1291,948,890,830,568,627,644,624,713,866,346,505,426.0,572.0,159,-520,679
85,10,57,3,3,0,173,97,104,62,69,50,93,63,75,97,92,50,71.0,80.0,-42,-5,-37
857,11,57,3,3,0,992,724,727,654,653,752,766,763,871,1150,610,843,726.0,868.0,233,-540,773
105,12,57,3,3,0,183,155,161,110,121,107,134,92,117,148,132,89,110.0,123.0,-43,-16,-27
685,13,57,3,3,0,811,606,636,506,529,574,561,554,769,983,537,616,576.0,712.0,79,-446,525
753,14,57,3,3,0,1260,1027,934,847,759,825,703,746,952,1314,922,778,850.0,1005.0,-144,-392,248
511,15,57,3,3,0,934,557,549,457,405,385,451,456,466,653,312,498,405.0,488.0,186,-341,527
482,16,57,3,3,0,859,536,538,476,513,518,582,592,590,903,514,438,476.0,618.0,-76,-389,313
375,17,57,3,3,0,656,598,440,429,353,375,366,327,426,575,405,314,360.0,431.0,-91,-170,79
157,18,57,3,3,0,270,206,172,148,152,164,156,179,175,195,85,140,112.0,140.0,55,-110,165
236,19,57,3,3,0,331,272,228,230,212,192,216,260,281,370,158,187,172.0,238.0,29,-212,241
771,20,57,3,3,0,1037,781,700,668,554,592,643,645,706,955,636,643,640.0,745.0,7,-319,326
198,21,57,3,3,0,321,306,283,187,180,190,227,209,280,324,195,155,175.0,225.0,-40,-129,89
67,22,57,3,3,0,134,124,103,81,47,88,70,59,76,90,35,48,42.0,58.0,13,-55,68
74,1,58,2,3,0,116,114,110,134,139,176,218,159,193,281,60,52,56.0,131.0,-8,-221,213
130,2,58,2,3,0,124,127,149,132,201,192,241,224,227,356,181,119,150.0,219.0,-62,-175,113
81,3,58,2,3,0,100,61,89,103,103,63,86,129,183,244,117,67,92.0,143.0,-50,-127,77
132,4,58,2,3,0,520,398,466,501,463,464,472,326,417,805,105,52,78.0,321.0,-53,-700,647
505,5,58,2,3,0,939,830,726,715,739,855,1133,824,910,1456,816,454,635.0,909.0,-362,-640,278
133,6,58,2,3,0,164,160,209,240,323,314,310,267,287,463,251,96,174.0,270.0,-155,-212,57
311,7,58,2,3,0,501,593,571,548,646,773,797,679,738,1182,600,283,442.0,688.0,-317,-582,265
135,8,58,2,3,0,200,167,199,121,199,221,226,243,264,497,192,96,144.0,262.0,-96,-305,209
271,9,58,2,3,0,374,342,351,384,378,429,596,574,615,869,297,127,212.0,431.0,-170,-572,402
136,10,58,2,3,0,162,108,140,126,161,139,167,205,233,425,254,71,162.0,250.0,-183,-171,-12
342,11,58,2,3,0,606,574,521,545,683,706,761,731,749,1017,461,270,366.0,583.0,-191,-556,365
84,12,58,2,3,0,127,126,110,128,145,145,229,198,198,315,211,60,136.0,195.0,-151,-104,-47
398,13,58,2,3,0,446,455,480,501,551,690,771,682,755,1430,754,390,572.0,858.0,-364,-676,312
371,14,58,2,3,0,500,524,534,645,779,871,851,876,865,1601,892,268,580.0,920.0,-624,-709,85
170,15,58,2,3,0,280,246,271,509,410,370,1437,406,420,845,174,81,128.0,367.0,-93,-671,578
47,16,58,2,3,0,139,112,83,118,124,88,110,128,133,246,134,39,86.0,140.0,-95,-112,17
231,17,58,2,3,0,398,280,324,325,335,319,439,335,447,756,439,130,284.0,442.0,-309,-317,8
67,18,58,2,3,0,105,96,92,93,116,102,142,175,166,247,102,51,76.0,133.0,-51,-145,94
29,19,58,2,3,0,64,60,48,65,77,81,68,54,102,113,47,21,34.0,60.0,-26,-66,40
298,20,58,2,3,0,570,694,1791,780,781,1602,764,548,596,1578,630,283,456.0,830.0,-347,-948,601
261,21,58,2,3,0,384,352,349,347,435,453,455,455,558,938,498,189,344.0,542.0,-309,-440,131
21,22,58,2,3,0,20,14,19,35,25,28,17,16,45,45,7,10,8.0,21.0,3,-38,41
223,1,59,2,3,0,766,615,1911,902,547,590,1049,393,448,746,228,125,176.0,366.0,-103,-518,415
68,2,59,2,3,0,301,236,299,183,317,301,410,266,224,235,105,67,86.0,136.0,-38,-130,92
95,3,59,2,3,0,210,170,205,129,178,248,263,289,273,340,208,63,136.0,204.0,-145,-132,-13
64,4,59,2,3,0,210,198,2153,193,216,265,2528,156,179,362,72,29,50.0,154.0,-43,-290,247
246,5,59,2,3,0,978,987,918,779,942,1243,1666,730,631,1027,542,251,396.0,607.0,-291,-485,194
232,6,59,2,3,0,521,577,609,647,742,968,961,755,678,1434,792,244,518.0,823.0,-548,-642,94
341,7,59,2,3,0,1597,1972,2081,1738,2176,2848,2646,1380,1053,1685,823,326,574.0,945.0,-497,-862,365
162,8,59,2,3,0,332,357,466,412,468,657,660,386,479,604,321,126,224.0,350.0,-195,-283,88
374,9,59,2,3,0,1067,835,808,584,546,819,1623,936,1038,1493,451,130,290.0,691.0,-321,-1042,721
136,10,59,2,3,0,289,222,206,200,234,316,360,349,312,543,250,76,163.0,290.0,-174,-293,119
751,11,59,2,3,0,2036,1793,2058,1654,1827,2527,2388,1650,1467,2828,1205,656,930.0,1563.0,-549,-1623,1074
232,12,59,2,3,0,401,428,462,351,450,511,752,626,577,1241,549,138,344.0,643.0,-411,-692,281
293,13,59,2,3,0,745,818,940,856,987,1387,1606,840,561,1020,602,249,426.0,624.0,-353,-418,65
512,14,59,2,3,0,1036,1237,1242,1377,1416,1736,1669,959,1021,1584,992,320,656.0,965.0,-672,-592,-80
342,15,59,2,3,0,854,706,739,693,717,1019,1203,828,859,1272,386,193,290.0,617.0,-193,-886,693
272,16,59,2,3,0,611,623,602,550,430,713,769,691,751,1208,523,161,342.0,631.0,-362,-685,323
232,17,59,2,3,0,532,566,595,580,641,816,847,522,619,891,508,132,320.0,510.0,-376,-383,7
106,18,59,2,3,0,172,152,204,142,221,243,304,268,291,431,173,74,124.0,226.0,-99,-258,159
75,19,59,2,3,0,182,229,277,157,228,366,291,139,186,225,91,51,71.0,122.0,-40,-134,94
53,20,59,2,3,0,210,204,174,226,215,324,310,182,148,242,128,33,80.0,134.0,-95,-114,19
143,21,59,2,3,0,391,524,533,558,687,656,661,278,275,432,182,64,123.0,226.0,-118,-250,132
33,22,59,2,3,0,110,100,111,89,97,146,137,83,61,140,53,29,41.0,74.0,-24,-87,63
128,1,60,1,3,0,149,133,134,134,141,138,161,113,162,163,142,84,113.0,130.0,-58,-21,-37
119,2,60,1,3,0,107,85,86,94,141,123,111,95,152,131,146,84,115.0,120.0,-62,15,-77
62,3,60,1,3,0,55,64,107,75,84,71,81,97,81,90,83,41,62.0,71.0,-42,-7,-35
74,4,60,1,3,0,85,87,95,97,119,87,131,79,100,123,88,65,76.0,92.0,-23,-35,12
223,5,60,1,3,0,228,225,215,255,232,227,447,284,279,330,341,184,262.0,285.0,-157,11,-168
149,6,60,1,3,0,134,119,161,145,138,167,182,170,183,198,254,107,180.0,186.0,-147,56,-203
162,7,60,1,3,0,124,180,157,181,138,136,198,152,160,191,159,74,116.0,141.0,-85,-32,-53
46,8,60,1,3,0,17,25,37,27,30,36,34,32,31,28,41,25,33.0,31.0,-16,13,-29
527,9,60,1,3,0,429,345,479,470,487,435,593,541,658,638,568,264,416.0,490.0,-304,-70,-234
197,10,60,1,3,0,156,161,164,160,151,154,208,163,172,213,297,121,209.0,210.0,-176,84,-260
408,11,60,1,3,0,341,313,360,325,317,361,402,385,402,439,430,213,322.0,361.0,-217,-9,-208
101,12,60,1,3,0,64,44,75,70,82,64,94,87,76,120,103,50,76.0,91.0,-53,-17,-36
116,13,60,1,3,0,90,92,88,94,88,102,92,82,85,95,109,50,80.0,85.0,-59,14,-73
142,14,60,1,3,0,107,141,117,126,120,123,153,141,134,164,130,78,104.0,124.0,-52,-34,-18
307,15,60,1,3,0,242,287,301,272,322,299,308,339,364,397,466,185,326.0,349.0,-281,69,-350
200,16,60,1,3,0,162,187,145,190,155,179,232,184,244,236,270,129,200.0,212.0,-141,34,-175
330,17,60,1,3,0,254,290,293,279,299,298,395,308,355,445,519,215,367.0,393.0,-304,74,-378
96,18,60,1,3,0,88,69,99,64,92,91,93,87,125,99,145,57,101.0,100.0,-88,46,-134
109,19,60,1,3,0,120,97,133,116,136,158,194,115,126,155,89,59,74.0,101.0,-30,-66,36
140,20,60,1,3,0,110,159,135,304,146,146,203,173,179,214,160,89,124.0,154.0,-71,-54,-17
228,21,60,1,3,0,179,190,260,217,273,229,256,263,252,263,274,154,214.0,230.0,-120,11,-131
91,22,60,1,3,0,89,80,70,81,75,75,68,54,66,57,65,35,50.0,52.0,-30,8,-38
264,1,1,1,4,0,266,271,235,260,162,265,228,369,374,305,193,309,251.0,269.0,116,-112,228
243,2,1,1,4,0,216,308,279,419,246,217,310,402,456,434,194,302,248.0,310.0,108,-240,348
176,3,1,1,4,0,149,236,164,187,153,157,178,204,219,180,128,201,164.0,170.0,73,-52,125
340,4,1,1,4,0,404,445,351,322,244,337,371,460,563,468,432,472,452.0,457.0,40,-36,76
337,5,1,1,4,0,373,360,329,335,345,623,350,453,570,500,253,378,316.0,377.0,125,-247,372
155,6,1,1,4,0,155,154,138,108,127,159,136,179,226,198,76,132,104.0,135.0,56,-122,178
484,7,1,1,4,0,482,482,353,339,259,422,394,483,601,468,290,412,351.0,390.0,122,-178,300
182,8,1,1,4,0,211,250,166,178,189,194,233,215,260,248,146,249,198.0,214.0,103,-102,205
2368,9,1,1,4,0,2080,2897,2187,2183,1804,2265,2711,3532,3800,2692,1680,2958,2319.0,2443.0,1278,-1012,2290
277,10,1,1,4,0,259,363,291,276,249,267,349,472,505,425,248,383,316.0,352.0,135,-177,312
617,11,1,1,4,0,629,780,561,554,569,631,764,871,1010,800,486,817,652.0,701.0,331,-314,645
154,12,1,1,4,0,143,167,149,136,95,156,166,204,262,236,78,191,134.0,168.0,113,-158,271
311,13,1,1,4,0,254,280,252,227,235,225,228,291,305,260,190,297,244.0,249.0,107,-70,177
393,14,1,1,4,0,394,313,330,384,256,301,351,521,505,405,250,355,302.0,337.0,105,-155,260
561,15,1,1,4,0,483,638,453,457,422,545,702,660,865,633,409,621,515.0,554.0,212,-224,436
423,16,1,1,4,0,368,357,440,329,325,381,447,480,474,497,228,445,336.0,390.0,217,-269,486
304,17,1,1,4,0,266,308,275,250,286,299,327,364,474,347,174,297,236.0,273.0,123,-173,296
209,18,1,1,4,0,287,307,223,276,226,258,368,331,404,292,181,307,244.0,260.0,126,-111,237
692,19,1,1,4,0,807,900,645,700,556,721,769,941,997,650,566,775,670.0,664.0,209,-84,293
107,20,1,1,4,0,106,114,181,131,111,101,120,155,199,115,72,126,99.0,104.0,54,-43,97
292,21,1,1,4,0,259,414,206,262,204,187,324,393,440,305,219,295,257.0,273.0,76,-86,162
305,22,1,1,4,0,356,398,288,194,351,302,310,458,461,292,234,401,318.0,309.0,167,-58,225
321,1,2,2,4,0,342,349,376,356,410,417,271,639,518,268,263,442,352.0,324.0,179,-5,184
325,2,2,2,4,0,246,290,259,337,266,368,334,609,519,292,264,403,334.0,320.0,139,-28,167
260,3,2,2,4,0,191,270,175,231,216,208,216,370,337,175,149,316,232.0,213.0,167,-26,193
369,4,2,2,4,0,412,406,405,459,464,449,231,675,811,368,359,470,414.0,399.0,111,-9,120
700,5,2,2,4,0,758,701,656,684,758,1227,469,1053,1125,657,560,806,683.0,674.0,246,-97,343
315,6,2,2,4,0,232,224,252,293,358,325,253,574,507,301,225,317,271.0,281.0,92,-76,168
1229,7,2,2,4,0,1100,977,862,990,917,1222,876,1567,1574,775,729,1060,894.0,855.0,331,-46,377
358,8,2,2,4,0,314,339,253,284,382,372,320,590,571,290,239,407,323.0,312.0,168,-51,219
8733,9,2,2,4,0,7234,9327,8266,8709,10596,10140,6925,13598,11515,5136,4688,10371,7530.0,6732.0,5683,-448,6131
832,10,2,2,4,0,658,835,723,792,866,969,642,1386,1258,750,559,1074,816.0,794.0,515,-191,706
1828,11,2,2,4,0,1655,2026,1678,1827,2216,2075,1763,3112,2877,1445,1635,2184,1910.0,1755.0,549,190,359
463,12,2,2,4,0,359,396,344,400,420,535,356,595,741,435,311,545,428.0,430.0,234,-124,358
1025,13,2,2,4,0,591,633,520,604,569,722,520,1137,974,498,486,847,666.0,610.0,361,-12,373
944,14,2,2,4,0,698,673,695,718,785,808,565,1273,1234,645,486,968,727.0,700.0,482,-159,641
1744,15,2,2,4,0,1539,1625,1420,1737,1785,1658,1293,2709,2467,1135,1205,1969,1587.0,1436.0,764,70,694
619,16,2,2,4,0,713,668,835,675,883,908,742,1001,1050,703,508,734,621.0,648.0,226,-195,421
687,17,2,2,4,0,683,657,625,567,721,958,582,1112,1192,689,445,769,607.0,634.0,324,-244,568
1181,18,2,2,4,0,1127,1467,1202,1533,1388,1310,817,2205,1578,856,899,1607,1253.0,1121.0,708,43,665
1837,19,2,2,4,0,1870,2279,1544,2253,2301,1915,1064,2892,2161,1110,1306,1905,1606.0,1440.0,599,196,403
259,20,2,2,4,0,213,199,327,300,319,331,173,470,398,244,215,285,250.0,248.0,70,-29,99
435,21,2,2,4,0,320,486,412,553,492,462,375,582,607,340,260,369,314.0,323.0,109,-80,189
639,22,2,2,4,0,626,765,687,670,1107,843,480,1076,1018,447,521,1186,854.0,718.0,665,74,591
162,1,3,1,4,0,184,219,211,160,159,169,112,163,167,157,101,187,144.0,148.0,86,-56,142
226,2,3,1,4,0,260,265,254,351,309,270,218,354,350,290,213,293,253.0,265.0,80,-77,157
241,3,3,1,4,0,228,261,237,261,246,234,155,184,233,279,174,228,201.0,227.0,54,-105,159
524,4,3,1,4,0,670,627,552,633,554,583,457,611,677,549,387,627,507.0,521.0,240,-162,402
355,5,3,1,4,0,327,372,413,373,319,387,300,411,434,516,235,377,306.0,376.0,142,-281,423
116,6,3,1,4,0,116,119,126,118,108,157,129,128,138,176,83,127,105.0,129.0,44,-93,137
334,7,3,1,4,0,317,345,393,358,328,376,327,415,400,420,235,353,294.0,336.0,118,-185,303
173,8,3,1,4,0,161,165,161,170,152,135,111,141,197,179,103,189,146.0,157.0,86,-76,162
1536,9,3,1,4,0,1472,1652,1649,1691,1490,1683,1421,1989,1829,1713,1159,1738,1448.0,1537.0,579,-554,1133
149,10,3,1,4,0,157,187,179,178,141,192,165,181,173,211,121,197,159.0,176.0,76,-90,166
386,11,3,1,4,0,393,413,417,373,340,401,333,437,427,470,296,446,371.0,404.0,150,-174,324
112,12,3,1,4,0,95,119,89,94,84,108,90,107,109,126,55,113,84.0,98.0,58,-71,129
364,13,3,1,4,0,302,305,302,324,321,309,274,302,328,389,251,371,311.0,337.0,120,-138,258
306,14,3,1,4,0,323,298,340,309,300,327,262,352,337,377,202,331,266.0,303.0,129,-175,304
335,15,3,1,4,0,357,357,351,316,352,336,342,428,424,401,264,349,306.0,338.0,85,-137,222
255,16,3,1,4,0,242,242,268,203,201,303,211,267,280,321,189,271,230.0,260.0,82,-132,214
262,17,3,1,4,0,237,248,277,255,193,250,211,244,275,284,146,275,210.0,235.0,129,-138,267
85,18,3,1,4,0,124,113,128,123,95,124,106,151,157,167,81,107,94.0,118.0,26,-86,112
433,19,3,1,4,0,495,542,501,506,466,488,346,464,567,506,316,529,422.0,450.0,213,-190,403
148,20,3,1,4,0,130,156,186,166,134,169,138,184,155,213,116,188,152.0,172.0,72,-97,169
291,21,3,1,4,0,239,271,255,273,253,271,195,252,267,297,206,288,247.0,264.0,82,-91,173
267,22,3,1,4,0,276,357,324,293,304,239,208,258,336,315,155,306,230.0,259.0,151,-160,311
131,1,4,2,4,0,238,251,282,229,249,216,166,212,210,117,96,135,116.0,116.0,39,-21,60
185,2,4,2,4,0,123,154,116,231,232,256,209,270,308,173,110,159,134.0,147.0,49,-63,112
148,3,4,2,4,0,106,123,97,118,134,193,128,165,176,89,72,136,104.0,99.0,64,-17,81
166,4,4,2,4,0,305,237,267,308,309,286,179,246,342,136,109,179,144.0,141.0,70,-27,97
425,5,4,2,4,0,413,430,414,426,492,712,401,438,436,351,212,361,286.0,308.0,149,-139,288
182,6,4,2,4,0,230,261,218,300,368,358,250,325,348,264,151,204,178.0,206.0,53,-113,166
467,7,4,2,4,0,484,405,407,399,489,606,454,468,556,225,175,357,266.0,252.0,182,-50,232
181,8,4,2,4,0,130,124,127,123,233,187,181,144,181,92,70,148,109.0,103.0,78,-22,100
3988,9,4,2,4,0,3317,3840,3624,4020,4618,5211,4012,4216,4195,2391,1639,3992,2816.0,2674.0,2353,-752,3105
418,10,4,2,4,0,277,350,329,360,409,444,331,432,386,248,166,443,304.0,286.0,277,-82,359
1039,11,4,2,4,0,829,888,876,892,1148,1130,943,1033,1154,680,651,982,816.0,771.0,331,-29,360
328,12,4,2,4,0,170,221,210,194,288,380,260,302,351,208,96,254,175.0,186.0,158,-112,270
570,13,4,2,4,0,362,423,480,475,550,584,385,397,419,248,284,584,434.0,372.0,300,36,264
638,14,4,2,4,0,449,371,468,562,658,673,556,567,651,338,242,578,410.0,386.0,336,-96,432
1404,15,4,2,4,0,1039,1012,1006,1138,1244,1296,1228,1343,1310,747,739,1438,1088.0,975.0,699,-8,707
459,16,4,2,4,0,533,457,595,544,655,744,726,677,787,450,226,461,344.0,379.0,235,-224,459
554,17,4,2,4,0,529,476,494,503,610,619,436,474,674,394,223,436,330.0,351.0,213,-171,384
612,18,4,2,4,0,426,506,417,546,535,615,563,615,519,231,173,535,354.0,313.0,362,-58,420
646,19,4,2,4,0,649,665,803,867,1031,840,522,652,848,213,233,610,422.0,352.0,377,20,357
157,20,4,2,4,0,183,200,348,324,316,208,150,157,208,123,85,166,126.0,125.0,81,-38,119
242,21,4,2,4,0,194,239,237,272,274,262,219,225,317,148,105,202,154.0,152.0,97,-43,140
244,22,4,2,4,0,261,255,248,232,335,334,222,288,303,90,85,233,159.0,136.0,148,-5,153
169,1,5,3,4,0,182,202,234,212,256,234,168,249,477,199,177,267,222.0,214.0,90,-22,112
2281,2,5,3,4,0,2130,2397,2353,2868,2565,3307,3096,3216,4503,4785,3067,2754,2910.0,3535.0,-313,-1718,1405
487,3,5,3,4,0,313,361,329,346,368,502,360,520,675,504,451,680,566.0,545.0,229,-53,282
124,4,5,3,4,0,246,278,163,179,202,242,199,305,514,151,92,197,144.0,147.0,105,-59,164
1090,5,5,3,4,0,1056,1064,1118,1183,1230,1449,1007,1411,1954,1724,1537,1481,1509.0,1581.0,-56,-187,131
1284,6,5,3,4,0,1224,1396,1210,1260,1418,1458,1238,1535,2328,2152,1881,1518,1700.0,1850.0,-363,-271,-92
2545,7,5,3,4,0,2653,3587,2963,3398,3600,3519,3268,3907,6576,4483,3060,2839,2950.0,3461.0,-221,-1423,1202
1118,8,5,3,4,0,1076,1493,1193,1334,1452,1749,1354,1585,2844,2093,1361,1353,1357.0,1602.0,-8,-732,724
1684,9,5,3,4,0,1309,1820,1577,1457,1550,1999,1555,2007,3029,1611,1579,2180,1880.0,1790.0,601,-32,633
1540,10,5,3,4,0,1831,2371,1991,2051,2291,2515,2293,2687,4443,3084,1836,2310,2073.0,2410.0,474,-1248,1722
1601,11,5,3,4,0,1392,1679,1539,1776,1799,1764,1493,1942,3067,2165,2419,2029,2224.0,2204.0,-390,254,-644
668,12,5,3,4,0,877,1066,892,885,890,1111,824,980,1510,1290,922,875,898.0,1029.0,-47,-368,321
3015,13,5,3,4,0,2351,2960,2437,2748,3368,3303,2808,3641,6231,3870,3403,2945,3174.0,3406.0,-458,-467,9
2704,14,5,3,4,0,2891,3967,3302,3413,3591,3584,3821,4668,7650,5825,3564,3197,3380.0,4195.0,-367,-2261,1894
1156,15,5,3,4,0,943,1216,1213,1206,1016,1295,1112,1294,2062,1260,1629,1592,1610.0,1494.0,-37,369,-406
895,16,5,3,4,0,1013,1221,954,900,992,1202,958,1353,2198,1919,1140,1262,1201.0,1440.0,122,-779,901
1174,17,5,3,4,0,1609,1715,1491,1500,1678,1773,1354,1770,2693,2364,1506,1541,1524.0,1804.0,35,-858,893
463,18,5,3,4,0,458,576,545,512,565,573,523,688,892,592,650,741,696.0,661.0,91,58,33
959,19,5,3,4,0,894,1170,1034,1023,1010,1135,824,1154,1710,924,939,1322,1130.0,1062.0,383,15,368
212,20,5,3,4,0,191,258,225,203,204,284,201,250,357,250,248,235,242.0,244.0,-13,-2,-11
1222,21,5,3,4,0,1008,1213,1083,1173,1245,1658,1590,1877,3217,2072,1105,1314,1210.0,1497.0,209,-967,1176
657,22,5,3,4,0,646,736,776,785,835,795,518,816,982,506,518,806,662.0,610.0,288,12,276
229,1,6,1,4,0,198,232,330,331,445,555,272,582,623,382,114,351,232.0,282.0,237,-268,505
403,2,6,1,4,0,246,327,333,428,409,543,553,546,680,484,300,452,376.0,412.0,152,-184,336
505,3,6,1,4,0,472,638,517,552,645,831,715,836,832,551,317,489,403.0,452.0,172,-234,406
142,4,6,1,4,0,260,324,331,345,369,502,362,440,598,212,102,180,141.0,165.0,78,-110,188
790,5,6,1,4,0,847,961,1004,1032,1165,1460,1050,1385,1850,1223,671,850,760.0,915.0,179,-552,731
980,6,6,1,4,0,849,934,1047,1058,1409,1565,1256,1491,1666,1515,717,1018,868.0,1083.0,301,-798,1099
1902,7,6,1,4,0,1413,1635,1575,1773,2139,2580,2061,2146,2737,1706,842,1734,1288.0,1427.0,892,-864,1756
582,8,6,1,4,0,433,477,430,532,655,690,724,762,993,533,312,595,454.0,480.0,283,-221,504
4896,9,6,1,4,0,3887,5187,5010,5237,6544,8215,6582,6734,6492,5607,2647,5713,4180.0,4656.0,3066,-2960,6026
453,10,6,1,4,0,472,589,632,639,680,913,743,853,894,799,409,719,564.0,642.0,310,-390,700
1498,11,6,1,4,0,1467,1717,1679,1859,2252,2410,2283,2584,2672,1728,1016,1729,1372.0,1491.0,713,-712,1425
687,12,6,1,4,0,619,761,704,848,964,1340,1065,1086,1291,1027,356,690,523.0,691.0,334,-671,1005
2486,13,6,1,4,0,1445,1808,1966,2293,2864,3253,2277,2327,2703,2119,1271,2126,1698.0,1839.0,855,-848,1703
2566,14,6,1,4,0,1910,2169,2264,2690,3318,3446,2827,2797,3447,2952,1308,2514,1911.0,2258.0,1206,-1644,2850
905,15,6,1,4,0,721,949,928,974,1151,1369,1262,1632,1972,795,459,876,668.0,710.0,417,-336,753
1029,16,6,1,4,0,1012,1027,1207,1181,1412,1938,1686,1663,2151,1566,597,1095,846.0,1086.0,498,-969,1467
1573,17,6,1,4,0,1396,1570,1605,1889,1918,2573,2247,1966,2770,1651,844,1487,1166.0,1327.0,643,-807,1450
267,18,6,1,4,0,208,292,259,301,348,390,371,447,476,264,148,314,231.0,242.0,166,-116,282
293,19,6,1,4,0,283,311,261,323,369,397,317,403,513,241,211,360,286.0,271.0,149,-30,179
453,20,6,1,4,0,530,585,806,750,810,888,646,803,1149,803,328,472,400.0,534.0,144,-475,619
497,21,6,1,4,0,358,387,403,502,566,687,665,655,845,620,247,468,358.0,445.0,221,-373,594
449,22,6,1,4,0,492,550,570,602,652,669,544,740,1032,399,306,506,406.0,404.0,200,-93,293
1119,1,7,3,4,0,994,1124,945,1154,1068,958,710,977,1212,1265,890,1247,1068.0,1134.0,357,-375,732
133,2,7,3,4,0,57,124,99,83,62,79,45,66,119,104,63,214,138.0,127.0,151,-41,192
131,3,7,3,4,0,50,51,85,56,51,54,43,56,75,86,64,154,109.0,101.0,90,-22,112
1132,4,7,3,4,0,872,926,824,1014,976,1027,677,793,1627,1352,1114,1508,1311.0,1325.0,394,-238,632
335,5,7,3,4,0,166,175,144,210,234,199,102,145,321,208,187,254,220.0,216.0,67,-21,88
340,6,7,3,4,0,190,155,149,157,167,182,145,176,251,253,175,322,248.0,250.0,147,-78,225
1248,7,7,3,4,0,729,614,644,701,698,710,494,739,1047,878,649,1303,976.0,943.0,654,-229,883
320,8,7,3,4,0,96,90,115,93,101,121,83,105,184,165,123,244,184.0,177.0,121,-42,163
1100,9,7,3,4,0,491,557,511,479,453,514,463,571,819,762,448,944,696.0,718.0,496,-314,810
134,10,7,3,4,0,38,32,27,46,65,36,87,45,96,92,54,103,78.0,83.0,49,-38,87
1289,11,7,3,4,0,808,786,664,704,653,923,563,731,1002,974,650,1188,919.0,937.0,538,-324,862
140,12,7,3,4,0,107,79,54,83,56,89,43,74,97,118,85,164,124.0,122.0,79,-33,112
660,13,7,3,4,0,240,232,241,288,302,284,232,288,493,470,361,599,480.0,477.0,238,-109,347
731,14,7,3,4,0,390,376,374,353,356,387,282,366,596,517,345,763,554.0,542.0,418,-172,590
915,15,7,3,4,0,466,382,390,895,578,350,278,533,736,534,424,754,589.0,571.0,330,-110,440
253,16,7,3,4,0,139,123,130,108,119,115,66,94,173,151,103,240,172.0,165.0,137,-48,185
163,17,7,3,4,0,140,72,59,68,91,68,60,83,119,101,59,203,131.0,121.0,144,-42,186
303,18,7,3,4,0,219,92,103,107,123,99,106,97,170,123,106,206,156.0,145.0,100,-17,117
324,19,7,3,4,0,266,153,169,211,178,184,111,151,300,181,154,357,256.0,231.0,203,-27,230
181,20,7,3,4,0,106,65,63,75,66,120,43,58,100,60,71,130,100.0,87.0,59,11,48
305,21,7,3,4,0,185,153,156,195,228,164,136,164,313,234,179,320,250.0,244.0,141,-55,196
185,22,7,3,4,0,127,69,65,102,113,130,76,95,177,129,74,323,198.0,175.0,249,-55,304
309,1,8,2,4,0,561,484,494,547,504,605,431,543,697,325,168,288,228.0,260.0,120,-157,277
54,2,8,2,4,0,82,70,56,86,60,80,64,106,112,40,25,38,32.0,34.0,13,-15,28
46,3,8,2,4,0,66,70,55,54,65,50,48,60,75,31,18,29,24.0,26.0,11,-13,24
50,4,8,2,4,0,177,131,96,96,105,107,59,86,132,40,51,59,55.0,50.0,8,11,-3
175,5,8,2,4,0,226,211,185,192,194,379,187,278,408,216,117,192,154.0,175.0,75,-99,174
278,6,8,2,4,0,375,352,304,284,383,452,363,447,587,357,148,207,178.0,237.0,59,-209,268
400,7,8,2,4,0,655,512,403,384,434,524,437,477,555,320,180,373,276.0,291.0,193,-140,333
38,8,8,2,4,0,77,84,53,53,40,61,59,55,64,30,23,28,26.0,27.0,5,-7,12
158,9,8,2,4,0,282,274,225,205,191,284,225,342,408,121,39,166,102.0,109.0,127,-82,209
50,10,8,2,4,0,77,81,56,48,72,86,66,86,129,68,34,47,40.0,50.0,13,-34,47
879,11,8,2,4,0,1203,1261,881,934,1240,1311,1156,1271,1767,893,628,788,708.0,770.0,160,-265,425
188,12,8,2,4,0,241,252,167,187,201,205,175,224,302,169,92,161,126.0,141.0,69,-77,146
108,13,8,2,4,0,204,145,156,130,129,149,129,127,215,80,56,93,74.0,76.0,37,-24,61
329,14,8,2,4,0,347,264,222,222,264,300,257,320,368,183,97,185,141.0,155.0,88,-86,174
511,15,8,2,4,0,810,793,638,611,791,867,742,941,1163,445,309,478,394.0,411.0,169,-136,305
184,16,8,2,4,0,266,209,221,204,189,253,233,287,401,211,94,172,133.0,159.0,78,-117,195
167,17,8,2,4,0,256,228,177,169,202,213,182,259,315,201,83,173,128.0,152.0,90,-118,208
78,18,8,2,4,0,99,97,66,59,77,86,70,117,145,54,20,51,36.0,42.0,31,-34,65
82,19,8,2,4,0,169,79,56,94,56,78,81,68,104,28,21,52,36.0,34.0,31,-7,38
37,20,8,2,4,0,50,37,61,45,63,77,40,57,62,28,20,37,28.0,28.0,17,-8,25
83,21,8,2,4,0,169,156,96,102,126,137,141,113,177,107,51,78,64.0,79.0,27,-56,83
18,22,8,2,4,0,50,45,25,30,29,39,29,28,30,11,11,8,10.0,10.0,-3,0,-3
807,1,9,1,4,0,969,925,835,829,878,839,851,1537,1734,940,540,957,748.0,812.0,417,-400,817
301,2,9,1,4,0,333,370,297,444,406,375,464,639,732,400,288,346,317.0,345.0,58,-112,170
333,3,9,1,4,0,350,427,288,345,346,426,433,493,573,322,195,323,259.0,280.0,128,-127,255
489,4,9,1,4,0,585,621,593,551,572,648,532,915,1057,659,394,601,498.0,551.0,207,-265,472
761,5,9,1,4,0,869,835,754,816,821,1394,1020,1293,1876,1072,611,873,742.0,852.0,262,-461,723
664,6,9,1,4,0,800,749,648,689,782,938,1018,1287,1597,1015,457,773,615.0,748.0,316,-558,874
1236,7,9,1,4,0,1662,1314,1119,1240,1232,1497,1547,1722,2394,1077,522,1253,888.0,951.0,731,-555,1286
310,8,9,1,4,0,423,462,359,317,365,407,489,581,742,375,248,450,349.0,358.0,202,-127,329
892,9,9,1,4,0,955,1092,904,1023,986,1197,1508,2163,2594,949,463,1024,744.0,812.0,561,-486,1047
222,10,9,1,4,0,262,320,307,308,261,338,373,502,713,341,210,322,266.0,291.0,112,-131,243
1181,11,9,1,4,0,1369,1459,1195,1141,1497,1413,1635,2059,2647,1466,939,1519,1229.0,1308.0,580,-527,1107
746,12,9,1,4,0,710,757,635,717,687,798,900,1083,1527,753,397,757,577.0,636.0,360,-356,716
694,13,9,1,4,0,695,817,660,609,745,771,828,1012,1235,691,404,655,530.0,583.0,251,-287,538
1013,14,9,1,4,0,1124,951,899,929,998,1228,1191,1470,2122,1000,589,1119,854.0,903.0,530,-411,941
796,15,9,1,4,0,913,926,862,813,942,1042,1090,1626,2068,1003,537,978,758.0,839.0,441,-466,907
873,16,9,1,4,0,894,947,966,785,977,1135,1284,1519,1632,1025,485,1058,772.0,856.0,573,-540,1113
962,17,9,1,4,0,1065,1061,902,924,1034,1175,1168,1619,2178,1217,467,1068,768.0,917.0,601,-750,1351
373,18,9,1,4,0,323,473,273,417,426,426,568,767,913,522,257,433,345.0,404.0,176,-265,441
329,19,9,1,4,0,386,363,316,315,365,365,407,443,594,254,172,277,224.0,234.0,105,-82,187
321,20,9,1,4,0,331,291,407,357,329,386,354,500,762,420,252,342,297.0,338.0,90,-168,258
238,21,9,1,4,0,396,383,263,316,283,360,444,478,651,365,184,306,245.0,285.0,122,-181,303
187,22,9,1,4,0,347,288,202,213,233,201,203,289,372,142,121,207,164.0,157.0,86,-21,107
1070,1,10,2,4,0,1391,1398,1353,1616,1715,1560,1261,1546,1428,635,513,975,744.0,708.0,462,-122,584
316,2,10,2,4,0,304,335,298,451,462,412,350,412,626,249,167,333,250.0,250.0,166,-82,248
330,3,10,2,4,0,304,432,328,313,335,434,451,516,701,285,178,320,249.0,261.0,142,-107,249
101,4,10,2,4,0,284,280,232,247,248,278,174,264,913,106,74,113,94.0,98.0,39,-32,71
1501,5,10,2,4,0,1763,1713,1549,1800,1833,2351,1555,1783,2691,1134,763,1522,1142.0,1140.0,759,-371,1130
2068,6,10,2,4,0,1838,2005,1957,2071,2572,2578,2110,2138,2356,1607,968,1908,1438.0,1494.0,940,-639,1579
3779,7,10,2,4,0,3584,3723,2665,3185,3623,4079,3911,3787,4830,2048,1323,3138,2230.0,2170.0,1815,-725,2540
610,8,10,2,4,0,562,695,612,635,770,774,678,852,1073,317,283,629,456.0,410.0,346,-34,380
1512,9,10,2,4,0,1748,2151,1841,2105,2230,2219,1912,2435,2500,695,488,1495,992.0,893.0,1007,-207,1214
554,10,10,2,4,0,401,605,509,467,597,723,646,783,869,475,293,738,516.0,502.0,445,-182,627
4083,11,10,2,4,0,4265,5237,4119,4343,5439,5089,5170,5016,5865,2657,2401,4119,3260.0,3059.0,1718,-256,1974
1828,12,10,2,4,0,1136,1339,997,1282,1228,1446,1175,1376,1737,923,549,1502,1026.0,991.0,953,-374,1327
2198,13,10,2,4,0,1462,1915,1717,1730,2030,2166,1672,1926,2621,900,720,1379,1050.0,1000.0,659,-180,839
3199,14,10,2,4,0,2464,2148,2124,2569,3033,2794,2644,2874,3243,1683,1042,2558,1800.0,1761.0,1516,-641,2157
1876,15,10,2,4,0,2464,3027,2635,2644,3079,3258,3003,3295,3490,1289,1038,1965,1502.0,1431.0,927,-251,1178
1278,16,10,2,4,0,1212,1354,1346,1388,1694,1779,1500,1547,1624,929,480,1234,857.0,881.0,754,-449,1203
1616,17,10,2,4,0,1484,1556,1388,1464,1556,1793,1457,1585,1952,989,516,1513,1014.0,1006.0,997,-473,1470
878,18,10,2,4,0,695,1147,600,1040,913,859,836,1130,958,546,402,859,630.0,602.0,457,-144,601
498,19,10,2,4,0,639,553,466,570,710,667,540,619,821,205,149,446,298.0,267.0,297,-56,353
401,20,10,2,4,0,248,344,487,446,463,501,422,419,597,296,163,296,230.0,252.0,133,-133,266
689,21,10,2,4,0,620,717,590,762,830,880,891,912,1151,413,242,475,358.0,377.0,233,-171,404
193,22,10,2,4,0,355,391,233,247,332,298,250,347,415,118,130,301,216.0,183.0,171,12,159
95,1,11,2,4,0,116,132,121,130,170,225,144,225,270,79,27,45,36.0,50.0,18,-52,70
192,2,11,2,4,0,130,150,124,141,193,215,192,267,384,296,172,285,228.0,251.0,113,-124,237
203,3,11,2,4,0,134,180,155,165,211,257,237,359,450,248,124,211,168.0,194.0,87,-124,211
952,4,11,2,4,0,666,671,764,635,596,755,684,938,1287,118,74,556,315.0,249.0,482,-44,526
676,5,11,2,4,0,665,754,743,840,1135,1134,707,1002,2805,1326,797,891,844.0,1005.0,94,-529,623
520,6,11,2,4,0,458,431,427,626,807,752,716,977,1443,903,436,535,486.0,625.0,99,-467,566
1575,7,11,2,4,0,1289,1432,1325,1510,2013,2253,1752,2198,3785,1878,1009,1343,1176.0,1410.0,334,-869,1203
464,8,11,2,4,0,293,383,273,396,591,635,370,1993,2925,603,248,417,332.0,423.0,169,-355,524
1095,9,11,2,4,0,1031,1203,1183,1216,1851,1526,1065,2044,2419,914,399,1078,738.0,797.0,679,-515,1194
403,10,11,2,4,0,250,385,389,373,565,452,368,493,935,666,303,492,398.0,487.0,189,-363,552
1041,11,11,2,4,0,897,1057,971,1038,1263,1231,1184,1531,2308,910,648,752,700.0,770.0,104,-262,366
561,12,11,2,4,0,469,546,479,591,657,831,701,917,1377,999,364,509,436.0,624.0,145,-635,780
953,13,11,2,4,0,479,696,616,754,991,941,754,1144,2067,1110,641,741,691.0,831.0,100,-469,569
1423,14,11,2,4,0,1161,1258,1321,1528,1922,1491,1090,1965,3560,2272,888,1199,1044.0,1453.0,311,-1384,1695
1097,15,11,2,4,0,1570,1718,1900,1877,2534,1978,2287,3147,4324,1028,639,1114,876.0,927.0,475,-389,864
456,16,11,2,4,0,420,420,475,487,636,528,521,941,1534,1004,347,476,412.0,609.0,129,-657,786
688,17,11,2,4,0,945,1034,885,1014,1148,1102,762,1142,1719,1133,438,685,562.0,752.0,247,-695,942
565,18,11,2,4,0,596,665,596,710,861,605,468,762,1967,434,268,656,462.0,453.0,388,-166,554
202,19,11,2,4,0,209,189,242,328,373,319,239,291,520,199,149,205,177.0,184.0,56,-50,106
310,20,11,2,4,0,305,265,352,383,500,317,253,326,532,432,291,409,350.0,377.0,118,-141,259
612,21,11,2,4,0,511,669,670,984,1191,1013,830,1010,1651,919,422,609,516.0,650.0,187,-497,684
128,22,11,2,4,0,79,102,96,114,179,154,114,204,257,135,104,114,109.0,118.0,10,-31,41
51,1,12,2,4,0,54,61,91,84,82,78,75,125,158,63,40,60,50.0,54.0,20,-23,43
240,2,12,2,4,0,208,229,212,242,297,409,425,375,535,421,246,288,267.0,318.0,42,-175,217
212,3,12,2,4,0,157,157,141,155,186,321,287,448,676,363,164,250,207.0,259.0,86,-199,285
80,4,12,2,4,0,158,142,166,192,229,328,289,360,496,86,74,109,92.0,90.0,35,-12,47
526,5,12,2,4,0,458,502,542,612,740,894,870,831,1260,724,451,621,536.0,599.0,170,-273,443
315,6,12,2,4,0,266,327,272,360,423,570,478,510,806,576,272,358,315.0,402.0,86,-304,390
1071,7,12,2,4,0,977,950,814,1067,1385,1544,1660,1778,2915,1529,762,977,870.0,1089.0,215,-767,982
543,8,12,2,4,0,328,438,304,387,526,657,689,668,1092,615,366,578,472.0,520.0,212,-249,461
836,9,12,2,4,0,644,800,706,726,1003,987,1170,1384,1437,718,363,821,592.0,634.0,458,-355,813
288,10,12,2,4,0,200,244,215,205,275,336,321,463,659,452,233,370,302.0,352.0,137,-219,356
460,11,12,2,4,0,406,417,417,424,503,619,691,743,1008,543,405,518,462.0,489.0,113,-138,251
301,12,12,2,4,0,316,324,321,323,384,576,518,577,816,634,247,323,285.0,401.0,76,-387,463
1070,13,12,2,4,0,754,897,796,976,1190,1442,1308,1432,2365,1304,951,1023,987.0,1093.0,72,-353,425
888,14,12,2,4,0,764,796,796,921,1180,1362,1148,1406,2228,1526,717,888,802.0,1044.0,171,-809,980
460,15,12,2,4,0,555,599,497,546,656,656,660,874,1121,438,306,511,408.0,418.0,205,-132,337
342,16,12,2,4,0,340,316,308,353,445,594,534,655,903,635,255,364,310.0,418.0,109,-380,489
531,17,12,2,4,0,590,590,570,561,665,852,609,763,1216,773,321,479,400.0,524.0,158,-452,610
195,18,12,2,4,0,227,185,203,218,279,280,218,239,420,249,153,274,214.0,225.0,121,-96,217
326,19,12,2,4,0,267,276,253,308,361,450,328,514,641,287,222,321,272.0,277.0,99,-65,164
207,20,12,2,4,0,187,187,221,263,289,325,272,292,402,296,142,238,190.0,225.0,96,-154,250
484,21,12,2,4,0,433,446,383,562,667,705,729,755,1158,815,410,484,447.0,570.0,74,-405,479
161,22,12,2,4,0,118,155,141,189,179,249,176,328,336,166,145,205,175.0,172.0,60,-21,81
125,1,13,1,4,0,94,156,130,143,149,181,158,314,461,180,102,190,146.0,157.0,88,-78,166
650,2,13,1,4,0,239,336,248,387,336,447,627,757,1396,1059,575,778,676.0,804.0,203,-484,687
409,3,13,1,4,0,117,165,174,186,216,287,324,527,720,520,270,473,372.0,421.0,203,-250,453
127,4,13,1,4,0,85,99,100,137,177,237,199,242,487,101,86,162,124.0,116.0,76,-15,91
1156,5,13,1,4,0,554,759,618,741,845,1263,1243,1605,2433,1860,1194,1302,1248.0,1452.0,108,-666,774
861,6,13,1,4,0,483,561,546,651,840,1069,1269,1370,2298,1440,720,878,799.0,1013.0,158,-720,878
1812,7,13,1,4,0,585,723,768,927,999,1485,1686,2126,3804,2217,1109,1504,1306.0,1610.0,395,-1108,1503
661,8,13,1,4,0,166,255,224,271,379,496,642,748,1215,772,404,591,498.0,589.0,187,-368,555
1064,9,13,1,4,0,449,600,502,550,650,835,848,1467,2021,1040,446,977,712.0,821.0,531,-594,1125
454,10,13,1,4,0,170,257,240,225,284,342,388,511,880,738,330,660,495.0,576.0,330,-408,738
1246,11,13,1,4,0,648,883,678,762,1001,1116,1451,1816,2525,1540,1130,1441,1286.0,1370.0,311,-410,721
631,12,13,1,4,0,270,410,377,409,440,725,733,889,1320,1015,377,598,488.0,663.0,221,-638,859
2041,13,13,1,4,0,487,781,785,958,1014,1437,1548,2026,3281,1882,1126,1456,1291.0,1488.0,330,-756,1086
1518,14,13,1,4,0,542,634,719,857,953,1313,1473,1843,2975,2324,1002,1413,1208.0,1580.0,411,-1322,1733
893,15,13,1,4,0,591,746,723,731,805,1089,1175,1502,2235,958,565,880,722.0,801.0,315,-393,708
723,16,13,1,4,0,444,503,489,505,669,868,924,1339,1557,1148,463,782,622.0,798.0,319,-685,1004
664,17,13,1,4,0,309,371,399,407,438,633,772,835,1281,1235,439,733,586.0,802.0,294,-796,1090
461,18,13,1,4,0,174,227,178,234,282,307,414,622,877,518,365,529,447.0,471.0,164,-153,317
397,19,13,1,4,0,155,177,191,236,231,291,296,396,542,311,224,349,286.0,295.0,125,-87,212
334,20,13,1,4,0,169,207,227,218,259,311,316,419,666,489,274,346,310.0,370.0,72,-215,287
535,21,13,1,4,0,202,287,271,303,362,519,627,715,1549,1036,394,463,428.0,631.0,69,-642,711
679,22,13,1,4,0,252,344,319,336,422,442,411,616,998,401,372,684,528.0,486.0,312,-29,341
354,1,14,1,4,0,534,459,422,464,522,661,472,781,1047,423,192,279,236.0,298.0,87,-231,318
992,2,14,1,4,0,856,985,706,939,877,1084,1148,1159,1879,1354,680,631,656.0,888.0,-49,-674,625
786,3,14,1,4,0,492,583,433,551,578,725,701,941,1442,814,347,566,456.0,576.0,219,-467,686
280,4,14,1,4,0,406,411,391,454,496,664,474,569,1295,274,176,281,228.0,244.0,105,-98,203
1488,5,14,1,4,0,1892,1614,1306,1417,1488,2289,1556,2162,4188,2540,1081,1111,1096.0,1577.0,30,-1459,1489
1218,6,14,1,4,0,1361,1443,1295,1412,1803,1996,1889,2073,3650,2495,863,893,878.0,1417.0,30,-1632,1662
3249,7,14,1,4,0,2492,2580,2168,2583,2886,3461,3252,3594,6275,3467,1356,2002,1679.0,2275.0,646,-2111,2757
790,8,14,1,4,0,602,630,509,619,652,805,800,914,1576,743,357,500,428.0,533.0,143,-386,529
1722,9,14,1,4,0,1766,2201,1866,1837,2246,2808,2902,3269,4342,1784,653,1364,1008.0,1267.0,711,-1131,1842
538,10,14,1,4,0,500,655,477,518,574,670,621,739,1316,892,381,556,468.0,610.0,175,-511,686
2607,11,14,1,4,0,2838,3224,2468,2600,3230,3453,3560,3776,5864,3032,1760,2316,2038.0,2369.0,556,-1272,1828
962,12,14,1,4,0,897,980,839,839,860,1325,1195,1285,2160,1579,453,603,528.0,878.0,150,-1126,1276
2467,13,14,1,4,0,1778,2039,1774,2024,2258,2481,2298,2594,4551,2375,1231,1427,1329.0,1678.0,196,-1144,1340
2716,14,14,1,4,0,2494,2508,2539,3103,3396,3571,3427,4047,8018,5309,1586,1915,1750.0,2937.0,329,-3723,4052
1890,15,14,1,4,0,1980,2136,1905,1897,2229,2579,2724,3014,4336,1679,826,1161,994.0,1222.0,335,-853,1188
1028,16,14,1,4,0,1346,1186,1236,1304,1341,1747,1512,1848,3179,2049,551,906,728.0,1169.0,355,-1498,1853
1395,17,14,1,4,0,1610,1468,1450,1536,1679,2187,1872,2355,3747,2461,732,1157,944.0,1450.0,425,-1729,2154
616,18,14,1,4,0,639,683,519,626,618,738,859,1140,1306,596,364,463,414.0,474.0,99,-232,331
1227,19,14,1,4,0,900,949,846,1022,1132,1218,970,1188,1784,769,415,765,590.0,650.0,350,-354,704
529,20,14,1,4,0,660,656,695,635,655,770,622,761,1417,877,373,399,386.0,550.0,26,-504,530
648,21,14,1,4,0,548,688,468,587,654,727,899,841,1546,1008,303,361,332.0,557.0,58,-705,763
725,22,14,1,4,0,624,692,573,663,777,675,517,944,1290,579,365,604,484.0,516.0,239,-214,453
667,1,15,2,4,0,712,656,680,680,720,820,623,807,1293,851,433,764,598.0,683.0,331,-418,749
361,2,15,2,4,0,184,252,242,468,405,456,394,535,639,509,300,415,358.0,408.0,115,-209,324
527,3,15,2,4,0,266,364,340,407,480,482,477,451,580,494,276,556,416.0,442.0,280,-218,498
982,4,15,2,4,0,1000,1124,1019,1062,1143,1276,969,1288,2146,1327,923,1308,1116.0,1186.0,385,-404,789
597,5,15,2,4,0,447,452,487,585,715,1123,634,781,1105,856,454,680,567.0,663.0,226,-402,628
584,6,15,2,4,0,507,478,422,472,667,840,774,803,1070,953,364,644,504.0,654.0,280,-589,869
1284,7,15,2,4,0,932,915,988,988,1162,1315,1224,1513,1837,1329,778,1244,1011.0,1117.0,466,-551,1017
713,8,15,2,4,0,602,669,598,604,750,729,770,798,1203,945,474,746,610.0,722.0,272,-471,743
549,9,15,2,4,0,221,266,335,313,351,438,425,536,825,423,180,427,304.0,343.0,247,-243,490
141,10,15,2,4,0,79,110,114,93,121,141,135,160,243,179,71,140,106.0,130.0,69,-108,177
1288,11,15,2,4,0,1122,1198,1215,1276,1793,1838,1848,1951,2643,1820,1058,1565,1312.0,1481.0,507,-762,1269
301,12,15,2,4,0,293,295,274,321,334,419,377,424,571,408,151,325,238.0,295.0,174,-257,431
1523,13,15,2,4,0,923,1024,961,977,1321,1377,1264,1433,1923,1604,884,1377,1130.0,1288.0,493,-720,1213
1062,14,15,2,4,0,723,780,738,834,1010,1081,952,1113,1482,1178,548,1003,776.0,910.0,455,-630,1085
681,15,15,2,4,0,432,444,464,536,601,733,722,894,1112,767,352,679,516.0,599.0,327,-415,742
261,16,15,2,4,0,236,284,317,260,295,373,329,377,483,446,164,271,218.0,294.0,107,-282,389
359,17,15,2,4,0,317,301,333,339,383,464,438,477,783,487,262,452,357.0,400.0,190,-225,415
217,18,15,2,4,0,213,189,158,212,189,235,212,345,456,397,140,227,184.0,255.0,87,-257,344
218,19,15,2,4,0,236,253,279,277,296,261,247,251,310,270,165,356,260.0,264.0,191,-105,296
381,20,15,2,4,0,328,342,482,408,414,486,426,491,644,555,263,408,336.0,409.0,145,-292,437
579,21,15,2,4,0,293,395,348,388,413,568,617,622,758,719,361,603,482.0,561.0,242,-358,600
106,22,15,2,4,0,121,150,115,124,187,159,142,152,169,104,79,149,114.0,111.0,70,-25,95
109,1,16,2,4,0,37,32,39,46,46,41,395,67,117,63,37,86,62.0,62.0,49,-26,75
755,2,16,2,4,0,1186,1072,971,1395,1426,1254,988,1142,1590,946,692,1035,864.0,891.0,343,-254,597
724,3,16,2,4,0,698,895,690,744,864,895,802,945,982,602,413,714,564.0,576.0,301,-189,490
282,4,16,2,4,0,803,698,717,716,794,737,477,625,985,300,271,404,338.0,325.0,133,-29,162
2405,5,16,2,4,0,2537,2734,2651,2620,2791,2955,1733,2221,3340,1470,1639,3175,2407.0,2095.0,1536,169,1367
279,6,16,2,4,0,410,402,479,502,552,488,424,410,575,248,260,384,322.0,297.0,124,12,112
2376,7,16,2,4,0,3356,3511,2812,3126,3130,3837,3617,3662,4024,1903,1708,2748,2228.0,2120.0,1040,-195,1235
792,8,16,2,4,0,933,1057,828,993,1217,1561,1243,1188,1616,679,442,672,557.0,598.0,230,-237,467
1558,9,16,2,4,0,1775,1785,1654,1766,1963,2010,1906,2111,2398,1196,1075,2249,1662.0,1507.0,1174,-121,1295
664,10,16,2,4,0,403,353,331,405,319,409,384,459,435,440,301,449,375.0,397.0,148,-139,287
605,11,16,2,4,0,753,875,786,701,745,840,781,777,930,527,626,655,640.0,603.0,29,99,-70
270,12,16,2,4,0,339,330,292,330,358,538,488,482,540,354,189,356,272.0,300.0,167,-165,332
2656,13,16,2,4,0,3025,3349,3221,3102,3388,3910,3483,3233,4206,2068,1780,2633,2206.0,2160.0,853,-288,1141
1515,14,16,2,4,0,1984,2022,1974,2200,2100,2323,1931,2018,2962,1570,1050,1823,1436.0,1481.0,773,-520,1293
555,15,16,2,4,0,836,827,820,769,777,723,606,634,886,424,422,628,525.0,491.0,206,-2,208
304,16,16,2,4,0,611,610,623,595,715,725,585,544,920,483,270,442,356.0,398.0,172,-213,385
835,17,16,2,4,0,1616,1475,1358,1456,1533,1680,1444,1489,2336,1714,653,1232,942.0,1200.0,579,-1061,1640
424,18,16,2,4,0,579,484,487,627,773,710,690,597,622,308,292,460,376.0,353.0,168,-16,184
1119,19,16,2,4,0,1484,1508,1498,1804,1815,1871,1308,1478,1878,681,691,1319,1005.0,897.0,628,10,618
160,20,16,2,4,0,211,204,370,530,502,347,184,172,247,131,105,125,115.0,120.0,20,-26,46
487,21,16,2,4,0,729,604,479,874,1106,695,580,634,1051,558,384,605,494.0,516.0,221,-174,395
1254,22,16,2,4,0,1499,1291,1253,1193,1427,1562,1308,1636,1781,730,952,1556,1254.0,1079.0,604,222,382
4039,1,17,2,4,0,2672,2922,2462,1180,1500,2397,1674,2362,3060,1909,501,2672,1586.0,1694.0,2171,-1408,3579
603,2,17,2,4,0,630,647,551,884,974,1076,1038,1033,1402,656,504,651,578.0,604.0,147,-152,299
413,3,17,2,4,0,430,507,344,410,446,541,468,630,827,268,214,376,295.0,286.0,162,-54,216
1550,4,17,2,4,0,1941,2551,971,995,1118,835,516,1494,2145,217,200,2331,1266.0,916.0,2131,-17,2148
2078,5,17,2,4,0,1834,1543,1533,1662,1864,2707,1708,2119,2450,1355,937,1478,1208.0,1257.0,541,-418,959
1362,6,17,2,4,0,1722,1828,1799,2028,2809,2863,2529,2927,3132,1460,775,1436,1106.0,1224.0,661,-685,1346
2269,7,17,2,4,0,3589,3471,2715,3147,4018,4409,4129,4087,5401,1885,1225,2010,1618.0,1707.0,785,-660,1445
974,8,17,2,4,0,1022,1337,977,1223,1490,1510,1452,1547,2066,692,491,877,684.0,687.0,386,-201,587
1506,9,17,2,4,0,1816,1983,1796,1715,2112,2192,2036,2188,2519,625,462,1475,968.0,854.0,1013,-163,1176
289,10,17,2,4,0,377,518,379,413,503,589,568,596,616,308,176,366,271.0,283.0,190,-132,322
2631,11,17,2,4,0,3393,3757,3219,3369,4854,5016,4475,5007,5643,2143,1862,2644,2253.0,2216.0,782,-281,1063
895,12,17,2,4,0,1276,1370,1233,1308,1681,2044,1627,1981,2357,973,442,916,679.0,777.0,474,-531,1005
2652,13,17,2,4,0,2675,3198,2587,2964,3829,3951,3277,3711,5424,1723,1261,2043,1652.0,1676.0,782,-462,1244
2562,14,17,2,4,0,2757,2736,2702,3421,4398,4500,3793,4237,5119,2463,1238,2429,1834.0,2043.0,1191,-1225,2416
1321,15,17,2,4,0,1853,2092,1953,2021,2513,2777,2324,2401,2755,895,768,1359,1064.0,1007.0,591,-127,718
848,16,17,2,4,0,1205,1158,1213,1120,1591,1818,1296,1466,1985,1002,357,841,599.0,733.0,484,-645,1129
1014,17,17,2,4,0,1645,1561,1517,1583,1906,2187,1670,2078,2533,1085,531,1104,818.0,907.0,573,-554,1127
721,18,17,2,4,0,977,1082,843,1055,1347,1279,1170,1218,1549,440,400,775,588.0,538.0,375,-40,415
587,19,17,2,4,0,766,859,586,702,806,897,700,869,1098,268,212,386,299.0,289.0,174,-56,230
607,20,17,2,4,0,946,870,1013,987,1230,1171,824,938,1120,617,359,603,481.0,526.0,244,-258,502
1831,21,17,2,4,0,1036,1284,861,1113,1278,1300,1165,1199,1748,631,397,661,529.0,563.0,264,-234,498
218,22,17,2,4,0,451,421,327,303,404,404,286,466,480,162,156,276,216.0,198.0,120,-6,126
319,1,18,2,4,0,709,759,629,425,535,502,314,574,754,315,362,767,564.0,481.0,405,47,358
404,2,18,2,4,0,421,595,461,551,450,435,635,692,866,452,295,448,372.0,398.0,153,-157,310
556,3,18,2,4,0,507,561,440,380,452,427,495,612,941,427,254,591,422.0,424.0,337,-173,510
100,4,18,2,4,0,498,353,301,382,397,346,199,341,546,125,89,159,124.0,124.0,70,-36,106
1235,5,18,2,4,0,1326,1270,1055,1379,1197,903,838,1187,1812,1017,704,1344,1024.0,1022.0,640,-313,953
701,6,18,2,4,0,1065,1021,869,1109,958,734,813,952,1669,741,475,869,672.0,695.0,394,-266,660
2841,7,18,2,4,0,3634,3404,2787,3450,3299,2451,2995,3812,5496,2330,1515,2865,2190.0,2237.0,1350,-815,2165
1425,8,18,2,4,0,1678,1725,1270,1462,1588,1052,1126,1234,2626,1165,641,1247,944.0,1018.0,606,-524,1130
540,9,18,2,4,0,397,473,460,457,448,529,384,525,1055,368,255,433,344.0,352.0,178,-113,291
485,10,18,2,4,0,182,302,352,363,291,255,362,355,448,365,155,240,198.0,253.0,85,-210,295
1281,11,18,2,4,0,1304,1178,1368,1353,1085,864,1310,1728,2261,1167,1028,1507,1268.0,1234.0,479,-139,618
236,12,18,2,4,0,421,412,315,365,335,301,356,946,847,641,223,316,270.0,393.0,93,-418,511
3513,13,18,2,4,0,3004,3190,2715,3210,3609,2265,2586,3058,5478,1932,1551,2981,2266.0,2155.0,1430,-381,1811
1504,14,18,2,4,0,1867,1905,1469,1701,1452,1141,1472,1941,3092,1731,893,1695,1294.0,1440.0,802,-838,1640
598,15,18,2,4,0,916,1100,1016,1000,913,659,638,706,1205,504,467,741,604.0,571.0,274,-37,311
222,16,18,2,4,0,470,347,353,277,263,202,272,348,657,298,154,273,214.0,242.0,119,-144,263
437,17,18,2,4,0,827,849,769,962,701,698,568,587,1351,576,253,448,350.0,426.0,195,-323,518
232,18,18,2,4,0,321,335,225,356,355,342,307,452,617,215,148,255,202.0,206.0,107,-67,174
721,19,18,2,4,0,733,783,589,621,716,684,572,853,1026,394,408,768,588.0,523.0,360,14,346
329,20,18,2,4,0,493,497,413,558,474,304,408,379,694,353,248,346,297.0,316.0,98,-105,203
600,21,18,2,4,0,683,599,723,667,832,623,693,804,1400,754,418,791,604.0,654.0,373,-336,709
464,22,18,2,4,0,645,383,283,369,508,307,324,496,710,280,266,503,384.0,350.0,237,-14,251
249,1,19,2,4,0,246,249,228,201,232,150,148,312,359,339,177,321,249.0,279.0,144,-162,306
375,2,19,2,4,0,283,346,330,388,290,304,344,442,485,409,248,357,302.0,338.0,109,-161,270
443,3,19,2,4,0,276,395,262,398,348,325,432,401,434,519,319,522,420.0,453.0,203,-200,403
1047,4,19,2,4,0,1112,1156,1039,990,1183,1150,795,1121,1802,1263,877,1267,1072.0,1136.0,390,-386,776
827,5,19,2,4,0,702,679,596,623,519,741,610,732,1083,1390,565,951,758.0,969.0,386,-825,1211
534,6,19,2,4,0,339,414,403,381,360,323,440,519,629,667,315,471,393.0,484.0,156,-352,508
1694,7,19,2,4,0,1362,1499,1162,1256,1311,1391,1370,1666,1642,1861,878,1578,1228.0,1439.0,700,-983,1683
395,8,19,2,4,0,342,380,264,316,332,330,480,421,414,426,317,451,384.0,398.0,134,-109,243
693,9,19,2,4,0,400,553,537,509,516,523,704,995,1243,727,322,827,574.0,625.0,505,-405,910
139,10,19,2,4,0,87,113,102,97,101,156,159,192,214,225,119,204,162.0,183.0,85,-106,191
1124,11,19,2,4,0,1024,1236,925,785,871,1280,881,1099,1374,1336,868,1301,1084.0,1168.0,433,-468,901
237,12,19,2,4,0,208,246,191,199,169,178,237,276,329,364,141,291,216.0,265.0,150,-223,373
1805,13,19,2,4,0,1150,1563,1391,1238,1360,1115,1052,1461,1615,1768,1165,1697,1431.0,1543.0,532,-603,1135
1403,14,19,2,4,0,984,996,913,957,1047,1104,1357,1223,1443,1429,856,1325,1090.0,1203.0,469,-573,1042
633,15,19,2,4,0,482,592,492,475,404,404,512,747,863,742,356,707,532.0,602.0,351,-386,737
396,16,19,2,4,0,350,345,337,298,379,393,374,473,566,558,262,443,352.0,421.0,181,-296,477
383,17,19,2,4,0,261,307,277,273,291,253,248,418,494,519,230,424,327.0,391.0,194,-289,483
251,18,19,2,4,0,229,307,216,229,183,186,285,325,402,404,188,330,259.0,307.0,142,-216,358
783,19,19,2,4,0,616,593,769,652,721,569,738,644,1082,704,546,870,708.0,707.0,324,-158,482
319,20,19,2,4,0,260,274,314,254,213,262,251,282,391,433,202,335,268.0,323.0,133,-231,364
390,21,19,2,4,0,411,522,312,356,360,419,276,346,497,487,257,378,318.0,374.0,121,-230,351
1070,22,19,2,4,0,775,794,828,639,929,731,657,664,964,785,666,1198,932.0,883.0,532,-119,651
532,1,20,1,4,0,987,982,1141,897,946,1150,1010,1563,1504,815,447,731,589.0,664.0,284,-368,652
310,2,20,1,4,0,429,522,373,681,595,570,759,692,785,585,277,403,340.0,422.0,126,-308,434
177,3,20,1,4,0,243,365,254,296,333,327,407,342,430,303,110,229,170.0,214.0,119,-193,312
371,4,20,1,4,0,745,768,998,675,772,925,740,925,1127,376,284,427,356.0,362.0,143,-92,235
657,5,20,1,4,0,980,978,903,990,1085,1885,1100,1320,1775,1096,562,764,663.0,807.0,202,-534,736
581,6,20,1,4,0,764,823,725,769,980,1023,1001,1064,1490,952,364,600,482.0,639.0,236,-588,824
813,7,20,1,4,0,1108,1210,1082,1134,1323,1432,1303,1408,1739,940,501,805,653.0,749.0,304,-439,743
138,8,20,1,4,0,291,326,221,257,295,289,333,332,371,229,113,151,132.0,164.0,38,-116,154
862,9,20,1,4,0,995,1269,1114,1097,1195,1320,1463,1644,2216,854,451,986,718.0,764.0,535,-403,938
155,10,20,1,4,0,212,277,223,187,218,240,280,255,372,218,114,237,176.0,190.0,123,-104,227
1015,11,20,1,4,0,1487,1639,1433,1571,1947,1897,1872,2263,3132,1586,987,1345,1166.0,1306.0,358,-599,957
430,12,20,1,4,0,722,759,661,681,684,855,798,870,1144,754,284,498,391.0,512.0,214,-470,684
687,13,20,1,4,0,716,788,622,676,985,861,883,944,1218,652,442,599,520.0,564.0,157,-210,367
719,14,20,1,4,0,959,936,866,965,1056,1067,1021,1121,1578,856,471,700,586.0,676.0,229,-385,614
1150,15,20,1,4,0,1823,1961,1826,1921,2037,2367,2323,2703,3371,1749,893,1369,1131.0,1337.0,476,-856,1332
523,16,20,1,4,0,751,751,798,730,829,920,1033,988,1333,941,363,579,471.0,628.0,216,-578,794
610,17,20,1,4,0,869,852,770,811,908,1056,973,1081,1561,1003,386,716,551.0,702.0,330,-617,947
387,18,20,1,4,0,580,799,587,681,684,714,853,905,1102,667,370,551,460.0,529.0,181,-297,478
212,19,20,1,4,0,339,376,332,444,478,491,437,403,555,253,188,258,223.0,233.0,70,-65,135
290,20,20,1,4,0,450,403,448,421,422,477,428,496,740,452,184,293,238.0,310.0,109,-268,377
216,21,20,1,4,0,347,397,335,338,351,433,450,479,533,395,223,292,258.0,303.0,69,-172,241
217,22,20,1,4,0,369,422,399,362,461,359,320,352,428,213,219,281,250.0,238.0,62,6,56
369,1,21,2,4,0,480,438,464,464,563,552,450,685,688,275,231,396,314.0,301.0,165,-44,209
427,2,21,2,4,0,494,611,509,837,743,640,687,714,1001,409,321,443,382.0,391.0,122,-88,210
455,3,21,2,4,0,555,665,393,509,544,557,650,671,789,370,239,440,340.0,350.0,201,-131,332
496,4,21,2,4,0,1175,1102,1018,1021,1288,1431,1045,1332,1807,402,360,619,490.0,460.0,259,-42,301
1538,5,21,2,4,0,2107,1866,1748,1887,2009,2921,2017,2913,3590,1589,1106,1523,1314.0,1406.0,417,-483,900
1124,6,21,2,4,0,1182,1170,1110,1307,1431,1596,1491,1717,1968,921,593,995,794.0,836.0,402,-328,730
2083,7,21,2,4,0,2449,2486,1895,2003,2387,2615,2547,2776,3299,1329,945,1856,1400.0,1377.0,911,-384,1295
549,8,21,2,4,0,634,789,589,641,800,787,813,782,1130,401,261,510,386.0,391.0,249,-140,389
908,9,21,2,4,0,996,1286,1093,1029,1303,1438,1702,2171,2397,475,354,1081,718.0,637.0,727,-121,848
224,10,21,2,4,0,263,323,295,287,282,358,395,493,595,225,179,348,264.0,251.0,169,-46,215
2129,11,21,2,4,0,2473,3080,2334,2394,3107,2962,3228,3579,4302,1623,1477,2234,1856.0,1778.0,757,-146,903
551,12,21,2,4,0,598,657,503,672,641,755,781,885,1016,398,230,537,384.0,388.0,307,-168,475
2725,13,21,2,4,0,2475,2921,2392,2559,2979,2860,2877,2989,3954,1565,1311,2239,1775.0,1705.0,928,-254,1182
1948,14,21,2,4,0,2122,1817,1841,2115,2398,2493,2358,2638,3291,1489,872,1684,1278.0,1348.0,812,-617,1429
1417,15,21,2,4,0,1755,1827,1550,1572,1914,1992,2163,2458,2897,961,793,1491,1142.0,1082.0,698,-168,866
667,16,21,2,4,0,703,828,848,789,996,1142,948,1247,1304,805,357,634,496.0,599.0,277,-448,725
544,17,21,2,4,0,632,689,696,720,817,950,757,948,1222,427,264,565,414.0,419.0,301,-163,464
415,18,21,2,4,0,569,777,495,680,640,694,837,946,924,385,327,518,422.0,410.0,191,-58,249
916,19,21,2,4,0,1021,1093,717,904,1088,1057,1007,1160,1513,414,423,828,626.0,555.0,405,9,396
300,20,21,2,4,0,317,246,378,375,374,365,407,493,612,296,209,288,248.0,264.0,79,-87,166
468,21,21,2,4,0,607,926,472,701,761,801,945,946,1143,404,239,410,324.0,351.0,171,-165,336
713,22,21,2,4,0,974,825,774,757,1154,914,753,1190,1198,462,436,1058,747.0,652.0,622,-26,648
555,1,22,4,4,0,523,603,553,600,670,690,633,790,925,325,455,653,554.0,478.0,198,130,68
270,2,22,4,4,0,322,387,317,493,447,408,431,527,546,194,218,317,268.0,243.0,99,24,75
292,3,22,4,4,0,265,350,301,313,341,355,371,359,418,168,163,287,225.0,206.0,124,-5,129
698,4,22,4,4,0,846,916,826,879,911,1074,915,1162,1615,471,523,831,677.0,608.0,308,52,256
665,5,22,4,4,0,706,738,715,745,722,1155,772,961,1167,445,516,738,627.0,566.0,222,71,151
653,6,22,4,4,0,647,692,656,677,767,841,878,933,1003,374,418,658,538.0,483.0,240,44,196
1860,7,22,4,4,0,1822,1978,1685,1638,1852,2308,2307,2370,2766,875,984,1739,1362.0,1199.0,755,109,646
243,8,22,4,4,0,241,352,275,285,300,313,320,355,484,139,184,247,216.0,190.0,63,45,18
629,9,22,4,4,0,810,979,912,937,951,992,1092,1209,1464,402,402,896,649.0,567.0,494,0,494
157,10,22,4,4,0,186,265,233,260,262,246,259,290,384,118,109,224,166.0,150.0,115,-9,124
1953,11,22,4,4,0,1949,2522,2016,2112,2209,2679,2595,2801,3241,1057,1612,2234,1923.0,1634.0,622,555,67
307,12,22,4,4,0,361,405,347,434,393,442,498,481,511,213,176,385,280.0,258.0,209,-37,246
1690,13,22,4,4,0,1277,1469,1298,1298,1461,1525,1603,1929,2115,754,885,1533,1209.0,1057.0,648,131,517
1228,14,22,4,4,0,1137,1026,959,1096,1283,1383,1309,1461,1740,591,724,1200,962.0,838.0,476,133,343
1676,15,22,4,4,0,1632,1956,1671,1999,1697,1991,2033,2127,2662,818,1237,1764,1500.0,1273.0,527,419,108
356,16,22,4,4,0,473,508,574,499,596,611,603,616,685,305,279,470,374.0,351.0,191,-26,217
347,17,22,4,4,0,412,494,442,503,514,645,501,559,768,256,278,497,388.0,344.0,219,22,197
262,18,22,4,4,0,409,530,373,503,451,397,473,480,608,216,257,389,323.0,287.0,132,41,91
408,19,22,4,4,0,476,514,420,483,505,553,489,516,595,169,217,412,314.0,266.0,195,48,147
100,20,22,4,4,0,120,135,198,189,145,189,159,216,258,69,99,133,116.0,100.0,34,30,4
306,21,22,4,4,0,393,540,321,402,487,425,510,487,657,185,238,361,300.0,261.0,123,53,70
404,22,22,4,4,0,493,470,454,420,611,511,443,413,533,157,228,535,382.0,307.0,307,71,236
61,1,23,1,4,0,123,63,113,83,134,126,104,114,215,76,41,45,43.0,54.0,4,-35,39
36,2,23,1,4,0,92,106,89,141,121,133,139,121,182,95,41,34,38.0,57.0,-7,-54,47
76,3,23,1,4,0,107,124,111,114,92,121,108,174,205,99,66,95,80.0,87.0,29,-33,62
53,4,23,1,4,0,172,132,149,201,202,250,161,243,439,74,40,54,47.0,56.0,14,-34,48
133,5,23,1,4,0,331,262,301,284,317,459,291,297,513,309,153,136,144.0,199.0,-17,-156,139
307,6,23,1,4,0,514,529,526,633,733,655,600,692,1047,578,273,312,292.0,388.0,39,-305,344
572,7,23,1,4,0,922,771,855,1000,1063,1138,1097,1099,1844,902,381,538,460.0,607.0,157,-521,678
226,8,23,1,4,0,211,195,143,212,261,250,277,308,545,238,158,237,198.0,211.0,79,-80,159
103,9,23,1,4,0,162,145,223,291,295,282,277,289,373,126,71,118,94.0,105.0,47,-55,102
35,10,23,1,4,0,54,71,100,108,107,108,100,115,162,93,53,69,61.0,72.0,16,-40,56
206,11,23,1,4,0,332,411,403,402,461,370,406,397,621,300,168,197,182.0,222.0,29,-132,161
68,12,23,1,4,0,96,91,121,141,112,150,164,143,266,151,36,61,48.0,83.0,25,-115,140
459,13,23,1,4,0,514,537,455,575,645,742,699,808,1460,748,389,430,410.0,522.0,41,-359,400
240,14,23,1,4,0,313,364,453,477,544,566,471,617,1100,524,174,251,212.0,316.0,77,-350,427
66,15,23,1,4,0,153,145,161,194,181,198,211,191,260,101,55,63,59.0,73.0,8,-46,54
125,16,23,1,4,0,178,180,285,274,266,326,324,313,534,275,79,103,91.0,152.0,24,-196,220
126,17,23,1,4,0,217,180,205,282,273,347,286,335,535,308,119,163,141.0,197.0,44,-189,233
31,18,23,1,4,0,56,58,88,101,114,102,89,87,129,60,25,51,38.0,45.0,26,-35,61
121,19,23,1,4,0,252,262,234,252,331,280,278,265,371,149,91,133,112.0,124.0,42,-58,100
66,20,23,1,4,0,190,138,222,247,251,250,189,199,335,168,84,69,76.0,107.0,-15,-84,69
76,21,23,1,4,0,112,151,113,180,161,167,197,186,360,209,62,83,72.0,118.0,21,-147,168
101,22,23,1,4,0,165,177,206,165,264,248,169,223,312,126,95,154,124.0,125.0,59,-31,90
600,1,24,2,4,0,507,485,527,653,687,651,489,558,362,679,494,731,612.0,635.0,237,-185,422
186,2,24,2,4,0,151,202,185,247,209,201,174,160,155,229,130,223,176.0,194.0,93,-99,192
99,3,24,2,4,0,76,95,106,108,130,97,99,82,59,106,63,136,100.0,102.0,73,-43,116
575,4,24,2,4,0,545,566,646,748,847,831,642,654,521,798,532,838,685.0,723.0,306,-266,572
524,5,24,2,4,0,421,431,486,460,559,615,471,430,474,703,394,653,524.0,583.0,259,-309,568
311,6,24,2,4,0,252,223,244,244,344,348,248,228,187,338,203,372,288.0,304.0,169,-135,304
527,7,24,2,4,0,457,437,443,584,549,525,474,421,353,610,362,607,484.0,526.0,245,-248,493
139,8,24,2,4,0,93,114,101,121,154,121,105,117,105,129,94,160,127.0,128.0,66,-35,101
1093,9,24,2,4,0,891,1008,1160,1083,1238,1180,1049,976,1007,1207,847,1361,1104.0,1138.0,514,-360,874
121,10,24,2,4,0,79,114,129,142,161,151,126,138,119,159,102,172,137.0,144.0,70,-57,127
1523,11,24,2,4,0,1291,1323,1469,1509,1821,1585,1270,1186,1077,1735,1066,1713,1390.0,1505.0,647,-669,1316
216,12,24,2,4,0,158,177,165,198,224,232,164,154,152,242,146,291,218.0,226.0,145,-96,241
379,13,24,2,4,0,297,312,337,350,330,362,307,254,182,340,242,360,301.0,314.0,118,-98,216
289,14,24,2,4,0,358,277,291,353,389,339,239,284,223,320,199,311,255.0,277.0,112,-121,233
1326,15,24,2,4,0,1124,1121,1210,1486,1568,1439,1239,1136,1024,1529,973,1602,1288.0,1368.0,629,-556,1185
296,16,24,2,4,0,286,265,300,346,383,407,272,273,274,370,238,369,304.0,326.0,131,-132,263
275,17,24,2,4,0,229,207,229,257,270,285,213,205,215,305,186,346,266.0,279.0,160,-119,279
350,18,24,2,4,0,340,375,354,394,437,448,353,321,324,518,242,572,407.0,444.0,330,-276,606
225,19,24,2,4,0,234,226,254,291,346,299,229,207,174,292,205,321,263.0,273.0,116,-87,203
240,20,24,2,4,0,204,204,232,259,222,255,197,217,217,267,199,277,238.0,248.0,78,-68,146
203,21,24,2,4,0,213,288,241,238,319,283,263,205,197,285,151,281,216.0,239.0,130,-134,264
85,22,24,2,4,0,80,87,80,75,119,71,81,63,53,93,68,133,100.0,98.0,65,-25,90
263,1,25,1,4,0,283,308,272,297,303,281,281,247,225,315,160,297,228.0,257.0,137,-155,292
133,2,25,1,4,0,143,175,143,190,187,165,167,133,176,164,108,164,136.0,145.0,56,-56,112
111,3,25,1,4,0,82,115,109,112,117,120,96,85,86,86,62,103,82.0,84.0,41,-24,65
270,4,25,1,4,0,353,385,362,331,427,429,308,324,417,323,190,356,273.0,290.0,166,-133,299
313,5,25,1,4,0,344,382,380,359,376,389,305,301,337,483,166,411,288.0,353.0,245,-317,562
183,6,25,1,4,0,162,175,187,156,227,205,162,169,174,188,119,173,146.0,160.0,54,-69,123
297,7,25,1,4,0,276,307,309,263,302,292,265,227,253,339,160,306,233.0,268.0,146,-179,325
101,8,25,1,4,0,59,95,91,82,103,99,83,81,91,111,56,97,76.0,88.0,41,-55,96
409,9,25,1,4,0,501,543,522,480,565,575,462,510,512,581,314,531,422.0,475.0,217,-267,484
59,10,25,1,4,0,103,113,124,96,117,108,102,103,109,128,57,103,80.0,96.0,46,-71,117
678,11,25,1,4,0,673,752,698,733,823,757,642,661,734,807,456,741,598.0,668.0,285,-351,636
126,12,25,1,4,0,134,157,139,120,153,155,115,129,138,165,79,158,118.0,134.0,79,-86,165
195,13,25,1,4,0,188,230,197,195,219,226,184,180,178,203,126,201,164.0,177.0,75,-77,152
191,14,25,1,4,0,205,180,189,189,186,187,161,189,173,186,103,191,147.0,160.0,88,-83,171
625,15,25,1,4,0,636,660,565,645,709,620,587,599,595,656,382,738,560.0,592.0,356,-274,630
214,16,25,1,4,0,230,266,292,242,319,331,219,258,266,270,142,257,200.0,223.0,115,-128,243
161,17,25,1,4,0,206,200,169,164,219,179,160,168,191,210,114,205,160.0,176.0,91,-96,187
183,18,25,1,4,0,219,230,256,240,260,259,202,201,205,241,127,267,197.0,212.0,140,-114,254
125,19,25,1,4,0,166,150,154,152,161,165,130,138,128,140,90,113,102.0,114.0,23,-50,73
102,20,25,1,4,0,134,144,142,148,158,109,123,106,134,131,54,117,86.0,101.0,63,-77,140
119,21,25,1,4,0,163,199,168,161,205,192,172,135,145,159,85,142,114.0,129.0,57,-74,131
65,22,25,1,4,0,72,91,70,67,99,74,50,53,61,68,34,78,56.0,60.0,44,-34,78
562,1,26,1,4,0,355,455,551,438,559,478,428,493,474,835,424,592,508.0,617.0,168,-411,579
223,2,26,1,4,0,123,203,222,190,240,237,204,210,215,310,178,234,206.0,241.0,56,-132,188
104,3,26,1,4,0,62,91,81,74,115,91,72,82,74,139,87,116,102.0,114.0,29,-52,81
763,4,26,1,4,0,509,573,717,674,824,853,604,747,817,1033,648,841,744.0,841.0,193,-385,578
456,5,26,1,4,0,334,442,494,344,458,388,382,361,382,695,383,524,454.0,534.0,141,-312,453
259,6,26,1,4,0,138,167,188,148,226,228,183,176,177,354,152,225,188.0,244.0,73,-202,275
488,7,26,1,4,0,259,291,346,365,453,344,338,348,336,608,328,530,429.0,489.0,202,-280,482
118,8,26,1,4,0,95,88,102,105,108,108,84,93,100,165,96,130,113.0,130.0,34,-69,103
964,9,26,1,4,0,560,678,769,689,886,875,627,766,825,1178,690,1101,896.0,990.0,411,-488,899
133,10,26,1,4,0,57,97,100,90,105,124,72,100,114,160,106,163,134.0,143.0,57,-54,111
1026,11,26,1,4,0,801,890,962,857,1124,918,791,915,1007,1591,766,1115,940.0,1157.0,349,-825,1174
214,12,26,1,4,0,99,112,125,115,140,155,101,129,108,227,115,167,141.0,170.0,52,-112,164
289,13,26,1,4,0,183,199,229,221,266,200,202,203,219,376,209,316,262.0,300.0,107,-167,274
304,14,26,1,4,0,185,185,207,254,276,252,194,283,262,357,201,287,244.0,282.0,86,-156,242
967,15,26,1,4,0,641,723,810,824,880,834,733,849,908,1436,623,970,796.0,1010.0,347,-813,1160
316,16,26,1,4,0,212,243,260,260,327,326,230,315,356,436,202,366,284.0,335.0,164,-234,398
255,17,26,1,4,0,121,164,200,157,190,184,143,174,192,302,179,246,212.0,242.0,67,-123,190
297,18,26,1,4,0,208,225,265,234,296,266,197,227,256,500,212,338,275.0,350.0,126,-288,414
261,19,26,1,4,0,172,190,254,215,281,225,176,194,227,304,176,286,231.0,255.0,110,-128,238
197,20,26,1,4,0,114,168,164,192,184,176,151,174,194,265,152,205,178.0,207.0,53,-113,166
205,21,26,1,4,0,186,174,206,235,213,228,210,194,216,307,140,222,181.0,223.0,82,-167,249
116,22,26,1,4,0,62,72,97,59,106,77,74,83,85,102,84,125,104.0,104.0,41,-18,59
113,1,27,4,4,0,166,151,149,152,203,190,188,201,262,80,97,160,128.0,112.0,63,17,46
50,2,27,4,4,0,81,86,43,35,60,52,76,100,59,26,35,34,34.0,32.0,-1,9,-10
37,3,27,4,4,0,34,38,23,35,33,31,42,40,37,22,17,26,22.0,22.0,9,-5,14
137,4,27,4,4,0,267,259,192,172,203,232,200,230,226,93,117,153,135.0,121.0,36,24,12
137,5,27,4,4,0,124,131,94,121,152,216,166,240,223,57,76,90,83.0,74.0,14,19,-5
81,6,27,4,4,0,91,91,85,90,104,106,110,130,121,57,59,72,66.0,63.0,13,2,11
152,7,27,4,4,0,273,264,203,199,232,258,215,231,199,113,137,218,178.0,156.0,81,24,57
22,8,27,4,4,0,23,35,28,32,37,31,31,28,33,16,10,28,19.0,18.0,18,-6,24
223,9,27,4,4,0,207,253,209,182,223,290,309,396,384,120,115,231,173.0,155.0,116,-5,121
25,10,27,4,4,0,21,31,23,25,29,35,34,41,40,20,18,18,18.0,19.0,0,-2,2
342,11,27,4,4,0,327,438,345,389,471,447,420,635,591,225,325,414,370.0,321.0,89,100,-11
40,12,27,4,4,0,44,50,31,41,43,50,52,66,85,10,18,37,28.0,22.0,19,8,11
131,13,27,4,4,0,105,161,119,127,130,145,141,166,161,78,99,131,115.0,103.0,32,21,11
88,14,27,4,4,0,107,118,88,93,86,118,117,128,163,57,77,90,84.0,75.0,13,20,-7
386,15,27,4,4,0,431,415,297,361,382,415,422,523,567,168,290,344,317.0,267.0,54,122,-68
88,16,27,4,4,0,72,86,72,79,106,110,92,120,142,48,54,76,65.0,59.0,22,6,16
74,17,27,4,4,0,84,62,48,45,64,96,79,112,124,41,43,61,52.0,48.0,18,2,16
51,18,27,4,4,0,68,83,59,50,84,61,85,108,127,23,28,50,39.0,34.0,22,5,17
45,19,27,4,4,0,79,77,61,82,88,87,77,106,83,28,38,67,52.0,44.0,29,10,19
34,20,27,4,4,0,35,34,28,26,35,47,43,77,67,17,20,19,20.0,19.0,-1,3,-4
66,21,27,4,4,0,77,99,52,57,82,79,83,68,82,41,52,48,50.0,47.0,-4,11,-15
30,22,27,4,4,0,63,68,50,44,61,42,40,48,45,18,18,48,33.0,28.0,30,0,30
311,1,28,2,4,0,493,512,736,581,360,145,129,306,492,378,283,374,328.0,345.0,91,-95,186
149,2,28,2,4,0,224,243,237,221,153,83,75,142,154,140,101,145,123.0,129.0,44,-39,83
124,3,28,2,4,0,133,164,131,165,105,47,48,67,109,121,79,109,94.0,103.0,30,-42,72
522,4,28,2,4,0,701,789,881,663,502,321,175,311,576,511,299,438,368.0,416.0,139,-212,351
444,5,28,2,4,0,495,600,609,554,488,356,206,340,526,495,291,361,326.0,382.0,70,-204,274
319,6,28,2,4,0,315,306,319,309,208,104,111,219,307,304,148,259,204.0,237.0,111,-156,267
479,7,28,2,4,0,643,668,672,573,446,246,241,312,378,406,284,400,342.0,363.0,116,-122,238
97,8,28,2,4,0,126,145,145,138,80,47,46,58,83,94,61,99,80.0,85.0,38,-33,71
642,9,28,2,4,0,692,927,973,869,740,398,282,593,912,598,355,607,481.0,520.0,252,-243,495
72,10,28,2,4,0,69,104,120,85,95,39,30,50,68,74,33,77,55.0,61.0,44,-41,85
910,11,28,2,4,0,1133,1369,1500,1116,610,270,351,609,1028,993,652,891,772.0,845.0,239,-341,580
150,12,28,2,4,0,180,188,194,175,130,47,59,107,208,200,69,151,110.0,140.0,82,-131,213
382,13,28,2,4,0,396,489,506,429,351,172,141,298,340,342,250,323,286.0,305.0,73,-92,165
341,14,28,2,4,0,443,350,442,406,206,143,136,170,239,290,184,293,238.0,256.0,109,-106,215
1088,15,28,2,4,0,1481,1596,1826,1257,815,643,498,965,1300,996,708,969,838.0,891.0,261,-288,549
279,16,28,2,4,0,320,331,346,286,253,116,101,212,331,334,134,250,192.0,239.0,116,-200,316
271,17,28,2,4,0,305,370,344,325,229,78,92,180,310,284,146,251,198.0,227.0,105,-138,243
164,18,28,2,4,0,210,345,285,288,200,69,95,138,176,229,97,153,125.0,160.0,56,-132,188
317,19,28,2,4,0,364,390,459,433,291,193,157,189,261,256,190,274,232.0,240.0,84,-66,150
97,20,28,2,4,0,161,172,225,158,135,51,35,76,157,115,82,120,101.0,106.0,38,-33,71
239,21,28,2,4,0,275,312,315,249,241,115,96,127,205,223,136,166,151.0,175.0,30,-87,117
138,22,28,2,4,0,234,241,211,111,123,58,56,108,145,104,92,153,122.0,116.0,61,-12,73
256,1,29,1,4,0,364,320,327,408,528,494,298,341,507,266,214,347,280.0,276.0,133,-52,185
158,2,29,1,4,0,191,127,108,198,213,197,180,169,225,142,99,142,120.0,128.0,43,-43,86
133,3,29,1,4,0,132,135,136,178,178,174,157,121,169,76,74,105,90.0,85.0,31,-2,33
234,4,29,1,4,0,394,364,332,388,450,529,355,417,450,177,170,259,214.0,202.0,89,-7,96
333,5,29,1,4,0,337,371,406,440,533,641,403,433,394,242,224,324,274.0,263.0,100,-18,118
231,6,29,1,4,0,208,185,223,244,297,328,172,256,310,160,139,211,175.0,170.0,72,-21,93
402,7,29,1,4,0,377,302,378,352,487,582,453,469,507,305,251,332,292.0,296.0,81,-54,135
86,8,29,1,4,0,107,116,114,132,168,143,117,124,97,55,43,101,72.0,66.0,58,-12,70
599,9,29,1,4,0,587,591,684,704,813,867,710,821,895,435,271,630,450.0,445.0,359,-164,523
95,10,29,1,4,0,95,81,120,108,129,137,85,114,124,79,66,108,87.0,84.0,42,-13,55
807,11,29,1,4,0,789,826,854,952,1272,1166,688,937,1154,552,589,835,712.0,659.0,246,37,209
142,12,29,1,4,0,121,144,151,183,202,193,186,189,178,106,91,145,118.0,114.0,54,-15,69
302,13,29,1,4,0,291,244,275,310,427,423,324,327,378,179,188,251,220.0,206.0,63,9,54
258,14,29,1,4,0,351,217,257,301,336,420,237,276,308,156,143,260,202.0,186.0,117,-13,130
841,15,29,1,4,0,811,816,971,1162,1196,1045,917,1072,1169,550,543,759,651.0,617.0,216,-7,223
262,16,29,1,4,0,272,236,352,315,395,429,270,308,378,261,177,285,231.0,241.0,108,-84,192
238,17,29,1,4,0,231,235,286,268,360,359,193,226,309,145,129,251,190.0,175.0,122,-16,138
202,18,29,1,4,0,247,214,238,244,281,263,253,214,293,168,110,183,146.0,154.0,73,-58,131
151,19,29,1,4,0,192,184,149,191,241,242,174,177,213,86,85,121,103.0,97.0,36,-1,37
68,20,29,1,4,0,84,83,135,121,146,128,96,89,130,65,59,92,76.0,72.0,33,-6,39
150,21,29,1,4,0,141,143,148,200,229,215,165,164,174,112,81,131,106.0,108.0,50,-31,81
82,22,29,1,4,0,96,96,121,92,130,140,82,95,85,44,40,74,57.0,53.0,34,-4,38
315,1,30,1,4,0,428,462,576,421,521,504,402,593,748,538,251,456,354.0,415.0,205,-287,492
198,2,30,1,4,0,234,259,204,306,266,231,316,323,344,263,166,191,178.0,207.0,25,-97,122
165,3,30,1,4,0,167,203,169,162,217,201,207,206,200,197,109,152,130.0,153.0,43,-88,131
651,4,30,1,4,0,887,986,1008,845,898,731,715,939,1050,755,424,693,558.0,624.0,269,-331,600
468,5,30,1,4,0,632,753,748,554,658,1072,583,560,641,624,348,443,396.0,472.0,95,-276,371
256,6,30,1,4,0,270,316,300,257,346,329,282,331,409,330,200,229,214.0,253.0,29,-130,159
540,7,30,1,4,0,607,578,623,481,543,678,438,630,646,659,309,458,384.0,475.0,149,-350,499
120,8,30,1,4,0,127,142,127,114,155,143,139,142,103,120,44,90,67.0,85.0,46,-76,122
894,9,30,1,4,0,985,1219,1303,1074,1237,1342,1295,1408,1829,1269,499,1006,752.0,925.0,507,-770,1277
117,10,30,1,4,0,96,158,161,124,125,189,162,142,255,213,82,152,117.0,149.0,70,-131,201
933,11,30,1,4,0,965,1031,1078,842,1106,1255,1040,1108,1430,1304,649,954,802.0,969.0,305,-655,960
198,12,30,1,4,0,206,264,228,177,230,275,218,275,247,282,85,186,136.0,184.0,101,-197,298
412,13,30,1,4,0,330,420,442,396,476,471,407,417,527,425,254,337,296.0,339.0,83,-171,254
426,14,30,1,4,0,404,359,472,400,422,469,405,382,502,442,251,354,302.0,349.0,103,-191,294
888,15,30,1,4,0,1028,1051,1251,1000,1181,1241,932,1214,1500,938,567,836,702.0,780.0,269,-371,640
363,16,30,1,4,0,406,395,467,358,427,529,447,473,526,572,259,428,344.0,420.0,169,-313,482
370,17,30,1,4,0,420,443,451,322,451,476,369,391,505,374,207,342,274.0,308.0,135,-167,302
194,18,30,1,4,0,234,345,272,282,266,282,298,320,358,335,144,206,175.0,228.0,62,-191,253
293,19,30,1,4,0,315,405,340,365,459,418,357,335,454,281,156,268,212.0,235.0,112,-125,237
121,20,30,1,4,0,221,225,291,189,230,259,188,209,244,199,108,153,130.0,153.0,45,-91,136
225,21,30,1,4,0,253,346,302,281,312,352,366,242,346,325,174,210,192.0,236.0,36,-151,187
137,22,30,1,4,0,201,264,224,175,240,219,123,190,198,139,94,144,119.0,126.0,50,-45,95
487,1,31,2,4,0,679,634,547,444,607,438,357,513,576,543,384,696,540.0,541.0,312,-159,471
234,2,31,2,4,0,225,250,183,177,213,139,117,236,257,243,199,312,256.0,251.0,113,-44,157
76,3,31,2,4,0,69,87,52,46,43,47,37,60,80,54,43,84,64.0,60.0,41,-11,52
527,4,31,2,4,0,614,681,595,494,449,410,328,585,816,536,311,688,500.0,512.0,377,-225,602
478,5,31,2,4,0,619,591,569,444,445,455,290,447,593,591,337,640,488.0,523.0,303,-254,557
350,6,31,2,4,0,300,376,284,251,265,236,233,275,385,322,230,435,332.0,329.0,205,-92,297
538,7,31,2,4,0,554,521,386,382,358,297,285,401,440,468,289,622,456.0,460.0,333,-179,512
79,8,31,2,4,0,62,68,61,45,60,31,30,61,103,57,64,78,71.0,66.0,14,7,7
1061,9,31,2,4,0,1224,1221,1023,972,1033,800,773,983,1319,1274,618,1449,1034.0,1114.0,831,-656,1487
123,10,31,2,4,0,132,140,110,112,99,93,94,126,167,115,84,164,124.0,121.0,80,-31,111
1193,11,31,2,4,0,1233,1314,879,894,893,729,862,988,1160,1203,919,1681,1300.0,1268.0,762,-284,1046
198,12,31,2,4,0,202,203,160,175,134,144,96,129,200,185,89,224,156.0,166.0,135,-96,231
496,13,31,2,4,0,289,334,287,249,266,194,192,281,283,417,232,460,346.0,370.0,228,-185,413
425,14,31,2,4,0,370,322,315,276,272,209,174,237,350,258,224,388,306.0,290.0,164,-34,198
1596,15,31,2,4,0,1897,1719,1389,1189,1547,1208,929,1465,1724,1540,1004,2273,1638.0,1606.0,1269,-536,1805
266,16,31,2,4,0,306,263,266,203,235,199,144,218,283,271,143,325,234.0,246.0,182,-128,310
321,17,31,2,4,0,396,354,336,258,251,209,203,255,374,375,195,380,288.0,317.0,185,-180,365
304,18,31,2,4,0,266,319,252,323,276,236,214,251,346,352,161,369,265.0,294.0,208,-191,399
256,19,31,2,4,0,327,247,205,195,187,133,91,159,186,215,146,225,186.0,195.0,79,-69,148
195,20,31,2,4,0,273,262,227,183,189,132,105,200,253,198,131,290,210.0,206.0,159,-67,226
193,21,31,2,4,0,204,258,182,135,163,159,132,134,174,188,135,235,185.0,186.0,100,-53,153
104,22,31,2,4,0,94,88,66,52,57,23,28,58,76,70,44,104,74.0,73.0,60,-26,86
217,1,32,3,4,0,205,249,256,328,379,426,299,501,825,333,136,253,194.0,241.0,117,-197,314
559,2,32,3,4,0,517,594,552,695,707,913,926,928,1393,1050,634,598,616.0,761.0,-36,-416,380
141,3,32,3,4,0,118,129,99,134,132,200,230,272,405,185,132,207,170.0,175.0,75,-53,128
127,4,32,3,4,0,352,376,194,240,313,370,330,446,852,178,127,199,163.0,168.0,72,-51,123
413,5,32,3,4,0,633,599,569,778,755,971,792,934,1509,1063,565,512,538.0,713.0,-53,-498,445
771,6,32,3,4,0,765,835,790,1052,1349,1421,1263,1461,2601,1965,1072,936,1004.0,1324.0,-136,-893,757
1694,7,32,3,4,0,1567,2055,1628,2244,2677,2814,2975,3077,5360,2858,1598,1729,1664.0,2062.0,131,-1260,1391
437,8,32,3,4,0,377,360,353,542,640,778,791,803,1442,701,396,447,422.0,515.0,51,-305,356
2465,9,32,3,4,0,2719,3307,2768,3295,4086,5098,5032,5800,8421,3465,1872,3263,2568.0,2867.0,1391,-1593,2984
1206,10,32,3,4,0,1619,1976,1690,1981,2497,3110,3025,3479,6171,2981,1510,1845,1678.0,2112.0,335,-1471,1806
1325,11,32,3,4,0,1121,1352,1272,1577,1829,2045,1978,2153,3757,2028,1542,1465,1504.0,1678.0,-77,-486,409
359,12,32,3,4,0,412,417,410,598,635,806,703,736,1319,827,443,434,438.0,568.0,-9,-384,375
1146,13,32,3,4,0,830,1060,888,1184,1505,1631,1500,1789,2863,1366,1047,1021,1034.0,1145.0,-26,-319,293
2423,14,32,3,4,0,2474,2930,3020,3796,4302,4617,4700,5194,9539,6024,2842,2528,2685.0,3798.0,-314,-3182,2868
680,15,32,3,4,0,616,852,799,1096,1291,1435,1528,1653,2646,934,580,745,662.0,753.0,165,-354,519
406,16,32,3,4,0,459,481,488,678,753,891,696,982,1629,1137,521,524,522.0,727.0,3,-616,619
663,17,32,3,4,0,812,802,747,984,1113,1544,1234,1513,2352,1658,771,808,790.0,1079.0,37,-887,924
314,18,32,3,4,0,380,411,360,626,548,706,724,738,1086,453,316,456,386.0,408.0,140,-137,277
468,19,32,3,4,0,398,383,376,528,616,644,644,694,1039,408,313,505,409.0,409.0,192,-95,287
172,20,32,3,4,0,270,261,287,297,277,359,279,304,514,324,210,169,190.0,234.0,-41,-114,73
452,21,32,3,4,0,456,460,358,538,648,785,855,1045,1704,937,403,499,451.0,613.0,96,-534,630
482,22,32,3,4,0,350,475,475,643,791,839,638,832,1045,394,365,562,464.0,440.0,197,-29,226
521,1,33,2,4,0,740,785,835,1350,1065,2065,1032,1283,1483,389,338,505,422.0,411.0,167,-51,218
214,2,33,2,4,0,229,244,208,404,346,402,396,360,567,208,160,208,184.0,192.0,48,-48,96
311,3,33,2,4,0,450,527,415,569,575,712,648,698,789,413,215,340,278.0,323.0,125,-198,323
84,4,33,2,4,0,342,374,346,429,397,451,276,389,488,143,102,126,114.0,124.0,24,-41,65
521,5,33,2,4,0,756,677,695,682,820,1286,786,820,1117,531,374,577,476.0,494.0,203,-157,360
246,6,33,2,4,0,363,414,357,477,644,726,594,615,705,385,198,241,220.0,275.0,43,-187,230
843,7,33,2,4,0,1356,1271,1075,1292,1454,1777,1435,1352,1707,803,424,738,581.0,655.0,314,-379,693
169,8,33,2,4,0,295,376,259,310,346,391,347,352,464,131,87,174,130.0,131.0,87,-44,131
195,9,33,2,4,0,205,277,296,248,286,326,342,407,475,130,117,221,169.0,156.0,104,-13,117
54,10,33,2,4,0,110,154,153,106,135,181,167,158,231,93,43,77,60.0,71.0,34,-50,84
1007,11,33,2,4,0,1589,1718,1504,1598,2024,2099,1880,1868,2181,991,782,1094,938.0,956.0,312,-209,521
180,12,33,2,4,0,338,384,268,290,349,532,430,438,495,251,128,183,156.0,187.0,55,-123,178
598,13,33,2,4,0,668,745,713,769,1026,1153,782,978,1229,546,360,592,476.0,499.0,232,-186,418
410,14,33,2,4,0,691,656,595,849,951,954,750,835,1053,508,259,492,376.0,420.0,233,-249,482
450,15,33,2,4,0,703,696,655,723,773,920,884,1063,1213,348,291,556,424.0,398.0,265,-57,322
138,16,33,2,4,0,264,212,303,273,340,406,336,358,440,200,80,136,108.0,139.0,56,-120,176
224,17,33,2,4,0,384,428,388,473,550,688,528,670,749,385,150,254,202.0,263.0,104,-235,339
176,18,33,2,4,0,281,308,207,297,275,314,302,385,408,188,136,178,157.0,167.0,42,-52,94
84,19,33,2,4,0,132,162,151,156,254,246,156,195,210,53,54,81,68.0,63.0,27,1,26
117,20,33,2,4,0,161,182,218,192,205,240,178,181,295,131,85,113,99.0,110.0,28,-46,74
610,21,33,2,4,0,772,950,666,1062,1276,1109,958,1012,1286,412,280,531,406.0,408.0,251,-132,383
104,22,33,2,4,0,257,265,200,199,236,256,202,210,228,66,80,160,120.0,102.0,80,14,66
226,1,34,2,4,0,301,229,293,265,342,422,337,524,679,950,175,263,219.0,463.0,88,-775,863
108,2,34,2,4,0,93,77,88,123,129,142,173,215,293,131,118,135,126.0,128.0,17,-13,30
48,3,34,2,4,0,68,68,57,63,80,87,94,102,118,60,38,63,50.0,54.0,25,-22,47
105,4,34,2,4,0,141,144,157,165,158,241,166,231,280,180,87,167,127.0,145.0,80,-93,173
163,5,34,2,4,0,165,176,134,135,208,419,226,291,404,151,140,210,175.0,167.0,70,-11,81
74,6,34,2,4,0,84,82,105,84,146,172,127,176,201,116,64,85,74.0,88.0,21,-52,73
296,7,34,2,4,0,336,249,208,207,253,405,274,383,451,230,146,276,211.0,217.0,130,-84,214
34,8,34,2,4,0,37,54,47,58,68,104,75,85,95,42,23,68,46.0,44.0,45,-19,64
101,9,34,2,4,0,95,114,119,105,149,140,175,225,268,104,54,144,99.0,101.0,90,-50,140
17,10,34,2,4,0,27,26,35,28,43,42,39,42,71,30,28,32,30.0,30.0,4,-2,6
278,11,34,2,4,0,322,305,326,286,477,566,501,644,669,334,279,388,334.0,334.0,109,-55,164
53,12,34,2,4,0,46,68,55,61,72,97,83,104,86,64,32,40,36.0,45.0,8,-32,40
151,13,34,2,4,0,133,124,117,113,185,186,192,206,272,140,97,162,130.0,133.0,65,-43,108
142,14,34,2,4,0,115,86,115,109,191,156,169,219,319,144,90,156,123.0,130.0,66,-54,120
179,15,34,2,4,0,241,174,199,216,262,293,289,400,452,190,120,235,178.0,182.0,115,-70,185
41,16,34,2,4,0,44,55,47,45,58,71,47,81,82,146,33,61,47.0,80.0,28,-113,141
89,17,34,2,4,0,96,123,93,121,118,158,115,135,228,105,59,115,87.0,93.0,56,-46,102
62,18,34,2,4,0,44,77,80,72,82,93,107,132,139,77,43,64,54.0,61.0,21,-34,55
19,19,34,2,4,0,39,48,22,42,64,69,52,62,81,42,40,28,34.0,37.0,-12,-2,-10
52,20,34,2,4,0,31,19,68,61,42,66,46,77,87,44,31,56,44.0,44.0,25,-13,38
151,21,34,2,4,0,134,132,92,109,169,208,170,201,238,124,83,169,126.0,125.0,86,-41,127
50,22,34,2,4,0,46,45,30,38,60,45,45,56,48,22,17,60,38.0,33.0,43,-5,48
178,1,35,2,4,0,228,169,138,110,96,130,129,206,317,238,124,175,150.0,179.0,51,-114,165
58,2,35,2,4,0,75,180,62,53,48,150,68,61,94,64,55,50,52.0,56.0,-5,-9,4
84,3,35,2,4,0,86,107,104,115,80,59,69,77,114,119,58,88,73.0,88.0,30,-61,91
422,4,35,2,4,0,679,1478,362,522,549,341,411,466,954,488,303,463,383.0,418.0,160,-185,345
310,5,35,2,4,0,337,329,313,287,213,226,219,270,560,493,212,308,260.0,338.0,96,-281,377
152,6,35,2,4,0,287,132,112,137,105,226,131,164,192,238,108,126,117.0,157.0,18,-130,148
802,7,35,2,4,0,634,622,583,483,376,451,391,462,714,609,352,736,544.0,566.0,384,-257,641
133,8,35,2,4,0,138,173,121,88,87,81,104,152,230,168,75,152,114.0,132.0,77,-93,170
1342,9,35,2,4,0,1049,1151,1204,796,688,783,887,1988,1893,1283,554,1157,856.0,998.0,603,-729,1332
179,10,35,2,4,0,232,292,302,238,333,211,167,204,333,316,132,218,175.0,222.0,86,-184,270
575,11,35,2,4,0,817,757,633,614,701,409,489,602,865,785,520,701,610.0,669.0,181,-265,446
178,12,35,2,4,0,214,361,199,120,104,272,168,194,280,264,100,195,148.0,186.0,95,-164,259
372,13,35,2,4,0,257,299,271,278,358,279,275,250,454,387,248,489,368.0,375.0,241,-139,380
250,14,35,2,4,0,254,201,225,287,201,184,168,191,300,319,141,195,168.0,218.0,54,-178,232
562,15,35,2,4,0,611,676,536,359,406,355,572,795,787,577,391,567,479.0,512.0,176,-186,362
310,16,35,2,4,0,499,394,422,178,222,287,394,374,566,545,193,390,292.0,376.0,197,-352,549
262,17,35,2,4,0,349,524,267,270,181,332,203,423,412,412,410,531,470.0,451.0,121,-2,123
658,18,35,2,4,0,297,502,255,324,353,331,397,363,562,555,242,485,364.0,427.0,243,-313,556
229,19,35,2,4,0,331,310,263,240,234,219,239,228,340,230,163,328,246.0,240.0,165,-67,232
239,20,35,2,4,0,423,567,467,292,184,281,158,348,846,378,203,261,232.0,281.0,58,-175,233
103,21,35,2,4,0,165,127,82,202,64,63,62,99,126,138,68,103,86.0,103.0,35,-70,105
195,22,35,2,4,0,102,107,81,71,56,91,46,89,107,57,72,88,80.0,72.0,16,15,1
111,1,36,1,4,0,276,268,259,263,265,263,222,276,374,264,140,173,156.0,192.0,33,-124,157
240,2,36,1,4,0,288,287,259,444,328,322,420,444,423,403,246,278,262.0,309.0,32,-157,189
363,3,36,1,4,0,439,598,415,527,467,541,608,505,619,534,251,398,324.0,394.0,147,-283,430
521,4,36,1,4,0,864,925,776,823,803,1019,845,1016,1441,741,459,672,566.0,624.0,213,-282,495
610,5,36,1,4,0,804,780,668,723,668,1080,712,743,1078,940,507,616,562.0,688.0,109,-433,542
149,6,36,1,4,0,191,212,209,143,177,210,217,212,273,247,107,152,130.0,169.0,45,-140,185
657,7,36,1,4,0,823,816,666,592,643,866,764,681,1011,688,350,548,449.0,529.0,198,-338,536
218,8,36,1,4,0,261,279,232,228,276,283,280,288,348,274,115,219,167.0,203.0,104,-159,263
1067,9,36,1,4,0,1334,1757,1676,1516,1456,1686,2097,2144,2562,1849,777,1549,1163.0,1392.0,772,-1072,1844
172,10,36,1,4,0,308,368,312,289,221,333,376,342,443,364,194,278,236.0,279.0,84,-170,254
407,11,36,1,4,0,642,720,594,521,656,670,713,682,857,658,425,546,486.0,543.0,121,-233,354
176,12,36,1,4,0,284,272,228,226,207,304,324,277,382,334,121,180,150.0,212.0,59,-213,272
721,13,36,1,4,0,623,789,655,636,756,829,875,790,1042,804,407,572,490.0,594.0,165,-397,562
422,14,36,1,4,0,561,418,478,457,520,525,514,567,656,654,303,427,365.0,461.0,124,-351,475
407,15,36,1,4,0,688,672,696,609,628,658,707,687,970,632,338,464,401.0,478.0,126,-294,420
740,16,36,1,4,0,976,969,1189,812,879,1194,1234,1296,1458,1429,526,890,708.0,948.0,364,-903,1267
376,17,36,1,4,0,527,529,432,433,504,586,532,579,879,712,262,444,353.0,473.0,182,-450,632
237,18,36,1,4,0,320,437,254,309,324,331,423,388,523,387,223,336,280.0,315.0,113,-164,277
595,19,36,1,4,0,855,952,717,778,859,919,871,786,1105,571,424,658,541.0,551.0,234,-147,381
351,20,36,1,4,0,469,390,863,400,378,452,406,568,732,616,327,364,346.0,436.0,37,-289,326
522,21,36,1,4,0,526,586,401,428,429,480,618,464,618,561,288,381,334.0,410.0,93,-273,366
307,22,36,1,4,0,364,391,379,393,463,364,346,348,497,267,165,333,249.0,255.0,168,-102,270
48,1,37,2,4,0,107,138,95,119,125,135,111,242,237,68,37,61,49.0,55.0,24,-31,55
97,2,37,2,4,0,126,123,110,141,143,170,165,182,271,140,100,100,100.0,113.0,0,-40,40
78,3,37,2,4,0,130,150,140,118,135,135,144,149,195,78,54,74,64.0,69.0,20,-24,44
36,4,37,2,4,0,133,142,156,136,151,163,97,128,205,34,44,59,52.0,46.0,15,10,5
154,5,37,2,4,0,366,331,297,273,290,355,284,276,560,275,186,178,182.0,213.0,-8,-89,81
97,6,37,2,4,0,134,155,164,187,210,258,234,289,496,209,109,109,109.0,142.0,0,-100,100
181,7,37,2,4,0,376,429,398,297,370,455,430,397,599,241,156,188,172.0,195.0,32,-85,117
70,8,37,2,4,0,134,191,136,138,154,165,187,192,226,67,52,65,58.0,61.0,13,-15,28
429,9,37,2,4,0,803,902,957,908,969,966,1096,1273,1753,510,290,467,378.0,422.0,177,-220,397
66,10,37,2,4,0,112,150,145,121,133,163,183,209,314,161,76,113,94.0,117.0,37,-85,122
358,11,37,2,4,0,500,626,524,494,659,663,720,808,1176,484,399,360,380.0,414.0,-39,-85,46
120,12,37,2,4,0,167,200,179,156,182,243,282,281,556,258,99,139,119.0,165.0,40,-159,199
165,13,37,2,4,0,222,334,278,240,275,311,284,290,435,164,126,133,130.0,141.0,7,-38,45
161,14,37,2,4,0,216,293,353,273,313,316,283,364,562,252,130,136,133.0,173.0,6,-122,128
293,15,37,2,4,0,534,604,578,536,581,660,738,799,1102,332,255,331,293.0,306.0,76,-77,153
100,16,37,2,4,0,272,226,274,204,230,271,257,362,526,267,110,92,101.0,156.0,-18,-157,139
96,17,37,2,4,0,189,225,184,208,271,292,260,313,627,286,115,133,124.0,178.0,18,-171,189
130,18,37,2,4,0,232,272,218,246,274,282,315,340,500,185,128,160,144.0,158.0,32,-57,89
111,19,37,2,4,0,382,339,300,311,310,311,260,209,299,101,86,133,110.0,107.0,47,-15,62
59,20,37,2,4,0,200,174,215,160,199,165,151,159,317,179,87,70,78.0,112.0,-17,-92,75
55,21,37,2,4,0,132,119,143,116,126,114,163,141,242,89,58,62,60.0,70.0,4,-31,35
66,22,37,2,4,0,139,154,146,135,155,139,103,121,126,60,44,65,54.0,56.0,21,-16,37
320,1,38,2,4,0,176,401,401,321,346,427,336,1289,571,175,135,300,218.0,203.0,165,-40,205
154,2,38,2,4,0,149,202,186,247,218,226,257,285,393,160,154,201,178.0,172.0,47,-6,53
287,3,38,2,4,0,182,235,185,198,218,291,326,339,631,236,164,278,221.0,226.0,114,-72,186
319,4,38,2,4,0,579,619,663,697,743,797,664,656,980,232,253,315,284.0,267.0,62,21,41
677,5,38,2,4,0,511,577,808,786,904,1230,923,1016,1536,609,478,708,593.0,598.0,230,-131,361
447,6,38,2,4,0,183,258,304,319,476,565,666,550,750,358,257,522,390.0,379.0,265,-101,366
2012,7,38,2,4,0,1838,2095,1935,1835,2200,2915,3148,3502,5481,1788,1203,1635,1419.0,1542.0,432,-585,1017
626,8,38,2,4,0,385,544,496,521,585,792,899,919,1474,502,371,567,469.0,480.0,196,-131,327
6812,9,38,2,4,0,6500,8617,8587,8085,9999,11167,12710,12394,15317,5306,3718,8079,5898.0,5701.0,4361,-1588,5949
1087,10,38,2,4,0,650,933,1046,1010,1186,1639,1709,1789,2693,1195,777,1366,1072.0,1113.0,589,-418,1007
2087,11,38,2,4,0,1039,1356,1362,1273,1726,2274,2226,2622,3296,1247,1529,2148,1838.0,1641.0,619,282,337
835,12,38,2,4,0,380,537,595,606,715,1083,1277,1265,1764,857,484,797,640.0,713.0,313,-373,686
1697,13,38,2,4,0,834,1174,1117,1091,1516,1988,2221,2449,3796,1214,995,1259,1127.0,1156.0,264,-219,483
1492,14,38,2,4,0,1035,851,918,1151,1553,1783,1739,1951,3130,1278,848,1290,1069.0,1139.0,442,-430,872
1369,15,38,2,4,0,888,1084,1050,1140,1443,1709,2001,2019,2088,700,801,1246,1024.0,916.0,445,101,344
827,16,38,2,4,0,568,585,851,689,870,1071,1120,1425,1562,736,376,772,574.0,628.0,396,-360,756
1093,17,38,2,4,0,1123,1343,1265,1384,1668,1721,1444,1769,3168,1244,677,1105,891.0,1009.0,428,-567,995
945,18,38,2,4,0,748,1047,978,991,1227,1477,1846,1591,1981,769,598,1058,828.0,808.0,460,-171,631
1541,19,38,2,4,0,2416,2738,2351,2715,3298,3035,2443,2622,3705,1059,1132,1642,1387.0,1278.0,510,73,437
330,20,38,2,4,0,208,307,592,510,660,624,494,548,828,333,235,331,283.0,300.0,96,-98,194
284,21,38,2,4,0,246,335,408,480,451,462,457,402,722,289,175,287,231.0,250.0,112,-114,226
509,22,38,2,4,0,315,472,426,421,630,651,605,913,1064,350,347,604,476.0,434.0,257,-3,260
213,1,39,1,4,0,256,231,232,275,253,330,234,241,272,250,161,224,192.0,212.0,63,-89,152
298,2,39,1,4,0,222,273,237,317,281,288,285,282,383,494,162,297,230.0,318.0,135,-332,467
399,3,39,1,4,0,297,409,278,346,325,397,353,331,374,412,213,364,288.0,330.0,151,-199,350
347,4,39,1,4,0,428,423,454,541,459,651,432,527,798,336,255,324,290.0,305.0,69,-81,150
354,5,39,1,4,0,404,345,365,374,356,560,353,364,502,560,198,280,239.0,346.0,82,-362,444
365,6,39,1,4,0,311,364,321,347,370,464,369,339,449,378,228,339,284.0,315.0,111,-150,261
1214,7,39,1,4,0,1159,1092,1036,1063,896,1347,1014,1020,1083,1132,648,948,798.0,909.0,300,-484,784
403,8,39,1,4,0,327,404,319,311,334,462,394,347,454,373,276,370,323.0,340.0,94,-97,191
2621,9,39,1,4,0,2056,2432,2474,2478,2391,3040,2810,2842,3119,2859,1337,2735,2036.0,2310.0,1398,-1522,2920
255,10,39,1,4,0,228,279,260,273,237,346,287,279,316,376,154,306,230.0,279.0,152,-222,374
787,11,39,1,4,0,875,944,898,914,919,1153,908,905,1057,1012,579,905,742.0,832.0,326,-433,759
439,12,39,1,4,0,334,387,321,370,350,407,325,334,414,397,195,355,275.0,316.0,160,-202,362
1066,13,39,1,4,0,645,721,619,623,691,837,696,646,778,797,602,842,722.0,747.0,240,-195,435
1159,14,39,1,4,0,938,870,860,976,801,1165,786,979,1154,954,596,986,791.0,845.0,390,-358,748
682,15,39,1,4,0,647,679,619,746,631,767,611,709,819,752,388,650,519.0,597.0,262,-364,626
1131,16,39,1,4,0,1091,1131,1321,1289,1127,1463,1111,1292,1497,1405,549,1164,856.0,1039.0,615,-856,1471
689,17,39,1,4,0,681,762,693,656,726,776,563,649,953,623,341,556,448.0,507.0,215,-282,497
479,18,39,1,4,0,623,627,554,655,558,641,586,610,611,627,347,556,452.0,510.0,209,-280,489
730,19,39,1,4,0,668,714,579,727,667,816,696,727,851,758,485,709,597.0,651.0,224,-273,497
125,20,39,1,4,0,162,139,215,222,181,222,152,145,208,248,87,111,99.0,149.0,24,-161,185
386,21,39,1,4,0,362,418,335,362,360,429,415,400,482,463,229,331,280.0,341.0,102,-234,336
485,22,39,1,4,0,636,673,545,503,567,621,450,630,549,617,346,607,476.0,523.0,261,-271,532
172,1,40,1,4,0,268,271,242,256,281,287,238,345,456,114,153,205,179.0,157.0,52,39,13
347,2,40,1,4,0,277,288,270,381,345,327,285,338,442,406,203,364,284.0,324.0,161,-203,364
298,3,40,1,4,0,205,287,238,235,267,246,282,331,382,195,193,311,252.0,233.0,118,-2,120
128,4,40,1,4,0,243,275,251,253,208,303,262,356,580,121,115,186,150.0,141.0,71,-6,77
378,5,40,1,4,0,459,461,461,453,451,636,487,569,804,459,234,390,312.0,361.0,156,-225,381
434,6,40,1,4,0,355,346,364,377,400,439,428,489,503,403,244,376,310.0,341.0,132,-159,291
953,7,40,1,4,0,891,877,768,778,692,815,855,912,1164,554,505,703,604.0,587.0,198,-49,247
299,8,40,1,4,0,256,316,230,226,277,310,284,316,428,223,193,301,247.0,239.0,108,-30,138
2284,9,40,1,4,0,2006,2367,2317,2288,2219,2478,2450,3345,3730,1930,1262,2615,1938.0,1936.0,1353,-668,2021
304,10,40,1,4,0,226,316,262,277,270,290,313,377,417,266,187,309,248.0,254.0,122,-79,201
1130,11,40,1,4,0,1098,1171,1053,1035,1139,1193,1114,1454,1527,877,754,1069,912.0,900.0,315,-123,438
377,12,40,1,4,0,283,344,324,354,314,340,317,350,507,305,161,323,242.0,263.0,162,-144,306
723,13,40,1,4,0,466,575,563,517,521,590,551,574,797,453,434,572,503.0,486.0,138,-19,157
797,14,40,1,4,0,701,609,620,657,647,687,548,872,1036,630,391,702,546.0,574.0,311,-239,550
969,15,40,1,4,0,916,952,851,928,863,800,942,1151,1258,739,529,861,695.0,710.0,332,-210,542
775,16,40,1,4,0,860,857,1022,954,876,1065,918,1189,1511,963,454,719,586.0,712.0,265,-509,774
430,17,40,1,4,0,418,440,412,436,456,456,452,506,737,420,189,443,316.0,351.0,254,-231,485
561,18,40,1,4,0,524,634,509,574,525,556,643,734,779,473,353,640,496.0,489.0,287,-120,407
475,19,40,1,4,0,433,415,359,423,434,437,390,480,602,285,241,431,336.0,319.0,190,-44,234
155,20,40,1,4,0,208,153,256,232,218,203,186,200,305,185,95,179,137.0,153.0,84,-90,174
292,21,40,1,4,0,282,291,238,303,301,293,309,345,496,293,157,234,196.0,228.0,77,-136,213
309,22,40,1,4,0,348,422,361,360,329,347,306,404,422,214,206,322,264.0,247.0,116,-8,124
313,1,41,3,4,0,255,249,227,228,228,248,166,277,348,224,140,212,176.0,192.0,72,-84,156
22,2,41,3,4,0,19,19,13,29,23,22,12,22,33,19,19,18,18.0,19.0,-1,0,-1
36,3,41,3,4,0,31,32,22,34,26,20,16,19,22,21,19,29,24.0,23.0,10,-2,12
320,4,41,3,4,0,385,371,412,397,450,433,353,372,511,424,244,378,311.0,349.0,134,-180,314
33,5,41,3,4,0,40,41,50,45,33,53,34,42,64,69,42,47,44.0,53.0,5,-27,32
57,6,41,3,4,0,94,77,54,58,60,65,52,74,75,83,59,59,59.0,67.0,0,-24,24
303,7,41,3,4,0,291,321,323,323,300,349,309,286,341,430,189,295,242.0,305.0,106,-241,347
78,8,41,3,4,0,97,85,61,83,86,76,58,62,78,105,64,83,74.0,84.0,19,-41,60
749,9,41,3,4,0,782,929,824,845,827,959,887,972,1235,1009,443,848,646.0,767.0,405,-566,971
12,10,41,3,4,0,25,33,22,15,35,23,23,13,26,34,17,20,18.0,24.0,3,-17,20
301,11,41,3,4,0,361,372,366,390,384,352,323,380,481,397,258,351,304.0,335.0,93,-139,232
40,12,41,3,4,0,45,28,35,34,41,44,29,35,37,61,16,26,21.0,34.0,10,-45,55
271,13,41,3,4,0,215,221,251,231,259,229,234,231,316,308,172,236,204.0,239.0,64,-136,200
146,14,41,3,4,0,203,189,186,204,209,192,150,188,209,242,134,155,144.0,177.0,21,-108,129
371,15,41,3,4,0,324,279,263,302,300,252,293,323,375,353,222,270,246.0,282.0,48,-131,179
51,16,41,3,4,0,65,48,56,41,58,58,26,64,62,54,47,52,50.0,51.0,5,-7,12
28,17,41,3,4,0,53,33,37,54,26,47,25,31,44,54,26,27,26.0,36.0,1,-28,29
43,18,41,3,4,0,71,65,63,56,64,42,57,83,105,92,41,56,48.0,63.0,15,-51,66
129,19,41,3,4,0,201,173,177,170,176,181,127,153,187,158,103,124,114.0,128.0,21,-55,76
12,20,41,3,4,0,25,16,43,25,22,19,17,12,27,22,12,27,20.0,20.0,15,-10,25
37,21,41,3,4,0,33,50,39,32,34,19,25,29,46,61,16,38,27.0,38.0,22,-45,67
62,22,41,3,4,0,92,117,107,90,78,77,62,61,65,66,41,61,51.0,56.0,20,-25,45
140,1,42,1,4,0,297,244,231,222,233,237,260,331,369,161,142,190,166.0,164.0,48,-19,67
233,2,42,1,4,0,304,293,280,397,351,388,519,521,651,386,202,309,256.0,299.0,107,-184,291
127,3,42,1,4,0,103,173,112,115,149,181,185,190,234,146,90,139,114.0,125.0,49,-56,105
149,4,42,1,4,0,248,267,240,223,271,313,223,301,382,210,141,181,161.0,177.0,40,-69,109
342,5,42,1,4,0,389,401,386,408,384,645,492,617,839,509,240,360,300.0,370.0,120,-269,389
266,6,42,1,4,0,313,328,323,371,429,508,453,504,690,387,163,254,208.0,268.0,91,-224,315
570,7,42,1,4,0,625,677,569,603,642,825,774,709,964,444,303,464,384.0,404.0,161,-141,302
204,8,42,1,4,0,277,268,247,194,300,278,277,302,443,175,132,238,185.0,182.0,106,-43,149
3040,9,42,1,4,0,2736,3407,3034,2769,3466,3967,4449,4901,5547,3229,1517,2906,2212.0,2551.0,1389,-1712,3101
247,10,42,1,4,0,300,323,305,295,375,362,434,458,665,381,181,321,251.0,294.0,140,-200,340
614,11,42,1,4,0,905,886,740,767,910,875,888,974,1139,690,508,722,615.0,640.0,214,-182,396
300,12,42,1,4,0,298,296,306,326,283,440,408,499,625,381,184,276,230.0,280.0,92,-197,289
514,13,42,1,4,0,470,518,437,434,560,591,602,602,830,407,320,433,376.0,387.0,113,-87,200
530,14,42,1,4,0,487,451,445,414,574,666,620,614,920,507,247,499,373.0,418.0,252,-260,512
842,15,42,1,4,0,1038,954,959,917,968,1148,998,1169,1424,732,558,806,682.0,699.0,248,-174,422
498,16,42,1,4,0,646,667,730,629,764,987,818,1066,1347,698,270,511,390.0,493.0,241,-428,669
421,17,42,1,4,0,540,567,522,526,503,752,630,700,988,570,203,418,310.0,397.0,215,-367,582
595,18,42,1,4,0,556,633,509,603,671,676,754,796,1043,605,368,580,474.0,518.0,212,-237,449
357,19,42,1,4,0,514,445,435,473,472,553,433,460,600,253,193,341,267.0,262.0,148,-60,208
140,20,42,1,4,0,208,157,246,168,172,243,227,222,229,139,105,116,110.0,120.0,11,-34,45
126,21,42,1,4,0,120,179,148,148,164,191,253,229,293,140,96,140,118.0,125.0,44,-44,88
218,22,42,1,4,0,331,309,255,234,372,256,198,199,322,111,123,264,194.0,166.0,141,12,129
368,1,43,2,4,0,139,212,242,279,368,455,354,457,516,264,193,369,281.0,275.0,176,-71,247
116,2,43,2,4,0,54,90,69,134,137,168,236,233,253,206,111,144,128.0,154.0,33,-95,128
145,3,43,2,4,0,111,161,112,170,148,180,212,200,238,219,114,172,143.0,168.0,58,-105,163
397,4,43,2,4,0,419,541,572,614,704,733,603,754,1094,601,390,482,436.0,491.0,92,-211,303
296,5,43,2,4,0,215,215,241,286,280,498,363,489,543,391,237,325,281.0,318.0,88,-154,242
233,6,43,2,4,0,168,222,253,319,361,472,444,568,578,495,153,185,169.0,278.0,32,-342,374
727,7,43,2,4,0,449,644,594,653,771,1001,1018,1094,1221,1031,476,846,661.0,784.0,370,-555,925
335,8,43,2,4,0,190,307,319,310,398,381,370,395,605,316,221,369,295.0,302.0,148,-95,243
2460,9,43,2,4,0,1283,1775,1807,1926,2292,2762,3019,3563,3747,2666,1125,2377,1751.0,2056.0,1252,-1541,2793
101,10,43,2,4,0,85,131,107,105,132,134,146,194,174,193,92,119,106.0,135.0,27,-101,128
901,11,43,2,4,0,574,791,789,884,1139,1155,1292,1491,1524,1070,552,1008,780.0,877.0,456,-518,974
179,12,43,2,4,0,127,135,142,163,206,280,258,340,409,346,81,166,124.0,198.0,85,-265,350
762,13,43,2,4,0,400,560,621,573,819,812,975,971,1119,789,422,734,578.0,648.0,312,-367,679
531,14,43,2,4,0,261,356,378,472,519,592,609,805,866,692,326,488,407.0,502.0,162,-366,528
1010,15,43,2,4,0,569,729,797,1116,1100,1259,1371,1516,1515,1138,549,969,759.0,885.0,420,-589,1009
434,16,43,2,4,0,355,306,462,346,475,707,729,779,906,749,253,446,350.0,483.0,193,-496,689
402,17,43,2,4,0,344,400,350,381,419,626,645,767,839,710,238,437,338.0,462.0,199,-472,671
508,18,43,2,4,0,182,309,251,400,389,434,571,612,638,509,288,542,415.0,446.0,254,-221,475
872,19,43,2,4,0,678,921,843,1057,1068,1256,1020,1269,1395,898,506,962,734.0,789.0,456,-392,848
130,20,43,2,4,0,141,164,243,183,190,183,170,200,213,159,106,164,135.0,143.0,58,-53,111
195,21,43,2,4,0,121,222,212,278,246,251,273,309,371,227,159,225,192.0,204.0,66,-68,134
358,22,43,2,4,0,301,459,440,381,659,536,422,639,783,366,217,537,377.0,373.0,320,-149,469
169,1,44,1,4,0,200,179,143,213,231,263,186,304,291,260,125,252,188.0,212.0,127,-135,262
48,2,44,1,4,0,27,47,40,86,70,45,62,97,95,78,48,59,54.0,62.0,11,-30,41
53,3,44,1,4,0,39,59,30,34,48,53,57,54,64,35,18,51,34.0,35.0,33,-17,50
341,4,44,1,4,0,530,580,328,387,431,542,458,551,739,435,233,445,339.0,371.0,212,-202,414
212,5,44,1,4,0,199,189,198,208,192,406,218,246,296,270,133,178,156.0,194.0,45,-137,182
69,6,44,1,4,0,66,77,68,83,102,108,119,125,125,156,59,89,74.0,101.0,30,-97,127
197,7,44,1,4,0,215,226,189,211,236,259,209,228,356,218,112,223,168.0,184.0,111,-106,217
29,8,44,1,4,0,31,34,37,39,38,29,27,53,51,47,21,35,28.0,34.0,14,-26,40
246,9,44,1,4,0,264,290,315,201,283,319,341,442,572,437,152,310,231.0,300.0,158,-285,443
32,10,44,1,4,0,39,40,44,25,47,48,35,38,46,44,34,25,30.0,34.0,-9,-10,1
177,11,44,1,4,0,166,199,160,179,202,235,218,248,301,251,138,200,169.0,196.0,62,-113,175
53,12,44,1,4,0,46,67,46,43,63,74,57,75,92,84,32,51,42.0,56.0,19,-52,71
113,13,44,1,4,0,82,94,85,75,106,81,95,123,131,106,79,112,96.0,99.0,33,-27,60
155,14,44,1,4,0,177,146,115,120,133,136,137,144,187,131,57,111,84.0,100.0,54,-74,128
107,15,44,1,4,0,105,120,103,117,123,127,129,149,230,149,78,139,108.0,122.0,61,-71,132
94,16,44,1,4,0,105,133,83,100,88,128,132,148,184,148,61,111,86.0,107.0,50,-87,137
109,17,44,1,4,0,119,132,99,113,129,125,121,157,211,135,74,132,103.0,114.0,58,-61,119
71,18,44,1,4,0,68,110,85,91,79,63,93,111,124,108,57,77,67.0,81.0,20,-51,71
76,19,44,1,4,0,78,114,94,86,129,93,93,126,129,69,51,75,63.0,65.0,24,-18,42
97,20,44,1,4,0,106,102,141,124,91,113,105,132,160,125,77,112,94.0,105.0,35,-48,83
111,21,44,1,4,0,117,132,93,101,114,118,176,150,182,148,77,137,107.0,121.0,60,-71,131
53,22,44,1,4,0,66,58,77,51,83,64,44,71,77,53,34,68,51.0,52.0,34,-19,53
92,1,45,1,4,0,166,137,100,120,182,195,186,244,388,154,85,126,106.0,122.0,41,-69,110
53,2,45,1,4,0,138,155,102,132,175,199,190,214,267,194,91,60,76.0,115.0,-31,-103,72
62,3,45,1,4,0,113,123,90,86,129,117,180,167,259,127,62,61,62.0,83.0,-1,-65,64
25,4,45,1,4,0,157,135,132,124,189,195,143,181,370,71,41,51,46.0,54.0,10,-30,40
110,5,45,1,4,0,347,268,235,259,271,451,335,432,691,448,194,129,162.0,257.0,-65,-254,189
217,6,45,1,4,0,406,511,409,457,615,665,719,699,1253,712,250,227,238.0,396.0,-23,-462,439
347,7,45,1,4,0,712,759,542,525,598,799,850,792,1449,549,320,297,308.0,389.0,-23,-229,206
83,8,45,1,4,0,156,184,119,112,180,176,226,231,426,153,81,103,92.0,112.0,22,-72,94
246,9,45,1,4,0,439,656,557,570,682,810,953,1204,1628,496,168,342,255.0,335.0,174,-328,502
26,10,45,1,4,0,93,99,74,74,93,96,119,135,240,121,56,54,55.0,77.0,-2,-65,63
402,11,45,1,4,0,685,815,558,664,879,928,1050,1083,1908,768,543,404,474.0,572.0,-139,-225,86
168,12,45,1,4,0,275,290,238,256,256,368,358,434,733,453,153,150,152.0,252.0,-3,-300,297
300,13,45,1,4,0,442,541,372,433,513,576,665,667,1158,476,272,257,264.0,335.0,-15,-204,189
380,14,45,1,4,0,706,670,565,604,728,823,894,1006,1883,910,372,312,342.0,531.0,-60,-538,478
337,15,45,1,4,0,745,772,623,618,806,968,1022,1202,2202,744,430,386,408.0,520.0,-44,-314,270
130,16,45,1,4,0,254,222,214,224,236,278,353,409,749,443,143,138,140.0,241.0,-5,-300,295
149,17,45,1,4,0,282,299,206,221,263,352,322,439,744,378,131,137,134.0,215.0,6,-247,253
130,18,45,1,4,0,186,224,163,185,197,242,345,391,594,265,149,173,161.0,196.0,24,-116,140
75,19,45,1,4,0,167,172,127,118,166,151,176,186,256,75,62,80,71.0,72.0,18,-13,31
23,20,45,1,4,0,86,60,103,92,81,101,86,92,172,124,38,29,34.0,64.0,-9,-86,77
64,21,45,1,4,0,166,180,107,108,126,155,205,212,325,144,79,70,74.0,98.0,-9,-65,56
38,22,45,1,4,0,142,116,90,66,138,116,107,126,152,43,36,52,44.0,44.0,16,-7,23
175,1,46,1,4,0,57,61,83,70,93,94,69,88,96,65,19,37,28.0,40.0,18,-46,64
86,2,46,1,4,0,153,150,145,260,181,192,214,209,182,216,75,82,78.0,124.0,7,-141,148
45,3,46,1,4,0,103,189,132,152,130,174,176,130,141,132,46,66,56.0,81.0,20,-86,106
48,4,46,1,4,0,224,215,203,267,229,259,158,186,277,124,81,65,73.0,90.0,-16,-43,27
78,5,46,1,4,0,251,265,277,338,249,374,267,205,292,350,117,93,105.0,187.0,-24,-233,209
92,6,46,1,4,0,261,334,403,369,409,407,332,341,384,513,121,108,114.0,247.0,-13,-392,379
209,7,46,1,4,0,477,501,534,578,578,669,572,480,596,555,214,153,184.0,307.0,-61,-341,280
22,8,46,1,4,0,53,84,72,80,105,82,89,70,67,66,26,12,19.0,35.0,-14,-40,26
37,9,46,1,4,0,189,205,161,153,130,99,91,101,84,62,19,63,41.0,48.0,44,-43,87
20,10,46,1,4,0,61,65,56,59,47,57,42,39,50,45,14,26,20.0,28.0,12,-31,43
188,11,46,1,4,0,391,511,498,540,652,534,502,474,569,538,214,216,215.0,323.0,2,-324,326
91,12,46,1,4,0,222,322,296,334,361,423,281,274,309,360,94,101,98.0,185.0,7,-266,273
162,13,46,1,4,0,300,423,331,415,474,378,372,326,383,353,154,150,152.0,219.0,-4,-199,195
129,14,46,1,4,0,433,458,439,537,516,505,471,372,457,538,139,100,120.0,259.0,-39,-399,360
151,15,46,1,4,0,439,481,523,527,619,525,437,429,453,388,129,152,140.0,223.0,23,-259,282
119,16,46,1,4,0,287,274,347,357,348,470,379,317,421,474,120,139,130.0,244.0,19,-354,373
114,17,46,1,4,0,267,285,332,369,394,455,353,348,428,459,95,148,122.0,234.0,53,-364,417
37,18,46,1,4,0,105,117,97,156,140,150,148,127,159,136,38,44,41.0,73.0,6,-98,104
137,19,46,1,4,0,190,224,186,211,236,239,216,174,238,151,59,93,76.0,101.0,34,-92,126
16,20,46,1,4,0,113,119,207,154,160,119,108,151,126,110,41,27,34.0,59.0,-14,-69,55
82,21,46,1,4,0,200,295,195,243,241,219,279,210,288,180,80,67,74.0,109.0,-13,-100,87
45,22,46,1,4,0,112,155,119,135,185,126,121,118,156,75,46,57,52.0,59.0,11,-29,40
169,1,47,2,4,0,123,151,184,200,260,330,188,341,384,208,78,136,107.0,141.0,58,-130,188
79,2,47,2,4,0,87,116,115,160,152,177,216,186,206,142,56,68,62.0,89.0,12,-86,98
52,3,47,2,4,0,89,116,92,95,118,103,121,125,115,74,44,45,44.0,54.0,1,-30,31
162,4,47,2,4,0,429,502,404,587,598,646,461,553,771,253,139,206,172.0,199.0,67,-114,181
304,5,47,2,4,0,360,435,525,529,541,770,548,657,933,673,263,243,253.0,393.0,-20,-410,390
389,6,47,2,4,0,494,668,812,815,909,849,800,764,993,964,338,340,339.0,547.0,2,-626,628
537,7,47,2,4,0,772,912,798,955,1028,1068,979,957,1332,1011,383,430,406.0,608.0,47,-628,675
111,8,47,2,4,0,155,182,158,166,260,200,213,203,275,128,67,102,84.0,99.0,35,-61,96
579,9,47,2,4,0,651,912,826,970,1165,1341,1182,1660,1546,767,278,638,458.0,561.0,360,-489,849
86,10,47,2,4,0,118,154,160,138,192,192,181,188,276,186,86,105,96.0,126.0,19,-100,119
1074,11,47,2,4,0,1322,1690,1549,1784,2086,2054,2015,2022,2642,2094,991,984,988.0,1356.0,-7,-1103,1096
274,12,47,2,4,0,317,446,403,446,466,481,368,453,691,614,157,211,184.0,327.0,54,-457,511
342,13,47,2,4,0,489,571,550,679,797,728,665,667,773,530,290,330,310.0,383.0,40,-240,280
891,14,47,2,4,0,998,1156,1405,1588,1680,1676,1390,1577,2409,1865,640,650,645.0,1052.0,10,-1225,1235
715,15,47,2,4,0,1000,1198,1267,1405,1649,1572,1696,1832,2222,1022,501,663,582.0,729.0,162,-521,683
256,16,47,2,4,0,336,378,470,475,562,525,475,492,661,605,178,211,194.0,331.0,33,-427,460
287,17,47,2,4,0,380,383,445,414,541,561,481,547,698,488,170,228,199.0,295.0,58,-318,376
246,18,47,2,4,0,228,311,284,350,418,427,469,556,601,361,197,246,222.0,268.0,49,-164,213
120,19,47,2,4,0,228,287,226,287,309,335,246,211,328,161,100,120,110.0,127.0,20,-61,81
145,20,47,2,4,0,207,287,447,415,439,445,330,373,430,326,140,158,149.0,208.0,18,-186,204
167,21,47,2,4,0,248,336,278,349,407,350,449,347,562,349,119,145,132.0,204.0,26,-230,256
48,22,47,2,4,0,101,109,89,128,149,133,82,97,100,69,37,53,45.0,53.0,16,-32,48
17,1,48,2,4,0,21,27,22,13,27,10,4,41,46,32,19,54,36.0,35.0,35,-13,48
53,2,48,2,4,0,165,176,148,181,200,159,126,119,169,142,104,91,98.0,112.0,-13,-38,25
163,3,48,2,4,0,260,348,233,350,323,327,297,353,430,278,168,258,213.0,235.0,90,-110,200
13,4,48,2,4,0,173,167,151,170,121,96,46,78,112,52,38,30,34.0,40.0,-8,-14,6
134,5,48,2,4,0,753,701,834,869,836,723,408,517,641,617,336,250,293.0,401.0,-86,-281,195
59,6,48,2,4,0,292,330,322,293,261,211,71,198,190,278,146,119,132.0,181.0,-27,-132,105
509,7,48,2,4,0,1514,1697,1542,1763,1885,1782,1445,1562,2281,1763,885,746,816.0,1131.0,-139,-878,739
285,8,48,2,4,0,566,798,670,854,973,842,579,768,886,691,295,401,348.0,462.0,106,-396,502
212,9,48,2,4,0,657,797,730,793,791,821,619,710,1008,472,229,471,350.0,391.0,242,-243,485
55,10,48,2,4,0,139,170,190,169,185,191,132,192,308,251,110,119,114.0,160.0,9,-141,150
106,11,48,2,4,0,309,295,297,299,267,195,95,307,309,370,299,211,255.0,293.0,-88,-71,-17
42,12,48,2,4,0,225,303,258,215,138,145,60,177,182,224,84,107,96.0,138.0,23,-140,163
733,13,48,2,4,0,1513,1845,1547,1898,2125,1949,1092,1644,1840,1468,940,941,940.0,1116.0,1,-528,529
211,14,48,2,4,0,823,772,817,797,693,546,306,774,911,1101,433,362,398.0,632.0,-71,-668,597
168,15,48,2,4,0,215,232,213,216,202,149,42,380,352,327,197,195,196.0,240.0,-2,-130,128
32,16,48,2,4,0,159,138,172,121,123,100,46,116,125,211,58,65,62.0,111.0,7,-153,160
42,17,48,2,4,0,204,204,207,195,142,140,74,141,165,230,105,87,96.0,141.0,-18,-125,107
66,18,48,2,4,0,238,254,259,254,219,159,110,281,215,204,105,130,118.0,146.0,25,-99,124
425,19,48,2,4,0,548,622,615,791,715,654,384,528,619,375,317,409,363.0,367.0,92,-58,150
25,20,48,2,4,0,140,142,167,210,170,119,62,80,104,116,61,54,58.0,77.0,-7,-55,48
75,21,48,2,4,0,347,415,360,504,331,168,145,214,250,261,108,136,122.0,168.0,28,-153,181
137,22,48,2,4,0,312,349,289,307,328,302,291,350,342,207,144,192,168.0,181.0,48,-63,111
177,1,49,1,4,0,153,184,190,187,321,371,283,435,596,174,80,151,116.0,135.0,71,-94,165
176,2,49,1,4,0,214,293,278,391,368,477,514,538,699,444,236,185,210.0,288.0,-51,-208,157
138,3,49,1,4,0,144,231,182,278,328,337,354,323,485,221,94,125,110.0,147.0,31,-127,158
242,4,49,1,4,0,446,557,512,616,785,877,636,879,1517,309,174,289,232.0,257.0,115,-135,250
287,5,49,1,4,0,442,498,519,553,602,1020,712,770,1305,743,339,285,312.0,456.0,-54,-404,350
422,6,49,1,4,0,430,556,596,658,834,1066,894,964,1597,855,344,344,344.0,514.0,0,-511,511
543,7,49,1,4,0,765,851,801,793,998,1278,1160,1107,1740,687,383,327,355.0,466.0,-56,-304,248
126,8,49,1,4,0,162,214,187,206,301,280,282,301,514,192,100,117,108.0,136.0,17,-92,109
360,9,49,1,4,0,549,687,668,710,890,1382,1240,1586,1899,542,186,403,294.0,377.0,217,-356,573
81,10,49,1,4,0,136,186,226,201,232,277,266,309,514,260,96,110,103.0,155.0,14,-164,178
645,11,49,1,4,0,744,993,872,955,1345,1406,1396,1446,2279,939,574,593,584.0,702.0,19,-365,384
229,12,49,1,4,0,241,288,279,356,409,638,519,571,900,502,180,199,190.0,294.0,19,-322,341
600,13,49,1,4,0,540,727,602,725,929,1066,990,1108,1749,708,414,412,413.0,511.0,-2,-294,292
792,14,49,1,4,0,886,926,1021,1208,1438,1525,1493,1622,2735,1331,509,557,533.0,799.0,48,-822,870
676,15,49,1,4,0,846,1069,1144,1284,1635,1804,1911,2130,3255,1119,581,616,598.0,772.0,35,-538,573
256,16,49,1,4,0,287,324,375,419,485,678,560,634,1014,597,202,210,206.0,336.0,8,-395,403
272,17,49,1,4,0,351,355,332,374,473,712,546,606,978,498,212,209,210.0,306.0,-3,-286,283
131,18,49,1,4,0,228,280,250,238,291,406,499,552,782,311,141,184,162.0,212.0,43,-170,213
131,19,49,1,4,0,208,243,206,229,283,315,299,258,424,127,80,97,88.0,101.0,17,-47,64
93,20,49,1,4,0,183,177,223,193,277,336,267,309,532,260,104,78,91.0,147.0,-26,-156,130
179,21,49,1,4,0,218,355,227,253,326,373,472,366,620,315,130,154,142.0,200.0,24,-185,209
71,22,49,1,4,0,157,191,155,137,237,206,170,232,274,80,52,66,59.0,66.0,14,-28,42
163,1,50,4,4,0,160,176,192,187,249,257,239,345,396,369,177,174,176.0,240.0,-3,-192,189
159,2,50,4,4,0,200,206,289,300,344,358,406,373,334,203,134,207,170.0,181.0,73,-69,142
27,3,50,4,4,0,59,78,58,65,160,123,116,59,90,51,29,42,36.0,41.0,13,-22,35
42,4,50,4,4,0,163,119,141,164,139,203,168,222,242,93,60,87,74.0,80.0,27,-33,60
272,5,50,4,4,0,450,413,455,488,625,731,758,778,781,288,239,321,280.0,283.0,82,-49,131
237,6,50,4,4,0,279,349,370,347,570,630,644,607,661,309,266,301,284.0,292.0,35,-43,78
464,7,50,4,4,0,616,559,584,576,690,772,807,782,994,540,419,572,496.0,510.0,153,-121,274
60,8,50,4,4,0,126,140,127,162,287,240,200,132,201,88,44,87,66.0,73.0,43,-44,87
411,9,50,4,4,0,453,438,526,486,516,619,721,938,1135,331,231,477,354.0,346.0,246,-100,346
131,10,50,4,4,0,158,185,230,205,301,268,247,370,403,140,92,140,116.0,124.0,48,-48,96
641,11,50,4,4,0,700,765,791,837,1017,1020,1227,1286,1781,805,710,885,798.0,800.0,175,-95,270
170,12,50,4,4,0,223,276,230,221,285,391,438,444,431,157,97,173,135.0,142.0,76,-60,136
404,13,50,4,4,0,556,558,552,574,734,729,766,589,806,391,375,484,430.0,417.0,109,-16,125
418,14,50,4,4,0,578,632,668,840,854,777,834,729,896,363,334,528,431.0,408.0,194,-29,223
363,15,50,4,4,0,493,406,443,507,510,573,616,797,1044,341,386,475,430.0,401.0,89,45,44
119,16,50,4,4,0,284,238,303,280,357,375,452,413,461,270,123,194,158.0,196.0,71,-147,218
167,17,50,4,4,0,224,235,250,255,292,394,414,458,478,157,99,182,140.0,146.0,83,-58,141
219,18,50,4,4,0,293,325,290,310,328,339,397,455,593,250,154,266,210.0,223.0,112,-96,208
66,19,50,4,4,0,108,118,118,139,151,144,114,136,149,45,36,75,56.0,52.0,39,-9,48
136,20,50,4,4,0,167,239,459,311,410,422,402,422,475,136,124,148,136.0,136.0,24,-12,36
141,21,50,4,4,0,319,382,320,375,494,446,595,355,464,194,145,188,166.0,176.0,43,-49,92
54,22,50,4,4,0,154,180,125,146,202,237,176,82,87,40,47,82,64.0,56.0,35,7,28
266,1,51,2,4,0,266,306,267,258,427,420,355,228,579,371,131,288,210.0,263.0,157,-240,397
192,2,51,2,4,0,152,177,118,180,214,200,244,165,338,215,134,179,156.0,176.0,45,-81,126
37,3,51,2,4,0,26,58,32,43,34,40,41,43,48,41,28,59,44.0,43.0,31,-13,44
108,4,51,2,4,0,244,264,181,202,267,304,268,372,383,131,61,110,86.0,101.0,49,-70,119
433,5,51,2,4,0,398,410,336,352,370,632,431,484,820,550,286,428,357.0,421.0,142,-264,406
425,6,51,2,4,0,387,411,362,305,443,521,495,362,758,508,322,432,377.0,421.0,110,-186,296
381,7,51,2,4,0,424,368,316,303,357,410,423,383,729,410,227,320,274.0,319.0,93,-183,276
62,8,51,2,4,0,63,71,48,59,51,78,61,91,136,74,57,53,55.0,61.0,-4,-17,13
1007,9,51,2,4,0,875,992,904,879,1153,1298,1305,1034,2232,1023,444,1072,758.0,846.0,628,-579,1207
131,10,51,2,4,0,172,201,169,192,217,237,215,191,328,208,107,160,134.0,158.0,53,-101,154
870,11,51,2,4,0,1017,1202,877,845,1153,1190,1239,807,1846,1142,747,1023,885.0,971.0,276,-395,671
235,12,51,2,4,0,182,202,165,177,232,306,226,131,436,290,111,237,174.0,213.0,126,-179,305
298,13,51,2,4,0,290,285,257,243,316,360,308,272,475,287,194,265,230.0,249.0,71,-93,164
513,14,51,2,4,0,439,424,404,405,509,554,543,420,747,459,249,457,353.0,388.0,208,-210,418
679,15,51,2,4,0,723,767,644,614,743,824,856,695,1454,752,503,780,642.0,678.0,277,-249,526
258,16,51,2,4,0,224,213,257,205,250,304,278,190,481,312,158,246,202.0,239.0,88,-154,242
238,17,51,2,4,0,299,303,226,226,283,329,289,235,425,324,139,263,201.0,242.0,124,-185,309
323,18,51,2,4,0,351,414,293,354,411,469,472,415,699,508,260,395,328.0,388.0,135,-248,383
116,19,51,2,4,0,120,126,118,94,128,154,125,64,125,66,52,82,67.0,67.0,30,-14,44
287,20,51,2,4,0,316,243,316,279,300,389,322,256,548,310,185,288,236.0,261.0,103,-125,228
121,21,51,2,4,0,172,180,121,162,175,188,226,181,259,170,96,124,110.0,130.0,28,-74,102
85,22,51,2,4,0,105,118,92,95,86,84,67,65,115,61,52,76,64.0,63.0,24,-9,33
303,1,52,1,4,0,284,312,308,315,327,336,292,421,473,415,199,338,268.0,317.0,139,-216,355
295,2,52,1,4,0,226,239,271,381,320,316,363,485,535,500,259,353,306.0,371.0,94,-241,335
180,3,52,1,4,0,124,177,198,210,230,224,233,229,234,273,129,208,168.0,203.0,79,-144,223
398,4,52,1,4,0,359,374,335,454,424,442,429,500,681,534,295,402,348.0,410.0,107,-239,346
493,5,52,1,4,0,498,454,508,557,495,659,704,743,849,933,442,540,491.0,638.0,98,-491,589
162,6,52,1,4,0,184,207,204,219,249,314,271,334,368,404,198,210,204.0,271.0,12,-206,218
546,7,52,1,4,0,505,542,531,579,617,771,679,776,936,911,376,595,486.0,627.0,219,-535,754
101,8,52,1,4,0,129,125,128,113,131,135,142,208,244,213,113,141,127.0,156.0,28,-100,128
875,9,52,1,4,0,876,978,1056,1120,1145,1408,1392,1836,2078,1526,521,1068,794.0,1038.0,547,-1005,1552
156,10,52,1,4,0,190,185,216,203,212,207,208,246,317,323,145,236,190.0,235.0,91,-178,269
458,11,52,1,4,0,403,502,513,553,616,611,660,847,820,821,461,589,525.0,624.0,128,-360,488
151,12,52,1,4,0,156,222,179,206,215,215,187,249,262,297,113,164,138.0,191.0,51,-184,235
470,13,52,1,4,0,396,448,411,475,528,576,625,746,750,758,431,483,457.0,557.0,52,-327,379
567,14,52,1,4,0,488,554,520,548,623,596,604,752,820,826,447,615,531.0,629.0,168,-379,547
254,15,52,1,4,0,299,309,330,357,379,387,524,623,684,550,252,401,326.0,401.0,149,-298,447
246,16,52,1,4,0,252,255,280,268,311,346,310,385,425,481,197,299,248.0,326.0,102,-284,386
321,17,52,1,4,0,270,349,338,350,384,424,364,460,493,505,239,383,311.0,376.0,144,-266,410
128,18,52,1,4,0,209,200,169,259,222,223,268,329,338,400,163,217,190.0,260.0,54,-237,291
320,19,52,1,4,0,230,303,292,281,324,364,303,369,450,249,117,274,196.0,213.0,157,-132,289
314,20,52,1,4,0,365,346,440,402,372,406,400,540,575,576,284,403,344.0,421.0,119,-292,411
285,21,52,1,4,0,242,263,225,299,275,293,365,346,404,376,178,272,225.0,275.0,94,-198,292
242,22,52,1,4,0,293,273,325,359,356,331,302,341,410,324,206,341,274.0,290.0,135,-118,253
191,1,53,2,4,0,248,310,413,581,617,628,446,636,846,241,179,180,180.0,200.0,1,-62,63
124,2,53,2,4,0,145,172,143,197,189,278,304,365,493,290,145,117,131.0,184.0,-28,-145,117
71,3,53,2,4,0,109,155,125,168,136,222,206,310,562,284,123,119,121.0,175.0,-4,-161,157
60,4,53,2,4,0,270,321,429,521,473,498,257,444,824,105,71,55,63.0,77.0,-16,-34,18
394,5,53,2,4,0,606,603,636,717,777,1042,762,1080,1730,983,504,400,452.0,629.0,-104,-479,375
566,6,53,2,4,0,412,563,701,945,973,1078,1023,1260,2243,1186,528,593,560.0,769.0,65,-658,723
551,7,53,2,4,0,1042,1265,1160,1176,1294,1622,1536,1637,2998,1261,553,503,528.0,772.0,-50,-708,658
164,8,53,2,4,0,177,203,154,257,272,308,299,372,645,313,178,140,159.0,210.0,-38,-135,97
959,9,53,2,4,0,631,1027,923,1121,1670,1369,1274,1967,3191,905,337,855,596.0,699.0,518,-568,1086
188,10,53,2,4,0,105,142,190,192,188,232,252,337,697,471,179,227,203.0,292.0,48,-292,340
763,11,53,2,4,0,1231,1592,1724,1702,2067,2163,1918,2283,3836,1631,972,777,874.0,1127.0,-195,-659,464
221,12,53,2,4,0,251,345,361,411,440,542,547,676,1270,658,229,229,229.0,372.0,0,-429,429
578,13,53,2,4,0,495,710,678,854,909,987,969,1064,2232,950,551,442,496.0,648.0,-109,-399,290
1011,14,53,2,4,0,824,900,1091,1257,1337,1548,1431,1720,3243,1894,828,807,818.0,1176.0,-21,-1066,1045
361,15,53,2,4,0,672,814,952,886,1003,1067,1140,1205,1850,574,328,328,328.0,410.0,0,-246,246
243,16,53,2,4,0,335,349,502,356,435,576,710,866,1354,755,244,256,250.0,418.0,12,-511,523
371,17,53,2,4,0,426,538,599,590,709,844,687,982,1756,938,322,403,362.0,554.0,81,-616,697
215,18,53,2,4,0,221,268,357,422,486,645,645,746,1041,462,182,250,216.0,298.0,68,-280,348
178,19,53,2,4,0,163,241,231,300,418,415,275,422,561,181,92,144,118.0,139.0,52,-89,141
203,20,53,2,4,0,375,484,631,758,749,722,571,643,1136,557,231,195,213.0,328.0,-36,-326,290
310,21,53,2,4,0,261,399,506,811,726,652,682,805,1567,639,298,275,286.0,404.0,-23,-341,318
62,22,53,2,4,0,141,163,123,259,159,164,109,207,305,102,62,72,67.0,79.0,10,-40,50
33,1,54,1,4,0,95,90,87,88,90,112,64,139,159,95,31,32,32.0,53.0,1,-64,65
50,2,54,1,4,0,81,108,54,102,103,88,129,116,195,181,91,58,74.0,110.0,-33,-90,57
91,3,54,1,4,0,174,223,139,192,148,178,215,227,336,327,113,110,112.0,183.0,-3,-214,211
28,4,54,1,4,0,157,103,119,110,107,124,113,153,246,99,35,29,32.0,54.0,-6,-64,58
95,5,54,1,4,0,231,201,164,169,165,260,194,267,387,398,155,108,132.0,220.0,-47,-243,196
101,6,54,1,4,0,207,206,161,192,228,277,262,301,471,484,121,103,112.0,236.0,-18,-363,345
312,7,54,1,4,0,574,604,450,433,565,670,629,591,961,723,263,300,282.0,429.0,37,-460,497
57,8,54,1,4,0,103,114,81,88,106,92,114,133,167,149,66,59,62.0,91.0,-7,-83,76
38,9,54,1,4,0,156,103,107,99,112,111,142,134,176,97,19,44,32.0,53.0,25,-78,103
15,10,54,1,4,0,53,59,61,36,46,27,44,52,62,66,20,31,26.0,39.0,11,-46,57
94,11,54,1,4,0,362,365,291,216,275,222,289,312,450,333,168,137,152.0,213.0,-31,-165,134
63,12,54,1,4,0,129,162,110,96,123,158,141,164,252,264,69,58,64.0,130.0,-11,-195,184
226,13,54,1,4,0,258,283,231,209,251,268,281,338,473,362,182,165,174.0,236.0,-17,-180,163
212,14,54,1,4,0,508,440,420,458,438,436,457,535,679,669,213,223,218.0,368.0,10,-456,466
69,15,54,1,4,0,148,165,119,117,144,152,167,161,255,131,59,54,56.0,81.0,-5,-72,67
104,16,54,1,4,0,242,217,211,166,169,231,258,278,385,450,105,110,108.0,222.0,5,-345,350
247,17,54,1,4,0,395,357,324,322,320,453,378,533,776,857,222,262,242.0,447.0,40,-635,675
20,18,54,1,4,0,42,60,45,47,38,50,51,83,65,41,21,20,20.0,27.0,-1,-20,19
72,19,54,1,4,0,125,118,82,101,115,152,128,129,166,109,50,66,58.0,75.0,16,-59,75
65,20,54,1,4,0,189,156,162,125,149,157,175,189,306,256,58,77,68.0,130.0,19,-198,217
176,21,54,1,4,0,296,319,224,270,298,329,421,381,634,493,193,190,192.0,292.0,-3,-300,297
70,22,54,1,4,0,188,152,109,132,165,141,126,204,277,131,70,96,83.0,99.0,26,-61,87
74,1,55,1,4,0,164,165,139,164,176,188,167,211,361,138,71,95,83.0,101.0,24,-67,91
259,2,55,1,4,0,328,421,327,407,402,486,521,434,743,406,299,256,278.0,320.0,-43,-107,64
181,3,55,1,4,0,265,289,218,256,255,374,366,390,683,304,135,211,173.0,217.0,76,-169,245
79,4,55,1,4,0,345,391,298,365,388,458,302,357,675,173,56,121,88.0,117.0,65,-117,182
644,5,55,1,4,0,1313,1243,1067,1135,1222,1530,1137,1318,2057,1186,681,782,732.0,883.0,101,-505,606
248,6,55,1,4,0,413,407,292,363,463,479,476,493,865,574,194,213,204.0,327.0,19,-380,399
473,7,55,1,4,0,983,935,718,720,875,922,870,894,1538,723,282,412,347.0,472.0,130,-441,571
346,8,55,1,4,0,383,469,311,358,454,470,495,510,974,417,214,254,234.0,295.0,40,-203,243
354,9,55,1,4,0,629,703,576,557,610,730,702,768,1105,569,259,493,376.0,440.0,234,-310,544
105,10,55,1,4,0,154,242,164,182,175,217,208,212,406,260,101,165,133.0,175.0,64,-159,223
494,11,55,1,4,0,631,724,557,652,768,765,828,786,1332,698,402,409,406.0,503.0,7,-296,303
205,12,55,1,4,0,288,311,262,276,281,350,363,356,774,420,110,193,152.0,241.0,83,-310,393
929,13,55,1,4,0,724,862,614,693,937,936,974,964,2069,891,397,516,456.0,601.0,119,-494,613
521,14,55,1,4,0,892,850,682,796,900,924,913,934,1916,1026,330,387,358.0,581.0,57,-696,753
311,15,55,1,4,0,541,581,492,491,561,604,663,556,982,370,195,281,238.0,282.0,86,-175,261
186,16,55,1,4,0,278,276,303,276,301,385,300,389,721,401,105,159,132.0,222.0,54,-296,350
333,17,55,1,4,0,623,562,511,551,548,722,567,687,1290,631,205,298,252.0,378.0,93,-426,519
114,18,55,1,4,0,190,170,135,152,178,217,240,253,385,180,95,138,116.0,138.0,43,-85,128
144,19,55,1,4,0,238,223,208,212,251,209,211,226,330,135,104,181,142.0,140.0,77,-31,108
477,20,55,1,4,0,797,796,935,790,970,909,844,751,1420,661,420,464,442.0,515.0,44,-241,285
402,21,55,1,4,0,575,671,425,496,540,574,623,639,1234,604,184,336,260.0,375.0,152,-420,572
78,22,55,1,4,0,124,152,127,131,146,126,126,150,236,76,111,111,111.0,99.0,0,35,-35
187,1,56,1,4,0,247,291,237,275,484,500,412,620,805,357,95,198,146.0,217.0,103,-262,365
444,2,56,1,4,0,450,444,342,521,806,851,856,921,1249,829,418,522,470.0,590.0,104,-411,515
322,3,56,1,4,0,336,322,265,347,507,500,528,675,925,601,288,415,352.0,435.0,127,-313,440
278,4,56,1,4,0,446,455,384,534,743,672,532,779,1421,437,212,313,262.0,321.0,101,-225,326
938,5,56,1,4,0,1182,899,922,1077,1757,2178,1620,1861,2915,2183,903,1084,994.0,1390.0,181,-1280,1461
322,6,56,1,4,0,405,383,373,395,690,798,757,934,1307,1141,304,330,317.0,592.0,26,-837,863
611,7,56,1,4,0,792,689,593,668,1173,1160,1214,1192,1610,1006,389,569,479.0,655.0,180,-617,797
305,8,56,1,4,0,308,304,235,316,582,505,511,601,970,406,198,368,283.0,324.0,170,-208,378
879,9,56,1,4,0,958,928,799,758,1347,1576,1507,1902,2685,1203,341,825,583.0,790.0,484,-862,1346
168,10,56,1,4,0,191,230,206,193,394,347,352,440,665,433,149,235,192.0,272.0,86,-284,370
854,11,56,1,4,0,1007,951,861,1014,1794,1646,1598,1955,2752,1481,650,861,756.0,997.0,211,-831,1042
268,12,56,1,4,0,275,281,260,281,443,510,475,511,802,624,159,229,194.0,337.0,70,-465,535
767,13,56,1,4,0,650,653,522,624,985,1009,905,1021,1551,970,478,608,543.0,685.0,130,-492,622
701,14,56,1,4,0,786,747,679,846,1361,1342,1399,1530,2696,1928,502,672,587.0,1034.0,170,-1426,1596
641,15,56,1,4,0,675,710,572,720,1247,1320,1351,1499,2124,704,292,530,411.0,509.0,238,-412,650
330,16,56,1,4,0,317,322,323,347,614,653,620,794,1252,837,201,313,257.0,450.0,112,-636,748
579,17,56,1,4,0,697,623,625,741,1241,1383,1339,1478,2360,1657,503,671,587.0,944.0,168,-1154,1322
219,18,56,1,4,0,287,264,213,231,425,414,399,601,698,428,129,211,170.0,256.0,82,-299,381
187,19,56,1,4,0,240,206,200,191,375,331,306,361,459,235,125,226,176.0,195.0,101,-110,211
740,20,56,1,4,0,1031,877,1159,994,1592,1671,1487,1581,2727,1846,758,896,827.0,1167.0,138,-1088,1226
445,21,56,1,4,0,636,634,391,538,758,764,827,896,1319,905,333,426,380.0,555.0,93,-572,665
155,22,56,1,4,0,167,152,156,136,271,219,256,312,397,173,117,199,158.0,163.0,82,-56,138
25,1,57,3,4,0,54,48,33,25,37,28,27,30,34,19,29,28,28.0,25.0,-1,10,-11
815,2,57,3,4,0,1315,1335,1170,1342,1395,1639,1736,1547,1939,1680,1190,1187,1188.0,1352.0,-3,-490,487
71,3,57,3,4,0,96,80,81,79,74,107,93,105,108,54,78,117,98.0,83.0,39,24,15
120,4,57,3,4,0,233,214,173,229,238,282,198,305,504,106,118,157,138.0,127.0,39,12,27
519,5,57,3,4,0,892,875,682,620,742,717,655,773,955,603,645,678,662.0,642.0,33,42,-9
165,6,57,3,4,0,285,216,207,172,194,197,214,225,272,216,223,191,207.0,210.0,-32,7,-39
451,7,57,3,4,0,695,659,545,644,631,622,551,636,1105,629,541,513,527.0,561.0,-28,-88,60
118,8,57,3,4,0,155,157,114,131,103,137,118,161,233,166,115,127,121.0,136.0,12,-51,63
513,9,57,3,4,0,948,890,830,568,627,644,624,713,866,346,505,757,631.0,536.0,252,159,93
53,10,57,3,4,0,97,104,62,69,50,93,63,75,97,92,50,85,68.0,76.0,35,-42,77
623,11,57,3,4,0,724,727,654,653,752,766,763,871,1150,610,843,857,850.0,770.0,14,233,-219
90,12,57,3,4,0,155,161,110,121,107,134,92,117,148,132,89,105,97.0,109.0,16,-43,59
621,13,57,3,4,0,606,636,506,529,574,561,554,769,983,537,616,685,650.0,613.0,69,79,-10
612,14,57,3,4,0,1027,934,847,759,825,703,746,952,1314,922,778,753,766.0,818.0,-25,-144,119
368,15,57,3,4,0,557,549,457,405,385,451,456,466,653,312,498,511,504.0,440.0,13,186,-173
408,16,57,3,4,0,536,538,476,513,518,582,592,590,903,514,438,482,460.0,478.0,44,-76,120
353,17,57,3,4,0,598,440,429,353,375,366,327,426,575,405,314,375,344.0,365.0,61,-91,152
133,18,57,3,4,0,206,172,148,152,164,156,179,175,195,85,140,157,148.0,127.0,17,55,-38
191,19,57,3,4,0,272,228,230,212,192,216,260,281,370,158,187,236,212.0,194.0,49,29,20
438,20,57,3,4,0,781,700,668,554,592,643,645,706,955,636,643,771,707.0,683.0,128,7,121
180,21,57,3,4,0,306,283,187,180,190,227,209,280,324,195,155,198,176.0,183.0,43,-40,83
46,22,57,3,4,0,124,103,81,47,88,70,59,76,90,35,48,67,58.0,50.0,19,13,6
61,1,58,2,4,0,114,110,134,139,176,218,159,193,281,60,52,74,63.0,62.0,22,-8,30
103,2,58,2,4,0,127,149,132,201,192,241,224,227,356,181,119,130,124.0,143.0,11,-62,73
65,3,58,2,4,0,61,89,103,103,63,86,129,183,244,117,67,81,74.0,88.0,14,-50,64
97,4,58,2,4,0,398,466,501,463,464,472,326,417,805,105,52,132,92.0,96.0,80,-53,133
463,5,58,2,4,0,830,726,715,739,855,1133,824,910,1456,816,454,505,480.0,592.0,51,-362,413
88,6,58,2,4,0,160,209,240,323,314,310,267,287,463,251,96,133,114.0,160.0,37,-155,192
395,7,58,2,4,0,593,571,548,646,773,797,679,738,1182,600,283,311,297.0,398.0,28,-317,345
117,8,58,2,4,0,167,199,121,199,221,226,243,264,497,192,96,135,116.0,141.0,39,-96,135
262,9,58,2,4,0,342,351,384,378,429,596,574,615,869,297,127,271,199.0,232.0,144,-170,314
107,10,58,2,4,0,108,140,126,161,139,167,205,233,425,254,71,136,104.0,154.0,65,-183,248
363,11,58,2,4,0,574,521,545,683,706,761,731,749,1017,461,270,342,306.0,358.0,72,-191,263
84,12,58,2,4,0,126,110,128,145,145,229,198,198,315,211,60,84,72.0,118.0,24,-151,175
481,13,58,2,4,0,455,480,501,551,690,771,682,755,1430,754,390,398,394.0,514.0,8,-364,372
333,14,58,2,4,0,524,534,645,779,871,851,876,865,1601,892,268,371,320.0,510.0,103,-624,727
192,15,58,2,4,0,246,271,509,410,370,1437,406,420,845,174,81,170,126.0,142.0,89,-93,182
55,16,58,2,4,0,112,83,118,124,88,110,128,133,246,134,39,47,43.0,73.0,8,-95,103
191,17,58,2,4,0,280,324,325,335,319,439,335,447,756,439,130,231,180.0,267.0,101,-309,410
60,18,58,2,4,0,96,92,93,116,102,142,175,166,247,102,51,67,59.0,73.0,16,-51,67
27,19,58,2,4,0,60,48,65,77,81,68,54,102,113,47,21,29,25.0,32.0,8,-26,34
337,20,58,2,4,0,694,1791,780,781,1602,764,548,596,1578,630,283,298,290.0,404.0,15,-347,362
260,21,58,2,4,0,352,349,347,435,453,455,455,558,938,498,189,261,225.0,316.0,72,-309,381
11,22,58,2,4,0,14,19,35,25,28,17,16,45,45,7,10,21,16.0,13.0,11,3,8
190,1,59,2,4,0,615,1911,902,547,590,1049,393,448,746,228,125,223,174.0,192.0,98,-103,201
72,2,59,2,4,0,236,299,183,317,301,410,266,224,235,105,67,68,68.0,80.0,1,-38,39
64,3,59,2,4,0,170,205,129,178,248,263,289,273,340,208,63,95,79.0,122.0,32,-145,177
61,4,59,2,4,0,198,2153,193,216,265,2528,156,179,362,72,29,64,46.0,55.0,35,-43,78
265,5,59,2,4,0,987,918,779,942,1243,1666,730,631,1027,542,251,246,248.0,346.0,-5,-291,286
308,6,59,2,4,0,577,609,647,742,968,961,755,678,1434,792,244,232,238.0,423.0,-12,-548,536
453,7,59,2,4,0,1972,2081,1738,2176,2848,2646,1380,1053,1685,823,326,341,334.0,497.0,15,-497,512
162,8,59,2,4,0,357,466,412,468,657,660,386,479,604,321,126,162,144.0,203.0,36,-195,231
366,9,59,2,4,0,835,808,584,546,819,1623,936,1038,1493,451,130,374,252.0,318.0,244,-321,565
99,10,59,2,4,0,222,206,200,234,316,360,349,312,543,250,76,136,106.0,154.0,60,-174,234
787,11,59,2,4,0,1793,2058,1654,1827,2527,2388,1650,1467,2828,1205,656,751,704.0,871.0,95,-549,644
271,12,59,2,4,0,428,462,351,450,511,752,626,577,1241,549,138,232,185.0,306.0,94,-411,505
362,13,59,2,4,0,818,940,856,987,1387,1606,840,561,1020,602,249,293,271.0,381.0,44,-353,397
660,14,59,2,4,0,1237,1242,1377,1416,1736,1669,959,1021,1584,992,320,512,416.0,608.0,192,-672,864
341,15,59,2,4,0,706,739,693,717,1019,1203,828,859,1272,386,193,342,268.0,307.0,149,-193,342
326,16,59,2,4,0,623,602,550,430,713,769,691,751,1208,523,161,272,216.0,319.0,111,-362,473
212,17,59,2,4,0,566,595,580,641,816,847,522,619,891,508,132,232,182.0,291.0,100,-376,476
104,18,59,2,4,0,152,204,142,221,243,304,268,291,431,173,74,106,90.0,118.0,32,-99,131
101,19,59,2,4,0,229,277,157,228,366,291,139,186,225,91,51,75,63.0,72.0,24,-40,64
51,20,59,2,4,0,204,174,226,215,324,310,182,148,242,128,33,53,43.0,71.0,20,-95,115
136,21,59,2,4,0,524,533,558,687,656,661,278,275,432,182,64,143,104.0,130.0,79,-118,197
28,22,59,2,4,0,100,111,89,97,146,137,83,61,140,53,29,33,31.0,38.0,4,-24,28
99,1,60,1,4,0,133,134,134,141,138,161,113,162,163,142,84,128,106.0,118.0,44,-58,102
80,2,60,1,4,0,85,86,94,141,123,111,95,152,131,146,84,119,102.0,116.0,35,-62,97
87,3,60,1,4,0,64,107,75,84,71,81,97,81,90,83,41,62,52.0,62.0,21,-42,63
70,4,60,1,4,0,87,95,97,119,87,131,79,100,123,88,65,74,70.0,76.0,9,-23,32
201,5,60,1,4,0,225,215,255,232,227,447,284,279,330,341,184,223,204.0,249.0,39,-157,196
150,6,60,1,4,0,119,161,145,138,167,182,170,183,198,254,107,149,128.0,170.0,42,-147,189
163,7,60,1,4,0,180,157,181,138,136,198,152,160,191,159,74,162,118.0,132.0,88,-85,173
41,8,60,1,4,0,25,37,27,30,36,34,32,31,28,41,25,46,36.0,37.0,21,-16,37
387,9,60,1,4,0,345,479,470,487,435,593,541,658,638,568,264,527,396.0,453.0,263,-304,567
152,10,60,1,4,0,161,164,160,151,154,208,163,172,213,297,121,197,159.0,205.0,76,-176,252
324,11,60,1,4,0,313,360,325,317,361,402,385,402,439,430,213,408,310.0,350.0,195,-217,412
76,12,60,1,4,0,44,75,70,82,64,94,87,76,120,103,50,101,76.0,85.0,51,-53,104
95,13,60,1,4,0,92,88,94,88,102,92,82,85,95,109,50,116,83.0,92.0,66,-59,125
114,14,60,1,4,0,141,117,126,120,123,153,141,134,164,130,78,142,110.0,117.0,64,-52,116
317,15,60,1,4,0,287,301,272,322,299,308,339,364,397,466,185,307,246.0,319.0,122,-281,403
183,16,60,1,4,0,187,145,190,155,179,232,184,244,236,270,129,200,164.0,200.0,71,-141,212
301,17,60,1,4,0,290,293,279,299,298,395,308,355,445,519,215,330,272.0,355.0,115,-304,419
88,18,60,1,4,0,69,99,64,92,91,93,87,125,99,145,57,96,76.0,99.0,39,-88,127
102,19,60,1,4,0,97,133,116,136,158,194,115,126,155,89,59,109,84.0,86.0,50,-30,80
134,20,60,1,4,0,159,135,304,146,146,203,173,179,214,160,89,140,114.0,130.0,51,-71,122
212,21,60,1,4,0,190,260,217,273,229,256,263,252,263,274,154,228,191.0,219.0,74,-120,194
67,22,60,1,4,0,80,70,81,75,75,68,54,66,57,65,35,91,63.0,64.0,56,-30,86
241,1,1,1,5,0,271,235,260,162,265,228,369,374,305,193,309,264,286.0,255.0,-45,116,-161
321,2,1,1,5,0,308,279,419,246,217,310,402,456,434,194,302,243,272.0,246.0,-59,108,-167
192,3,1,1,5,0,236,164,187,153,157,178,204,219,180,128,201,176,188.0,168.0,-25,73,-98
407,4,1,1,5,0,445,351,322,244,337,371,460,563,468,432,472,340,406.0,415.0,-132,40,-172
331,5,1,1,5,0,360,329,335,345,623,350,453,570,500,253,378,337,358.0,323.0,-41,125,-166
144,6,1,1,5,0,154,138,108,127,159,136,179,226,198,76,132,155,144.0,121.0,23,56,-33
450,7,1,1,5,0,482,353,339,259,422,394,483,601,468,290,412,484,448.0,395.0,72,122,-50
251,8,1,1,5,0,250,166,178,189,194,233,215,260,248,146,249,182,216.0,192.0,-67,103,-170
2754,9,1,1,5,0,2897,2187,2183,1804,2265,2711,3532,3800,2692,1680,2958,2368,2663.0,2335.0,-590,1278,-1868
377,10,1,1,5,0,363,291,276,249,267,349,472,505,425,248,383,277,330.0,303.0,-106,135,-241
720,11,1,1,5,0,780,561,554,569,631,764,871,1010,800,486,817,617,717.0,640.0,-200,331,-531
186,12,1,1,5,0,167,149,136,95,156,166,204,262,236,78,191,154,172.0,141.0,-37,113,-150
328,13,1,1,5,0,280,252,227,235,225,228,291,305,260,190,297,311,304.0,266.0,14,107,-93
307,14,1,1,5,0,313,330,384,256,301,351,521,505,405,250,355,393,374.0,333.0,38,105,-67
562,15,1,1,5,0,638,453,457,422,545,702,660,865,633,409,621,561,591.0,530.0,-60,212,-272
403,16,1,1,5,0,357,440,329,325,381,447,480,474,497,228,445,423,434.0,365.0,-22,217,-239
284,17,1,1,5,0,308,275,250,286,299,327,364,474,347,174,297,304,300.0,258.0,7,123,-116
324,18,1,1,5,0,307,223,276,226,258,368,331,404,292,181,307,209,258.0,232.0,-98,126,-224
738,19,1,1,5,0,900,645,700,556,721,769,941,997,650,566,775,692,734.0,678.0,-83,209,-292
119,20,1,1,5,0,114,181,131,111,101,120,155,199,115,72,126,107,116.0,102.0,-19,54,-73
328,21,1,1,5,0,414,206,262,204,187,324,393,440,305,219,295,292,294.0,269.0,-3,76,-79
324,22,1,1,5,0,398,288,194,351,302,310,458,461,292,234,401,305,353.0,313.0,-96,167,-263
383,1,2,2,5,0,349,376,356,410,417,271,639,518,268,263,442,321,382.0,342.0,-121,179,-300
415,2,2,2,5,0,290,259,337,266,368,334,609,519,292,264,403,325,364.0,331.0,-78,139,-217
258,3,2,2,5,0,270,175,231,216,208,216,370,337,175,149,316,260,288.0,242.0,-56,167,-223
376,4,2,2,5,0,406,405,459,464,449,231,675,811,368,359,470,369,420.0,399.0,-101,111,-212
679,5,2,2,5,0,701,656,684,758,1227,469,1053,1125,657,560,806,700,753.0,689.0,-106,246,-352
350,6,2,2,5,0,224,252,293,358,325,253,574,507,301,225,317,315,316.0,286.0,-2,92,-94
1119,7,2,2,5,0,977,862,990,917,1222,876,1567,1574,775,729,1060,1229,1144.0,1006.0,169,331,-162
384,8,2,2,5,0,339,253,284,382,372,320,590,571,290,239,407,358,382.0,335.0,-49,168,-217
8990,9,2,2,5,0,9327,8266,8709,10596,10140,6925,13598,11515,5136,4688,10371,8733,9552.0,7931.0,-1638,5683,-7321
939,10,2,2,5,0,835,723,792,866,969,642,1386,1258,750,559,1074,832,953.0,822.0,-242,515,-757
1916,11,2,2,5,0,2026,1678,1827,2216,2075,1763,3112,2877,1445,1635,2184,1828,2006.0,1882.0,-356,549,-905
483,12,2,2,5,0,396,344,400,420,535,356,595,741,435,311,545,463,504.0,440.0,-82,234,-316
993,13,2,2,5,0,633,520,604,569,722,520,1137,974,498,486,847,1025,936.0,786.0,178,361,-183
932,14,2,2,5,0,673,695,718,785,808,565,1273,1234,645,486,968,944,956.0,799.0,-24,482,-506
1919,15,2,2,5,0,1625,1420,1737,1785,1658,1293,2709,2467,1135,1205,1969,1744,1856.0,1639.0,-225,764,-989
699,16,2,2,5,0,668,835,675,883,908,742,1001,1050,703,508,734,619,676.0,620.0,-115,226,-341
748,17,2,2,5,0,657,625,567,721,958,582,1112,1192,689,445,769,687,728.0,634.0,-82,324,-406
1494,18,2,2,5,0,1467,1202,1533,1388,1310,817,2205,1578,856,899,1607,1181,1394.0,1229.0,-426,708,-1134
1784,19,2,2,5,0,2279,1544,2253,2301,1915,1064,2892,2161,1110,1306,1905,1837,1871.0,1683.0,-68,599,-667
240,20,2,2,5,0,199,327,300,319,331,173,470,398,244,215,285,259,272.0,253.0,-26,70,-96
466,21,2,2,5,0,486,412,553,492,462,375,582,607,340,260,369,435,402.0,355.0,66,109,-43
827,22,2,2,5,0,765,687,670,1107,843,480,1076,1018,447,521,1186,639,912.0,782.0,-547,665,-1212
155,1,3,1,5,0,219,211,160,159,169,112,163,167,157,101,187,162,174.0,150.0,-25,86,-111
236,2,3,1,5,0,265,254,351,309,270,218,354,350,290,213,293,226,260.0,244.0,-67,80,-147
255,3,3,1,5,0,261,237,261,246,234,155,184,233,279,174,228,241,234.0,214.0,13,54,-41
389,4,3,1,5,0,627,552,633,554,583,457,611,677,549,387,627,524,576.0,513.0,-103,240,-343
370,5,3,1,5,0,372,413,373,319,387,300,411,434,516,235,377,355,366.0,322.0,-22,142,-164
129,6,3,1,5,0,119,126,118,108,157,129,128,138,176,83,127,116,122.0,109.0,-11,44,-55
323,7,3,1,5,0,345,393,358,328,376,327,415,400,420,235,353,334,344.0,307.0,-19,118,-137
157,8,3,1,5,0,165,161,170,152,135,111,141,197,179,103,189,173,181.0,155.0,-16,86,-102
1581,9,3,1,5,0,1652,1649,1691,1490,1683,1421,1989,1829,1713,1159,1738,1536,1637.0,1478.0,-202,579,-781
174,10,3,1,5,0,187,179,178,141,192,165,181,173,211,121,197,149,173.0,156.0,-48,76,-124
375,11,3,1,5,0,413,417,373,340,401,333,437,427,470,296,446,386,416.0,376.0,-60,150,-210
112,12,3,1,5,0,119,89,94,84,108,90,107,109,126,55,113,112,112.0,93.0,-1,58,-59
437,13,3,1,5,0,305,302,324,321,309,274,302,328,389,251,371,364,368.0,329.0,-7,120,-127
338,14,3,1,5,0,298,340,309,300,327,262,352,337,377,202,331,306,318.0,280.0,-25,129,-154
366,15,3,1,5,0,357,351,316,352,336,342,428,424,401,264,349,335,342.0,316.0,-14,85,-99
230,16,3,1,5,0,242,268,203,201,303,211,267,280,321,189,271,255,263.0,238.0,-16,82,-98
250,17,3,1,5,0,248,277,255,193,250,211,244,275,284,146,275,262,268.0,228.0,-13,129,-142
111,18,3,1,5,0,113,128,123,95,124,106,151,157,167,81,107,85,96.0,91.0,-22,26,-48
489,19,3,1,5,0,542,501,506,466,488,346,464,567,506,316,529,433,481.0,426.0,-96,213,-309
168,20,3,1,5,0,156,186,166,134,169,138,184,155,213,116,188,148,168.0,151.0,-40,72,-112
280,21,3,1,5,0,271,255,273,253,271,195,252,267,297,206,288,291,290.0,262.0,3,82,-79
240,22,3,1,5,0,357,324,293,304,239,208,258,336,315,155,306,267,286.0,243.0,-39,151,-190
161,1,4,2,5,0,251,282,229,249,216,166,212,210,117,96,135,131,133.0,121.0,-4,39,-43
191,2,4,2,5,0,154,116,231,232,256,209,270,308,173,110,159,185,172.0,151.0,26,49,-23
139,3,4,2,5,0,123,97,118,134,193,128,165,176,89,72,136,148,142.0,119.0,12,64,-52
96,4,4,2,5,0,237,267,308,309,286,179,246,342,136,109,179,166,172.0,151.0,-13,70,-83
290,5,4,2,5,0,430,414,426,492,712,401,438,436,351,212,361,425,393.0,333.0,64,149,-85
203,6,4,2,5,0,261,218,300,368,358,250,325,348,264,151,204,182,193.0,179.0,-22,53,-75
449,7,4,2,5,0,405,407,399,489,606,454,468,556,225,175,357,467,412.0,333.0,110,182,-72
165,8,4,2,5,0,124,127,123,233,187,181,144,181,92,70,148,181,164.0,133.0,33,78,-45
3668,9,4,2,5,0,3840,3624,4020,4618,5211,4012,4216,4195,2391,1639,3992,3988,3990.0,3206.0,-4,2353,-2357
434,10,4,2,5,0,350,329,360,409,444,331,432,386,248,166,443,418,430.0,342.0,-25,277,-302
1051,11,4,2,5,0,888,876,892,1148,1130,943,1033,1154,680,651,982,1039,1010.0,891.0,57,331,-274
298,12,4,2,5,0,221,210,194,288,380,260,302,351,208,96,254,328,291.0,226.0,74,158,-84
485,13,4,2,5,0,423,480,475,550,584,385,397,419,248,284,584,570,577.0,479.0,-14,300,-314
439,14,4,2,5,0,371,468,562,658,673,556,567,651,338,242,578,638,608.0,486.0,60,336,-276
1200,15,4,2,5,0,1012,1006,1138,1244,1296,1228,1343,1310,747,739,1438,1404,1421.0,1194.0,-34,699,-733
468,16,4,2,5,0,457,595,544,655,744,726,677,787,450,226,461,459,460.0,382.0,-2,235,-237
554,17,4,2,5,0,476,494,503,610,619,436,474,674,394,223,436,554,495.0,404.0,118,213,-95
676,18,4,2,5,0,506,417,546,535,615,563,615,519,231,173,535,612,574.0,440.0,77,362,-285
562,19,4,2,5,0,665,803,867,1031,840,522,652,848,213,233,610,646,628.0,496.0,36,377,-341
116,20,4,2,5,0,200,348,324,316,208,150,157,208,123,85,166,157,162.0,136.0,-9,81,-90
221,21,4,2,5,0,239,237,272,274,262,219,225,317,148,105,202,242,222.0,183.0,40,97,-57
241,22,4,2,5,0,255,248,232,335,334,222,288,303,90,85,233,244,238.0,187.0,11,148,-137
193,1,5,3,5,0,202,234,212,256,234,168,249,477,199,177,267,169,218.0,204.0,-98,90,-188
2227,2,5,3,5,0,2397,2353,2868,2565,3307,3096,3216,4503,4785,3067,2754,2281,2518.0,2701.0,-473,-313,-160
440,3,5,3,5,0,361,329,346,368,502,360,520,675,504,451,680,487,584.0,539.0,-193,229,-422
132,4,5,3,5,0,278,163,179,202,242,199,305,514,151,92,197,124,160.0,138.0,-73,105,-178
1021,5,5,3,5,0,1064,1118,1183,1230,1449,1007,1411,1954,1724,1537,1481,1090,1286.0,1369.0,-391,-56,-335
1266,6,5,3,5,0,1396,1210,1260,1418,1458,1238,1535,2328,2152,1881,1518,1284,1401.0,1561.0,-234,-363,129
2879,7,5,3,5,0,3587,2963,3398,3600,3519,3268,3907,6576,4483,3060,2839,2545,2692.0,2815.0,-294,-221,-73
1259,8,5,3,5,0,1493,1193,1334,1452,1749,1354,1585,2844,2093,1361,1353,1118,1236.0,1277.0,-235,-8,-227
1684,9,5,3,5,0,1820,1577,1457,1550,1999,1555,2007,3029,1611,1579,2180,1684,1932.0,1814.0,-496,601,-1097
1616,10,5,3,5,0,2371,1991,2051,2291,2515,2293,2687,4443,3084,1836,2310,1540,1925.0,1895.0,-770,474,-1244
1578,11,5,3,5,0,1679,1539,1776,1799,1764,1493,1942,3067,2165,2419,2029,1601,1815.0,2016.0,-428,-390,-38
648,12,5,3,5,0,1066,892,885,890,1111,824,980,1510,1290,922,875,668,772.0,822.0,-207,-47,-160
3119,13,5,3,5,0,2960,2437,2748,3368,3303,2808,3641,6231,3870,3403,2945,3015,2980.0,3121.0,70,-458,528
2715,14,5,3,5,0,3967,3302,3413,3591,3584,3821,4668,7650,5825,3564,3197,2704,2950.0,3155.0,-493,-367,-126
1224,15,5,3,5,0,1216,1213,1206,1016,1295,1112,1294,2062,1260,1629,1592,1156,1374.0,1459.0,-436,-37,-399
1069,16,5,3,5,0,1221,954,900,992,1202,958,1353,2198,1919,1140,1262,895,1078.0,1099.0,-367,122,-489
1020,17,5,3,5,0,1715,1491,1500,1678,1773,1354,1770,2693,2364,1506,1541,1174,1358.0,1407.0,-367,35,-402
546,18,5,3,5,0,576,545,512,565,573,523,688,892,592,650,741,463,602.0,618.0,-278,91,-369
988,19,5,3,5,0,1170,1034,1023,1010,1135,824,1154,1710,924,939,1322,959,1140.0,1073.0,-363,383,-746
191,20,5,3,5,0,258,225,203,204,284,201,250,357,250,248,235,212,224.0,232.0,-23,-13,-10
1105,21,5,3,5,0,1213,1083,1173,1245,1658,1590,1877,3217,2072,1105,1314,1222,1268.0,1214.0,-92,209,-301
585,22,5,3,5,0,736,776,785,835,795,518,816,982,506,518,806,657,732.0,660.0,-149,288,-437
285,1,6,1,5,0,232,330,331,445,555,272,582,623,382,114,351,229,290.0,231.0,-122,237,-359
419,2,6,1,5,0,327,333,428,409,543,553,546,680,484,300,452,403,428.0,385.0,-49,152,-201
604,3,6,1,5,0,638,517,552,645,831,715,836,832,551,317,489,505,497.0,437.0,16,172,-156
124,4,6,1,5,0,324,331,345,369,502,362,440,598,212,102,180,142,161.0,141.0,-38,78,-116
838,5,6,1,5,0,961,1004,1032,1165,1460,1050,1385,1850,1223,671,850,790,820.0,770.0,-60,179,-239
1077,6,6,1,5,0,934,1047,1058,1409,1565,1256,1491,1666,1515,717,1018,980,999.0,905.0,-38,301,-339
2031,7,6,1,5,0,1635,1575,1773,2139,2580,2061,2146,2737,1706,842,1734,1902,1818.0,1493.0,168,892,-724
569,8,6,1,5,0,477,430,532,655,690,724,762,993,533,312,595,582,588.0,496.0,-13,283,-296
5717,9,6,1,5,0,5187,5010,5237,6544,8215,6582,6734,6492,5607,2647,5713,4896,5304.0,4419.0,-817,3066,-3883
603,10,6,1,5,0,589,632,639,680,913,743,853,894,799,409,719,453,586.0,527.0,-266,310,-576
1701,11,6,1,5,0,1717,1679,1859,2252,2410,2283,2584,2672,1728,1016,1729,1498,1614.0,1414.0,-231,713,-944
838,12,6,1,5,0,761,704,848,964,1340,1065,1086,1291,1027,356,690,687,688.0,578.0,-3,334,-337
2863,13,6,1,5,0,1808,1966,2293,2864,3253,2277,2327,2703,2119,1271,2126,2486,2306.0,1961.0,360,855,-495
2841,14,6,1,5,0,2169,2264,2690,3318,3446,2827,2797,3447,2952,1308,2514,2566,2540.0,2129.0,52,1206,-1154
1141,15,6,1,5,0,949,928,974,1151,1369,1262,1632,1972,795,459,876,905,890.0,747.0,29,417,-388
1047,16,6,1,5,0,1027,1207,1181,1412,1938,1686,1663,2151,1566,597,1095,1029,1062.0,907.0,-66,498,-564
1636,17,6,1,5,0,1570,1605,1889,1918,2573,2247,1966,2770,1651,844,1487,1573,1530.0,1301.0,86,643,-557
427,18,6,1,5,0,292,259,301,348,390,371,447,476,264,148,314,267,290.0,243.0,-47,166,-213
362,19,6,1,5,0,311,261,323,369,397,317,403,513,241,211,360,293,326.0,288.0,-67,149,-216
543,20,6,1,5,0,585,806,750,810,888,646,803,1149,803,328,472,453,462.0,418.0,-19,144,-163
551,21,6,1,5,0,387,403,502,566,687,665,655,845,620,247,468,497,482.0,404.0,29,221,-192
585,22,6,1,5,0,550,570,602,652,669,544,740,1032,399,306,506,449,478.0,420.0,-57,200,-257
1184,1,7,3,5,0,1124,945,1154,1068,958,710,977,1212,1265,890,1247,1119,1183.0,1085.0,-128,357,-485
132,2,7,3,5,0,124,99,83,62,79,45,66,119,104,63,214,133,174.0,137.0,-81,151,-232
164,3,7,3,5,0,51,85,56,51,54,43,56,75,86,64,154,131,142.0,116.0,-23,90,-113
1430,4,7,3,5,0,926,824,1014,976,1027,677,793,1627,1352,1114,1508,1132,1320.0,1251.0,-376,394,-770
308,5,7,3,5,0,175,144,210,234,199,102,145,321,208,187,254,335,294.0,259.0,81,67,14
315,6,7,3,5,0,155,149,157,167,182,145,176,251,253,175,322,340,331.0,279.0,18,147,-129
1216,7,7,3,5,0,614,644,701,698,710,494,739,1047,878,649,1303,1248,1276.0,1067.0,-55,654,-709
272,8,7,3,5,0,90,115,93,101,121,83,105,184,165,123,244,320,282.0,229.0,76,121,-45
1025,9,7,3,5,0,557,511,479,453,514,463,571,819,762,448,944,1100,1022.0,831.0,156,496,-340
119,10,7,3,5,0,32,27,46,65,36,87,45,96,92,54,103,134,118.0,97.0,31,49,-18
1048,11,7,3,5,0,786,664,704,653,923,563,731,1002,974,650,1188,1289,1238.0,1042.0,101,538,-437
153,12,7,3,5,0,79,54,83,56,89,43,74,97,118,85,164,140,152.0,130.0,-24,79,-103
769,13,7,3,5,0,232,241,288,302,284,232,288,493,470,361,599,660,630.0,540.0,61,238,-177
685,14,7,3,5,0,376,374,353,356,387,282,366,596,517,345,763,731,747.0,613.0,-32,418,-450
865,15,7,3,5,0,382,390,895,578,350,278,533,736,534,424,754,915,834.0,698.0,161,330,-169
187,16,7,3,5,0,123,130,108,119,115,66,94,173,151,103,240,253,246.0,199.0,13,137,-124
182,17,7,3,5,0,72,59,68,91,68,60,83,119,101,59,203,163,183.0,142.0,-40,144,-184
187,18,7,3,5,0,92,103,107,123,99,106,97,170,123,106,206,303,254.0,205.0,97,100,-3
363,19,7,3,5,0,153,169,211,178,184,111,151,300,181,154,357,324,340.0,278.0,-33,203,-236
128,20,7,3,5,0,65,63,75,66,120,43,58,100,60,71,130,181,156.0,127.0,51,59,-8
340,21,7,3,5,0,153,156,195,228,164,136,164,313,234,179,320,305,312.0,268.0,-15,141,-156
255,22,7,3,5,0,69,65,102,113,130,76,95,177,129,74,323,185,254.0,194.0,-138,249,-387
527,1,8,2,5,0,484,494,547,504,605,431,543,697,325,168,288,309,298.0,255.0,21,120,-99
68,2,8,2,5,0,70,56,86,60,80,64,106,112,40,25,38,54,46.0,39.0,16,13,3
51,3,8,2,5,0,70,55,54,65,50,48,60,75,31,18,29,46,38.0,31.0,17,11,6
54,4,8,2,5,0,131,96,96,105,107,59,86,132,40,51,59,50,54.0,53.0,-9,8,-17
229,5,8,2,5,0,211,185,192,194,379,187,278,408,216,117,192,175,184.0,161.0,-17,75,-92
368,6,8,2,5,0,352,304,284,383,452,363,447,587,357,148,207,278,242.0,211.0,71,59,12
374,7,8,2,5,0,512,403,384,434,524,437,477,555,320,180,373,400,386.0,318.0,27,193,-166
44,8,8,2,5,0,84,53,53,40,61,59,55,64,30,23,28,38,33.0,30.0,10,5,5
211,9,8,2,5,0,274,225,205,191,284,225,342,408,121,39,166,158,162.0,121.0,-8,127,-135
71,10,8,2,5,0,81,56,48,72,86,66,86,129,68,34,47,50,48.0,44.0,3,13,-10
1067,11,8,2,5,0,1261,881,934,1240,1311,1156,1271,1767,893,628,788,879,834.0,765.0,91,160,-69
202,12,8,2,5,0,252,167,187,201,205,175,224,302,169,92,161,188,174.0,147.0,27,69,-42
163,13,8,2,5,0,145,156,130,129,149,129,127,215,80,56,93,108,100.0,86.0,15,37,-22
340,14,8,2,5,0,264,222,222,264,300,257,320,368,183,97,185,329,257.0,204.0,144,88,56
775,15,8,2,5,0,793,638,611,791,867,742,941,1163,445,309,478,511,494.0,433.0,33,169,-136
195,16,8,2,5,0,209,221,204,189,253,233,287,401,211,94,172,184,178.0,150.0,12,78,-66
198,17,8,2,5,0,228,177,169,202,213,182,259,315,201,83,173,167,170.0,141.0,-6,90,-96
114,18,8,2,5,0,97,66,59,77,86,70,117,145,54,20,51,78,64.0,50.0,27,31,-4
45,19,8,2,5,0,79,56,94,56,78,81,68,104,28,21,52,82,67.0,52.0,30,31,-1
33,20,8,2,5,0,37,61,45,63,77,40,57,62,28,20,37,37,37.0,31.0,0,17,-17
124,21,8,2,5,0,156,96,102,126,137,141,113,177,107,51,78,83,80.0,71.0,5,27,-22
20,22,8,2,5,0,45,25,30,29,39,29,28,30,11,11,8,18,13.0,12.0,10,-3,13
919,1,9,1,5,0,925,835,829,878,839,851,1537,1734,940,540,957,807,882.0,768.0,-150,417,-567
327,2,9,1,5,0,370,297,444,406,375,464,639,732,400,288,346,301,324.0,312.0,-45,58,-103
363,3,9,1,5,0,427,288,345,346,426,433,493,573,322,195,323,333,328.0,284.0,10,128,-118
595,4,9,1,5,0,621,593,551,572,648,532,915,1057,659,394,601,489,545.0,495.0,-112,207,-319
808,5,9,1,5,0,835,754,816,821,1394,1020,1293,1876,1072,611,873,761,817.0,748.0,-112,262,-374
769,6,9,1,5,0,749,648,689,782,938,1018,1287,1597,1015,457,773,664,718.0,631.0,-109,316,-425
1215,7,9,1,5,0,1314,1119,1240,1232,1497,1547,1722,2394,1077,522,1253,1236,1244.0,1004.0,-17,731,-748
404,8,9,1,5,0,462,359,317,365,407,489,581,742,375,248,450,310,380.0,336.0,-140,202,-342
976,9,9,1,5,0,1092,904,1023,986,1197,1508,2163,2594,949,463,1024,892,958.0,793.0,-132,561,-693
345,10,9,1,5,0,320,307,308,261,338,373,502,713,341,210,322,222,272.0,251.0,-100,112,-212
1355,11,9,1,5,0,1459,1195,1141,1497,1413,1635,2059,2647,1466,939,1519,1181,1350.0,1213.0,-338,580,-918
837,12,9,1,5,0,757,635,717,687,798,900,1083,1527,753,397,757,746,752.0,633.0,-11,360,-371
773,13,9,1,5,0,817,660,609,745,771,828,1012,1235,691,404,655,694,674.0,584.0,39,251,-212
903,14,9,1,5,0,951,899,929,998,1228,1191,1470,2122,1000,589,1119,1013,1066.0,907.0,-106,530,-636
1015,15,9,1,5,0,926,862,813,942,1042,1090,1626,2068,1003,537,978,796,887.0,770.0,-182,441,-623
1015,16,9,1,5,0,947,966,785,977,1135,1284,1519,1632,1025,485,1058,873,966.0,805.0,-185,573,-758
1084,17,9,1,5,0,1061,902,924,1034,1175,1168,1619,2178,1217,467,1068,962,1015.0,832.0,-106,601,-707
497,18,9,1,5,0,473,273,417,426,426,568,767,913,522,257,433,373,403.0,354.0,-60,176,-236
290,19,9,1,5,0,363,316,315,365,365,407,443,594,254,172,277,329,303.0,259.0,52,105,-53
324,20,9,1,5,0,291,407,357,329,386,354,500,762,420,252,342,321,332.0,305.0,-21,90,-111
357,21,9,1,5,0,383,263,316,283,360,444,478,651,365,184,306,238,272.0,243.0,-68,122,-190
231,22,9,1,5,0,288,202,213,233,201,203,289,372,142,121,207,187,197.0,172.0,-20,86,-106
1137,1,10,2,5,0,1398,1353,1616,1715,1560,1261,1546,1428,635,513,975,1070,1022.0,853.0,95,462,-367
408,2,10,2,5,0,335,298,451,462,412,350,412,626,249,167,333,316,324.0,272.0,-17,166,-183
439,3,10,2,5,0,432,328,313,335,434,451,516,701,285,178,320,330,325.0,276.0,10,142,-132
453,4,10,2,5,0,280,232,247,248,278,174,264,913,106,74,113,101,107.0,96.0,-12,39,-51
1649,5,10,2,5,0,1713,1549,1800,1833,2351,1555,1783,2691,1134,763,1522,1501,1512.0,1262.0,-21,759,-780
2171,6,10,2,5,0,2005,1957,2071,2572,2578,2110,2138,2356,1607,968,1908,2068,1988.0,1648.0,160,940,-780
4223,7,10,2,5,0,3723,2665,3185,3623,4079,3911,3787,4830,2048,1323,3138,3779,3458.0,2747.0,641,1815,-1174
883,8,10,2,5,0,695,612,635,770,774,678,852,1073,317,283,629,610,620.0,507.0,-19,346,-365
1848,9,10,2,5,0,2151,1841,2105,2230,2219,1912,2435,2500,695,488,1495,1512,1504.0,1165.0,17,1007,-990
830,10,10,2,5,0,605,509,467,597,723,646,783,869,475,293,738,554,646.0,528.0,-184,445,-629
4704,11,10,2,5,0,5237,4119,4343,5439,5089,5170,5016,5865,2657,2401,4119,4083,4101.0,3534.0,-36,1718,-1754
1895,12,10,2,5,0,1339,997,1282,1228,1446,1175,1376,1737,923,549,1502,1828,1665.0,1293.0,326,953,-627
2809,13,10,2,5,0,1915,1717,1730,2030,2166,1672,1926,2621,900,720,1379,2198,1788.0,1432.0,819,659,160
3067,14,10,2,5,0,2148,2124,2569,3033,2794,2644,2874,3243,1683,1042,2558,3199,2878.0,2266.0,641,1516,-875
2506,15,10,2,5,0,3027,2635,2644,3079,3258,3003,3295,3490,1289,1038,1965,1876,1920.0,1626.0,-89,927,-1016
1437,16,10,2,5,0,1354,1346,1388,1694,1779,1500,1547,1624,929,480,1234,1278,1256.0,997.0,44,754,-710
1696,17,10,2,5,0,1556,1388,1464,1556,1793,1457,1585,1952,989,516,1513,1616,1564.0,1215.0,103,997,-894
1319,18,10,2,5,0,1147,600,1040,913,859,836,1130,958,546,402,859,878,868.0,713.0,19,457,-438
474,19,10,2,5,0,553,466,570,710,667,540,619,821,205,149,446,498,472.0,364.0,52,297,-245
429,20,10,2,5,0,344,487,446,463,501,422,419,597,296,163,296,401,348.0,287.0,105,133,-28
883,21,10,2,5,0,717,590,762,830,880,891,912,1151,413,242,475,689,582.0,469.0,214,233,-19
254,22,10,2,5,0,391,233,247,332,298,250,347,415,118,130,301,193,247.0,208.0,-108,171,-279
103,1,11,2,5,0,132,121,130,170,225,144,225,270,79,27,45,95,70.0,56.0,50,18,32
231,2,11,2,5,0,150,124,141,193,215,192,267,384,296,172,285,192,238.0,216.0,-93,113,-206
178,3,11,2,5,0,180,155,165,211,257,237,359,450,248,124,211,203,207.0,179.0,-8,87,-95
1106,4,11,2,5,0,671,764,635,596,755,684,938,1287,118,74,556,952,754.0,527.0,396,482,-86
702,5,11,2,5,0,754,743,840,1135,1134,707,1002,2805,1326,797,891,676,784.0,788.0,-215,94,-309
582,6,11,2,5,0,431,427,626,807,752,716,977,1443,903,436,535,520,528.0,497.0,-15,99,-114
1488,7,11,2,5,0,1432,1325,1510,2013,2253,1752,2198,3785,1878,1009,1343,1575,1459.0,1309.0,232,334,-102
574,8,11,2,5,0,383,273,396,591,635,370,1993,2925,603,248,417,464,440.0,376.0,47,169,-122
1082,9,11,2,5,0,1203,1183,1216,1851,1526,1065,2044,2419,914,399,1078,1095,1086.0,857.0,17,679,-662
512,10,11,2,5,0,385,389,373,565,452,368,493,935,666,303,492,403,448.0,399.0,-89,189,-278
985,11,11,2,5,0,1057,971,1038,1263,1231,1184,1531,2308,910,648,752,1041,896.0,814.0,289,104,185
555,12,11,2,5,0,546,479,591,657,831,701,917,1377,999,364,509,561,535.0,478.0,52,145,-93
1002,13,11,2,5,0,696,616,754,991,941,754,1144,2067,1110,641,741,953,847.0,778.0,212,100,112
1368,14,11,2,5,0,1258,1321,1528,1922,1491,1090,1965,3560,2272,888,1199,1423,1311.0,1170.0,224,311,-87
2340,15,11,2,5,0,1718,1900,1877,2534,1978,2287,3147,4324,1028,639,1114,1097,1106.0,950.0,-17,475,-492
410,16,11,2,5,0,420,475,487,636,528,521,941,1534,1004,347,476,456,466.0,426.0,-20,129,-149
650,17,11,2,5,0,1034,885,1014,1148,1102,762,1142,1719,1133,438,685,688,686.0,604.0,3,247,-244
712,18,11,2,5,0,665,596,710,861,605,468,762,1967,434,268,656,565,610.0,496.0,-91,388,-479
188,19,11,2,5,0,189,242,328,373,319,239,291,520,199,149,205,202,204.0,185.0,-3,56,-59
302,20,11,2,5,0,265,352,383,500,317,253,326,532,432,291,409,310,360.0,337.0,-99,118,-217
587,21,11,2,5,0,669,670,984,1191,1013,830,1010,1651,919,422,609,612,610.0,548.0,3,187,-184
104,22,11,2,5,0,102,96,114,179,154,114,204,257,135,104,114,128,121.0,115.0,14,10,4
45,1,12,2,5,0,61,91,84,82,78,75,125,158,63,40,60,51,56.0,50.0,-9,20,-29
252,2,12,2,5,0,229,212,242,297,409,425,375,535,421,246,288,240,264.0,258.0,-48,42,-90
180,3,12,2,5,0,157,141,155,186,321,287,448,676,363,164,250,212,231.0,209.0,-38,86,-124
71,4,12,2,5,0,142,166,192,229,328,289,360,496,86,74,109,80,94.0,88.0,-29,35,-64
535,5,12,2,5,0,502,542,612,740,894,870,831,1260,724,451,621,526,574.0,533.0,-95,170,-265
316,6,12,2,5,0,327,272,360,423,570,478,510,806,576,272,358,315,336.0,315.0,-43,86,-129
1025,7,12,2,5,0,950,814,1067,1385,1544,1660,1778,2915,1529,762,977,1071,1024.0,937.0,94,215,-121
590,8,12,2,5,0,438,304,387,526,657,689,668,1092,615,366,578,543,560.0,496.0,-35,212,-247
734,9,12,2,5,0,800,706,726,1003,987,1170,1384,1437,718,363,821,836,828.0,673.0,15,458,-443
292,10,12,2,5,0,244,215,205,275,336,321,463,659,452,233,370,288,329.0,297.0,-82,137,-219
406,11,12,2,5,0,417,417,424,503,619,691,743,1008,543,405,518,460,489.0,461.0,-58,113,-171
331,12,12,2,5,0,324,321,323,384,576,518,577,816,634,247,323,301,312.0,290.0,-22,76,-98
1210,13,12,2,5,0,897,796,976,1190,1442,1308,1432,2365,1304,951,1023,1070,1046.0,1015.0,47,72,-25
823,14,12,2,5,0,796,796,921,1180,1362,1148,1406,2228,1526,717,888,888,888.0,831.0,0,171,-171
520,15,12,2,5,0,599,497,546,656,656,660,874,1121,438,306,511,460,486.0,426.0,-51,205,-256
325,16,12,2,5,0,316,308,353,445,594,534,655,903,635,255,364,342,353.0,320.0,-22,109,-131
540,17,12,2,5,0,590,570,561,665,852,609,763,1216,773,321,479,531,505.0,444.0,52,158,-106
252,18,12,2,5,0,185,203,218,279,280,218,239,420,249,153,274,195,234.0,207.0,-79,121,-200
279,19,12,2,5,0,276,253,308,361,450,328,514,641,287,222,321,326,324.0,290.0,5,99,-94
233,20,12,2,5,0,187,221,263,289,325,272,292,402,296,142,238,207,222.0,196.0,-31,96,-127
492,21,12,2,5,0,446,383,562,667,705,729,755,1158,815,410,484,484,484.0,459.0,0,74,-74
183,22,12,2,5,0,155,141,189,179,249,176,328,336,166,145,205,161,183.0,170.0,-44,60,-104
145,1,13,1,5,0,156,130,143,149,181,158,314,461,180,102,190,125,158.0,139.0,-65,88,-153
682,2,13,1,5,0,336,248,387,336,447,627,757,1396,1059,575,778,650,714.0,668.0,-128,203,-331
472,3,13,1,5,0,165,174,186,216,287,324,527,720,520,270,473,409,441.0,384.0,-64,203,-267
117,4,13,1,5,0,99,100,137,177,237,199,242,487,101,86,162,127,144.0,125.0,-35,76,-111
1192,5,13,1,5,0,759,618,741,845,1263,1243,1605,2433,1860,1194,1302,1156,1229.0,1217.0,-146,108,-254
934,6,13,1,5,0,561,546,651,840,1069,1269,1370,2298,1440,720,878,861,870.0,820.0,-17,158,-175
1956,7,13,1,5,0,723,768,927,999,1485,1686,2126,3804,2217,1109,1504,1812,1658.0,1475.0,308,395,-87
732,8,13,1,5,0,255,224,271,379,496,642,748,1215,772,404,591,661,626.0,552.0,70,187,-117
948,9,13,1,5,0,600,502,550,650,835,848,1467,2021,1040,446,977,1064,1020.0,829.0,87,531,-444
586,10,13,1,5,0,257,240,225,284,342,388,511,880,738,330,660,454,557.0,481.0,-206,330,-536
1265,11,13,1,5,0,883,678,762,1001,1116,1451,1816,2525,1540,1130,1441,1246,1344.0,1272.0,-195,311,-506
632,12,13,1,5,0,410,377,409,440,725,733,889,1320,1015,377,598,631,614.0,535.0,33,221,-188
2368,13,13,1,5,0,781,785,958,1014,1437,1548,2026,3281,1882,1126,1456,2041,1748.0,1541.0,585,330,255
1509,14,13,1,5,0,634,719,857,953,1313,1473,1843,2975,2324,1002,1413,1518,1466.0,1311.0,105,411,-306
948,15,13,1,5,0,746,723,731,805,1089,1175,1502,2235,958,565,880,893,886.0,779.0,13,315,-302
758,16,13,1,5,0,503,489,505,669,868,924,1339,1557,1148,463,782,723,752.0,656.0,-59,319,-378
655,17,13,1,5,0,371,399,407,438,633,772,835,1281,1235,439,733,664,698.0,612.0,-69,294,-363
541,18,13,1,5,0,227,178,234,282,307,414,622,877,518,365,529,461,495.0,452.0,-68,164,-232
405,19,13,1,5,0,177,191,236,231,291,296,396,542,311,224,349,397,373.0,323.0,48,125,-77
368,20,13,1,5,0,207,227,218,259,311,316,419,666,489,274,346,334,340.0,318.0,-12,72,-84
597,21,13,1,5,0,287,271,303,362,519,627,715,1549,1036,394,463,535,499.0,464.0,72,69,3
736,22,13,1,5,0,344,319,336,422,442,411,616,998,401,372,684,679,682.0,578.0,-5,312,-317
355,1,14,1,5,0,459,422,464,522,661,472,781,1047,423,192,279,354,316.0,275.0,75,87,-12
1295,2,14,1,5,0,985,706,939,877,1084,1148,1159,1879,1354,680,631,992,812.0,768.0,361,-49,410
1042,3,14,1,5,0,583,433,551,578,725,701,941,1442,814,347,566,786,676.0,566.0,220,219,1
376,4,14,1,5,0,411,391,454,496,664,474,569,1295,274,176,281,280,280.0,246.0,-1,105,-106
1668,5,14,1,5,0,1614,1306,1417,1488,2289,1556,2162,4188,2540,1081,1111,1488,1300.0,1227.0,377,30,347
1582,6,14,1,5,0,1443,1295,1412,1803,1996,1889,2073,3650,2495,863,893,1218,1056.0,991.0,325,30,295
3444,7,14,1,5,0,2580,2168,2583,2886,3461,3252,3594,6275,3467,1356,2002,3249,2626.0,2202.0,1247,646,601
998,8,14,1,5,0,630,509,619,652,805,800,914,1576,743,357,500,790,645.0,549.0,290,143,147
2162,9,14,1,5,0,2201,1866,1837,2246,2808,2902,3269,4342,1784,653,1364,1722,1543.0,1246.0,358,711,-353
802,10,14,1,5,0,655,477,518,574,670,621,739,1316,892,381,556,538,547.0,492.0,-18,175,-193
3244,11,14,1,5,0,3224,2468,2600,3230,3453,3560,3776,5864,3032,1760,2316,2607,2462.0,2228.0,291,556,-265
960,12,14,1,5,0,980,839,839,860,1325,1195,1285,2160,1579,453,603,962,782.0,673.0,359,150,209
3049,13,14,1,5,0,2039,1774,2024,2258,2481,2298,2594,4551,2375,1231,1427,2467,1947.0,1708.0,1040,196,844
3025,14,14,1,5,0,2508,2539,3103,3396,3571,3427,4047,8018,5309,1586,1915,2716,2316.0,2072.0,801,329,472
2275,15,14,1,5,0,2136,1905,1897,2229,2579,2724,3014,4336,1679,826,1161,1890,1526.0,1292.0,729,335,394
1278,16,14,1,5,0,1186,1236,1304,1341,1747,1512,1848,3179,2049,551,906,1028,967.0,828.0,122,355,-233
1621,17,14,1,5,0,1468,1450,1536,1679,2187,1872,2355,3747,2461,732,1157,1395,1276.0,1095.0,238,425,-187
759,18,14,1,5,0,683,519,626,618,738,859,1140,1306,596,364,463,616,540.0,481.0,153,99,54
1203,19,14,1,5,0,949,846,1022,1132,1218,970,1188,1784,769,415,765,1227,996.0,802.0,462,350,112
594,20,14,1,5,0,656,695,635,655,770,622,761,1417,877,373,399,529,464.0,434.0,130,26,104
917,21,14,1,5,0,688,468,587,654,727,899,841,1546,1008,303,361,648,504.0,437.0,287,58,229
778,22,14,1,5,0,692,573,663,777,675,517,944,1290,579,365,604,725,664.0,565.0,121,239,-118
727,1,15,2,5,0,656,680,680,720,820,623,807,1293,851,433,764,667,716.0,621.0,-97,331,-428
462,2,15,2,5,0,252,242,468,405,456,394,535,639,509,300,415,361,388.0,359.0,-54,115,-169
562,3,15,2,5,0,364,340,407,480,482,477,451,580,494,276,556,527,542.0,453.0,-29,280,-309
1002,4,15,2,5,0,1124,1019,1062,1143,1276,969,1288,2146,1327,923,1308,982,1145.0,1071.0,-326,385,-711
621,5,15,2,5,0,452,487,585,715,1123,634,781,1105,856,454,680,597,638.0,577.0,-83,226,-309
685,6,15,2,5,0,478,422,472,667,840,774,803,1070,953,364,644,584,614.0,531.0,-60,280,-340
1298,7,15,2,5,0,915,988,988,1162,1315,1224,1513,1837,1329,778,1244,1284,1264.0,1102.0,40,466,-426
727,8,15,2,5,0,669,598,604,750,729,770,798,1203,945,474,746,713,730.0,644.0,-33,272,-305
477,9,15,2,5,0,266,335,313,351,438,425,536,825,423,180,427,549,488.0,385.0,122,247,-125
183,10,15,2,5,0,110,114,93,121,141,135,160,243,179,71,140,141,140.0,117.0,1,69,-68
1340,11,15,2,5,0,1198,1215,1276,1793,1838,1848,1951,2643,1820,1058,1565,1288,1426.0,1304.0,-277,507,-784
312,12,15,2,5,0,295,274,321,334,419,377,424,571,408,151,325,301,313.0,259.0,-24,174,-198
1631,13,15,2,5,0,1024,961,977,1321,1377,1264,1433,1923,1604,884,1377,1523,1450.0,1261.0,146,493,-347
1044,14,15,2,5,0,780,738,834,1010,1081,952,1113,1482,1178,548,1003,1062,1032.0,871.0,59,455,-396
651,15,15,2,5,0,444,464,536,601,733,722,894,1112,767,352,679,681,680.0,571.0,2,327,-325
296,16,15,2,5,0,284,317,260,295,373,329,377,483,446,164,271,261,266.0,232.0,-10,107,-117
428,17,15,2,5,0,301,333,339,383,464,438,477,783,487,262,452,359,406.0,358.0,-93,190,-283
291,18,15,2,5,0,189,158,212,189,235,212,345,456,397,140,227,217,222.0,195.0,-10,87,-97
179,19,15,2,5,0,253,279,277,296,261,247,251,310,270,165,356,218,287.0,246.0,-138,191,-329
378,20,15,2,5,0,342,482,408,414,486,426,491,644,555,263,408,381,394.0,351.0,-27,145,-172
645,21,15,2,5,0,395,348,388,413,568,617,622,758,719,361,603,579,591.0,514.0,-24,242,-266
141,22,15,2,5,0,150,115,124,187,159,142,152,169,104,79,149,106,128.0,111.0,-43,70,-113
100,1,16,2,5,0,32,39,46,46,41,395,67,117,63,37,86,109,98.0,77.0,23,49,-26
884,2,16,2,5,0,1072,971,1395,1426,1254,988,1142,1590,946,692,1035,755,895.0,827.0,-280,343,-623
743,3,16,2,5,0,895,690,744,864,895,802,945,982,602,413,714,724,719.0,617.0,10,301,-291
274,4,16,2,5,0,698,717,716,794,737,477,625,985,300,271,404,282,343.0,319.0,-122,133,-255
2457,5,16,2,5,0,2734,2651,2620,2791,2955,1733,2221,3340,1470,1639,3175,2405,2790.0,2406.0,-770,1536,-2306
286,6,16,2,5,0,402,479,502,552,488,424,410,575,248,260,384,279,332.0,308.0,-105,124,-229
2932,7,16,2,5,0,3511,2812,3126,3130,3837,3617,3662,4024,1903,1708,2748,2376,2562.0,2277.0,-372,1040,-1412
892,8,16,2,5,0,1057,828,993,1217,1561,1243,1188,1616,679,442,672,792,732.0,635.0,120,230,-110
2005,9,16,2,5,0,1785,1654,1766,1963,2010,1906,2111,2398,1196,1075,2249,1558,1904.0,1627.0,-691,1174,-1865
501,10,16,2,5,0,353,331,405,319,409,384,459,435,440,301,449,664,556.0,471.0,215,148,67
586,11,16,2,5,0,875,786,701,745,840,781,777,930,527,626,655,605,630.0,629.0,-50,29,-79
359,12,16,2,5,0,330,292,330,358,538,488,482,540,354,189,356,270,313.0,272.0,-86,167,-253
3148,13,16,2,5,0,3349,3221,3102,3388,3910,3483,3233,4206,2068,1780,2633,2656,2644.0,2356.0,23,853,-830
1509,14,16,2,5,0,2022,1974,2200,2100,2323,1931,2018,2962,1570,1050,1823,1515,1669.0,1463.0,-308,773,-1081
606,15,16,2,5,0,827,820,769,777,723,606,634,886,424,422,628,555,592.0,535.0,-73,206,-279
376,16,16,2,5,0,610,623,595,715,725,585,544,920,483,270,442,304,373.0,339.0,-138,172,-310
1023,17,16,2,5,0,1475,1358,1456,1533,1680,1444,1489,2336,1714,653,1232,835,1034.0,907.0,-397,579,-976
486,18,16,2,5,0,484,487,627,773,710,690,597,622,308,292,460,424,442.0,392.0,-36,168,-204
1215,19,16,2,5,0,1508,1498,1804,1815,1871,1308,1478,1878,681,691,1319,1119,1219.0,1043.0,-200,628,-828
126,20,16,2,5,0,204,370,530,502,347,184,172,247,131,105,125,160,142.0,130.0,35,20,15
577,21,16,2,5,0,604,479,874,1106,695,580,634,1051,558,384,605,487,546.0,492.0,-118,221,-339
1336,22,16,2,5,0,1291,1253,1193,1427,1562,1308,1636,1781,730,952,1556,1254,1405.0,1254.0,-302,604,-906
883,1,17,2,5,0,2922,2462,1180,1500,2397,1674,2362,3060,1909,501,2672,4039,3356.0,2404.0,1367,2171,-804
785,2,17,2,5,0,647,551,884,974,1076,1038,1033,1402,656,504,651,603,627.0,586.0,-48,147,-195
543,3,17,2,5,0,507,344,410,446,541,468,630,827,268,214,376,413,394.0,334.0,37,162,-125
280,4,17,2,5,0,2551,971,995,1118,835,516,1494,2145,217,200,2331,1550,1940.0,1360.0,-781,2131,-2912
1399,5,17,2,5,0,1543,1533,1662,1864,2707,1708,2119,2450,1355,937,1478,2078,1778.0,1498.0,600,541,59
1591,6,17,2,5,0,1828,1799,2028,2809,2863,2529,2927,3132,1460,775,1436,1362,1399.0,1191.0,-74,661,-735
2615,7,17,2,5,0,3471,2715,3147,4018,4409,4129,4087,5401,1885,1225,2010,2269,2140.0,1835.0,259,785,-526
1192,8,17,2,5,0,1337,977,1223,1490,1510,1452,1547,2066,692,491,877,974,926.0,781.0,97,386,-289
1216,9,17,2,5,0,1983,1796,1715,2112,2192,2036,2188,2519,625,462,1475,1506,1490.0,1148.0,31,1013,-982
407,10,17,2,5,0,518,379,413,503,589,568,596,616,308,176,366,289,328.0,277.0,-77,190,-267
3008,11,17,2,5,0,3757,3219,3369,4854,5016,4475,5007,5643,2143,1862,2644,2631,2638.0,2379.0,-13,782,-795
1031,12,17,2,5,0,1370,1233,1308,1681,2044,1627,1981,2357,973,442,916,895,906.0,751.0,-21,474,-495
2981,13,17,2,5,0,3198,2587,2964,3829,3951,3277,3711,5424,1723,1261,2043,2652,2348.0,1985.0,609,782,-173
2723,14,17,2,5,0,2736,2702,3421,4398,4500,3793,4237,5119,2463,1238,2429,2562,2496.0,2076.0,133,1191,-1058
1533,15,17,2,5,0,2092,1953,2021,2513,2777,2324,2401,2755,895,768,1359,1321,1340.0,1149.0,-38,591,-629
822,16,17,2,5,0,1158,1213,1120,1591,1818,1296,1466,1985,1002,357,841,848,844.0,682.0,7,484,-477
1204,17,17,2,5,0,1561,1517,1583,1906,2187,1670,2078,2533,1085,531,1104,1014,1059.0,883.0,-90,573,-663
1235,18,17,2,5,0,1082,843,1055,1347,1279,1170,1218,1549,440,400,775,721,748.0,632.0,-54,375,-429
555,19,17,2,5,0,859,586,702,806,897,700,869,1098,268,212,386,587,486.0,395.0,201,174,27
619,20,17,2,5,0,870,1013,987,1230,1171,824,938,1120,617,359,603,607,605.0,523.0,4,244,-240
842,21,17,2,5,0,1284,861,1113,1278,1300,1165,1199,1748,631,397,661,1831,1246.0,963.0,1170,264,906
323,22,17,2,5,0,421,327,303,404,404,286,466,480,162,156,276,218,247.0,217.0,-58,120,-178
351,1,18,2,5,0,759,629,425,535,502,314,574,754,315,362,767,319,543.0,483.0,-448,405,-853
525,2,18,2,5,0,595,461,551,450,435,635,692,866,452,295,448,404,426.0,382.0,-44,153,-197
550,3,18,2,5,0,561,440,380,452,427,495,612,941,427,254,591,556,574.0,467.0,-35,337,-372
115,4,18,2,5,0,353,301,382,397,346,199,341,546,125,89,159,100,130.0,116.0,-59,70,-129
1081,5,18,2,5,0,1270,1055,1379,1197,903,838,1187,1812,1017,704,1344,1235,1290.0,1094.0,-109,640,-749
638,6,18,2,5,0,1021,869,1109,958,734,813,952,1669,741,475,869,701,785.0,682.0,-168,394,-562
2834,7,18,2,5,0,3404,2787,3450,3299,2451,2995,3812,5496,2330,1515,2865,2841,2853.0,2407.0,-24,1350,-1374
1531,8,18,2,5,0,1725,1270,1462,1588,1052,1126,1234,2626,1165,641,1247,1425,1336.0,1104.0,178,606,-428
513,9,18,2,5,0,473,460,457,448,529,384,525,1055,368,255,433,540,486.0,409.0,107,178,-71
249,10,18,2,5,0,302,352,363,291,255,362,355,448,365,155,240,485,362.0,293.0,245,85,160
827,11,18,2,5,0,1178,1368,1353,1085,864,1310,1728,2261,1167,1028,1507,1281,1394.0,1272.0,-226,479,-705
253,12,18,2,5,0,412,315,365,335,301,356,946,847,641,223,316,236,276.0,258.0,-80,93,-173
3250,13,18,2,5,0,3190,2715,3210,3609,2265,2586,3058,5478,1932,1551,2981,3513,3247.0,2682.0,532,1430,-898
1408,14,18,2,5,0,1905,1469,1701,1452,1141,1472,1941,3092,1731,893,1695,1504,1600.0,1364.0,-191,802,-993
514,15,18,2,5,0,1100,1016,1000,913,659,638,706,1205,504,467,741,598,670.0,602.0,-143,274,-417
166,16,18,2,5,0,347,353,277,263,202,272,348,657,298,154,273,222,248.0,216.0,-51,119,-170
409,17,18,2,5,0,849,769,962,701,698,568,587,1351,576,253,448,437,442.0,379.0,-11,195,-206
240,18,18,2,5,0,335,225,356,355,342,307,452,617,215,148,255,232,244.0,212.0,-23,107,-130
776,19,18,2,5,0,783,589,621,716,684,572,853,1026,394,408,768,721,744.0,632.0,-47,360,-407
249,20,18,2,5,0,497,413,558,474,304,408,379,694,353,248,346,329,338.0,308.0,-17,98,-115
553,21,18,2,5,0,599,723,667,832,623,693,804,1400,754,418,791,600,696.0,603.0,-191,373,-564
518,22,18,2,5,0,383,283,369,508,307,324,496,710,280,266,503,464,484.0,411.0,-39,237,-276
248,1,19,2,5,0,249,228,201,232,150,148,312,359,339,177,321,249,285.0,249.0,-72,144,-216
412,2,19,2,5,0,346,330,388,290,304,344,442,485,409,248,357,375,366.0,327.0,18,109,-91
583,3,19,2,5,0,395,262,398,348,325,432,401,434,519,319,522,443,482.0,428.0,-79,203,-282
1549,4,19,2,5,0,1156,1039,990,1183,1150,795,1121,1802,1263,877,1267,1047,1157.0,1064.0,-220,390,-610
852,5,19,2,5,0,679,596,623,519,741,610,732,1083,1390,565,951,827,889.0,781.0,-124,386,-510
553,6,19,2,5,0,414,403,381,360,323,440,519,629,667,315,471,534,502.0,440.0,63,156,-93
1792,7,19,2,5,0,1499,1162,1256,1311,1391,1370,1666,1642,1861,878,1578,1694,1636.0,1383.0,116,700,-584
445,8,19,2,5,0,380,264,316,332,330,480,421,414,426,317,451,395,423.0,388.0,-56,134,-190
791,9,19,2,5,0,553,537,509,516,523,704,995,1243,727,322,827,693,760.0,614.0,-134,505,-639
193,10,19,2,5,0,113,102,97,101,156,159,192,214,225,119,204,139,172.0,154.0,-65,85,-150
1278,11,19,2,5,0,1236,925,785,871,1280,881,1099,1374,1336,868,1301,1124,1212.0,1098.0,-177,433,-610
315,12,19,2,5,0,246,191,199,169,178,237,276,329,364,141,291,237,264.0,223.0,-54,150,-204
2074,13,19,2,5,0,1563,1391,1238,1360,1115,1052,1461,1615,1768,1165,1697,1805,1751.0,1556.0,108,532,-424
1419,14,19,2,5,0,996,913,957,1047,1104,1357,1223,1443,1429,856,1325,1403,1364.0,1195.0,78,469,-391
707,15,19,2,5,0,592,492,475,404,404,512,747,863,742,356,707,633,670.0,565.0,-74,351,-425
470,16,19,2,5,0,345,337,298,379,393,374,473,566,558,262,443,396,420.0,367.0,-47,181,-228
397,17,19,2,5,0,307,277,273,291,253,248,418,494,519,230,424,383,404.0,346.0,-41,194,-235
340,18,19,2,5,0,307,216,229,183,186,285,325,402,404,188,330,251,290.0,256.0,-79,142,-221
781,19,19,2,5,0,593,769,652,721,569,738,644,1082,704,546,870,783,826.0,733.0,-87,324,-411
317,20,19,2,5,0,274,314,254,213,262,251,282,391,433,202,335,319,327.0,285.0,-16,133,-149
460,21,19,2,5,0,522,312,356,360,419,276,346,497,487,257,378,390,384.0,342.0,12,121,-109
1179,22,19,2,5,0,794,828,639,929,731,657,664,964,785,666,1198,1070,1134.0,978.0,-128,532,-660
612,1,20,1,5,0,982,1141,897,946,1150,1010,1563,1504,815,447,731,532,632.0,570.0,-199,284,-483
422,2,20,1,5,0,522,373,681,595,570,759,692,785,585,277,403,310,356.0,330.0,-93,126,-219
183,3,20,1,5,0,365,254,296,333,327,407,342,430,303,110,229,177,203.0,172.0,-52,119,-171
462,4,20,1,5,0,768,998,675,772,925,740,925,1127,376,284,427,371,399.0,361.0,-56,143,-199
680,5,20,1,5,0,978,903,990,1085,1885,1100,1320,1775,1096,562,764,657,710.0,661.0,-107,202,-309
589,6,20,1,5,0,823,725,769,980,1023,1001,1064,1490,952,364,600,581,590.0,515.0,-19,236,-255
957,7,20,1,5,0,1210,1082,1134,1323,1432,1303,1408,1739,940,501,805,813,809.0,706.0,8,304,-296
130,8,20,1,5,0,326,221,257,295,289,333,332,371,229,113,151,138,144.0,134.0,-13,38,-51
846,9,20,1,5,0,1269,1114,1097,1195,1320,1463,1644,2216,854,451,986,862,924.0,766.0,-124,535,-659
197,10,20,1,5,0,277,223,187,218,240,280,255,372,218,114,237,155,196.0,169.0,-82,123,-205
1158,11,20,1,5,0,1639,1433,1571,1947,1897,1872,2263,3132,1586,987,1345,1015,1180.0,1116.0,-330,358,-688
503,12,20,1,5,0,759,661,681,684,855,798,870,1144,754,284,498,430,464.0,404.0,-68,214,-282
716,13,20,1,5,0,788,622,676,985,861,883,944,1218,652,442,599,687,643.0,576.0,88,157,-69
644,14,20,1,5,0,936,866,965,1056,1067,1021,1121,1578,856,471,700,719,710.0,630.0,19,229,-210
1156,15,20,1,5,0,1961,1826,1921,2037,2367,2323,2703,3371,1749,893,1369,1150,1260.0,1137.0,-219,476,-695
593,16,20,1,5,0,751,798,730,829,920,1033,988,1333,941,363,579,523,551.0,488.0,-56,216,-272
659,17,20,1,5,0,852,770,811,908,1056,973,1081,1561,1003,386,716,610,663.0,571.0,-106,330,-436
534,18,20,1,5,0,799,587,681,684,714,853,905,1102,667,370,551,387,469.0,436.0,-164,181,-345
206,19,20,1,5,0,376,332,444,478,491,437,403,555,253,188,258,212,235.0,219.0,-46,70,-116
264,20,20,1,5,0,403,448,421,422,477,428,496,740,452,184,293,290,292.0,256.0,-3,109,-112
328,21,20,1,5,0,397,335,338,351,433,450,479,533,395,223,292,216,254.0,244.0,-76,69,-145
259,22,20,1,5,0,422,399,362,461,359,320,352,428,213,219,281,217,249.0,239.0,-64,62,-126
368,1,21,2,5,0,438,464,464,563,552,450,685,688,275,231,396,369,382.0,332.0,-27,165,-192
437,2,21,2,5,0,611,509,837,743,640,687,714,1001,409,321,443,427,435.0,397.0,-16,122,-138
525,3,21,2,5,0,665,393,509,544,557,650,671,789,370,239,440,455,448.0,378.0,15,201,-186
497,4,21,2,5,0,1102,1018,1021,1288,1431,1045,1332,1807,402,360,619,496,558.0,492.0,-123,259,-382
1537,5,21,2,5,0,1866,1748,1887,2009,2921,2017,2913,3590,1589,1106,1523,1538,1530.0,1389.0,15,417,-402
1199,6,21,2,5,0,1170,1110,1307,1431,1596,1491,1717,1968,921,593,995,1124,1060.0,904.0,129,402,-273
2108,7,21,2,5,0,2486,1895,2003,2387,2615,2547,2776,3299,1329,945,1856,2083,1970.0,1628.0,227,911,-684
610,8,21,2,5,0,789,589,641,800,787,813,782,1130,401,261,510,549,530.0,440.0,39,249,-210
1044,9,21,2,5,0,1286,1093,1029,1303,1438,1702,2171,2397,475,354,1081,908,994.0,781.0,-173,727,-900
290,10,21,2,5,0,323,295,287,282,358,395,493,595,225,179,348,224,286.0,250.0,-124,169,-293
2434,11,21,2,5,0,3080,2334,2394,3107,2962,3228,3579,4302,1623,1477,2234,2129,2182.0,1947.0,-105,757,-862
590,12,21,2,5,0,657,503,672,641,755,781,885,1016,398,230,537,551,544.0,439.0,14,307,-293
3260,13,21,2,5,0,2921,2392,2559,2979,2860,2877,2989,3954,1565,1311,2239,2725,2482.0,2092.0,486,928,-442
1801,14,21,2,5,0,1817,1841,2115,2398,2493,2358,2638,3291,1489,872,1684,1948,1816.0,1501.0,264,812,-548
1453,15,21,2,5,0,1827,1550,1572,1914,1992,2163,2458,2897,961,793,1491,1417,1454.0,1234.0,-74,698,-772
656,16,21,2,5,0,828,848,789,996,1142,948,1247,1304,805,357,634,667,650.0,553.0,33,277,-244
561,17,21,2,5,0,689,696,720,817,950,757,948,1222,427,264,565,544,554.0,458.0,-21,301,-322
620,18,21,2,5,0,777,495,680,640,694,837,946,924,385,327,518,415,466.0,420.0,-103,191,-294
847,19,21,2,5,0,1093,717,904,1088,1057,1007,1160,1513,414,423,828,916,872.0,722.0,88,405,-317
336,20,21,2,5,0,246,378,375,374,365,407,493,612,296,209,288,300,294.0,266.0,12,79,-67
587,21,21,2,5,0,926,472,701,761,801,945,946,1143,404,239,410,468,439.0,372.0,58,171,-113
772,22,21,2,5,0,825,774,757,1154,914,753,1190,1198,462,436,1058,713,886.0,736.0,-345,622,-967
624,1,22,4,5,0,603,553,600,670,690,633,790,925,325,455,653,555,604.0,554.0,-98,198,-296
316,2,22,4,5,0,387,317,493,447,408,431,527,546,194,218,317,270,294.0,268.0,-47,99,-146
335,3,22,4,5,0,350,301,313,341,355,371,359,418,168,163,287,292,290.0,247.0,5,124,-119
714,4,22,4,5,0,916,826,879,911,1074,915,1162,1615,471,523,831,698,764.0,684.0,-133,308,-441
640,5,22,4,5,0,738,715,745,722,1155,772,961,1167,445,516,738,665,702.0,640.0,-73,222,-295
606,6,22,4,5,0,692,656,677,767,841,878,933,1003,374,418,658,653,656.0,576.0,-5,240,-245
1899,7,22,4,5,0,1978,1685,1638,1852,2308,2307,2370,2766,875,984,1739,1860,1800.0,1528.0,121,755,-634
229,8,22,4,5,0,352,275,285,300,313,320,355,484,139,184,247,243,245.0,225.0,-4,63,-67
772,9,22,4,5,0,979,912,937,951,992,1092,1209,1464,402,402,896,629,762.0,642.0,-267,494,-761
222,10,22,4,5,0,265,233,260,262,246,259,290,384,118,109,224,157,190.0,163.0,-67,115,-182
2227,11,22,4,5,0,2522,2016,2112,2209,2679,2595,2801,3241,1057,1612,2234,1953,2094.0,1933.0,-281,622,-903
351,12,22,4,5,0,405,347,434,393,442,498,481,511,213,176,385,307,346.0,289.0,-78,209,-287
1813,13,22,4,5,0,1469,1298,1298,1461,1525,1603,1929,2115,754,885,1533,1690,1612.0,1369.0,157,648,-491
1058,14,22,4,5,0,1026,959,1096,1283,1383,1309,1461,1740,591,724,1200,1228,1214.0,1051.0,28,476,-448
1729,15,22,4,5,0,1956,1671,1999,1697,1991,2033,2127,2662,818,1237,1764,1676,1720.0,1559.0,-88,527,-615
444,16,22,4,5,0,508,574,499,596,611,603,616,685,305,279,470,356,413.0,368.0,-114,191,-305
424,17,22,4,5,0,494,442,503,514,645,501,559,768,256,278,497,347,422.0,374.0,-150,219,-369
395,18,22,4,5,0,530,373,503,451,397,473,480,608,216,257,389,262,326.0,303.0,-127,132,-259
386,19,22,4,5,0,514,420,483,505,553,489,516,595,169,217,412,408,410.0,346.0,-4,195,-199
129,20,22,4,5,0,135,198,189,145,189,159,216,258,69,99,133,100,116.0,111.0,-33,34,-67
395,21,22,4,5,0,540,321,402,487,425,510,487,657,185,238,361,306,334.0,302.0,-55,123,-178
398,22,22,4,5,0,470,454,420,611,511,443,413,533,157,228,535,404,470.0,389.0,-131,307,-438
38,1,23,1,5,0,63,113,83,134,126,104,114,215,76,41,45,61,53.0,49.0,16,4,12
31,2,23,1,5,0,106,89,141,121,133,139,121,182,95,41,34,36,35.0,37.0,2,-7,9
72,3,23,1,5,0,124,111,114,92,121,108,174,205,99,66,95,76,86.0,79.0,-19,29,-48
41,4,23,1,5,0,132,149,201,202,250,161,243,439,74,40,54,53,54.0,49.0,-1,14,-15
149,5,23,1,5,0,262,301,284,317,459,291,297,513,309,153,136,133,134.0,141.0,-3,-17,14
331,6,23,1,5,0,529,526,633,733,655,600,692,1047,578,273,312,307,310.0,297.0,-5,39,-44
675,7,23,1,5,0,771,855,1000,1063,1138,1097,1099,1844,902,381,538,572,555.0,497.0,34,157,-123
236,8,23,1,5,0,195,143,212,261,250,277,308,545,238,158,237,226,232.0,207.0,-11,79,-90
101,9,23,1,5,0,145,223,291,295,282,277,289,373,126,71,118,103,110.0,97.0,-15,47,-62
53,10,23,1,5,0,71,100,108,107,108,100,115,162,93,53,69,35,52.0,52.0,-34,16,-50
183,11,23,1,5,0,411,403,402,461,370,406,397,621,300,168,197,206,202.0,190.0,9,29,-20
60,12,23,1,5,0,91,121,141,112,150,164,143,266,151,36,61,68,64.0,55.0,7,25,-18
518,13,23,1,5,0,537,455,575,645,742,699,808,1460,748,389,430,459,444.0,426.0,29,41,-12
290,14,23,1,5,0,364,453,477,544,566,471,617,1100,524,174,251,240,246.0,222.0,-11,77,-88
67,15,23,1,5,0,145,161,194,181,198,211,191,260,101,55,63,66,64.0,61.0,3,8,-5
96,16,23,1,5,0,180,285,274,266,326,324,313,534,275,79,103,125,114.0,102.0,22,24,-2
142,17,23,1,5,0,180,205,282,273,347,286,335,535,308,119,163,126,144.0,136.0,-37,44,-81
35,18,23,1,5,0,58,88,101,114,102,89,87,129,60,25,51,31,41.0,36.0,-20,26,-46
130,19,23,1,5,0,262,234,252,331,280,278,265,371,149,91,133,121,127.0,115.0,-12,42,-54
80,20,23,1,5,0,138,222,247,251,250,189,199,335,168,84,69,66,68.0,73.0,-3,-15,12
106,21,23,1,5,0,151,113,180,161,167,197,186,360,209,62,83,76,80.0,74.0,-7,21,-28
143,22,23,1,5,0,177,206,165,264,248,169,223,312,126,95,154,101,128.0,117.0,-53,59,-112
672,1,24,2,5,0,485,527,653,687,651,489,558,362,679,494,731,600,666.0,608.0,-131,237,-368
188,2,24,2,5,0,202,185,247,209,201,174,160,155,229,130,223,186,204.0,180.0,-37,93,-130
113,3,24,2,5,0,95,106,108,130,97,99,82,59,106,63,136,99,118.0,99.0,-37,73,-110
694,4,24,2,5,0,566,646,748,847,831,642,654,521,798,532,838,575,706.0,648.0,-263,306,-569
606,5,24,2,5,0,431,486,460,559,615,471,430,474,703,394,653,524,588.0,524.0,-129,259,-388
341,6,24,2,5,0,223,244,244,344,348,248,228,187,338,203,372,311,342.0,295.0,-61,169,-230
608,7,24,2,5,0,437,443,584,549,525,474,421,353,610,362,607,527,567.0,499.0,-80,245,-325
138,8,24,2,5,0,114,101,121,154,121,105,117,105,129,94,160,139,150.0,131.0,-21,66,-87
1267,9,24,2,5,0,1008,1160,1083,1238,1180,1049,976,1007,1207,847,1361,1093,1227.0,1100.0,-268,514,-782
154,10,24,2,5,0,114,129,142,161,151,126,138,119,159,102,172,121,146.0,132.0,-51,70,-121
1554,11,24,2,5,0,1323,1469,1509,1821,1585,1270,1186,1077,1735,1066,1713,1523,1618.0,1434.0,-190,647,-837
232,12,24,2,5,0,177,165,198,224,232,164,154,152,242,146,291,216,254.0,218.0,-75,145,-220
362,13,24,2,5,0,312,337,350,330,362,307,254,182,340,242,360,379,370.0,327.0,19,118,-99
319,14,24,2,5,0,277,291,353,389,339,239,284,223,320,199,311,289,300.0,266.0,-22,112,-134
1507,15,24,2,5,0,1121,1210,1486,1568,1439,1239,1136,1024,1529,973,1602,1326,1464.0,1300.0,-276,629,-905
339,16,24,2,5,0,265,300,346,383,407,272,273,274,370,238,369,296,332.0,301.0,-73,131,-204
278,17,24,2,5,0,207,229,257,270,285,213,205,215,305,186,346,275,310.0,269.0,-71,160,-231
498,18,24,2,5,0,375,354,394,437,448,353,321,324,518,242,572,350,461.0,388.0,-222,330,-552
242,19,24,2,5,0,226,254,291,346,299,229,207,174,292,205,321,225,273.0,250.0,-96,116,-212
244,20,24,2,5,0,204,232,259,222,255,197,217,217,267,199,277,240,258.0,239.0,-37,78,-115
248,21,24,2,5,0,288,241,238,319,283,263,205,197,285,151,281,203,242.0,212.0,-78,130,-208
82,22,24,2,5,0,87,80,75,119,71,81,63,53,93,68,133,85,109.0,95.0,-48,65,-113
287,1,25,1,5,0,308,272,297,303,281,281,247,225,315,160,297,263,280.0,240.0,-34,137,-171
153,2,25,1,5,0,175,143,190,187,165,167,133,176,164,108,164,133,148.0,135.0,-31,56,-87
102,3,25,1,5,0,115,109,112,117,120,96,85,86,86,62,103,111,107.0,92.0,8,41,-33
290,4,25,1,5,0,385,362,331,427,429,308,324,417,323,190,356,270,313.0,272.0,-86,166,-252
351,5,25,1,5,0,382,380,359,376,389,305,301,337,483,166,411,313,362.0,297.0,-98,245,-343
210,6,25,1,5,0,175,187,156,227,205,162,169,174,188,119,173,183,178.0,158.0,10,54,-44
331,7,25,1,5,0,307,309,263,302,292,265,227,253,339,160,306,297,302.0,254.0,-9,146,-155
97,8,25,1,5,0,95,91,82,103,99,83,81,91,111,56,97,101,99.0,85.0,4,41,-37
540,9,25,1,5,0,543,522,480,565,575,462,510,512,581,314,531,409,470.0,418.0,-122,217,-339
104,10,25,1,5,0,113,124,96,117,108,102,103,109,128,57,103,59,81.0,73.0,-44,46,-90
793,11,25,1,5,0,752,698,733,823,757,642,661,734,807,456,741,678,710.0,625.0,-63,285,-348
152,12,25,1,5,0,157,139,120,153,155,115,129,138,165,79,158,126,142.0,121.0,-32,79,-111
251,13,25,1,5,0,230,197,195,219,226,184,180,178,203,126,201,195,198.0,174.0,-6,75,-81
194,14,25,1,5,0,180,189,189,186,187,161,189,173,186,103,191,191,191.0,162.0,0,88,-88
720,15,25,1,5,0,660,565,645,709,620,587,599,595,656,382,738,625,682.0,582.0,-113,356,-469
255,16,25,1,5,0,266,292,242,319,331,219,258,266,270,142,257,214,236.0,204.0,-43,115,-158
191,17,25,1,5,0,200,169,164,219,179,160,168,191,210,114,205,161,183.0,160.0,-44,91,-135
283,18,25,1,5,0,230,256,240,260,259,202,201,205,241,127,267,183,225.0,192.0,-84,140,-224
138,19,25,1,5,0,150,154,152,161,165,130,138,128,140,90,113,125,119.0,109.0,12,23,-11
136,20,25,1,5,0,144,142,148,158,109,123,106,134,131,54,117,102,110.0,91.0,-15,63,-78
156,21,25,1,5,0,199,168,161,205,192,172,135,145,159,85,142,119,130.0,115.0,-23,57,-80
79,22,25,1,5,0,91,70,67,99,74,50,53,61,68,34,78,65,72.0,59.0,-13,44,-57
626,1,26,1,5,0,455,551,438,559,478,428,493,474,835,424,592,562,577.0,526.0,-30,168,-198
203,2,26,1,5,0,203,222,190,240,237,204,210,215,310,178,234,223,228.0,212.0,-11,56,-67
125,3,26,1,5,0,91,81,74,115,91,72,82,74,139,87,116,104,110.0,102.0,-12,29,-41
792,4,26,1,5,0,573,717,674,824,853,604,747,817,1033,648,841,763,802.0,751.0,-78,193,-271
456,5,26,1,5,0,442,494,344,458,388,382,361,382,695,383,524,456,490.0,454.0,-68,141,-209
222,6,26,1,5,0,167,188,148,226,228,183,176,177,354,152,225,259,242.0,212.0,34,73,-39
475,7,26,1,5,0,291,346,365,453,344,338,348,336,608,328,530,488,509.0,449.0,-42,202,-244
97,8,26,1,5,0,88,102,105,108,108,84,93,100,165,96,130,118,124.0,115.0,-12,34,-46
1020,9,26,1,5,0,678,769,689,886,875,627,766,825,1178,690,1101,964,1032.0,918.0,-137,411,-548
138,10,26,1,5,0,97,100,90,105,124,72,100,114,160,106,163,133,148.0,134.0,-30,57,-87
1072,11,26,1,5,0,890,962,857,1124,918,791,915,1007,1591,766,1115,1026,1070.0,969.0,-89,349,-438
182,12,26,1,5,0,112,125,115,140,155,101,129,108,227,115,167,214,190.0,165.0,47,52,-5
290,13,26,1,5,0,199,229,221,266,200,202,203,219,376,209,316,289,302.0,271.0,-27,107,-134
275,14,26,1,5,0,185,207,254,276,252,194,283,262,357,201,287,304,296.0,264.0,17,86,-69
965,15,26,1,5,0,723,810,824,880,834,733,849,908,1436,623,970,967,968.0,853.0,-3,347,-350
282,16,26,1,5,0,243,260,260,327,326,230,315,356,436,202,366,316,341.0,295.0,-50,164,-214
226,17,26,1,5,0,164,200,157,190,184,143,174,192,302,179,246,255,250.0,227.0,9,67,-58
357,18,26,1,5,0,225,265,234,296,266,197,227,256,500,212,338,297,318.0,282.0,-41,126,-167
241,19,26,1,5,0,190,254,215,281,225,176,194,227,304,176,286,261,274.0,241.0,-25,110,-135
174,20,26,1,5,0,168,164,192,184,176,151,174,194,265,152,205,197,201.0,185.0,-8,53,-61
251,21,26,1,5,0,174,206,235,213,228,210,194,216,307,140,222,205,214.0,189.0,-17,82,-99
121,22,26,1,5,0,72,97,59,106,77,74,83,85,102,84,125,116,120.0,108.0,-9,41,-50
154,1,27,4,5,0,151,149,152,203,190,188,201,262,80,97,160,113,136.0,123.0,-47,63,-110
78,2,27,4,5,0,86,43,35,60,52,76,100,59,26,35,34,50,42.0,40.0,16,-1,17
25,3,27,4,5,0,38,23,35,33,31,42,40,37,22,17,26,37,32.0,27.0,11,9,2
139,4,27,4,5,0,259,192,172,203,232,200,230,226,93,117,153,137,145.0,136.0,-16,36,-52
164,5,27,4,5,0,131,94,121,152,216,166,240,223,57,76,90,137,114.0,101.0,47,14,33
74,6,27,4,5,0,91,85,90,104,106,110,130,121,57,59,72,81,76.0,71.0,9,13,-4
167,7,27,4,5,0,264,203,199,232,258,215,231,199,113,137,218,152,185.0,169.0,-66,81,-147
76,8,27,4,5,0,35,28,32,37,31,31,28,33,16,10,28,22,25.0,20.0,-6,18,-24
244,9,27,4,5,0,253,209,182,223,290,309,396,384,120,115,231,223,227.0,190.0,-8,116,-124
33,10,27,4,5,0,31,23,25,29,35,34,41,40,20,18,18,25,22.0,20.0,7,0,7
390,11,27,4,5,0,438,345,389,471,447,420,635,591,225,325,414,342,378.0,360.0,-72,89,-161
39,12,27,4,5,0,50,31,41,43,50,52,66,85,10,18,37,40,38.0,32.0,3,19,-16
102,13,27,4,5,0,161,119,127,130,145,141,166,161,78,99,131,131,131.0,120.0,0,32,-32
75,14,27,4,5,0,118,88,93,86,118,117,128,163,57,77,90,88,89.0,85.0,-2,13,-15
300,15,27,4,5,0,415,297,361,382,415,422,523,567,168,290,344,386,365.0,340.0,42,54,-12
66,16,27,4,5,0,86,72,79,106,110,92,120,142,48,54,76,88,82.0,73.0,12,22,-10
75,17,27,4,5,0,62,48,45,64,96,79,112,124,41,43,61,74,68.0,59.0,13,18,-5
59,18,27,4,5,0,83,59,50,84,61,85,108,127,23,28,50,51,50.0,43.0,1,22,-21
65,19,27,4,5,0,77,61,82,88,87,77,106,83,28,38,67,45,56.0,50.0,-22,29,-51
34,20,27,4,5,0,34,28,26,35,47,43,77,67,17,20,19,34,26.0,24.0,15,-1,16
99,21,27,4,5,0,99,52,57,82,79,83,68,82,41,52,48,66,57.0,55.0,18,-4,22
46,22,27,4,5,0,68,50,44,61,42,40,48,45,18,18,48,30,39.0,32.0,-18,30,-48
427,1,28,2,5,0,512,736,581,360,145,129,306,492,378,283,374,311,342.0,323.0,-63,91,-154
178,2,28,2,5,0,243,237,221,153,83,75,142,154,140,101,145,149,147.0,132.0,4,44,-40
169,3,28,2,5,0,164,131,165,105,47,48,67,109,121,79,109,124,116.0,104.0,15,30,-15
580,4,28,2,5,0,789,881,663,502,321,175,311,576,511,299,438,522,480.0,420.0,84,139,-55
497,5,28,2,5,0,600,609,554,488,356,206,340,526,495,291,361,444,402.0,365.0,83,70,13
271,6,28,2,5,0,306,319,309,208,104,111,219,307,304,148,259,319,289.0,242.0,60,111,-51
557,7,28,2,5,0,668,672,573,446,246,241,312,378,406,284,400,479,440.0,388.0,79,116,-37
93,8,28,2,5,0,145,145,138,80,47,46,58,83,94,61,99,97,98.0,86.0,-2,38,-40
701,9,28,2,5,0,927,973,869,740,398,282,593,912,598,355,607,642,624.0,535.0,35,252,-217
113,10,28,2,5,0,104,120,85,95,39,30,50,68,74,33,77,72,74.0,61.0,-5,44,-49
1046,11,28,2,5,0,1369,1500,1116,610,270,351,609,1028,993,652,891,910,900.0,818.0,19,239,-220
175,12,28,2,5,0,188,194,175,130,47,59,107,208,200,69,151,150,150.0,123.0,-1,82,-83
440,13,28,2,5,0,489,506,429,351,172,141,298,340,342,250,323,382,352.0,318.0,59,73,-14
325,14,28,2,5,0,350,442,406,206,143,136,170,239,290,184,293,341,317.0,273.0,48,109,-61
1209,15,28,2,5,0,1596,1826,1257,815,643,498,965,1300,996,708,969,1088,1028.0,922.0,119,261,-142
305,16,28,2,5,0,331,346,286,253,116,101,212,331,334,134,250,279,264.0,221.0,29,116,-87
354,17,28,2,5,0,370,344,325,229,78,92,180,310,284,146,251,271,261.0,223.0,20,105,-85
270,18,28,2,5,0,345,285,288,200,69,95,138,176,229,97,153,164,158.0,138.0,11,56,-45
341,19,28,2,5,0,390,459,433,291,193,157,189,261,256,190,274,317,296.0,260.0,43,84,-41
175,20,28,2,5,0,172,225,158,135,51,35,76,157,115,82,120,97,108.0,100.0,-23,38,-61
247,21,28,2,5,0,312,315,249,241,115,96,127,205,223,136,166,239,202.0,180.0,73,30,43
145,22,28,2,5,0,241,211,111,123,58,56,108,145,104,92,153,138,146.0,128.0,-15,61,-76
335,1,29,1,5,0,320,327,408,528,494,298,341,507,266,214,347,256,302.0,272.0,-91,133,-224
164,2,29,1,5,0,127,108,198,213,197,180,169,225,142,99,142,158,150.0,133.0,16,43,-27
145,3,29,1,5,0,135,136,178,178,174,157,121,169,76,74,105,133,119.0,104.0,28,31,-3
290,4,29,1,5,0,364,332,388,450,529,355,417,450,177,170,259,234,246.0,221.0,-25,89,-114
361,5,29,1,5,0,371,406,440,533,641,403,433,394,242,224,324,333,328.0,294.0,9,100,-91
217,6,29,1,5,0,185,223,244,297,328,172,256,310,160,139,211,231,221.0,194.0,20,72,-52
428,7,29,1,5,0,302,378,352,487,582,453,469,507,305,251,332,402,367.0,328.0,70,81,-11
111,8,29,1,5,0,116,114,132,168,143,117,124,97,55,43,101,86,94.0,77.0,-15,58,-73
641,9,29,1,5,0,591,684,704,813,867,710,821,895,435,271,630,599,614.0,500.0,-31,359,-390
119,10,29,1,5,0,81,120,108,129,137,85,114,124,79,66,108,95,102.0,90.0,-13,42,-55
903,11,29,1,5,0,826,854,952,1272,1166,688,937,1154,552,589,835,807,821.0,744.0,-28,246,-274
176,12,29,1,5,0,144,151,183,202,193,186,189,178,106,91,145,142,144.0,126.0,-3,54,-57
319,13,29,1,5,0,244,275,310,427,423,324,327,378,179,188,251,302,276.0,247.0,51,63,-12
238,14,29,1,5,0,217,257,301,336,420,237,276,308,156,143,260,258,259.0,220.0,-2,117,-119
892,15,29,1,5,0,816,971,1162,1196,1045,917,1072,1169,550,543,759,841,800.0,714.0,82,216,-134
281,16,29,1,5,0,236,352,315,395,429,270,308,378,261,177,285,262,274.0,241.0,-23,108,-131
285,17,29,1,5,0,235,286,268,360,359,193,226,309,145,129,251,238,244.0,206.0,-13,122,-135
270,18,29,1,5,0,214,238,244,281,263,253,214,293,168,110,183,202,192.0,165.0,19,73,-54
164,19,29,1,5,0,184,149,191,241,242,174,177,213,86,85,121,151,136.0,119.0,30,36,-6
101,20,29,1,5,0,83,135,121,146,128,96,89,130,65,59,92,68,80.0,73.0,-24,33,-57
180,21,29,1,5,0,143,148,200,229,215,165,164,174,112,81,131,150,140.0,121.0,19,50,-31
95,22,29,1,5,0,96,121,92,130,140,82,95,85,44,40,74,82,78.0,65.0,8,34,-26
445,1,30,1,5,0,462,576,421,521,504,402,593,748,538,251,456,315,386.0,341.0,-141,205,-346
263,2,30,1,5,0,259,204,306,266,231,316,323,344,263,166,191,198,194.0,185.0,7,25,-18
213,3,30,1,5,0,203,169,162,217,201,207,206,200,197,109,152,165,158.0,142.0,13,43,-30
781,4,30,1,5,0,986,1008,845,898,731,715,939,1050,755,424,693,651,672.0,589.0,-42,269,-311
502,5,30,1,5,0,753,748,554,658,1072,583,560,641,624,348,443,468,456.0,420.0,25,95,-70
264,6,30,1,5,0,316,300,257,346,329,282,331,409,330,200,229,256,242.0,228.0,27,29,-2
534,7,30,1,5,0,578,623,481,543,678,438,630,646,659,309,458,540,499.0,436.0,82,149,-67
136,8,30,1,5,0,142,127,114,155,143,139,142,103,120,44,90,120,105.0,85.0,30,46,-16
1099,9,30,1,5,0,1219,1303,1074,1237,1342,1295,1408,1829,1269,499,1006,894,950.0,800.0,-112,507,-619
156,10,30,1,5,0,158,161,124,125,189,162,142,255,213,82,152,117,134.0,117.0,-35,70,-105
1003,11,30,1,5,0,1031,1078,842,1106,1255,1040,1108,1430,1304,649,954,933,944.0,845.0,-21,305,-326
229,12,30,1,5,0,264,228,177,230,275,218,275,247,282,85,186,198,192.0,156.0,12,101,-89
434,13,30,1,5,0,420,442,396,476,471,407,417,527,425,254,337,412,374.0,334.0,75,83,-8
325,14,30,1,5,0,359,472,400,422,469,405,382,502,442,251,354,426,390.0,344.0,72,103,-31
1017,15,30,1,5,0,1051,1251,1000,1181,1241,932,1214,1500,938,567,836,888,862.0,764.0,52,269,-217
377,16,30,1,5,0,395,467,358,427,529,447,473,526,572,259,428,363,396.0,350.0,-65,169,-234
431,17,30,1,5,0,443,451,322,451,476,369,391,505,374,207,342,370,356.0,306.0,28,135,-107
282,18,30,1,5,0,345,272,282,266,282,298,320,358,335,144,206,194,200.0,181.0,-12,62,-74
330,19,30,1,5,0,405,340,365,459,418,357,335,454,281,156,268,293,280.0,239.0,25,112,-87
186,20,30,1,5,0,225,291,189,230,259,188,209,244,199,108,153,121,137.0,127.0,-32,45,-77
299,21,30,1,5,0,346,302,281,312,352,366,242,346,325,174,210,225,218.0,203.0,15,36,-21
133,22,30,1,5,0,264,224,175,240,219,123,190,198,139,94,144,137,140.0,125.0,-7,50,-57
649,1,31,2,5,0,634,547,444,607,438,357,513,576,543,384,696,487,592.0,522.0,-209,312,-521
314,2,31,2,5,0,250,183,177,213,139,117,236,257,243,199,312,234,273.0,248.0,-78,113,-191
64,3,31,2,5,0,87,52,46,43,47,37,60,80,54,43,84,76,80.0,68.0,-8,41,-49
617,4,31,2,5,0,681,595,494,449,410,328,585,816,536,311,688,527,608.0,509.0,-161,377,-538
571,5,31,2,5,0,591,569,444,445,455,290,447,593,591,337,640,478,559.0,485.0,-162,303,-465
391,6,31,2,5,0,376,284,251,265,236,233,275,385,322,230,435,350,392.0,338.0,-85,205,-290
593,7,31,2,5,0,521,386,382,358,297,285,401,440,468,289,622,538,580.0,483.0,-84,333,-417
91,8,31,2,5,0,68,61,45,60,31,30,61,103,57,64,78,79,78.0,74.0,1,14,-13
1394,9,31,2,5,0,1221,1023,972,1033,800,773,983,1319,1274,618,1449,1061,1255.0,1043.0,-388,831,-1219
176,10,31,2,5,0,140,110,112,99,93,94,126,167,115,84,164,123,144.0,124.0,-41,80,-121
1428,11,31,2,5,0,1314,879,894,893,729,862,988,1160,1203,919,1681,1193,1437.0,1264.0,-488,762,-1250
224,12,31,2,5,0,203,160,175,134,144,96,129,200,185,89,224,198,211.0,170.0,-26,135,-161
484,13,31,2,5,0,334,287,249,266,194,192,281,283,417,232,460,496,478.0,396.0,36,228,-192
429,14,31,2,5,0,322,315,276,272,209,174,237,350,258,224,388,425,406.0,346.0,37,164,-127
1876,15,31,2,5,0,1719,1389,1189,1547,1208,929,1465,1724,1540,1004,2273,1596,1934.0,1624.0,-677,1269,-1946
300,16,31,2,5,0,263,266,203,235,199,144,218,283,271,143,325,266,296.0,245.0,-59,182,-241
402,17,31,2,5,0,354,336,258,251,209,203,255,374,375,195,380,321,350.0,299.0,-59,185,-244
419,18,31,2,5,0,319,252,323,276,236,214,251,346,352,161,369,304,336.0,278.0,-65,208,-273
285,19,31,2,5,0,247,205,195,187,133,91,159,186,215,146,225,256,240.0,209.0,31,79,-48
274,20,31,2,5,0,262,227,183,189,132,105,200,253,198,131,290,195,242.0,205.0,-95,159,-254
286,21,31,2,5,0,258,182,135,163,159,132,134,174,188,135,235,193,214.0,188.0,-42,100,-142
97,22,31,2,5,0,88,66,52,57,23,28,58,76,70,44,104,104,104.0,84.0,0,60,-60
192,1,32,3,5,0,249,256,328,379,426,299,501,825,333,136,253,217,235.0,202.0,-36,117,-153
552,2,32,3,5,0,594,552,695,707,913,926,928,1393,1050,634,598,559,578.0,597.0,-39,-36,-3
156,3,32,3,5,0,129,99,134,132,200,230,272,405,185,132,207,141,174.0,160.0,-66,75,-141
128,4,32,3,5,0,376,194,240,313,370,330,446,852,178,127,199,127,163.0,151.0,-72,72,-144
385,5,32,3,5,0,599,569,778,755,971,792,934,1509,1063,565,512,413,462.0,497.0,-99,-53,-46
749,6,32,3,5,0,835,790,1052,1349,1421,1263,1461,2601,1965,1072,936,771,854.0,926.0,-165,-136,-29
1756,7,32,3,5,0,2055,1628,2244,2677,2814,2975,3077,5360,2858,1598,1729,1694,1712.0,1674.0,-35,131,-166
462,8,32,3,5,0,360,353,542,640,778,791,803,1442,701,396,447,437,442.0,427.0,-10,51,-61
2754,9,32,3,5,0,3307,2768,3295,4086,5098,5032,5800,8421,3465,1872,3263,2465,2864.0,2533.0,-798,1391,-2189
1444,10,32,3,5,0,1976,1690,1981,2497,3110,3025,3479,6171,2981,1510,1845,1206,1526.0,1520.0,-639,335,-974
1301,11,32,3,5,0,1352,1272,1577,1829,2045,1978,2153,3757,2028,1542,1465,1325,1395.0,1444.0,-140,-77,-63
341,12,32,3,5,0,417,410,598,635,806,703,736,1319,827,443,434,359,396.0,412.0,-75,-9,-66
1168,13,32,3,5,0,1060,888,1184,1505,1631,1500,1789,2863,1366,1047,1021,1146,1084.0,1071.0,125,-26,151
2523,14,32,3,5,0,2930,3020,3796,4302,4617,4700,5194,9539,6024,2842,2528,2423,2476.0,2598.0,-105,-314,209
733,15,32,3,5,0,852,799,1096,1291,1435,1528,1653,2646,934,580,745,680,712.0,668.0,-65,165,-230
468,16,32,3,5,0,481,488,678,753,891,696,982,1629,1137,521,524,406,465.0,484.0,-118,3,-121
615,17,32,3,5,0,802,747,984,1113,1544,1234,1513,2352,1658,771,808,663,736.0,747.0,-145,37,-182
359,18,32,3,5,0,411,360,626,548,706,724,738,1086,453,316,456,314,385.0,362.0,-142,140,-282
482,19,32,3,5,0,383,376,528,616,644,644,694,1039,408,313,505,468,486.0,429.0,-37,192,-229
136,20,32,3,5,0,261,287,297,277,359,279,304,514,324,210,169,172,170.0,184.0,3,-41,44
488,21,32,3,5,0,460,358,538,648,785,855,1045,1704,937,403,499,452,476.0,451.0,-47,96,-143
469,22,32,3,5,0,475,475,643,791,839,638,832,1045,394,365,562,482,522.0,470.0,-80,197,-277
647,1,33,2,5,0,785,835,1350,1065,2065,1032,1283,1483,389,338,505,521,513.0,455.0,16,167,-151
226,2,33,2,5,0,244,208,404,346,402,396,360,567,208,160,208,214,211.0,194.0,6,48,-42
387,3,33,2,5,0,527,415,569,575,712,648,698,789,413,215,340,311,326.0,289.0,-29,125,-154
102,4,33,2,5,0,374,346,429,397,451,276,389,488,143,102,126,84,105.0,104.0,-42,24,-66
559,5,33,2,5,0,677,695,682,820,1286,786,820,1117,531,374,577,521,549.0,491.0,-56,203,-259
257,6,33,2,5,0,414,357,477,644,726,594,615,705,385,198,241,246,244.0,228.0,5,43,-38
928,7,33,2,5,0,1271,1075,1292,1454,1777,1435,1352,1707,803,424,738,843,790.0,668.0,105,314,-209
231,8,33,2,5,0,376,259,310,346,391,347,352,464,131,87,174,169,172.0,143.0,-5,87,-92
239,9,33,2,5,0,277,296,248,286,326,342,407,475,130,117,221,195,208.0,178.0,-26,104,-130
89,10,33,2,5,0,154,153,106,135,181,167,158,231,93,43,77,54,66.0,58.0,-23,34,-57
1280,11,33,2,5,0,1718,1504,1598,2024,2099,1880,1868,2181,991,782,1094,1007,1050.0,961.0,-87,312,-399
217,12,33,2,5,0,384,268,290,349,532,430,438,495,251,128,183,180,182.0,164.0,-3,55,-58
847,13,33,2,5,0,745,713,769,1026,1153,782,978,1229,546,360,592,598,595.0,517.0,6,232,-226
471,14,33,2,5,0,656,595,849,951,954,750,835,1053,508,259,492,410,451.0,387.0,-82,233,-315
632,15,33,2,5,0,696,655,723,773,920,884,1063,1213,348,291,556,450,503.0,432.0,-106,265,-371
174,16,33,2,5,0,212,303,273,340,406,336,358,440,200,80,136,138,137.0,118.0,2,56,-54
307,17,33,2,5,0,428,388,473,550,688,528,670,749,385,150,254,224,239.0,209.0,-30,104,-134
297,18,33,2,5,0,308,207,297,275,314,302,385,408,188,136,178,176,177.0,163.0,-2,42,-44
109,19,33,2,5,0,162,151,156,254,246,156,195,210,53,54,81,84,82.0,73.0,3,27,-24
117,20,33,2,5,0,182,218,192,205,240,178,181,295,131,85,113,117,115.0,105.0,4,28,-24
649,21,33,2,5,0,950,666,1062,1276,1109,958,1012,1286,412,280,531,610,570.0,474.0,79,251,-172
150,22,33,2,5,0,265,200,199,236,256,202,210,228,66,80,160,104,132.0,115.0,-56,80,-136
214,1,34,2,5,0,229,293,265,342,422,337,524,679,950,175,263,226,244.0,221.0,-37,88,-125
106,2,34,2,5,0,77,88,123,129,142,173,215,293,131,118,135,108,122.0,120.0,-27,17,-44
62,3,34,2,5,0,68,57,63,80,87,94,102,118,60,38,63,48,56.0,50.0,-15,25,-40
117,4,34,2,5,0,144,157,165,158,241,166,231,280,180,87,167,105,136.0,120.0,-62,80,-142
126,5,34,2,5,0,176,134,135,208,419,226,291,404,151,140,210,163,186.0,171.0,-47,70,-117
80,6,34,2,5,0,82,105,84,146,172,127,176,201,116,64,85,74,80.0,74.0,-11,21,-32
237,7,34,2,5,0,249,208,207,253,405,274,383,451,230,146,276,296,286.0,239.0,20,130,-110
43,8,34,2,5,0,54,47,58,68,104,75,85,95,42,23,68,34,51.0,42.0,-34,45,-79
111,9,34,2,5,0,114,119,105,149,140,175,225,268,104,54,144,101,122.0,100.0,-43,90,-133
42,10,34,2,5,0,26,35,28,43,42,39,42,71,30,28,32,17,24.0,26.0,-15,4,-19
361,11,34,2,5,0,305,326,286,477,566,501,644,669,334,279,388,278,333.0,315.0,-110,109,-219
58,12,34,2,5,0,68,55,61,72,97,83,104,86,64,32,40,53,46.0,42.0,13,8,5
190,13,34,2,5,0,124,117,113,185,186,192,206,272,140,97,162,151,156.0,137.0,-11,65,-76
133,14,34,2,5,0,86,115,109,191,156,169,219,319,144,90,156,142,149.0,129.0,-14,66,-80
236,15,34,2,5,0,174,199,216,262,293,289,400,452,190,120,235,179,207.0,178.0,-56,115,-171
44,16,34,2,5,0,55,47,45,58,71,47,81,82,146,33,61,41,51.0,45.0,-20,28,-48
71,17,34,2,5,0,123,93,121,118,158,115,135,228,105,59,115,89,102.0,88.0,-26,56,-82
76,18,34,2,5,0,77,80,72,82,93,107,132,139,77,43,64,62,63.0,56.0,-2,21,-23
48,19,34,2,5,0,48,22,42,64,69,52,62,81,42,40,28,19,24.0,29.0,-9,-12,3
34,20,34,2,5,0,19,68,61,42,66,46,77,87,44,31,56,52,54.0,46.0,-4,25,-29
120,21,34,2,5,0,132,92,109,169,208,170,201,238,124,83,169,151,160.0,134.0,-18,86,-104
40,22,34,2,5,0,45,30,38,60,45,45,56,48,22,17,60,50,55.0,42.0,-10,43,-53
198,1,35,2,5,0,169,138,110,96,130,129,206,317,238,124,175,178,176.0,159.0,3,51,-48
59,2,35,2,5,0,180,62,53,48,150,68,61,94,64,55,50,58,54.0,54.0,8,-5,13
113,3,35,2,5,0,107,104,115,80,59,69,77,114,119,58,88,84,86.0,77.0,-4,30,-34
404,4,35,2,5,0,1478,362,522,549,341,411,466,954,488,303,463,422,442.0,396.0,-41,160,-201
321,5,35,2,5,0,329,313,287,213,226,219,270,560,493,212,308,310,309.0,277.0,2,96,-94
161,6,35,2,5,0,132,112,137,105,226,131,164,192,238,108,126,152,139.0,129.0,26,18,8
743,7,35,2,5,0,622,583,483,376,451,391,462,714,609,352,736,802,769.0,630.0,66,384,-318
162,8,35,2,5,0,173,121,88,87,81,104,152,230,168,75,152,133,142.0,120.0,-19,77,-96
1371,9,35,2,5,0,1151,1204,796,688,783,887,1988,1893,1283,554,1157,1342,1250.0,1018.0,185,603,-418
232,10,35,2,5,0,292,302,238,333,211,167,204,333,316,132,218,179,198.0,176.0,-39,86,-125
790,11,35,2,5,0,757,633,614,701,409,489,602,865,785,520,701,575,638.0,599.0,-126,181,-307
199,12,35,2,5,0,361,199,120,104,272,168,194,280,264,100,195,178,186.0,158.0,-17,95,-112
444,13,35,2,5,0,299,271,278,358,279,275,250,454,387,248,489,372,430.0,370.0,-117,241,-358
224,14,35,2,5,0,201,225,287,201,184,168,191,300,319,141,195,250,222.0,195.0,55,54,1
623,15,35,2,5,0,676,536,359,406,355,572,795,787,577,391,567,562,564.0,507.0,-5,176,-181
389,16,35,2,5,0,394,422,178,222,287,394,374,566,545,193,390,310,350.0,298.0,-80,197,-277
352,17,35,2,5,0,524,267,270,181,332,203,423,412,412,410,531,262,396.0,401.0,-269,121,-390
692,18,35,2,5,0,502,255,324,353,331,397,363,562,555,242,485,658,572.0,462.0,173,243,-70
232,19,35,2,5,0,310,263,240,234,219,239,228,340,230,163,328,229,278.0,240.0,-99,165,-264
256,20,35,2,5,0,567,467,292,184,281,158,348,846,378,203,261,239,250.0,234.0,-22,58,-80
121,21,35,2,5,0,127,82,202,64,63,62,99,126,138,68,103,103,103.0,91.0,0,35,-35
88,22,35,2,5,0,107,81,71,56,91,46,89,107,57,72,88,195,142.0,118.0,107,16,91
133,1,36,1,5,0,268,259,263,265,263,222,276,374,264,140,173,111,142.0,141.0,-62,33,-95
349,2,36,1,5,0,287,259,444,328,322,420,444,423,403,246,278,240,259.0,255.0,-38,32,-70
397,3,36,1,5,0,598,415,527,467,541,608,505,619,534,251,398,363,380.0,337.0,-35,147,-182
645,4,36,1,5,0,925,776,823,803,1019,845,1016,1441,741,459,672,521,596.0,551.0,-151,213,-364
516,5,36,1,5,0,780,668,723,668,1080,712,743,1078,940,507,616,610,613.0,578.0,-6,109,-115
170,6,36,1,5,0,212,209,143,177,210,217,212,273,247,107,152,149,150.0,136.0,-3,45,-48
631,7,36,1,5,0,816,666,592,643,866,764,681,1011,688,350,548,657,602.0,518.0,109,198,-89
272,8,36,1,5,0,279,232,228,276,283,280,288,348,274,115,219,218,218.0,184.0,-1,104,-105
1547,9,36,1,5,0,1757,1676,1516,1456,1686,2097,2144,2562,1849,777,1549,1067,1308.0,1131.0,-482,772,-1254
226,10,36,1,5,0,368,312,289,221,333,376,342,443,364,194,278,172,225.0,215.0,-106,84,-190
545,11,36,1,5,0,720,594,521,656,670,713,682,857,658,425,546,407,476.0,459.0,-139,121,-260
242,12,36,1,5,0,272,228,226,207,304,324,277,382,334,121,180,176,178.0,159.0,-4,59,-63
849,13,36,1,5,0,789,655,636,756,829,875,790,1042,804,407,572,721,646.0,567.0,149,165,-16
450,14,36,1,5,0,418,478,457,520,525,514,567,656,654,303,427,422,424.0,384.0,-5,124,-129
503,15,36,1,5,0,672,696,609,628,658,707,687,970,632,338,464,407,436.0,403.0,-57,126,-183
929,16,36,1,5,0,969,1189,812,879,1194,1234,1296,1458,1429,526,890,740,815.0,719.0,-150,364,-514
475,17,36,1,5,0,529,432,433,504,586,532,579,879,712,262,444,376,410.0,361.0,-68,182,-250
399,18,36,1,5,0,437,254,309,324,331,423,388,523,387,223,336,237,286.0,265.0,-99,113,-212
611,19,36,1,5,0,952,717,778,859,919,871,786,1105,571,424,658,595,626.0,559.0,-63,234,-297
290,20,36,1,5,0,390,863,400,378,452,406,568,732,616,327,364,351,358.0,347.0,-13,37,-50
505,21,36,1,5,0,586,401,428,429,480,618,464,618,561,288,381,522,452.0,397.0,141,93,48
314,22,36,1,5,0,391,379,393,463,364,346,348,497,267,165,333,307,320.0,268.0,-26,168,-194
42,1,37,2,5,0,138,95,119,125,135,111,242,237,68,37,61,48,54.0,49.0,-13,24,-37
72,2,37,2,5,0,123,110,141,143,170,165,182,271,140,100,100,97,98.0,99.0,-3,0,-3
87,3,37,2,5,0,150,140,118,135,135,144,149,195,78,54,74,78,76.0,69.0,4,20,-16
32,4,37,2,5,0,142,156,136,151,163,97,128,205,34,44,59,36,48.0,46.0,-23,15,-38
123,5,37,2,5,0,331,297,273,290,355,284,276,560,275,186,178,154,166.0,173.0,-24,-8,-16
103,6,37,2,5,0,155,164,187,210,258,234,289,496,209,109,109,97,103.0,105.0,-12,0,-12
193,7,37,2,5,0,429,398,297,370,455,430,397,599,241,156,188,181,184.0,175.0,-7,32,-39
76,8,37,2,5,0,191,136,138,154,165,187,192,226,67,52,65,70,68.0,62.0,5,13,-8
504,9,37,2,5,0,902,957,908,969,966,1096,1273,1753,510,290,467,429,448.0,395.0,-38,177,-215
89,10,37,2,5,0,150,145,121,133,163,183,209,314,161,76,113,66,90.0,85.0,-47,37,-84
395,11,37,2,5,0,626,524,494,659,663,720,808,1176,484,399,360,358,359.0,372.0,-2,-39,37
123,12,37,2,5,0,200,179,156,182,243,282,281,556,258,99,139,120,130.0,119.0,-19,40,-59
184,13,37,2,5,0,334,278,240,275,311,284,290,435,164,126,133,165,149.0,141.0,32,7,25
188,14,37,2,5,0,293,353,273,313,316,283,364,562,252,130,136,161,148.0,142.0,25,6,19
293,15,37,2,5,0,604,578,536,581,660,738,799,1102,332,255,331,293,312.0,293.0,-38,76,-114
79,16,37,2,5,0,226,274,204,230,271,257,362,526,267,110,92,100,96.0,101.0,8,-18,26
119,17,37,2,5,0,225,184,208,271,292,260,313,627,286,115,133,96,114.0,115.0,-37,18,-55
141,18,37,2,5,0,272,218,246,274,282,315,340,500,185,128,160,130,145.0,139.0,-30,32,-62
127,19,37,2,5,0,339,300,311,310,311,260,209,299,101,86,133,111,122.0,110.0,-22,47,-69
80,20,37,2,5,0,174,215,160,199,165,151,159,317,179,87,70,59,64.0,72.0,-11,-17,6
62,21,37,2,5,0,119,143,116,126,114,163,141,242,89,58,62,55,58.0,58.0,-7,4,-11
61,22,37,2,5,0,154,146,135,155,139,103,121,126,60,44,65,66,66.0,58.0,1,21,-20
311,1,38,2,5,0,401,401,321,346,427,336,1289,571,175,135,300,320,310.0,252.0,20,165,-145
174,2,38,2,5,0,202,186,247,218,226,257,285,393,160,154,201,154,178.0,170.0,-47,47,-94
352,3,38,2,5,0,235,185,198,218,291,326,339,631,236,164,278,287,282.0,243.0,9,114,-105
299,4,38,2,5,0,619,663,697,743,797,664,656,980,232,253,315,319,317.0,296.0,4,62,-58
703,5,38,2,5,0,577,808,786,904,1230,923,1016,1536,609,478,708,677,692.0,621.0,-31,230,-261
450,6,38,2,5,0,258,304,319,476,565,666,550,750,358,257,522,447,484.0,409.0,-75,265,-340
1985,7,38,2,5,0,2095,1935,1835,2200,2915,3148,3502,5481,1788,1203,1635,2012,1824.0,1617.0,377,432,-55
775,8,38,2,5,0,544,496,521,585,792,899,919,1474,502,371,567,626,596.0,521.0,59,196,-137
7957,9,38,2,5,0,8617,8587,8085,9999,11167,12710,12394,15317,5306,3718,8079,6812,7446.0,6203.0,-1267,4361,-5628
1463,10,38,2,5,0,933,1046,1010,1186,1639,1709,1789,2693,1195,777,1366,1087,1226.0,1077.0,-279,589,-868
2259,11,38,2,5,0,1356,1362,1273,1726,2274,2226,2622,3296,1247,1529,2148,2087,2118.0,1921.0,-61,619,-680
979,12,38,2,5,0,537,595,606,715,1083,1277,1265,1764,857,484,797,835,816.0,705.0,38,313,-275
1832,13,38,2,5,0,1174,1117,1091,1516,1988,2221,2449,3796,1214,995,1259,1697,1478.0,1317.0,438,264,174
1391,14,38,2,5,0,851,918,1151,1553,1783,1739,1951,3130,1278,848,1290,1492,1391.0,1210.0,202,442,-240
1509,15,38,2,5,0,1084,1050,1140,1443,1709,2001,2019,2088,700,801,1246,1369,1308.0,1139.0,123,445,-322
842,16,38,2,5,0,585,851,689,870,1071,1120,1425,1562,736,376,772,827,800.0,658.0,55,396,-341
1503,17,38,2,5,0,1343,1265,1384,1668,1721,1444,1769,3168,1244,677,1105,1093,1099.0,958.0,-12,428,-440
1316,18,38,2,5,0,1047,978,991,1227,1477,1846,1591,1981,769,598,1058,945,1002.0,867.0,-113,460,-573
1606,19,38,2,5,0,2738,2351,2715,3298,3035,2443,2622,3705,1059,1132,1642,1541,1592.0,1438.0,-101,510,-611
400,20,38,2,5,0,307,592,510,660,624,494,548,828,333,235,331,330,330.0,299.0,-1,96,-97
326,21,38,2,5,0,335,408,480,451,462,457,402,722,289,175,287,284,286.0,249.0,-3,112,-115
589,22,38,2,5,0,472,426,421,630,651,605,913,1064,350,347,604,509,556.0,487.0,-95,257,-352
175,1,39,1,5,0,231,232,275,253,330,234,241,272,250,161,224,213,218.0,199.0,-11,63,-74
329,2,39,1,5,0,273,237,317,281,288,285,282,383,494,162,297,298,298.0,252.0,1,135,-134
353,3,39,1,5,0,409,278,346,325,397,353,331,374,412,213,364,399,382.0,325.0,35,151,-116
230,4,39,1,5,0,423,454,541,459,651,432,527,798,336,255,324,347,336.0,309.0,23,69,-46
296,5,39,1,5,0,345,365,374,356,560,353,364,502,560,198,280,354,317.0,277.0,74,82,-8
359,6,39,1,5,0,364,321,347,370,464,369,339,449,378,228,339,365,352.0,311.0,26,111,-85
1085,7,39,1,5,0,1092,1036,1063,896,1347,1014,1020,1083,1132,648,948,1214,1081.0,937.0,266,300,-34
345,8,39,1,5,0,404,319,311,334,462,394,347,454,373,276,370,403,386.0,350.0,33,94,-61
2524,9,39,1,5,0,2432,2474,2478,2391,3040,2810,2842,3119,2859,1337,2735,2621,2678.0,2231.0,-114,1398,-1512
297,10,39,1,5,0,279,260,273,237,346,287,279,316,376,154,306,255,280.0,238.0,-51,152,-203
820,11,39,1,5,0,944,898,914,919,1153,908,905,1057,1012,579,905,787,846.0,757.0,-118,326,-444
342,12,39,1,5,0,387,321,370,350,407,325,334,414,397,195,355,439,397.0,330.0,84,160,-76
971,13,39,1,5,0,721,619,623,691,837,696,646,778,797,602,842,1066,954.0,837.0,224,240,-16
919,14,39,1,5,0,870,860,976,801,1165,786,979,1154,954,596,986,1159,1072.0,914.0,173,390,-217
669,15,39,1,5,0,679,619,746,631,767,611,709,819,752,388,650,682,666.0,573.0,32,262,-230
1057,16,39,1,5,0,1131,1321,1289,1127,1463,1111,1292,1497,1405,549,1164,1131,1148.0,948.0,-33,615,-648
570,17,39,1,5,0,762,693,656,726,776,563,649,953,623,341,556,689,622.0,529.0,133,215,-82
612,18,39,1,5,0,627,554,655,558,641,586,610,611,627,347,556,479,518.0,461.0,-77,209,-286
631,19,39,1,5,0,714,579,727,667,816,696,727,851,758,485,709,730,720.0,641.0,21,224,-203
128,20,39,1,5,0,139,215,222,181,222,152,145,208,248,87,111,125,118.0,108.0,14,24,-10
360,21,39,1,5,0,418,335,362,360,429,415,400,482,463,229,331,386,358.0,315.0,55,102,-47
461,22,39,1,5,0,673,545,503,567,621,450,630,549,617,346,607,485,546.0,479.0,-122,261,-383
211,1,40,1,5,0,271,242,256,281,287,238,345,456,114,153,205,172,188.0,177.0,-33,52,-85
383,2,40,1,5,0,288,270,381,345,327,285,338,442,406,203,364,347,356.0,305.0,-17,161,-178
379,3,40,1,5,0,287,238,235,267,246,282,331,382,195,193,311,298,304.0,267.0,-13,118,-131
156,4,40,1,5,0,275,251,253,208,303,262,356,580,121,115,186,128,157.0,143.0,-58,71,-129
467,5,40,1,5,0,461,461,453,451,636,487,569,804,459,234,390,378,384.0,334.0,-12,156,-168
485,6,40,1,5,0,346,364,377,400,439,428,489,503,403,244,376,434,405.0,351.0,58,132,-74
906,7,40,1,5,0,877,768,778,692,815,855,912,1164,554,505,703,953,828.0,720.0,250,198,52
310,8,40,1,5,0,316,230,226,277,310,284,316,428,223,193,301,299,300.0,264.0,-2,108,-110
2880,9,40,1,5,0,2367,2317,2288,2219,2478,2450,3345,3730,1930,1262,2615,2284,2450.0,2054.0,-331,1353,-1684
370,10,40,1,5,0,316,262,277,270,290,313,377,417,266,187,309,304,306.0,267.0,-5,122,-127
1243,11,40,1,5,0,1171,1053,1035,1139,1193,1114,1454,1527,877,754,1069,1130,1100.0,984.0,61,315,-254
500,12,40,1,5,0,344,324,354,314,340,317,350,507,305,161,323,377,350.0,287.0,54,162,-108
877,13,40,1,5,0,575,563,517,521,590,551,574,797,453,434,572,723,648.0,576.0,151,138,13
764,14,40,1,5,0,609,620,657,647,687,548,872,1036,630,391,702,797,750.0,630.0,95,311,-216
1092,15,40,1,5,0,952,851,928,863,800,942,1151,1258,739,529,861,969,915.0,786.0,108,332,-224
822,16,40,1,5,0,857,1022,954,876,1065,918,1189,1511,963,454,719,775,747.0,649.0,56,265,-209
470,17,40,1,5,0,440,412,436,456,456,452,506,737,420,189,443,430,436.0,354.0,-13,254,-267
659,18,40,1,5,0,634,509,574,525,556,643,734,779,473,353,640,561,600.0,518.0,-79,287,-366
512,19,40,1,5,0,415,359,423,434,437,390,480,602,285,241,431,475,453.0,382.0,44,190,-146
153,20,40,1,5,0,153,256,232,218,203,186,200,305,185,95,179,155,167.0,143.0,-24,84,-108
346,21,40,1,5,0,291,238,303,301,293,309,345,496,293,157,234,292,263.0,228.0,58,77,-19
385,22,40,1,5,0,422,361,360,329,347,306,404,422,214,206,322,309,316.0,279.0,-13,116,-129
130,1,41,3,5,0,249,227,228,228,248,166,277,348,224,140,212,313,262.0,222.0,101,72,29
20,2,41,3,5,0,19,13,29,23,22,12,22,33,19,19,18,22,20.0,20.0,4,-1,5
17,3,41,3,5,0,32,22,34,26,20,16,19,22,21,19,29,36,32.0,28.0,7,10,-3
244,4,41,3,5,0,371,412,397,450,433,353,372,511,424,244,378,320,349.0,314.0,-58,134,-192
29,5,41,3,5,0,41,50,45,33,53,34,42,64,69,42,47,33,40.0,41.0,-14,5,-19
45,6,41,3,5,0,77,54,58,60,65,52,74,75,83,59,59,57,58.0,58.0,-2,0,-2
192,7,41,3,5,0,321,323,323,300,349,309,286,341,430,189,295,303,299.0,262.0,8,106,-98
62,8,41,3,5,0,85,61,83,86,76,58,62,78,105,64,83,78,80.0,75.0,-5,19,-24
579,9,41,3,5,0,929,824,845,827,959,887,972,1235,1009,443,848,749,798.0,680.0,-99,405,-504
20,10,41,3,5,0,33,22,15,35,23,23,13,26,34,17,20,12,16.0,16.0,-8,3,-11
241,11,41,3,5,0,372,366,390,384,352,323,380,481,397,258,351,301,326.0,303.0,-50,93,-143
25,12,41,3,5,0,28,35,34,41,44,29,35,37,61,16,26,40,33.0,27.0,14,10,4
218,13,41,3,5,0,221,251,231,259,229,234,231,316,308,172,236,271,254.0,226.0,35,64,-29
105,14,41,3,5,0,189,186,204,209,192,150,188,209,242,134,155,146,150.0,145.0,-9,21,-30
311,15,41,3,5,0,279,263,302,300,252,293,323,375,353,222,270,371,320.0,288.0,101,48,53
39,16,41,3,5,0,48,56,41,58,58,26,64,62,54,47,52,51,52.0,50.0,-1,5,-6
26,17,41,3,5,0,33,37,54,26,47,25,31,44,54,26,27,28,28.0,27.0,1,1,0
37,18,41,3,5,0,65,63,56,64,42,57,83,105,92,41,56,43,50.0,47.0,-13,15,-28
115,19,41,3,5,0,173,177,170,176,181,127,153,187,158,103,124,129,126.0,119.0,5,21,-16
19,20,41,3,5,0,16,43,25,22,19,17,12,27,22,12,27,12,20.0,17.0,-15,15,-30
27,21,41,3,5,0,50,39,32,34,19,25,29,46,61,16,38,37,38.0,30.0,-1,22,-23
37,22,41,3,5,0,117,107,90,78,77,62,61,65,66,41,61,62,62.0,55.0,1,20,-19
165,1,42,1,5,0,244,231,222,233,237,260,331,369,161,142,190,140,165.0,157.0,-50,48,-98
292,2,42,1,5,0,293,280,397,351,388,519,521,651,386,202,309,233,271.0,248.0,-76,107,-183
131,3,42,1,5,0,173,112,115,149,181,185,190,234,146,90,139,127,133.0,119.0,-12,49,-61
153,4,42,1,5,0,267,240,223,271,313,223,301,382,210,141,181,149,165.0,157.0,-32,40,-72
344,5,42,1,5,0,401,386,408,384,645,492,617,839,509,240,360,342,351.0,314.0,-18,120,-138
293,6,42,1,5,0,328,323,371,429,508,453,504,690,387,163,254,266,260.0,228.0,12,91,-79
555,7,42,1,5,0,677,569,603,642,825,774,709,964,444,303,464,570,517.0,446.0,106,161,-55
221,8,42,1,5,0,268,247,194,300,278,277,302,443,175,132,238,204,221.0,191.0,-34,106,-140
2996,9,42,1,5,0,3407,3034,2769,3466,3967,4449,4901,5547,3229,1517,2906,3040,2973.0,2488.0,134,1389,-1255
278,10,42,1,5,0,323,305,295,375,362,434,458,665,381,181,321,247,284.0,250.0,-74,140,-214
698,11,42,1,5,0,886,740,767,910,875,888,974,1139,690,508,722,614,668.0,615.0,-108,214,-322
321,12,42,1,5,0,296,306,326,283,440,408,499,625,381,184,276,300,288.0,253.0,24,92,-68
507,13,42,1,5,0,518,437,434,560,591,602,602,830,407,320,433,514,474.0,422.0,81,113,-32
473,14,42,1,5,0,451,445,414,574,666,620,614,920,507,247,499,530,514.0,425.0,31,252,-221
817,15,42,1,5,0,954,959,917,968,1148,998,1169,1424,732,558,806,842,824.0,735.0,36,248,-212
504,16,42,1,5,0,667,730,629,764,987,818,1066,1347,698,270,511,498,504.0,426.0,-13,241,-254
498,17,42,1,5,0,567,522,526,503,752,630,700,988,570,203,418,421,420.0,347.0,3,215,-212
656,18,42,1,5,0,633,509,603,671,676,754,796,1043,605,368,580,595,588.0,514.0,15,212,-197
363,19,42,1,5,0,445,435,473,472,553,433,460,600,253,193,341,357,349.0,297.0,16,148,-132
127,20,42,1,5,0,157,246,168,172,243,227,222,229,139,105,116,140,128.0,120.0,24,11,13
155,21,42,1,5,0,179,148,148,164,191,253,229,293,140,96,140,126,133.0,121.0,-14,44,-58
232,22,42,1,5,0,309,255,234,372,256,198,199,322,111,123,264,218,241.0,202.0,-46,141,-187
312,1,43,2,5,0,212,242,279,368,455,354,457,516,264,193,369,368,368.0,310.0,-1,176,-177
120,2,43,2,5,0,90,69,134,137,168,236,233,253,206,111,144,116,130.0,124.0,-28,33,-61
184,3,43,2,5,0,161,112,170,148,180,212,200,238,219,114,172,145,158.0,144.0,-27,58,-85
375,4,43,2,5,0,541,572,614,704,733,603,754,1094,601,390,482,397,440.0,423.0,-85,92,-177
251,5,43,2,5,0,215,241,286,280,498,363,489,543,391,237,325,296,310.0,286.0,-29,88,-117
254,6,43,2,5,0,222,253,319,361,472,444,568,578,495,153,185,233,209.0,190.0,48,32,16
791,7,43,2,5,0,644,594,653,771,1001,1018,1094,1221,1031,476,846,727,786.0,683.0,-119,370,-489
297,8,43,2,5,0,307,319,310,398,381,370,395,605,316,221,369,335,352.0,308.0,-34,148,-182
2143,9,43,2,5,0,1775,1807,1926,2292,2762,3019,3563,3747,2666,1125,2377,2460,2418.0,1987.0,83,1252,-1169
114,10,43,2,5,0,131,107,105,132,134,146,194,174,193,92,119,101,110.0,104.0,-18,27,-45
895,11,43,2,5,0,791,789,884,1139,1155,1292,1491,1524,1070,552,1008,901,954.0,820.0,-107,456,-563
201,12,43,2,5,0,135,142,163,206,280,258,340,409,346,81,166,179,172.0,142.0,13,85,-72
790,13,43,2,5,0,560,621,573,819,812,975,971,1119,789,422,734,762,748.0,639.0,28,312,-284
450,14,43,2,5,0,356,378,472,519,592,609,805,866,692,326,488,531,510.0,448.0,43,162,-119
1108,15,43,2,5,0,729,797,1116,1100,1259,1371,1516,1515,1138,549,969,1010,990.0,843.0,41,420,-379
381,16,43,2,5,0,306,462,346,475,707,729,779,906,749,253,446,434,440.0,378.0,-12,193,-205
430,17,43,2,5,0,400,350,381,419,626,645,767,839,710,238,437,402,420.0,359.0,-35,199,-234
519,18,43,2,5,0,309,251,400,389,434,571,612,638,509,288,542,508,525.0,446.0,-34,254,-288
971,19,43,2,5,0,921,843,1057,1068,1256,1020,1269,1395,898,506,962,872,917.0,780.0,-90,456,-546
104,20,43,2,5,0,164,243,183,190,183,170,200,213,159,106,164,130,147.0,133.0,-34,58,-92
179,21,43,2,5,0,222,212,278,246,251,273,309,371,227,159,225,195,210.0,193.0,-30,66,-96
448,22,43,2,5,0,459,440,381,659,536,422,639,783,366,217,537,358,448.0,371.0,-179,320,-499
218,1,44,1,5,0,179,143,213,231,263,186,304,291,260,125,252,169,210.0,182.0,-83,127,-210
61,2,44,1,5,0,47,40,86,70,45,62,97,95,78,48,59,48,54.0,52.0,-11,11,-22
69,3,44,1,5,0,59,30,34,48,53,57,54,64,35,18,51,53,52.0,41.0,2,33,-31
391,4,44,1,5,0,580,328,387,431,542,458,551,739,435,233,445,341,393.0,340.0,-104,212,-316
190,5,44,1,5,0,189,198,208,192,406,218,246,296,270,133,178,212,195.0,174.0,34,45,-11
81,6,44,1,5,0,77,68,83,102,108,119,125,125,156,59,89,69,79.0,72.0,-20,30,-50
226,7,44,1,5,0,226,189,211,236,259,209,228,356,218,112,223,197,210.0,177.0,-26,111,-137
43,8,44,1,5,0,34,37,39,38,29,27,53,51,47,21,35,29,32.0,28.0,-6,14,-20
338,9,44,1,5,0,290,315,201,283,319,341,442,572,437,152,310,246,278.0,236.0,-64,158,-222
38,10,44,1,5,0,40,44,25,47,48,35,38,46,44,34,25,32,28.0,30.0,7,-9,16
214,11,44,1,5,0,199,160,179,202,235,218,248,301,251,138,200,177,188.0,172.0,-23,62,-85
76,12,44,1,5,0,67,46,43,63,74,57,75,92,84,32,51,53,52.0,45.0,2,19,-17
144,13,44,1,5,0,94,85,75,106,81,95,123,131,106,79,112,113,112.0,101.0,1,33,-32
108,14,44,1,5,0,146,115,120,133,136,137,144,187,131,57,111,155,133.0,108.0,44,54,-10
108,15,44,1,5,0,120,103,117,123,127,129,149,230,149,78,139,107,123.0,108.0,-32,61,-93
101,16,44,1,5,0,133,83,100,88,128,132,148,184,148,61,111,94,102.0,89.0,-17,50,-67
108,17,44,1,5,0,132,99,113,129,125,121,157,211,135,74,132,109,120.0,105.0,-23,58,-81
97,18,44,1,5,0,110,85,91,79,63,93,111,124,108,57,77,71,74.0,68.0,-6,20,-26
107,19,44,1,5,0,114,94,86,129,93,93,126,129,69,51,75,76,76.0,67.0,1,24,-23
87,20,44,1,5,0,102,141,124,91,113,105,132,160,125,77,112,97,104.0,95.0,-15,35,-50
172,21,44,1,5,0,132,93,101,114,118,176,150,182,148,77,137,111,124.0,108.0,-26,60,-86
50,22,44,1,5,0,58,77,51,83,64,44,71,77,53,34,68,53,60.0,52.0,-15,34,-49
105,1,45,1,5,0,137,100,120,182,195,186,244,388,154,85,126,92,109.0,101.0,-34,41,-75
77,2,45,1,5,0,155,102,132,175,199,190,214,267,194,91,60,53,56.0,68.0,-7,-31,24
68,3,45,1,5,0,123,90,86,129,117,180,167,259,127,62,61,62,62.0,62.0,1,-1,2
21,4,45,1,5,0,135,132,124,189,195,143,181,370,71,41,51,25,38.0,39.0,-26,10,-36
118,5,45,1,5,0,268,235,259,271,451,335,432,691,448,194,129,110,120.0,144.0,-19,-65,46
259,6,45,1,5,0,511,409,457,615,665,719,699,1253,712,250,227,217,222.0,231.0,-10,-23,13
332,7,45,1,5,0,759,542,525,598,799,850,792,1449,549,320,297,347,322.0,321.0,50,-23,73
114,8,45,1,5,0,184,119,112,180,176,226,231,426,153,81,103,83,93.0,89.0,-20,22,-42
344,9,45,1,5,0,656,557,570,682,810,953,1204,1628,496,168,342,246,294.0,252.0,-96,174,-270
39,10,45,1,5,0,99,74,74,93,96,119,135,240,121,56,54,26,40.0,45.0,-28,-2,-26
487,11,45,1,5,0,815,558,664,879,928,1050,1083,1908,768,543,404,402,403.0,450.0,-2,-139,137
191,12,45,1,5,0,290,238,256,256,368,358,434,733,453,153,150,168,159.0,157.0,18,-3,21
350,13,45,1,5,0,541,372,433,513,576,665,667,1158,476,272,257,300,278.0,276.0,43,-15,58
366,14,45,1,5,0,670,565,604,728,823,894,1006,1883,910,372,312,380,346.0,355.0,68,-60,128
361,15,45,1,5,0,772,623,618,806,968,1022,1202,2202,744,430,386,337,362.0,384.0,-49,-44,-5
145,16,45,1,5,0,222,214,224,236,278,353,409,749,443,143,138,130,134.0,137.0,-8,-5,-3
138,17,45,1,5,0,299,206,221,263,352,322,439,744,378,131,137,149,143.0,139.0,12,6,6
137,18,45,1,5,0,224,163,185,197,242,345,391,594,265,149,173,130,152.0,151.0,-43,24,-67
84,19,45,1,5,0,172,127,118,166,151,176,186,256,75,62,80,75,78.0,72.0,-5,18,-23
20,20,45,1,5,0,60,103,92,81,101,86,92,172,124,38,29,23,26.0,30.0,-6,-9,3
97,21,45,1,5,0,180,107,108,126,155,205,212,325,144,79,70,64,67.0,71.0,-6,-9,3
43,22,45,1,5,0,116,90,66,138,116,107,126,152,43,36,52,38,45.0,42.0,-14,16,-30
5,1,46,1,5,0,61,83,70,93,94,69,88,96,65,19,37,175,106.0,77.0,138,18,120
83,2,46,1,5,0,150,145,260,181,192,214,209,182,216,75,82,86,84.0,81.0,4,7,-3
69,3,46,1,5,0,189,132,152,130,174,176,130,141,132,46,66,45,56.0,52.0,-21,20,-41
29,4,46,1,5,0,215,203,267,229,259,158,186,277,124,81,65,48,56.0,65.0,-17,-16,-1
81,5,46,1,5,0,265,277,338,249,374,267,205,292,350,117,93,78,86.0,96.0,-15,-24,9
90,6,46,1,5,0,334,403,369,409,407,332,341,384,513,121,108,92,100.0,107.0,-16,-13,-3
203,7,46,1,5,0,501,534,578,578,669,572,480,596,555,214,153,209,181.0,192.0,56,-61,117
19,8,46,1,5,0,84,72,80,105,82,89,70,67,66,26,12,22,17.0,20.0,10,-14,24
30,9,46,1,5,0,205,161,153,130,99,91,101,84,62,19,63,37,50.0,40.0,-26,44,-70
6,10,46,1,5,0,65,56,59,47,57,42,39,50,45,14,26,20,23.0,20.0,-6,12,-18
191,11,46,1,5,0,511,498,540,652,534,502,474,569,538,214,216,188,202.0,206.0,-28,2,-30
90,12,46,1,5,0,322,296,334,361,423,281,274,309,360,94,101,91,96.0,95.0,-10,7,-17
149,13,46,1,5,0,423,331,415,474,378,372,326,383,353,154,150,162,156.0,155.0,12,-4,16
104,14,46,1,5,0,458,439,537,516,505,471,372,457,538,139,100,129,114.0,123.0,29,-39,68
108,15,46,1,5,0,481,523,527,619,525,437,429,453,388,129,152,151,152.0,144.0,-1,23,-24
158,16,46,1,5,0,274,347,357,348,470,379,317,421,474,120,139,119,129.0,126.0,-20,19,-39
114,17,46,1,5,0,285,332,369,394,455,353,348,428,459,95,148,114,131.0,119.0,-34,53,-87
55,18,46,1,5,0,117,97,156,140,150,148,127,159,136,38,44,37,40.0,40.0,-7,6,-13
105,19,46,1,5,0,224,186,211,236,239,216,174,238,151,59,93,137,115.0,96.0,44,34,10
19,20,46,1,5,0,119,207,154,160,119,108,151,126,110,41,27,16,22.0,28.0,-11,-14,3
94,21,46,1,5,0,295,195,243,241,219,279,210,288,180,80,67,82,74.0,76.0,15,-13,28
34,22,46,1,5,0,155,119,135,185,126,121,118,156,75,46,57,45,51.0,49.0,-12,11,-23
219,1,47,2,5,0,151,184,200,260,330,188,341,384,208,78,136,169,152.0,128.0,33,58,-25
116,2,47,2,5,0,116,115,160,152,177,216,186,206,142,56,68,79,74.0,68.0,11,12,-1
72,3,47,2,5,0,116,92,95,118,103,121,125,115,74,44,45,52,48.0,47.0,7,1,6
160,4,47,2,5,0,502,404,587,598,646,461,553,771,253,139,206,162,184.0,169.0,-44,67,-111
396,5,47,2,5,0,435,525,529,541,770,548,657,933,673,263,243,304,274.0,270.0,61,-20,81
526,6,47,2,5,0,668,812,815,909,849,800,764,993,964,338,340,389,364.0,356.0,49,2,47
623,7,47,2,5,0,912,798,955,1028,1068,979,957,1332,1011,383,430,537,484.0,450.0,107,47,60
136,8,47,2,5,0,182,158,166,260,200,213,203,275,128,67,102,111,106.0,93.0,9,35,-26
734,9,47,2,5,0,912,826,970,1165,1341,1182,1660,1546,767,278,638,579,608.0,498.0,-59,360,-419
125,10,47,2,5,0,154,160,138,192,192,181,188,276,186,86,105,86,96.0,92.0,-19,19,-38
1356,11,47,2,5,0,1690,1549,1784,2086,2054,2015,2022,2642,2094,991,984,1074,1029.0,1016.0,90,-7,97
326,12,47,2,5,0,446,403,446,466,481,368,453,691,614,157,211,274,242.0,214.0,63,54,9
436,13,47,2,5,0,571,550,679,797,728,665,667,773,530,290,330,342,336.0,321.0,12,40,-28
1055,14,47,2,5,0,1156,1405,1588,1680,1676,1390,1577,2409,1865,640,650,891,770.0,727.0,241,10,231
913,15,47,2,5,0,1198,1267,1405,1649,1572,1696,1832,2222,1022,501,663,715,689.0,626.0,52,162,-110
312,16,47,2,5,0,378,470,475,562,525,475,492,661,605,178,211,256,234.0,215.0,45,33,12
352,17,47,2,5,0,383,445,414,541,561,481,547,698,488,170,228,287,258.0,228.0,59,58,1
307,18,47,2,5,0,311,284,350,418,427,469,556,601,361,197,246,246,246.0,230.0,0,49,-49
168,19,47,2,5,0,287,226,287,309,335,246,211,328,161,100,120,120,120.0,113.0,0,20,-20
189,20,47,2,5,0,287,447,415,439,445,330,373,430,326,140,158,145,152.0,148.0,-13,18,-31
210,21,47,2,5,0,336,278,349,407,350,449,347,562,349,119,145,167,156.0,144.0,22,26,-4
62,22,47,2,5,0,109,89,128,149,133,82,97,100,69,37,53,48,50.0,46.0,-5,16,-21
10,1,48,2,5,0,27,22,13,27,10,4,41,46,32,19,54,17,36.0,30.0,-37,35,-72
62,2,48,2,5,0,176,148,181,200,159,126,119,169,142,104,91,53,72.0,83.0,-38,-13,-25
176,3,48,2,5,0,348,233,350,323,327,297,353,430,278,168,258,163,210.0,196.0,-95,90,-185
7,4,48,2,5,0,167,151,170,121,96,46,78,112,52,38,30,13,22.0,27.0,-17,-8,-9
145,5,48,2,5,0,701,834,869,836,723,408,517,641,617,336,250,134,192.0,240.0,-116,-86,-30
72,6,48,2,5,0,330,322,293,261,211,71,198,190,278,146,119,59,89.0,108.0,-60,-27,-33
752,7,48,2,5,0,1697,1542,1763,1885,1782,1445,1562,2281,1763,885,746,509,628.0,713.0,-237,-139,-98
317,8,48,2,5,0,798,670,854,973,842,579,768,886,691,295,401,285,343.0,327.0,-116,106,-222
177,9,48,2,5,0,797,730,793,791,821,619,710,1008,472,229,471,212,342.0,304.0,-259,242,-501
137,10,48,2,5,0,170,190,169,185,191,132,192,308,251,110,119,55,87.0,95.0,-64,9,-73
111,11,48,2,5,0,295,297,299,267,195,95,307,309,370,299,211,106,158.0,205.0,-105,-88,-17
42,12,48,2,5,0,303,258,215,138,145,60,177,182,224,84,107,42,74.0,78.0,-65,23,-88
782,13,48,2,5,0,1845,1547,1898,2125,1949,1092,1644,1840,1468,940,941,733,837.0,871.0,-208,1,-209
283,14,48,2,5,0,772,817,797,693,546,306,774,911,1101,433,362,211,286.0,335.0,-151,-71,-80
241,15,48,2,5,0,232,213,216,202,149,42,380,352,327,197,195,168,182.0,187.0,-27,-2,-25
39,16,48,2,5,0,138,172,121,123,100,46,116,125,211,58,65,32,48.0,52.0,-33,7,-40
50,17,48,2,5,0,204,207,195,142,140,74,141,165,230,105,87,42,64.0,78.0,-45,-18,-27
70,18,48,2,5,0,254,259,254,219,159,110,281,215,204,105,130,66,98.0,100.0,-64,25,-89
215,19,48,2,5,0,622,615,791,715,654,384,528,619,375,317,409,425,417.0,384.0,16,92,-76
34,20,48,2,5,0,142,167,210,170,119,62,80,104,116,61,54,25,40.0,47.0,-29,-7,-22
123,21,48,2,5,0,415,360,504,331,168,145,214,250,261,108,136,75,106.0,106.0,-61,28,-89
117,22,48,2,5,0,349,289,307,328,302,291,350,342,207,144,192,137,164.0,158.0,-55,48,-103
200,1,49,1,5,0,184,190,187,321,371,283,435,596,174,80,151,177,164.0,136.0,26,71,-45
241,2,49,1,5,0,293,278,391,368,477,514,538,699,444,236,185,176,180.0,199.0,-9,-51,42
233,3,49,1,5,0,231,182,278,328,337,354,323,485,221,94,125,138,132.0,119.0,13,31,-18
251,4,49,1,5,0,557,512,616,785,877,636,879,1517,309,174,289,242,266.0,235.0,-47,115,-162
359,5,49,1,5,0,498,519,553,602,1020,712,770,1305,743,339,285,287,286.0,304.0,2,-54,56
524,6,49,1,5,0,556,596,658,834,1066,894,964,1597,855,344,344,422,383.0,370.0,78,0,78
829,7,49,1,5,0,851,801,793,998,1278,1160,1107,1740,687,383,327,543,435.0,418.0,216,-56,272
207,8,49,1,5,0,214,187,206,301,280,282,301,514,192,100,117,126,122.0,114.0,9,17,-8
460,9,49,1,5,0,687,668,710,890,1382,1240,1586,1899,542,186,403,360,382.0,316.0,-43,217,-260
120,10,49,1,5,0,186,226,201,232,277,266,309,514,260,96,110,81,96.0,96.0,-29,14,-43
899,11,49,1,5,0,993,872,955,1345,1406,1396,1446,2279,939,574,593,645,619.0,604.0,52,19,33
302,12,49,1,5,0,288,279,356,409,638,519,571,900,502,180,199,229,214.0,203.0,30,19,11
843,13,49,1,5,0,727,602,725,929,1066,990,1108,1749,708,414,412,600,506.0,475.0,188,-2,190
1003,14,49,1,5,0,926,1021,1208,1438,1525,1493,1622,2735,1331,509,557,792,674.0,619.0,235,48,187
899,15,49,1,5,0,1069,1144,1284,1635,1804,1911,2130,3255,1119,581,616,676,646.0,624.0,60,35,25
309,16,49,1,5,0,324,375,419,485,678,560,634,1014,597,202,210,256,233.0,223.0,46,8,38
280,17,49,1,5,0,355,332,374,473,712,546,606,978,498,212,209,272,240.0,231.0,63,-3,66
214,18,49,1,5,0,280,250,238,291,406,499,552,782,311,141,184,131,158.0,152.0,-53,43,-96
161,19,49,1,5,0,243,206,229,283,315,299,258,424,127,80,97,131,114.0,103.0,34,17,17
126,20,49,1,5,0,177,223,193,277,336,267,309,532,260,104,78,93,86.0,92.0,15,-26,41
263,21,49,1,5,0,355,227,253,326,373,472,366,620,315,130,154,179,166.0,154.0,25,24,1
97,22,49,1,5,0,191,155,137,237,206,170,232,274,80,52,66,71,68.0,63.0,5,14,-9
140,1,50,4,5,0,176,192,187,249,257,239,345,396,369,177,174,163,168.0,171.0,-11,-3,-8
159,2,50,4,5,0,206,289,300,344,358,406,373,334,203,134,207,159,183.0,167.0,-48,73,-121
40,3,50,4,5,0,78,58,65,160,123,116,59,90,51,29,42,27,34.0,33.0,-15,13,-28
47,4,50,4,5,0,119,141,164,139,203,168,222,242,93,60,87,42,64.0,63.0,-45,27,-72
333,5,50,4,5,0,413,455,488,625,731,758,778,781,288,239,321,272,296.0,277.0,-49,82,-131
309,6,50,4,5,0,349,370,347,570,630,644,607,661,309,266,301,237,269.0,268.0,-64,35,-99
433,7,50,4,5,0,559,584,576,690,772,807,782,994,540,419,572,464,518.0,485.0,-108,153,-261
67,8,50,4,5,0,140,127,162,287,240,200,132,201,88,44,87,60,74.0,64.0,-27,43,-70
394,9,50,4,5,0,438,526,486,516,619,721,938,1135,331,231,477,411,444.0,373.0,-66,246,-312
131,10,50,4,5,0,185,230,205,301,268,247,370,403,140,92,140,131,136.0,121.0,-9,48,-57
740,11,50,4,5,0,765,791,837,1017,1020,1227,1286,1781,805,710,885,641,763.0,745.0,-244,175,-419
210,12,50,4,5,0,276,230,221,285,391,438,444,431,157,97,173,170,172.0,147.0,-3,76,-79
455,13,50,4,5,0,558,552,574,734,729,766,589,806,391,375,484,404,444.0,421.0,-80,109,-189
445,14,50,4,5,0,632,668,840,854,777,834,729,896,363,334,528,418,473.0,427.0,-110,194,-304
466,15,50,4,5,0,406,443,507,510,573,616,797,1044,341,386,475,363,419.0,408.0,-112,89,-201
150,16,50,4,5,0,238,303,280,357,375,452,413,461,270,123,194,119,156.0,145.0,-75,71,-146
188,17,50,4,5,0,235,250,255,292,394,414,458,478,157,99,182,167,174.0,149.0,-15,83,-98
283,18,50,4,5,0,325,290,310,328,339,397,455,593,250,154,266,219,242.0,213.0,-47,112,-159
76,19,50,4,5,0,118,118,139,151,144,114,136,149,45,36,75,66,70.0,59.0,-9,39,-48
160,20,50,4,5,0,239,459,311,410,422,402,422,475,136,124,148,136,142.0,136.0,-12,24,-36
176,21,50,4,5,0,382,320,375,494,446,595,355,464,194,145,188,141,164.0,158.0,-47,43,-90
34,22,50,4,5,0,180,125,146,202,237,176,82,87,40,47,82,54,68.0,61.0,-28,35,-63
225,1,51,2,5,0,306,267,258,427,420,355,228,579,371,131,288,266,277.0,228.0,-22,157,-179
167,2,51,2,5,0,177,118,180,214,200,244,165,338,215,134,179,192,186.0,168.0,13,45,-32
53,3,51,2,5,0,58,32,43,34,40,41,43,48,41,28,59,37,48.0,41.0,-22,31,-53
70,4,51,2,5,0,264,181,202,267,304,268,372,383,131,61,110,108,109.0,93.0,-2,49,-51
456,5,51,2,5,0,410,336,352,370,632,431,484,820,550,286,428,433,430.0,382.0,5,142,-137
545,6,51,2,5,0,411,362,305,443,521,495,362,758,508,322,432,425,428.0,393.0,-7,110,-117
388,7,51,2,5,0,368,316,303,357,410,423,383,729,410,227,320,381,350.0,309.0,61,93,-32
47,8,51,2,5,0,71,48,59,51,78,61,91,136,74,57,53,62,58.0,57.0,9,-4,13
969,9,51,2,5,0,992,904,879,1153,1298,1305,1034,2232,1023,444,1072,1007,1040.0,841.0,-65,628,-693
178,10,51,2,5,0,201,169,192,217,237,215,191,328,208,107,160,131,146.0,133.0,-29,53,-82
969,11,51,2,5,0,1202,877,845,1153,1190,1239,807,1846,1142,747,1023,870,946.0,880.0,-153,276,-429
226,12,51,2,5,0,202,165,177,232,306,226,131,436,290,111,237,235,236.0,194.0,-2,126,-128
335,13,51,2,5,0,285,257,243,316,360,308,272,475,287,194,265,298,282.0,252.0,33,71,-38
513,14,51,2,5,0,424,404,405,509,554,543,420,747,459,249,457,513,485.0,406.0,56,208,-152
725,15,51,2,5,0,767,644,614,743,824,856,695,1454,752,503,780,679,730.0,654.0,-101,277,-378
251,16,51,2,5,0,213,257,205,250,304,278,190,481,312,158,246,258,252.0,221.0,12,88,-76
293,17,51,2,5,0,303,226,226,283,329,289,235,425,324,139,263,238,250.0,213.0,-25,124,-149
426,18,51,2,5,0,414,293,354,411,469,472,415,699,508,260,395,323,359.0,326.0,-72,135,-207
125,19,51,2,5,0,126,118,94,128,154,125,64,125,66,52,82,116,99.0,83.0,34,30,4
285,20,51,2,5,0,243,316,279,300,389,322,256,548,310,185,288,287,288.0,253.0,-1,103,-104
134,21,51,2,5,0,180,121,162,175,188,226,181,259,170,96,124,121,122.0,114.0,-3,28,-31
53,22,51,2,5,0,118,92,95,86,84,67,65,115,61,52,76,85,80.0,71.0,9,24,-15
272,1,52,1,5,0,312,308,315,327,336,292,421,473,415,199,338,303,320.0,280.0,-35,139,-174
304,2,52,1,5,0,239,271,381,320,316,363,485,535,500,259,353,295,324.0,302.0,-58,94,-152
191,3,52,1,5,0,177,198,210,230,224,233,229,234,273,129,208,180,194.0,172.0,-28,79,-107
365,4,52,1,5,0,374,335,454,424,442,429,500,681,534,295,402,398,400.0,365.0,-4,107,-111
508,5,52,1,5,0,454,508,557,495,659,704,743,849,933,442,540,493,516.0,492.0,-47,98,-145
176,6,52,1,5,0,207,204,219,249,314,271,334,368,404,198,210,162,186.0,190.0,-48,12,-60
558,7,52,1,5,0,542,531,579,617,771,679,776,936,911,376,595,546,570.0,506.0,-49,219,-268
103,8,52,1,5,0,125,128,113,131,135,142,208,244,213,113,141,101,121.0,118.0,-40,28,-68
905,9,52,1,5,0,978,1056,1120,1145,1408,1392,1836,2078,1526,521,1068,875,972.0,821.0,-193,547,-740
189,10,52,1,5,0,185,216,203,212,207,208,246,317,323,145,236,156,196.0,179.0,-80,91,-171
423,11,52,1,5,0,502,513,553,616,611,660,847,820,821,461,589,458,524.0,503.0,-131,128,-259
133,12,52,1,5,0,222,179,206,215,215,187,249,262,297,113,164,151,158.0,143.0,-13,51,-64
474,13,52,1,5,0,448,411,475,528,576,625,746,750,758,431,483,470,476.0,461.0,-13,52,-65
493,14,52,1,5,0,554,520,548,623,596,604,752,820,826,447,615,567,591.0,543.0,-48,168,-216
311,15,52,1,5,0,309,330,357,379,387,524,623,684,550,252,401,254,328.0,302.0,-147,149,-296
238,16,52,1,5,0,255,280,268,311,346,310,385,425,481,197,299,246,272.0,247.0,-53,102,-155
315,17,52,1,5,0,349,338,350,384,424,364,460,493,505,239,383,321,352.0,314.0,-62,144,-206
161,18,52,1,5,0,200,169,259,222,223,268,329,338,400,163,217,128,172.0,169.0,-89,54,-143
298,19,52,1,5,0,303,292,281,324,364,303,369,450,249,117,274,320,297.0,237.0,46,157,-111
306,20,52,1,5,0,346,440,402,372,406,400,540,575,576,284,403,314,358.0,334.0,-89,119,-208
266,21,52,1,5,0,263,225,299,275,293,365,346,404,376,178,272,285,278.0,245.0,13,94,-81
239,22,52,1,5,0,273,325,359,356,331,302,341,410,324,206,341,242,292.0,263.0,-99,135,-234
192,1,53,2,5,0,310,413,581,617,628,446,636,846,241,179,180,191,186.0,183.0,11,1,10
158,2,53,2,5,0,172,143,197,189,278,304,365,493,290,145,117,124,120.0,129.0,7,-28,35
119,3,53,2,5,0,155,125,168,136,222,206,310,562,284,123,119,71,95.0,104.0,-48,-4,-44
50,4,53,2,5,0,321,429,521,473,498,257,444,824,105,71,55,60,58.0,62.0,5,-16,21
380,5,53,2,5,0,603,636,717,777,1042,762,1080,1730,983,504,400,394,397.0,433.0,-6,-104,98
477,6,53,2,5,0,563,701,945,973,1078,1023,1260,2243,1186,528,593,566,580.0,562.0,-27,65,-92
645,7,53,2,5,0,1265,1160,1176,1294,1622,1536,1637,2998,1261,553,503,551,527.0,536.0,48,-50,98
178,8,53,2,5,0,203,154,257,272,308,299,372,645,313,178,140,164,152.0,161.0,24,-38,62
831,9,53,2,5,0,1027,923,1121,1670,1369,1274,1967,3191,905,337,855,959,907.0,717.0,104,518,-414
213,10,53,2,5,0,142,190,192,188,232,252,337,697,471,179,227,188,208.0,198.0,-39,48,-87
993,11,53,2,5,0,1592,1724,1702,2067,2163,1918,2283,3836,1631,972,777,763,770.0,837.0,-14,-195,181
283,12,53,2,5,0,345,361,411,440,542,547,676,1270,658,229,229,221,225.0,226.0,-8,0,-8
697,13,53,2,5,0,710,678,854,909,987,969,1064,2232,950,551,442,578,510.0,524.0,136,-109,245
1085,14,53,2,5,0,900,1091,1257,1337,1548,1431,1720,3243,1894,828,807,1011,909.0,882.0,204,-21,225
426,15,53,2,5,0,814,952,886,1003,1067,1140,1205,1850,574,328,328,361,344.0,339.0,33,0,33
222,16,53,2,5,0,349,502,356,435,576,710,866,1354,755,244,256,243,250.0,248.0,-13,12,-25
448,17,53,2,5,0,538,599,590,709,844,687,982,1756,938,322,403,371,387.0,365.0,-32,81,-113
304,18,53,2,5,0,268,357,422,486,645,645,746,1041,462,182,250,215,232.0,216.0,-35,68,-103
144,19,53,2,5,0,241,231,300,418,415,275,422,561,181,92,144,178,161.0,138.0,34,52,-18
189,20,53,2,5,0,484,631,758,749,722,571,643,1136,557,231,195,203,199.0,210.0,8,-36,44
369,21,53,2,5,0,399,506,811,726,652,682,805,1567,639,298,275,310,292.0,294.0,35,-23,58
93,22,53,2,5,0,163,123,259,159,164,109,207,305,102,62,72,62,67.0,65.0,-10,10,-20
18,1,54,1,5,0,90,87,88,90,112,64,139,159,95,31,32,33,32.0,32.0,1,1,0
67,2,54,1,5,0,108,54,102,103,88,129,116,195,181,91,58,50,54.0,66.0,-8,-33,25
126,3,54,1,5,0,223,139,192,148,178,215,227,336,327,113,110,91,100.0,105.0,-19,-3,-16
28,4,54,1,5,0,103,119,110,107,124,113,153,246,99,35,29,28,28.0,31.0,-1,-6,5
80,5,54,1,5,0,201,164,169,165,260,194,267,387,398,155,108,95,102.0,119.0,-13,-47,34
118,6,54,1,5,0,206,161,192,228,277,262,301,471,484,121,103,101,102.0,108.0,-2,-18,16
311,7,54,1,5,0,604,450,433,565,670,629,591,961,723,263,300,312,306.0,292.0,12,37,-25
51,8,54,1,5,0,114,81,88,106,92,114,133,167,149,66,59,57,58.0,61.0,-2,-7,5
31,9,54,1,5,0,103,107,99,112,111,142,134,176,97,19,44,38,41.0,34.0,-6,25,-31
25,10,54,1,5,0,59,61,36,46,27,44,52,62,66,20,31,15,23.0,22.0,-16,11,-27
101,11,54,1,5,0,365,291,216,275,222,289,312,450,333,168,137,94,116.0,133.0,-43,-31,-12
82,12,54,1,5,0,162,110,96,123,158,141,164,252,264,69,58,63,60.0,63.0,5,-11,16
205,13,54,1,5,0,283,231,209,251,268,281,338,473,362,182,165,226,196.0,191.0,61,-17,78
206,14,54,1,5,0,440,420,458,438,436,457,535,679,669,213,223,212,218.0,216.0,-11,10,-21
64,15,54,1,5,0,165,119,117,144,152,167,161,255,131,59,54,69,62.0,61.0,15,-5,20
89,16,54,1,5,0,217,211,166,169,231,258,278,385,450,105,110,104,107.0,106.0,-6,5,-11
257,17,54,1,5,0,357,324,322,320,453,378,533,776,857,222,262,247,254.0,244.0,-15,40,-55
33,18,54,1,5,0,60,45,47,38,50,51,83,65,41,21,20,20,20.0,20.0,0,-1,1
45,19,54,1,5,0,118,82,101,115,152,128,129,166,109,50,66,72,69.0,63.0,6,16,-10
70,20,54,1,5,0,156,162,125,149,157,175,189,306,256,58,77,65,71.0,67.0,-12,19,-31
193,21,54,1,5,0,319,224,270,298,329,421,381,634,493,193,190,176,183.0,186.0,-14,-3,-11
62,22,54,1,5,0,152,109,132,165,141,126,204,277,131,70,96,70,83.0,79.0,-26,26,-52
75,1,55,1,5,0,165,139,164,176,188,167,211,361,138,71,95,74,84.0,80.0,-21,24,-45
276,2,55,1,5,0,421,327,407,402,486,521,434,743,406,299,256,259,258.0,271.0,3,-43,46
248,3,55,1,5,0,289,218,256,255,374,366,390,683,304,135,211,181,196.0,176.0,-30,76,-106
138,4,55,1,5,0,391,298,365,388,458,302,357,675,173,56,121,79,100.0,85.0,-42,65,-107
814,5,55,1,5,0,1243,1067,1135,1222,1530,1137,1318,2057,1186,681,782,644,713.0,702.0,-138,101,-239
307,6,55,1,5,0,407,292,363,463,479,476,493,865,574,194,213,248,230.0,218.0,35,19,16
536,7,55,1,5,0,935,718,720,875,922,870,894,1538,723,282,412,473,442.0,389.0,61,130,-69
509,8,55,1,5,0,469,311,358,454,470,495,510,974,417,214,254,346,300.0,271.0,92,40,52
430,9,55,1,5,0,703,576,557,610,730,702,768,1105,569,259,493,354,424.0,369.0,-139,234,-373
174,10,55,1,5,0,242,164,182,175,217,208,212,406,260,101,165,105,135.0,124.0,-60,64,-124
495,11,55,1,5,0,724,557,652,768,765,828,786,1332,698,402,409,494,452.0,435.0,85,7,78
216,12,55,1,5,0,311,262,276,281,350,363,356,774,420,110,193,205,199.0,169.0,12,83,-71
990,13,55,1,5,0,862,614,693,937,936,974,964,2069,891,397,516,929,722.0,614.0,413,119,294
645,14,55,1,5,0,850,682,796,900,924,913,934,1916,1026,330,387,521,454.0,413.0,134,57,77
304,15,55,1,5,0,581,492,491,561,604,663,556,982,370,195,281,311,296.0,262.0,30,86,-56
195,16,55,1,5,0,276,303,276,301,385,300,389,721,401,105,159,186,172.0,150.0,27,54,-27
363,17,55,1,5,0,562,511,551,548,722,567,687,1290,631,205,298,333,316.0,279.0,35,93,-58
150,18,55,1,5,0,170,135,152,178,217,240,253,385,180,95,138,114,126.0,116.0,-24,43,-67
138,19,55,1,5,0,223,208,212,251,209,211,226,330,135,104,181,144,162.0,143.0,-37,77,-114
481,20,55,1,5,0,796,935,790,970,909,844,751,1420,661,420,464,477,470.0,454.0,13,44,-31
415,21,55,1,5,0,671,425,496,540,574,623,639,1234,604,184,336,402,369.0,307.0,66,152,-86
108,22,55,1,5,0,152,127,131,146,126,126,150,236,76,111,111,78,94.0,100.0,-33,0,-33
218,1,56,1,5,0,291,237,275,484,500,412,620,805,357,95,198,187,192.0,160.0,-11,103,-114
470,2,56,1,5,0,444,342,521,806,851,856,921,1249,829,418,522,444,483.0,461.0,-78,104,-182
461,3,56,1,5,0,322,265,347,507,500,528,675,925,601,288,415,322,368.0,342.0,-93,127,-220
276,4,56,1,5,0,455,384,534,743,672,532,779,1421,437,212,313,278,296.0,268.0,-35,101,-136
1042,5,56,1,5,0,899,922,1077,1757,2178,1620,1861,2915,2183,903,1084,938,1011.0,975.0,-146,181,-327
356,6,56,1,5,0,383,373,395,690,798,757,934,1307,1141,304,330,322,326.0,319.0,-8,26,-34
624,7,56,1,5,0,689,593,668,1173,1160,1214,1192,1610,1006,389,569,611,590.0,523.0,42,180,-138
370,8,56,1,5,0,304,235,316,582,505,511,601,970,406,198,368,305,336.0,290.0,-63,170,-233
785,9,56,1,5,0,928,799,758,1347,1576,1507,1902,2685,1203,341,825,879,852.0,682.0,54,484,-430
197,10,56,1,5,0,230,206,193,394,347,352,440,665,433,149,235,168,202.0,184.0,-67,86,-153
961,11,56,1,5,0,951,861,1014,1794,1646,1598,1955,2752,1481,650,861,854,858.0,788.0,-7,211,-218
266,12,56,1,5,0,281,260,281,443,510,475,511,802,624,159,229,268,248.0,219.0,39,70,-31
810,13,56,1,5,0,653,522,624,985,1009,905,1021,1551,970,478,608,767,688.0,618.0,159,130,29
850,14,56,1,5,0,747,679,846,1361,1342,1399,1530,2696,1928,502,672,701,686.0,625.0,29,170,-141
696,15,56,1,5,0,710,572,720,1247,1320,1351,1499,2124,704,292,530,641,586.0,488.0,111,238,-127
347,16,56,1,5,0,322,323,347,614,653,620,794,1252,837,201,313,330,322.0,281.0,17,112,-95
591,17,56,1,5,0,623,625,741,1241,1383,1339,1478,2360,1657,503,671,579,625.0,584.0,-92,168,-260
281,18,56,1,5,0,264,213,231,425,414,399,601,698,428,129,211,219,215.0,186.0,8,82,-74
250,19,56,1,5,0,206,200,191,375,331,306,361,459,235,125,226,187,206.0,179.0,-39,101,-140
908,20,56,1,5,0,877,1159,994,1592,1671,1487,1581,2727,1846,758,896,740,818.0,798.0,-156,138,-294
444,21,56,1,5,0,634,391,538,758,764,827,896,1319,905,333,426,445,436.0,401.0,19,93,-74
143,22,56,1,5,0,152,156,136,271,219,256,312,397,173,117,199,155,177.0,157.0,-44,82,-126
38,1,57,3,5,0,48,33,25,37,28,27,30,34,19,29,28,25,26.0,27.0,-3,-1,-2
815,2,57,3,5,0,1335,1170,1342,1395,1639,1736,1547,1939,1680,1190,1187,815,1001.0,1064.0,-372,-3,-369
70,3,57,3,5,0,80,81,79,74,107,93,105,108,54,78,117,71,94.0,89.0,-46,39,-85
110,4,57,3,5,0,214,173,229,238,282,198,305,504,106,118,157,120,138.0,132.0,-37,39,-76
472,5,57,3,5,0,875,682,620,742,717,655,773,955,603,645,678,519,598.0,614.0,-159,33,-192
153,6,57,3,5,0,216,207,172,194,197,214,225,272,216,223,191,165,178.0,193.0,-26,-32,6
400,7,57,3,5,0,659,545,644,631,622,551,636,1105,629,541,513,451,482.0,502.0,-62,-28,-34
117,8,57,3,5,0,157,114,131,103,137,118,161,233,166,115,127,118,122.0,120.0,-9,12,-21
503,9,57,3,5,0,890,830,568,627,644,624,713,866,346,505,757,513,635.0,592.0,-244,252,-496
57,10,57,3,5,0,104,62,69,50,93,63,75,97,92,50,85,53,69.0,63.0,-32,35,-67
558,11,57,3,5,0,727,654,653,752,766,763,871,1150,610,843,857,623,740.0,774.0,-234,14,-248
70,12,57,3,5,0,161,110,121,107,134,92,117,148,132,89,105,90,98.0,95.0,-15,16,-31
541,13,57,3,5,0,636,506,529,574,561,554,769,983,537,616,685,621,653.0,641.0,-64,69,-133
592,14,57,3,5,0,934,847,759,825,703,746,952,1314,922,778,753,612,682.0,714.0,-141,-25,-116
351,15,57,3,5,0,549,457,405,385,451,456,466,653,312,498,511,368,440.0,459.0,-143,13,-156
403,16,57,3,5,0,538,476,513,518,582,592,590,903,514,438,482,408,445.0,443.0,-74,44,-118
267,17,57,3,5,0,440,429,353,375,366,327,426,575,405,314,375,353,364.0,347.0,-22,61,-83
146,18,57,3,5,0,172,148,152,164,156,179,175,195,85,140,157,133,145.0,143.0,-24,17,-41
184,19,57,3,5,0,228,230,212,192,216,260,281,370,158,187,236,191,214.0,205.0,-45,49,-94
521,20,57,3,5,0,700,668,554,592,643,645,706,955,636,643,771,438,604.0,617.0,-333,128,-461
157,21,57,3,5,0,283,187,180,190,227,209,280,324,195,155,198,180,189.0,178.0,-18,43,-61
41,22,57,3,5,0,103,81,47,88,70,59,76,90,35,48,67,46,56.0,54.0,-21,19,-40
69,1,58,2,5,0,110,134,139,176,218,159,193,281,60,52,74,61,68.0,62.0,-13,22,-35
154,2,58,2,5,0,149,132,201,192,241,224,227,356,181,119,130,103,116.0,117.0,-27,11,-38
79,3,58,2,5,0,89,103,103,63,86,129,183,244,117,67,81,65,73.0,71.0,-16,14,-30
103,4,58,2,5,0,466,501,463,464,472,326,417,805,105,52,132,97,114.0,94.0,-35,80,-115
516,5,58,2,5,0,726,715,739,855,1133,824,910,1456,816,454,505,463,484.0,474.0,-42,51,-93
118,6,58,2,5,0,209,240,323,314,310,267,287,463,251,96,133,88,110.0,106.0,-45,37,-82
408,7,58,2,5,0,571,548,646,773,797,679,738,1182,600,283,311,395,353.0,330.0,84,28,56
169,8,58,2,5,0,199,121,199,221,226,243,264,497,192,96,135,117,126.0,116.0,-18,39,-57
258,9,58,2,5,0,351,384,378,429,596,574,615,869,297,127,271,262,266.0,220.0,-9,144,-153
135,10,58,2,5,0,140,126,161,139,167,205,233,425,254,71,136,107,122.0,105.0,-29,65,-94
373,11,58,2,5,0,521,545,683,706,761,731,749,1017,461,270,342,363,352.0,325.0,21,72,-51
68,12,58,2,5,0,110,128,145,145,229,198,198,315,211,60,84,84,84.0,76.0,0,24,-24
498,13,58,2,5,0,480,501,551,690,771,682,755,1430,754,390,398,481,440.0,423.0,83,8,75
363,14,58,2,5,0,534,645,779,871,851,876,865,1601,892,268,371,333,352.0,324.0,-38,103,-141
246,15,58,2,5,0,271,509,410,370,1437,406,420,845,174,81,170,192,181.0,148.0,22,89,-67
60,16,58,2,5,0,83,118,124,88,110,128,133,246,134,39,47,55,51.0,47.0,8,8,0
211,17,58,2,5,0,324,325,335,319,439,335,447,756,439,130,231,191,211.0,184.0,-40,101,-141
67,18,58,2,5,0,92,93,116,102,142,175,166,247,102,51,67,60,64.0,59.0,-7,16,-23
30,19,58,2,5,0,48,65,77,81,68,54,102,113,47,21,29,27,28.0,26.0,-2,8,-10
395,20,58,2,5,0,1791,780,781,1602,764,548,596,1578,630,283,298,337,318.0,306.0,39,15,24
236,21,58,2,5,0,349,347,435,453,455,455,558,938,498,189,261,260,260.0,237.0,-1,72,-73
20,22,58,2,5,0,19,35,25,28,17,16,45,45,7,10,21,11,16.0,14.0,-10,11,-21
233,1,59,2,5,0,1911,902,547,590,1049,393,448,746,228,125,223,190,206.0,179.0,-33,98,-131
70,2,59,2,5,0,299,183,317,301,410,266,224,235,105,67,68,72,70.0,69.0,4,1,3
75,3,59,2,5,0,205,129,178,248,263,289,273,340,208,63,95,64,80.0,74.0,-31,32,-63
50,4,59,2,5,0,2153,193,216,265,2528,156,179,362,72,29,64,61,62.0,51.0,-3,35,-38
230,5,59,2,5,0,918,779,942,1243,1666,730,631,1027,542,251,246,265,256.0,254.0,19,-5,24
344,6,59,2,5,0,609,647,742,968,961,755,678,1434,792,244,232,308,270.0,261.0,76,-12,88
371,7,59,2,5,0,2081,1738,2176,2848,2646,1380,1053,1685,823,326,341,453,397.0,373.0,112,15,97
182,8,59,2,5,0,466,412,468,657,660,386,479,604,321,126,162,162,162.0,150.0,0,36,-36
407,9,59,2,5,0,808,584,546,819,1623,936,1038,1493,451,130,374,366,370.0,290.0,-8,244,-252
136,10,59,2,5,0,206,200,234,316,360,349,312,543,250,76,136,99,118.0,104.0,-37,60,-97
807,11,59,2,5,0,2058,1654,1827,2527,2388,1650,1467,2828,1205,656,751,787,769.0,731.0,36,95,-59
262,12,59,2,5,0,462,351,450,511,752,626,577,1241,549,138,232,271,252.0,214.0,39,94,-55
351,13,59,2,5,0,940,856,987,1387,1606,840,561,1020,602,249,293,362,328.0,301.0,69,44,25
557,14,59,2,5,0,1242,1377,1416,1736,1669,959,1021,1584,992,320,512,660,586.0,497.0,148,192,-44
375,15,59,2,5,0,739,693,717,1019,1203,828,859,1272,386,193,342,341,342.0,292.0,-1,149,-150
270,16,59,2,5,0,602,550,430,713,769,691,751,1208,523,161,272,326,299.0,253.0,54,111,-57
222,17,59,2,5,0,595,580,641,816,847,522,619,891,508,132,232,212,222.0,192.0,-20,100,-120
121,18,59,2,5,0,204,142,221,243,304,268,291,431,173,74,106,104,105.0,95.0,-2,32,-34
66,19,59,2,5,0,277,157,228,366,291,139,186,225,91,51,75,101,88.0,76.0,26,24,2
65,20,59,2,5,0,174,226,215,324,310,182,148,242,128,33,53,51,52.0,46.0,-2,20,-22
155,21,59,2,5,0,533,558,687,656,661,278,275,432,182,64,143,136,140.0,114.0,-7,79,-86
48,22,59,2,5,0,111,89,97,146,137,83,61,140,53,29,33,28,30.0,30.0,-5,4,-9
108,1,60,1,5,0,134,134,141,138,161,113,162,163,142,84,128,99,114.0,104.0,-29,44,-73
84,2,60,1,5,0,86,94,141,123,111,95,152,131,146,84,119,80,100.0,94.0,-39,35,-74
86,3,60,1,5,0,107,75,84,71,81,97,81,90,83,41,62,87,74.0,63.0,25,21,4
62,4,60,1,5,0,95,97,119,87,131,79,100,123,88,65,74,70,72.0,70.0,-4,9,-13
224,5,60,1,5,0,215,255,232,227,447,284,279,330,341,184,223,201,212.0,203.0,-22,39,-61
152,6,60,1,5,0,161,145,138,167,182,170,183,198,254,107,149,150,150.0,135.0,1,42,-41
162,7,60,1,5,0,157,181,138,136,198,152,160,191,159,74,162,163,162.0,133.0,1,88,-87
28,8,60,1,5,0,37,27,30,36,34,32,31,28,41,25,46,41,44.0,37.0,-5,21,-26
410,9,60,1,5,0,479,470,487,435,593,541,658,638,568,264,527,387,457.0,393.0,-140,263,-403
163,10,60,1,5,0,164,160,151,154,208,163,172,213,297,121,197,152,174.0,157.0,-45,76,-121
345,11,60,1,5,0,360,325,317,361,402,385,402,439,430,213,408,324,366.0,315.0,-84,195,-279
71,12,60,1,5,0,75,70,82,64,94,87,76,120,103,50,101,76,88.0,76.0,-25,51,-76
137,13,60,1,5,0,88,94,88,102,92,82,85,95,109,50,116,95,106.0,87.0,-21,66,-87
90,14,60,1,5,0,117,126,120,123,153,141,134,164,130,78,142,114,128.0,111.0,-28,64,-92
322,15,60,1,5,0,301,272,322,299,308,339,364,397,466,185,307,317,312.0,270.0,10,122,-112
140,16,60,1,5,0,145,190,155,179,232,184,244,236,270,129,200,183,192.0,171.0,-17,71,-88
296,17,60,1,5,0,293,279,299,298,395,308,355,445,519,215,330,301,316.0,282.0,-29,115,-144
101,18,60,1,5,0,99,64,92,91,93,87,125,99,145,57,96,88,92.0,80.0,-8,39,-47
100,19,60,1,5,0,133,116,136,158,194,115,126,155,89,59,109,102,106.0,90.0,-7,50,-57
104,20,60,1,5,0,135,304,146,146,203,173,179,214,160,89,140,134,137.0,121.0,-6,51,-57
258,21,60,1,5,0,260,217,273,229,256,263,252,263,274,154,228,212,220.0,198.0,-16,74,-90
47,22,60,1,5,0,70,81,75,75,68,54,66,57,65,35,91,67,79.0,64.0,-24,56,-80
251,1,1,1,6,0,235,260,162,265,228,369,374,305,193,309,264,241,252.0,271.0,-23,-45,22
230,2,1,1,6,0,279,419,246,217,310,402,456,434,194,302,243,321,282.0,289.0,78,-59,137
155,3,1,1,6,0,164,187,153,157,178,204,219,180,128,201,176,192,184.0,190.0,16,-25,41
314,4,1,1,6,0,351,322,244,337,371,460,563,468,432,472,340,407,374.0,406.0,67,-132,199
336,5,1,1,6,0,329,335,345,623,350,453,570,500,253,378,337,331,334.0,349.0,-6,-41,35
166,6,1,1,6,0,138,108,127,159,136,179,226,198,76,132,155,144,150.0,144.0,-11,23,-34
432,7,1,1,6,0,353,339,259,422,394,483,601,468,290,412,484,450,467.0,449.0,-34,72,-106
173,8,1,1,6,0,166,178,189,194,233,215,260,248,146,249,182,251,216.0,227.0,69,-67,136
2696,9,1,1,6,0,2187,2183,1804,2265,2711,3532,3800,2692,1680,2958,2368,2754,2561.0,2693.0,386,-590,976
293,10,1,1,6,0,291,276,249,267,349,472,505,425,248,383,277,377,327.0,346.0,100,-106,206
689,11,1,1,6,0,561,554,569,631,764,871,1010,800,486,817,617,720,668.0,718.0,103,-200,303
149,12,1,1,6,0,149,136,95,156,166,204,262,236,78,191,154,186,170.0,177.0,32,-37,69
293,13,1,1,6,0,252,227,235,225,228,291,305,260,190,297,311,328,320.0,312.0,17,14,3
297,14,1,1,6,0,330,384,256,301,351,521,505,405,250,355,393,307,350.0,352.0,-86,38,-124
591,15,1,1,6,0,453,457,422,545,702,660,865,633,409,621,561,562,562.0,581.0,1,-60,61
455,16,1,1,6,0,440,329,325,381,447,480,474,497,228,445,423,403,413.0,424.0,-20,-22,2
259,17,1,1,6,0,275,250,286,299,327,364,474,347,174,297,304,284,294.0,295.0,-20,7,-27
299,18,1,1,6,0,223,276,226,258,368,331,404,292,181,307,209,324,266.0,280.0,115,-98,213
626,19,1,1,6,0,645,700,556,721,769,941,997,650,566,775,692,738,715.0,735.0,46,-83,129
138,20,1,1,6,0,181,131,111,101,120,155,199,115,72,126,107,119,113.0,117.0,12,-19,31
285,21,1,1,6,0,206,262,204,187,324,393,440,305,219,295,292,328,310.0,305.0,36,-3,39
284,22,1,1,6,0,288,194,351,302,310,458,461,292,234,401,305,324,314.0,343.0,19,-96,115
408,1,2,2,6,0,376,356,410,417,271,639,518,268,263,442,321,383,352.0,382.0,62,-121,183
354,2,2,2,6,0,259,337,266,368,334,609,519,292,264,403,325,415,370.0,381.0,90,-78,168
252,3,2,2,6,0,175,231,216,208,216,370,337,175,149,316,260,258,259.0,278.0,-2,-56,54
352,4,2,2,6,0,405,459,464,449,231,675,811,368,359,470,369,376,372.0,405.0,7,-101,108
724,5,2,2,6,0,656,684,758,1227,469,1053,1125,657,560,806,700,679,690.0,728.0,-21,-106,85
352,6,2,2,6,0,252,293,358,325,253,574,507,301,225,317,315,350,332.0,327.0,35,-2,37
1113,7,2,2,6,0,862,990,917,1222,876,1567,1574,775,729,1060,1229,1119,1174.0,1136.0,-110,169,-279
335,8,2,2,6,0,253,284,382,372,320,590,571,290,239,407,358,384,371.0,383.0,26,-49,75
9100,9,2,2,6,0,8266,8709,10596,10140,6925,13598,11515,5136,4688,10371,8733,8990,8862.0,9365.0,257,-1638,1895
901,10,2,2,6,0,723,792,866,969,642,1386,1258,750,559,1074,832,939,886.0,948.0,107,-242,349
1948,11,2,2,6,0,1678,1827,2216,2075,1763,3112,2877,1445,1635,2184,1828,1916,1872.0,1976.0,88,-356,444
513,12,2,2,6,0,344,400,420,535,356,595,741,435,311,545,463,483,473.0,497.0,20,-82,102
829,13,2,2,6,0,520,604,569,722,520,1137,974,498,486,847,1025,993,1009.0,955.0,-32,178,-210
1043,14,2,2,6,0,695,718,785,808,565,1273,1234,645,486,968,944,932,938.0,948.0,-12,-24,12
1847,15,2,2,6,0,1420,1737,1785,1658,1293,2709,2467,1135,1205,1969,1744,1919,1832.0,1877.0,175,-225,400
876,16,2,2,6,0,835,675,883,908,742,1001,1050,703,508,734,619,699,659.0,684.0,80,-115,195
707,17,2,2,6,0,625,567,721,958,582,1112,1192,689,445,769,687,748,718.0,735.0,61,-82,143
1511,18,2,2,6,0,1202,1533,1388,1310,817,2205,1578,856,899,1607,1181,1494,1338.0,1427.0,313,-426,739
1845,19,2,2,6,0,1544,2253,2301,1915,1064,2892,2161,1110,1306,1905,1837,1784,1810.0,1842.0,-53,-68,15
371,20,2,2,6,0,327,300,319,331,173,470,398,244,215,285,259,240,250.0,261.0,-19,-26,7
394,21,2,2,6,0,412,553,492,462,375,582,607,340,260,369,435,466,450.0,423.0,31,66,-35
849,22,2,2,6,0,687,670,1107,843,480,1076,1018,447,521,1186,639,827,733.0,884.0,188,-547,735
200,1,3,1,6,0,211,160,159,169,112,163,167,157,101,187,162,155,158.0,168.0,-7,-25,18
265,2,3,1,6,0,254,351,309,270,218,354,350,290,213,293,226,236,231.0,252.0,10,-67,77
251,3,3,1,6,0,237,261,246,234,155,184,233,279,174,228,241,255,248.0,241.0,14,13,1
503,4,3,1,6,0,552,633,554,583,457,611,677,549,387,627,524,389,456.0,513.0,-135,-103,-32
404,5,3,1,6,0,413,373,319,387,300,411,434,516,235,377,355,370,362.0,367.0,15,-22,37
142,6,3,1,6,0,126,118,108,157,129,128,138,176,83,127,116,129,122.0,124.0,13,-11,24
407,7,3,1,6,0,393,358,328,376,327,415,400,420,235,353,334,323,328.0,337.0,-11,-19,8
177,8,3,1,6,0,161,170,152,135,111,141,197,179,103,189,173,157,165.0,173.0,-16,-16,0
1833,9,3,1,6,0,1649,1691,1490,1683,1421,1989,1829,1713,1159,1738,1536,1581,1558.0,1618.0,45,-202,247
163,10,3,1,6,0,179,178,141,192,165,181,173,211,121,197,149,174,162.0,173.0,25,-48,73
444,11,3,1,6,0,417,373,340,401,333,437,427,470,296,446,386,375,380.0,402.0,-11,-60,49
126,12,3,1,6,0,89,94,84,108,90,107,109,126,55,113,112,112,112.0,112.0,0,-1,1
425,13,3,1,6,0,302,324,321,309,274,302,328,389,251,371,364,437,400.0,391.0,73,-7,80
396,14,3,1,6,0,340,309,300,327,262,352,337,377,202,331,306,338,322.0,325.0,32,-25,57
380,15,3,1,6,0,351,316,352,336,342,428,424,401,264,349,335,366,350.0,350.0,31,-14,45
322,16,3,1,6,0,268,203,201,303,211,267,280,321,189,271,255,230,242.0,252.0,-25,-16,-9
285,17,3,1,6,0,277,255,193,250,211,244,275,284,146,275,262,250,256.0,262.0,-12,-13,1
132,18,3,1,6,0,128,123,95,124,106,151,157,167,81,107,85,111,98.0,101.0,26,-22,48
457,19,3,1,6,0,501,506,466,488,346,464,567,506,316,529,433,489,461.0,484.0,56,-96,152
179,20,3,1,6,0,186,166,134,169,138,184,155,213,116,188,148,168,158.0,168.0,20,-40,60
277,21,3,1,6,0,255,273,253,271,195,252,267,297,206,288,291,280,286.0,286.0,-11,3,-14
317,22,3,1,6,0,324,293,304,239,208,258,336,315,155,306,267,240,254.0,271.0,-27,-39,12
142,1,4,2,6,0,282,229,249,216,166,212,210,117,96,135,131,161,146.0,142.0,30,-4,34
176,2,4,2,6,0,116,231,232,256,209,270,308,173,110,159,185,191,188.0,178.0,6,26,-20
117,3,4,2,6,0,97,118,134,193,128,165,176,89,72,136,148,139,144.0,141.0,-9,12,-21
85,4,4,2,6,0,267,308,309,286,179,246,342,136,109,179,166,96,131.0,147.0,-70,-13,-57
324,5,4,2,6,0,414,426,492,712,401,438,436,351,212,361,425,290,358.0,359.0,-135,64,-199
195,6,4,2,6,0,218,300,368,358,250,325,348,264,151,204,182,203,192.0,196.0,21,-22,43
285,7,4,2,6,0,407,399,489,606,454,468,556,225,175,357,467,449,458.0,424.0,-18,110,-128
127,8,4,2,6,0,127,123,233,187,181,144,181,92,70,148,181,165,173.0,165.0,-16,33,-49
3906,9,4,2,6,0,3624,4020,4618,5211,4012,4216,4195,2391,1639,3992,3988,3668,3828.0,3883.0,-320,-4,-316
344,10,4,2,6,0,329,360,409,444,331,432,386,248,166,443,418,434,426.0,432.0,16,-25,41
947,11,4,2,6,0,876,892,1148,1130,943,1033,1154,680,651,982,1039,1051,1045.0,1024.0,12,57,-45
271,12,4,2,6,0,210,194,288,380,260,302,351,208,96,254,328,298,313.0,293.0,-30,74,-104
345,13,4,2,6,0,480,475,550,584,385,397,419,248,284,584,570,485,528.0,546.0,-85,-14,-71
516,14,4,2,6,0,468,562,658,673,556,567,651,338,242,578,638,439,538.0,552.0,-199,60,-259
1131,15,4,2,6,0,1006,1138,1244,1296,1228,1343,1310,747,739,1438,1404,1200,1302.0,1347.0,-204,-34,-170
446,16,4,2,6,0,595,544,655,744,726,677,787,450,226,461,459,468,464.0,463.0,9,-2,11
548,17,4,2,6,0,494,503,610,619,436,474,674,394,223,436,554,554,554.0,515.0,0,118,-118
709,18,4,2,6,0,417,546,535,615,563,615,519,231,173,535,612,676,644.0,608.0,64,77,-13
459,19,4,2,6,0,803,867,1031,840,522,652,848,213,233,610,646,562,604.0,606.0,-84,36,-120
162,20,4,2,6,0,348,324,316,208,150,157,208,123,85,166,157,116,136.0,146.0,-41,-9,-32
226,21,4,2,6,0,237,272,274,262,219,225,317,148,105,202,242,221,232.0,222.0,-21,40,-61
205,22,4,2,6,0,248,232,335,334,222,288,303,90,85,233,244,241,242.0,239.0,-3,11,-14
170,1,5,3,6,0,234,212,256,234,168,249,477,199,177,267,169,193,181.0,210.0,24,-98,122
1995,2,5,3,6,0,2353,2868,2565,3307,3096,3216,4503,4785,3067,2754,2281,2227,2254.0,2421.0,-54,-473,419
356,3,5,3,6,0,329,346,368,502,360,520,675,504,451,680,487,440,464.0,536.0,-47,-193,146
112,4,5,3,6,0,163,179,202,242,199,305,514,151,92,197,124,132,128.0,151.0,8,-73,81
990,5,5,3,6,0,1118,1183,1230,1449,1007,1411,1954,1724,1537,1481,1090,1021,1056.0,1197.0,-69,-391,322
1165,6,5,3,6,0,1210,1260,1418,1458,1238,1535,2328,2152,1881,1518,1284,1266,1275.0,1356.0,-18,-234,216
2279,7,5,3,6,0,2963,3398,3600,3519,3268,3907,6576,4483,3060,2839,2545,2879,2712.0,2754.0,334,-294,628
955,8,5,3,6,0,1193,1334,1452,1749,1354,1585,2844,2093,1361,1353,1118,1259,1188.0,1243.0,141,-235,376
1682,9,5,3,6,0,1577,1457,1550,1999,1555,2007,3029,1611,1579,2180,1684,1684,1684.0,1849.0,0,-496,496
1343,10,5,3,6,0,1991,2051,2291,2515,2293,2687,4443,3084,1836,2310,1540,1616,1578.0,1822.0,76,-770,846
1375,11,5,3,6,0,1539,1776,1799,1764,1493,1942,3067,2165,2419,2029,1601,1578,1590.0,1736.0,-23,-428,405
536,12,5,3,6,0,892,885,890,1111,824,980,1510,1290,922,875,668,648,658.0,730.0,-20,-207,187
2522,13,5,3,6,0,2437,2748,3368,3303,2808,3641,6231,3870,3403,2945,3015,3119,3067.0,3026.0,104,70,34
2598,14,5,3,6,0,3302,3413,3591,3584,3821,4668,7650,5825,3564,3197,2704,2715,2710.0,2872.0,11,-493,504
1121,15,5,3,6,0,1213,1206,1016,1295,1112,1294,2062,1260,1629,1592,1156,1224,1190.0,1324.0,68,-436,504
835,16,5,3,6,0,954,900,992,1202,958,1353,2198,1919,1140,1262,895,1069,982.0,1075.0,174,-367,541
997,17,5,3,6,0,1491,1500,1678,1773,1354,1770,2693,2364,1506,1541,1174,1020,1097.0,1245.0,-154,-367,213
473,18,5,3,6,0,545,512,565,573,523,688,892,592,650,741,463,546,504.0,583.0,83,-278,361
854,19,5,3,6,0,1034,1023,1010,1135,824,1154,1710,924,939,1322,959,988,974.0,1090.0,29,-363,392
173,20,5,3,6,0,225,203,204,284,201,250,357,250,248,235,212,191,202.0,213.0,-21,-23,2
910,21,5,3,6,0,1083,1173,1245,1658,1590,1877,3217,2072,1105,1314,1222,1105,1164.0,1214.0,-117,-92,-25
602,22,5,3,6,0,776,785,835,795,518,816,982,506,518,806,657,585,621.0,683.0,-72,-149,77
289,1,6,1,6,0,330,331,445,555,272,582,623,382,114,351,229,285,257.0,288.0,56,-122,178
390,2,6,1,6,0,333,428,409,543,553,546,680,484,300,452,403,419,411.0,425.0,16,-49,65
525,3,6,1,6,0,517,552,645,831,715,836,832,551,317,489,505,604,554.0,533.0,99,16,83
93,4,6,1,6,0,331,345,369,502,362,440,598,212,102,180,142,124,133.0,149.0,-18,-38,20
870,5,6,1,6,0,1004,1032,1165,1460,1050,1385,1850,1223,671,850,790,838,814.0,826.0,48,-60,108
1165,6,6,1,6,0,1047,1058,1409,1565,1256,1491,1666,1515,717,1018,980,1077,1028.0,1025.0,97,-38,135
1983,7,6,1,6,0,1575,1773,2139,2580,2061,2146,2737,1706,842,1734,1902,2031,1966.0,1889.0,129,168,-39
606,8,6,1,6,0,430,532,655,690,724,762,993,533,312,595,582,569,576.0,582.0,-13,-13,0
5445,9,6,1,6,0,5010,5237,6544,8215,6582,6734,6492,5607,2647,5713,4896,5717,5306.0,5442.0,821,-817,1638
532,10,6,1,6,0,632,639,680,913,743,853,894,799,409,719,453,603,528.0,592.0,150,-266,416
1735,11,6,1,6,0,1679,1859,2252,2410,2283,2584,2672,1728,1016,1729,1498,1701,1600.0,1643.0,203,-231,434
753,12,6,1,6,0,704,848,964,1340,1065,1086,1291,1027,356,690,687,838,762.0,738.0,151,-3,154
2426,13,6,1,6,0,1966,2293,2864,3253,2277,2327,2703,2119,1271,2126,2486,2863,2674.0,2492.0,377,360,17
2880,14,6,1,6,0,2264,2690,3318,3446,2827,2797,3447,2952,1308,2514,2566,2841,2704.0,2640.0,275,52,223
1077,15,6,1,6,0,928,974,1151,1369,1262,1632,1972,795,459,876,905,1141,1023.0,974.0,236,29,207
1133,16,6,1,6,0,1207,1181,1412,1938,1686,1663,2151,1566,597,1095,1029,1047,1038.0,1057.0,18,-66,84
1382,17,6,1,6,0,1605,1889,1918,2573,2247,1966,2770,1651,844,1487,1573,1636,1604.0,1565.0,63,86,-23
418,18,6,1,6,0,259,301,348,390,371,447,476,264,148,314,267,427,347.0,336.0,160,-47,207
342,19,6,1,6,0,261,323,369,397,317,403,513,241,211,360,293,362,328.0,338.0,69,-67,136
623,20,6,1,6,0,806,750,810,888,646,803,1149,803,328,472,453,543,498.0,489.0,90,-19,109
436,21,6,1,6,0,403,502,566,687,665,655,845,620,247,468,497,551,524.0,505.0,54,29,25
503,22,6,1,6,0,570,602,652,669,544,740,1032,399,306,506,449,585,517.0,513.0,136,-57,193
1456,1,7,3,6,0,945,1154,1068,958,710,977,1212,1265,890,1247,1119,1184,1152.0,1183.0,65,-128,193
248,2,7,3,6,0,99,83,62,79,45,66,119,104,63,214,133,132,132.0,160.0,-1,-81,80
163,3,7,3,6,0,85,56,51,54,43,56,75,86,64,154,131,164,148.0,150.0,33,-23,56
1670,4,7,3,6,0,824,1014,976,1027,677,793,1627,1352,1114,1508,1132,1430,1281.0,1357.0,298,-376,674
285,5,7,3,6,0,144,210,234,199,102,145,321,208,187,254,335,308,322.0,299.0,-27,81,-108
352,6,7,3,6,0,149,157,167,182,145,176,251,253,175,322,340,315,328.0,326.0,-25,18,-43
1405,7,7,3,6,0,644,701,698,710,494,739,1047,878,649,1303,1248,1216,1232.0,1256.0,-32,-55,23
242,8,7,3,6,0,115,93,101,121,83,105,184,165,123,244,320,272,296.0,279.0,-48,76,-124
1038,9,7,3,6,0,511,479,453,514,463,571,819,762,448,944,1100,1025,1062.0,1023.0,-75,156,-231
86,10,7,3,6,0,27,46,65,36,87,45,96,92,54,103,134,119,126.0,119.0,-15,31,-46
1276,11,7,3,6,0,664,704,653,923,563,731,1002,974,650,1188,1289,1048,1168.0,1175.0,-241,101,-342
162,12,7,3,6,0,54,83,56,89,43,74,97,118,85,164,140,153,146.0,152.0,13,-24,37
569,13,7,3,6,0,241,288,302,284,232,288,493,470,361,599,660,769,714.0,676.0,109,61,48
764,14,7,3,6,0,374,353,356,387,282,366,596,517,345,763,731,685,708.0,726.0,-46,-32,-14
808,15,7,3,6,0,390,895,578,350,278,533,736,534,424,754,915,865,890.0,845.0,-50,161,-211
234,16,7,3,6,0,130,108,119,115,66,94,173,151,103,240,253,187,220.0,227.0,-66,13,-79
206,17,7,3,6,0,59,68,91,68,60,83,119,101,59,203,163,182,172.0,183.0,19,-40,59
204,18,7,3,6,0,103,107,123,99,106,97,170,123,106,206,303,187,245.0,232.0,-116,97,-213
378,19,7,3,6,0,169,211,178,184,111,151,300,181,154,357,324,363,344.0,348.0,39,-33,72
151,20,7,3,6,0,63,75,66,120,43,58,100,60,71,130,181,128,154.0,146.0,-53,51,-104
358,21,7,3,6,0,156,195,228,164,136,164,313,234,179,320,305,340,322.0,322.0,35,-15,50
260,22,7,3,6,0,65,102,113,130,76,95,177,129,74,323,185,255,220.0,254.0,70,-138,208
516,1,8,2,6,0,494,547,504,605,431,543,697,325,168,288,309,527,418.0,375.0,218,21,197
55,2,8,2,6,0,56,86,60,80,64,106,112,40,25,38,54,68,61.0,53.0,14,16,-2
51,3,8,2,6,0,55,54,65,50,48,60,75,31,18,29,46,51,48.0,42.0,5,17,-12
60,4,8,2,6,0,96,96,105,107,59,86,132,40,51,59,50,54,52.0,54.0,4,-9,13
259,5,8,2,6,0,185,192,194,379,187,278,408,216,117,192,175,229,202.0,199.0,54,-17,71
463,6,8,2,6,0,304,284,383,452,363,447,587,357,148,207,278,368,323.0,284.0,90,71,19
355,7,8,2,6,0,403,384,434,524,437,477,555,320,180,373,400,374,387.0,382.0,-26,27,-53
60,8,8,2,6,0,53,53,40,61,59,55,64,30,23,28,38,44,41.0,37.0,6,10,-4
185,9,8,2,6,0,225,205,191,284,225,342,408,121,39,166,158,211,184.0,178.0,53,-8,61
60,10,8,2,6,0,56,48,72,86,66,86,129,68,34,47,50,71,60.0,56.0,21,3,18
1002,11,8,2,6,0,881,934,1240,1311,1156,1271,1767,893,628,788,879,1067,973.0,911.0,188,91,97
170,12,8,2,6,0,167,187,201,205,175,224,302,169,92,161,188,202,195.0,184.0,14,27,-13
149,13,8,2,6,0,156,130,129,149,129,127,215,80,56,93,108,163,136.0,121.0,55,15,40
259,14,8,2,6,0,222,222,264,300,257,320,368,183,97,185,329,340,334.0,285.0,11,144,-133
845,15,8,2,6,0,638,611,791,867,742,941,1163,445,309,478,511,775,643.0,588.0,264,33,231
243,16,8,2,6,0,221,204,189,253,233,287,401,211,94,172,184,195,190.0,184.0,11,12,-1
189,17,8,2,6,0,177,169,202,213,182,259,315,201,83,173,167,198,182.0,179.0,31,-6,37
140,18,8,2,6,0,66,59,77,86,70,117,145,54,20,51,78,114,96.0,81.0,36,27,9
37,19,8,2,6,0,56,94,56,78,81,68,104,28,21,52,82,45,64.0,60.0,-37,30,-67
64,20,8,2,6,0,61,45,63,77,40,57,62,28,20,37,37,33,35.0,36.0,-4,0,-4
102,21,8,2,6,0,96,102,126,137,141,113,177,107,51,78,83,124,104.0,95.0,41,5,36
17,22,8,2,6,0,25,30,29,39,29,28,30,11,11,8,18,20,19.0,15.0,2,10,-8
933,1,9,1,6,0,835,829,878,839,851,1537,1734,940,540,957,807,919,863.0,894.0,112,-150,262
290,2,9,1,6,0,297,444,406,375,464,639,732,400,288,346,301,327,314.0,325.0,26,-45,71
302,3,9,1,6,0,288,345,346,426,433,493,573,322,195,323,333,363,348.0,340.0,30,10,20
532,4,9,1,6,0,593,551,572,648,532,915,1057,659,394,601,489,595,542.0,562.0,106,-112,218
800,5,9,1,6,0,754,816,821,1394,1020,1293,1876,1072,611,873,761,808,784.0,814.0,47,-112,159
751,6,9,1,6,0,648,689,782,938,1018,1287,1597,1015,457,773,664,769,716.0,735.0,105,-109,214
1019,7,9,1,6,0,1119,1240,1232,1497,1547,1722,2394,1077,522,1253,1236,1215,1226.0,1235.0,-21,-17,-4
335,8,9,1,6,0,359,317,365,407,489,581,742,375,248,450,310,404,357.0,388.0,94,-140,234
1062,9,9,1,6,0,904,1023,986,1197,1508,2163,2594,949,463,1024,892,976,934.0,964.0,84,-132,216
302,10,9,1,6,0,307,308,261,338,373,502,713,341,210,322,222,345,284.0,296.0,123,-100,223
1281,11,9,1,6,0,1195,1141,1497,1413,1635,2059,2647,1466,939,1519,1181,1355,1268.0,1352.0,174,-338,512
677,12,9,1,6,0,635,717,687,798,900,1083,1527,753,397,757,746,837,792.0,780.0,91,-11,102
655,13,9,1,6,0,660,609,745,771,828,1012,1235,691,404,655,694,773,734.0,707.0,79,39,40
937,14,9,1,6,0,899,929,998,1228,1191,1470,2122,1000,589,1119,1013,903,958.0,1012.0,-110,-106,-4
879,15,9,1,6,0,862,813,942,1042,1090,1626,2068,1003,537,978,796,1015,906.0,930.0,219,-182,401
949,16,9,1,6,0,966,785,977,1135,1284,1519,1632,1025,485,1058,873,1015,944.0,982.0,142,-185,327
875,17,9,1,6,0,902,924,1034,1175,1168,1619,2178,1217,467,1068,962,1084,1023.0,1038.0,122,-106,228
408,18,9,1,6,0,273,417,426,426,568,767,913,522,257,433,373,497,435.0,434.0,124,-60,184
263,19,9,1,6,0,316,315,365,365,407,443,594,254,172,277,329,290,310.0,299.0,-39,52,-91
387,20,9,1,6,0,407,357,329,386,354,500,762,420,252,342,321,324,322.0,329.0,3,-21,24
732,21,9,1,6,0,263,316,283,360,444,478,651,365,184,306,238,357,298.0,300.0,119,-68,187
186,22,9,1,6,0,202,213,233,201,203,289,372,142,121,207,187,231,209.0,208.0,44,-20,64
2596,1,10,2,6,0,1353,1616,1715,1560,1261,1546,1428,635,513,975,1070,1137,1104.0,1061.0,67,95,-28
510,2,10,2,6,0,298,451,462,412,350,412,626,249,167,333,316,408,362.0,352.0,92,-17,109
413,3,10,2,6,0,328,313,335,434,451,516,701,285,178,320,330,439,384.0,363.0,109,10,99
335,4,10,2,6,0,232,247,248,278,174,264,913,106,74,113,101,453,277.0,222.0,352,-12,364
1954,5,10,2,6,0,1549,1800,1833,2351,1555,1783,2691,1134,763,1522,1501,1649,1575.0,1557.0,148,-21,169
2517,6,10,2,6,0,1957,2071,2572,2578,2110,2138,2356,1607,968,1908,2068,2171,2120.0,2049.0,103,160,-57
3954,7,10,2,6,0,2665,3185,3623,4079,3911,3787,4830,2048,1323,3138,3779,4223,4001.0,3713.0,444,641,-197
1085,8,10,2,6,0,612,635,770,774,678,852,1073,317,283,629,610,883,746.0,707.0,273,-19,292
2203,9,10,2,6,0,1841,2105,2230,2219,1912,2435,2500,695,488,1495,1512,1848,1680.0,1618.0,336,17,319
966,10,10,2,6,0,509,467,597,723,646,783,869,475,293,738,554,830,692.0,707.0,276,-184,460
4995,11,10,2,6,0,4119,4343,5439,5089,5170,5016,5865,2657,2401,4119,4083,4704,4394.0,4302.0,621,-36,657
1662,12,10,2,6,0,997,1282,1228,1446,1175,1376,1737,923,549,1502,1828,1895,1862.0,1742.0,67,326,-259
2761,13,10,2,6,0,1717,1730,2030,2166,1672,1926,2621,900,720,1379,2198,2809,2504.0,2129.0,611,819,-208
3400,14,10,2,6,0,2124,2569,3033,2794,2644,2874,3243,1683,1042,2558,3199,3067,3133.0,2941.0,-132,641,-773
2778,15,10,2,6,0,2635,2644,3079,3258,3003,3295,3490,1289,1038,1965,1876,2506,2191.0,2116.0,630,-89,719
1882,16,10,2,6,0,1346,1388,1694,1779,1500,1547,1624,929,480,1234,1278,1437,1358.0,1316.0,159,44,115
1720,17,10,2,6,0,1388,1464,1556,1793,1457,1585,1952,989,516,1513,1616,1696,1656.0,1608.0,80,103,-23
1184,18,10,2,6,0,600,1040,913,859,836,1130,958,546,402,859,878,1319,1098.0,1019.0,441,19,422
571,19,10,2,6,0,466,570,710,667,540,619,821,205,149,446,498,474,486.0,473.0,-24,52,-76
660,20,10,2,6,0,487,446,463,501,422,419,597,296,163,296,401,429,415.0,375.0,28,105,-77
1688,21,10,2,6,0,590,762,830,880,891,912,1151,413,242,475,689,883,786.0,682.0,194,214,-20
310,22,10,2,6,0,233,247,332,298,250,347,415,118,130,301,193,254,224.0,249.0,61,-108,169
101,1,11,2,6,0,121,130,170,225,144,225,270,79,27,45,95,103,99.0,81.0,8,50,-42
213,2,11,2,6,0,124,141,193,215,192,267,384,296,172,285,192,231,212.0,236.0,39,-93,132
177,3,11,2,6,0,155,165,211,257,237,359,450,248,124,211,203,178,190.0,197.0,-25,-8,-17
818,4,11,2,6,0,764,635,596,755,684,938,1287,118,74,556,952,1106,1029.0,871.0,154,396,-242
734,5,11,2,6,0,743,840,1135,1134,707,1002,2805,1326,797,891,676,702,689.0,756.0,26,-215,241
612,6,11,2,6,0,427,626,807,752,716,977,1443,903,436,535,520,582,551.0,546.0,62,-15,77
1335,7,11,2,6,0,1325,1510,2013,2253,1752,2198,3785,1878,1009,1343,1575,1488,1532.0,1469.0,-87,232,-319
426,8,11,2,6,0,273,396,591,635,370,1993,2925,603,248,417,464,574,519.0,485.0,110,47,63
1215,9,11,2,6,0,1183,1216,1851,1526,1065,2044,2419,914,399,1078,1095,1082,1088.0,1085.0,-13,17,-30
470,10,11,2,6,0,389,373,565,452,368,493,935,666,303,492,403,512,458.0,469.0,109,-89,198
944,11,11,2,6,0,971,1038,1263,1231,1184,1531,2308,910,648,752,1041,985,1013.0,926.0,-56,289,-345
561,12,11,2,6,0,479,591,657,831,701,917,1377,999,364,509,561,555,558.0,542.0,-6,52,-58
876,13,11,2,6,0,616,754,991,941,754,1144,2067,1110,641,741,953,1002,978.0,899.0,49,212,-163
1487,14,11,2,6,0,1321,1528,1922,1491,1090,1965,3560,2272,888,1199,1423,1368,1396.0,1330.0,-55,224,-279
1882,15,11,2,6,0,1900,1877,2534,1978,2287,3147,4324,1028,639,1114,1097,2340,1718.0,1517.0,1243,-17,1260
475,16,11,2,6,0,475,487,636,528,521,941,1534,1004,347,476,456,410,433.0,447.0,-46,-20,-26
716,17,11,2,6,0,885,1014,1148,1102,762,1142,1719,1133,438,685,688,650,669.0,674.0,-38,3,-41
722,18,11,2,6,0,596,710,861,605,468,762,1967,434,268,656,565,712,638.0,644.0,147,-91,238
167,19,11,2,6,0,242,328,373,319,239,291,520,199,149,205,202,188,195.0,198.0,-14,-3,-11
286,20,11,2,6,0,352,383,500,317,253,326,532,432,291,409,310,302,306.0,340.0,-8,-99,91
580,21,11,2,6,0,670,984,1191,1013,830,1010,1651,919,422,609,612,587,600.0,603.0,-25,3,-28
132,22,11,2,6,0,96,114,179,154,114,204,257,135,104,114,128,104,116.0,115.0,-24,14,-38
46,1,12,2,6,0,91,84,82,78,75,125,158,63,40,60,51,45,48.0,52.0,-6,-9,3
266,2,12,2,6,0,212,242,297,409,425,375,535,421,246,288,240,252,246.0,260.0,12,-48,60
206,3,12,2,6,0,141,155,186,321,287,448,676,363,164,250,212,180,196.0,214.0,-32,-38,6
61,4,12,2,6,0,166,192,229,328,289,360,496,86,74,109,80,71,76.0,87.0,-9,-29,20
628,5,12,2,6,0,542,612,740,894,870,831,1260,724,451,621,526,535,530.0,561.0,9,-95,104
346,6,12,2,6,0,272,360,423,570,478,510,806,576,272,358,315,316,316.0,330.0,1,-43,44
958,7,12,2,6,0,814,1067,1385,1544,1660,1778,2915,1529,762,977,1071,1025,1048.0,1024.0,-46,94,-140
543,8,12,2,6,0,304,387,526,657,689,668,1092,615,366,578,543,590,566.0,570.0,47,-35,82
867,9,12,2,6,0,706,726,1003,987,1170,1384,1437,718,363,821,836,734,785.0,797.0,-102,15,-117
316,10,12,2,6,0,215,205,275,336,321,463,659,452,233,370,288,292,290.0,317.0,4,-82,86
448,11,12,2,6,0,417,424,503,619,691,743,1008,543,405,518,460,406,433.0,461.0,-54,-58,4
301,12,12,2,6,0,321,323,384,576,518,577,816,634,247,323,301,331,316.0,318.0,30,-22,52
930,13,12,2,6,0,796,976,1190,1442,1308,1432,2365,1304,951,1023,1070,1210,1140.0,1101.0,140,47,93
850,14,12,2,6,0,796,921,1180,1362,1148,1406,2228,1526,717,888,888,823,856.0,866.0,-65,0,-65
507,15,12,2,6,0,497,546,656,656,660,874,1121,438,306,511,460,520,490.0,497.0,60,-51,111
362,16,12,2,6,0,308,353,445,594,534,655,903,635,255,364,342,325,334.0,344.0,-17,-22,5
517,17,12,2,6,0,570,561,665,852,609,763,1216,773,321,479,531,540,536.0,517.0,9,52,-43
248,18,12,2,6,0,203,218,279,280,218,239,420,249,153,274,195,252,224.0,240.0,57,-79,136
247,19,12,2,6,0,253,308,361,450,328,514,641,287,222,321,326,279,302.0,309.0,-47,5,-52
232,20,12,2,6,0,221,263,289,325,272,292,402,296,142,238,207,233,220.0,226.0,26,-31,57
471,21,12,2,6,0,383,562,667,705,729,755,1158,815,410,484,484,492,488.0,487.0,8,0,8
216,22,12,2,6,0,141,189,179,249,176,328,336,166,145,205,161,183,172.0,183.0,22,-44,66
92,1,13,1,6,0,130,143,149,181,158,314,461,180,102,190,125,145,135.0,153.0,20,-65,85
486,2,13,1,6,0,248,387,336,447,627,757,1396,1059,575,778,650,682,666.0,703.0,32,-128,160
356,3,13,1,6,0,174,186,216,287,324,527,720,520,270,473,409,472,440.0,451.0,63,-64,127
78,4,13,1,6,0,100,137,177,237,199,242,487,101,86,162,127,117,122.0,135.0,-10,-35,25
925,5,13,1,6,0,618,741,845,1263,1243,1605,2433,1860,1194,1302,1156,1192,1174.0,1217.0,36,-146,182
738,6,13,1,6,0,546,651,840,1069,1269,1370,2298,1440,720,878,861,934,898.0,891.0,73,-17,90
1321,7,13,1,6,0,768,927,999,1485,1686,2126,3804,2217,1109,1504,1812,1956,1884.0,1757.0,144,308,-164
531,8,13,1,6,0,224,271,379,496,642,748,1215,772,404,591,661,732,696.0,661.0,71,70,1
854,9,13,1,6,0,502,550,650,835,848,1467,2021,1040,446,977,1064,948,1006.0,996.0,-116,87,-203
385,10,13,1,6,0,240,225,284,342,388,511,880,738,330,660,454,586,520.0,567.0,132,-206,338
930,11,13,1,6,0,678,762,1001,1116,1451,1816,2525,1540,1130,1441,1246,1265,1256.0,1317.0,19,-195,214
491,12,13,1,6,0,377,409,440,725,733,889,1320,1015,377,598,631,632,632.0,620.0,1,33,-32
1518,13,13,1,6,0,785,958,1014,1437,1548,2026,3281,1882,1126,1456,2041,2368,2204.0,1955.0,327,585,-258
1135,14,13,1,6,0,719,857,953,1313,1473,1843,2975,2324,1002,1413,1518,1509,1514.0,1480.0,-9,105,-114
697,15,13,1,6,0,723,731,805,1089,1175,1502,2235,958,565,880,893,948,920.0,907.0,55,13,42
663,16,13,1,6,0,489,505,669,868,924,1339,1557,1148,463,782,723,758,740.0,754.0,35,-59,94
498,17,13,1,6,0,399,407,438,633,772,835,1281,1235,439,733,664,655,660.0,684.0,-9,-69,60
380,18,13,1,6,0,178,234,282,307,414,622,877,518,365,529,461,541,501.0,510.0,80,-68,148
266,19,13,1,6,0,191,236,231,291,296,396,542,311,224,349,397,405,401.0,384.0,8,48,-40
358,20,13,1,6,0,227,218,259,311,316,419,666,489,274,346,334,368,351.0,349.0,34,-12,46
405,21,13,1,6,0,271,303,362,519,627,715,1549,1036,394,463,535,597,566.0,532.0,62,72,-10
526,22,13,1,6,0,319,336,422,442,411,616,998,401,372,684,679,736,708.0,700.0,57,-5,62
429,1,14,1,6,0,422,464,522,661,472,781,1047,423,192,279,354,355,354.0,329.0,1,75,-74
955,2,14,1,6,0,706,939,877,1084,1148,1159,1879,1354,680,631,992,1295,1144.0,973.0,303,361,-58
724,3,14,1,6,0,433,551,578,725,701,941,1442,814,347,566,786,1042,914.0,798.0,256,220,36
386,4,14,1,6,0,391,454,496,664,474,569,1295,274,176,281,280,376,328.0,312.0,96,-1,97
1412,5,14,1,6,0,1306,1417,1488,2289,1556,2162,4188,2540,1081,1111,1488,1668,1578.0,1422.0,180,377,-197
1360,6,14,1,6,0,1295,1412,1803,1996,1889,2073,3650,2495,863,893,1218,1582,1400.0,1231.0,364,325,39
2666,7,14,1,6,0,2168,2583,2886,3461,3252,3594,6275,3467,1356,2002,3249,3444,3346.0,2898.0,195,1247,-1052
720,8,14,1,6,0,509,619,652,805,800,914,1576,743,357,500,790,998,894.0,763.0,208,290,-82
2247,9,14,1,6,0,1866,1837,2246,2808,2902,3269,4342,1784,653,1364,1722,2162,1942.0,1749.0,440,358,82
574,10,14,1,6,0,477,518,574,670,621,739,1316,892,381,556,538,802,670.0,632.0,264,-18,282
2604,11,14,1,6,0,2468,2600,3230,3453,3560,3776,5864,3032,1760,2316,2607,3244,2926.0,2722.0,637,291,346
811,12,14,1,6,0,839,839,860,1325,1195,1285,2160,1579,453,603,962,960,961.0,842.0,-2,359,-361
2213,13,14,1,6,0,1774,2024,2258,2481,2298,2594,4551,2375,1231,1427,2467,3049,2758.0,2314.0,582,1040,-458
2701,14,14,1,6,0,2539,3103,3396,3571,3427,4047,8018,5309,1586,1915,2716,3025,2870.0,2552.0,309,801,-492
1899,15,14,1,6,0,1905,1897,2229,2579,2724,3014,4336,1679,826,1161,1890,2275,2082.0,1775.0,385,729,-344
1264,16,14,1,6,0,1236,1304,1341,1747,1512,1848,3179,2049,551,906,1028,1278,1153.0,1071.0,250,122,128
1288,17,14,1,6,0,1450,1536,1679,2187,1872,2355,3747,2461,732,1157,1395,1621,1508.0,1391.0,226,238,-12
757,18,14,1,6,0,519,626,618,738,859,1140,1306,596,364,463,616,759,688.0,613.0,143,153,-10
969,19,14,1,6,0,846,1022,1132,1218,970,1188,1784,769,415,765,1227,1203,1215.0,1065.0,-24,462,-486
627,20,14,1,6,0,695,635,655,770,622,761,1417,877,373,399,529,594,562.0,507.0,65,130,-65
661,21,14,1,6,0,468,587,654,727,899,841,1546,1008,303,361,648,917,782.0,642.0,269,287,-18
831,22,14,1,6,0,573,663,777,675,517,944,1290,579,365,604,725,778,752.0,702.0,53,121,-68
689,1,15,2,6,0,680,680,720,820,623,807,1293,851,433,764,667,727,697.0,719.0,60,-97,157
414,2,15,2,6,0,242,468,405,456,394,535,639,509,300,415,361,462,412.0,413.0,101,-54,155
528,3,15,2,6,0,340,407,480,482,477,451,580,494,276,556,527,562,544.0,548.0,35,-29,64
1096,4,15,2,6,0,1019,1062,1143,1276,969,1288,2146,1327,923,1308,982,1002,992.0,1097.0,20,-326,346
651,5,15,2,6,0,487,585,715,1123,634,781,1105,856,454,680,597,621,609.0,633.0,24,-83,107
706,6,15,2,6,0,422,472,667,840,774,803,1070,953,364,644,584,685,634.0,638.0,101,-60,161
1141,7,15,2,6,0,988,988,1162,1315,1224,1513,1837,1329,778,1244,1284,1298,1291.0,1275.0,14,40,-26
660,8,15,2,6,0,598,604,750,729,770,798,1203,945,474,746,713,727,720.0,729.0,14,-33,47
696,9,15,2,6,0,335,313,351,438,425,536,825,423,180,427,549,477,513.0,484.0,-72,122,-194
151,10,15,2,6,0,114,93,121,141,135,160,243,179,71,140,141,183,162.0,155.0,42,1,41
1313,11,15,2,6,0,1215,1276,1793,1838,1848,1951,2643,1820,1058,1565,1288,1340,1314.0,1398.0,52,-277,329
293,12,15,2,6,0,274,321,334,419,377,424,571,408,151,325,301,312,306.0,313.0,11,-24,35
1539,13,15,2,6,0,961,977,1321,1377,1264,1433,1923,1604,884,1377,1523,1631,1577.0,1510.0,108,146,-38
1052,14,15,2,6,0,738,834,1010,1081,952,1113,1482,1178,548,1003,1062,1044,1053.0,1036.0,-18,59,-77
616,15,15,2,6,0,464,536,601,733,722,894,1112,767,352,679,681,651,666.0,670.0,-30,2,-32
275,16,15,2,6,0,317,260,295,373,329,377,483,446,164,271,261,296,278.0,276.0,35,-10,45
383,17,15,2,6,0,333,339,383,464,438,477,783,487,262,452,359,428,394.0,413.0,69,-93,162
297,18,15,2,6,0,158,212,189,235,212,345,456,397,140,227,217,291,254.0,245.0,74,-10,84
255,19,15,2,6,0,279,277,296,261,247,251,310,270,165,356,218,179,198.0,251.0,-39,-138,99
462,20,15,2,6,0,482,408,414,486,426,491,644,555,263,408,381,378,380.0,389.0,-3,-27,24
499,21,15,2,6,0,348,388,413,568,617,622,758,719,361,603,579,645,612.0,609.0,66,-24,90
121,22,15,2,6,0,115,124,187,159,142,152,169,104,79,149,106,141,124.0,132.0,35,-43,78
151,1,16,2,6,0,39,46,46,41,395,67,117,63,37,86,109,100,104.0,98.0,-9,23,-32
765,2,16,2,6,0,971,1395,1426,1254,988,1142,1590,946,692,1035,755,884,820.0,891.0,129,-280,409
629,3,16,2,6,0,690,744,864,895,802,945,982,602,413,714,724,743,734.0,727.0,19,10,9
292,4,16,2,6,0,717,716,794,737,477,625,985,300,271,404,282,274,278.0,320.0,-8,-122,114
2398,5,16,2,6,0,2651,2620,2791,2955,1733,2221,3340,1470,1639,3175,2405,2457,2431.0,2679.0,52,-770,822
452,6,16,2,6,0,479,502,552,488,424,410,575,248,260,384,279,286,282.0,316.0,7,-105,112
2420,7,16,2,6,0,2812,3126,3130,3837,3617,3662,4024,1903,1708,2748,2376,2932,2654.0,2685.0,556,-372,928
815,8,16,2,6,0,828,993,1217,1561,1243,1188,1616,679,442,672,792,892,842.0,785.0,100,120,-20
1936,9,16,2,6,0,1654,1766,1963,2010,1906,2111,2398,1196,1075,2249,1558,2005,1782.0,1937.0,447,-691,1138
523,10,16,2,6,0,331,405,319,409,384,459,435,440,301,449,664,501,582.0,538.0,-163,215,-378
670,11,16,2,6,0,786,701,745,840,781,777,930,527,626,655,605,586,596.0,615.0,-19,-50,31
296,12,16,2,6,0,292,330,358,538,488,482,540,354,189,356,270,359,314.0,328.0,89,-86,175
2856,13,16,2,6,0,3221,3102,3388,3910,3483,3233,4206,2068,1780,2633,2656,3148,2902.0,2812.0,492,23,469
1506,14,16,2,6,0,1974,2200,2100,2323,1931,2018,2962,1570,1050,1823,1515,1509,1512.0,1616.0,-6,-308,302
538,15,16,2,6,0,820,769,777,723,606,634,886,424,422,628,555,606,580.0,596.0,51,-73,124
403,16,16,2,6,0,623,595,715,725,585,544,920,483,270,442,304,376,340.0,374.0,72,-138,210
1076,17,16,2,6,0,1358,1456,1533,1680,1444,1489,2336,1714,653,1232,835,1023,929.0,1030.0,188,-397,585
428,18,16,2,6,0,487,627,773,710,690,597,622,308,292,460,424,486,455.0,457.0,62,-36,98
1237,19,16,2,6,0,1498,1804,1815,1871,1308,1478,1878,681,691,1319,1119,1215,1167.0,1218.0,96,-200,296
176,20,16,2,6,0,370,530,502,347,184,172,247,131,105,125,160,126,143.0,137.0,-34,35,-69
560,21,16,2,6,0,479,874,1106,695,580,634,1051,558,384,605,487,577,532.0,556.0,90,-118,208
1463,22,16,2,6,0,1253,1193,1427,1562,1308,1636,1781,730,952,1556,1254,1336,1295.0,1382.0,82,-302,384
4181,1,17,2,6,0,2462,1180,1500,2397,1674,2362,3060,1909,501,2672,4039,883,2461.0,2531.0,-3156,1367,-4523
827,2,17,2,6,0,551,884,974,1076,1038,1033,1402,656,504,651,603,785,694.0,680.0,182,-48,230
491,3,17,2,6,0,344,410,446,541,468,630,827,268,214,376,413,543,478.0,444.0,130,37,93
361,4,17,2,6,0,971,995,1118,835,516,1494,2145,217,200,2331,1550,280,915.0,1387.0,-1270,-781,-489
1459,5,17,2,6,0,1533,1662,1864,2707,1708,2119,2450,1355,937,1478,2078,1399,1738.0,1652.0,-679,600,-1279
1598,6,17,2,6,0,1799,2028,2809,2863,2529,2927,3132,1460,775,1436,1362,1591,1476.0,1463.0,229,-74,303
2569,7,17,2,6,0,2715,3147,4018,4409,4129,4087,5401,1885,1225,2010,2269,2615,2442.0,2298.0,346,259,87
1135,8,17,2,6,0,977,1223,1490,1510,1452,1547,2066,692,491,877,974,1192,1083.0,1014.0,218,97,121
1544,9,17,2,6,0,1796,1715,2112,2192,2036,2188,2519,625,462,1475,1506,1216,1361.0,1399.0,-290,31,-321
451,10,17,2,6,0,379,413,503,589,568,596,616,308,176,366,289,407,348.0,354.0,118,-77,195
3307,11,17,2,6,0,3219,3369,4854,5016,4475,5007,5643,2143,1862,2644,2631,3008,2820.0,2761.0,377,-13,390
1009,12,17,2,6,0,1233,1308,1681,2044,1627,1981,2357,973,442,916,895,1031,963.0,947.0,136,-21,157
2611,13,17,2,6,0,2587,2964,3829,3951,3277,3711,5424,1723,1261,2043,2652,2981,2816.0,2559.0,329,609,-280
3091,14,17,2,6,0,2702,3421,4398,4500,3793,4237,5119,2463,1238,2429,2562,2723,2642.0,2571.0,161,133,28
1474,15,17,2,6,0,1953,2021,2513,2777,2324,2401,2755,895,768,1359,1321,1533,1427.0,1404.0,212,-38,250
1085,16,17,2,6,0,1213,1120,1591,1818,1296,1466,1985,1002,357,841,848,822,835.0,837.0,-26,7,-33
1328,17,17,2,6,0,1517,1583,1906,2187,1670,2078,2533,1085,531,1104,1014,1204,1109.0,1107.0,190,-90,280
973,18,17,2,6,0,843,1055,1347,1279,1170,1218,1549,440,400,775,721,1235,978.0,910.0,514,-54,568
690,19,17,2,6,0,586,702,806,897,700,869,1098,268,212,386,587,555,571.0,509.0,-32,201,-233
800,20,17,2,6,0,1013,987,1230,1171,824,938,1120,617,359,603,607,619,613.0,610.0,12,4,8
1735,21,17,2,6,0,861,1113,1278,1300,1165,1199,1748,631,397,661,1831,842,1336.0,1111.0,-989,1170,-2159
452,22,17,2,6,0,327,303,404,404,286,466,480,162,156,276,218,323,270.0,272.0,105,-58,163
300,1,18,2,6,0,629,425,535,502,314,574,754,315,362,767,319,351,335.0,479.0,32,-448,480
442,2,18,2,6,0,461,551,450,435,635,692,866,452,295,448,404,525,464.0,459.0,121,-44,165
476,3,18,2,6,0,440,380,452,427,495,612,941,427,254,591,556,550,553.0,566.0,-6,-35,29
114,4,18,2,6,0,301,382,397,346,199,341,546,125,89,159,100,115,108.0,125.0,15,-59,74
1056,5,18,2,6,0,1055,1379,1197,903,838,1187,1812,1017,704,1344,1235,1081,1158.0,1220.0,-154,-109,-45
694,6,18,2,6,0,869,1109,958,734,813,952,1669,741,475,869,701,638,670.0,736.0,-63,-168,105
2558,7,18,2,6,0,2787,3450,3299,2451,2995,3812,5496,2330,1515,2865,2841,2834,2838.0,2847.0,-7,-24,17
1329,8,18,2,6,0,1270,1462,1588,1052,1126,1234,2626,1165,641,1247,1425,1531,1478.0,1401.0,106,178,-72
805,9,18,2,6,0,460,457,448,529,384,525,1055,368,255,433,540,513,526.0,495.0,-27,107,-134
405,10,18,2,6,0,352,363,291,255,362,355,448,365,155,240,485,249,367.0,325.0,-236,245,-481
792,11,18,2,6,0,1368,1353,1085,864,1310,1728,2261,1167,1028,1507,1281,827,1054.0,1205.0,-454,-226,-228
238,12,18,2,6,0,315,365,335,301,356,946,847,641,223,316,236,253,244.0,268.0,17,-80,97
2524,13,18,2,6,0,2715,3210,3609,2265,2586,3058,5478,1932,1551,2981,3513,3250,3382.0,3248.0,-263,532,-795
1487,14,18,2,6,0,1469,1701,1452,1141,1472,1941,3092,1731,893,1695,1504,1408,1456.0,1536.0,-96,-191,95
446,15,18,2,6,0,1016,1000,913,659,638,706,1205,504,467,741,598,514,556.0,618.0,-84,-143,59
164,16,18,2,6,0,353,277,263,202,272,348,657,298,154,273,222,166,194.0,220.0,-56,-51,-5
373,17,18,2,6,0,769,962,701,698,568,587,1351,576,253,448,437,409,423.0,431.0,-28,-11,-17
199,18,18,2,6,0,225,356,355,342,307,452,617,215,148,255,232,240,236.0,242.0,8,-23,31
679,19,18,2,6,0,589,621,716,684,572,853,1026,394,408,768,721,776,748.0,755.0,55,-47,102
207,20,18,2,6,0,413,558,474,304,408,379,694,353,248,346,329,249,289.0,308.0,-80,-17,-63
553,21,18,2,6,0,723,667,832,623,693,804,1400,754,418,791,600,553,576.0,648.0,-47,-191,144
466,22,18,2,6,0,283,369,508,307,324,496,710,280,266,503,464,518,491.0,495.0,54,-39,93
328,1,19,2,6,0,228,201,232,150,148,312,359,339,177,321,249,248,248.0,273.0,-1,-72,71
347,2,19,2,6,0,330,388,290,304,344,442,485,409,248,357,375,412,394.0,381.0,37,18,19
484,3,19,2,6,0,262,398,348,325,432,401,434,519,319,522,443,583,513.0,516.0,140,-79,219
1033,4,19,2,6,0,1039,990,1183,1150,795,1121,1802,1263,877,1267,1047,1549,1298.0,1288.0,502,-220,722
794,5,19,2,6,0,596,623,519,741,610,732,1083,1390,565,951,827,852,840.0,877.0,25,-124,149
570,6,19,2,6,0,403,381,360,323,440,519,629,667,315,471,534,553,544.0,519.0,19,63,-44
1554,7,19,2,6,0,1162,1256,1311,1391,1370,1666,1642,1861,878,1578,1694,1792,1743.0,1688.0,98,116,-18
395,8,19,2,6,0,264,316,332,330,480,421,414,426,317,451,395,445,420.0,430.0,50,-56,106
804,9,19,2,6,0,537,509,516,523,704,995,1243,727,322,827,693,791,742.0,770.0,98,-134,232
190,10,19,2,6,0,102,97,101,156,159,192,214,225,119,204,139,193,166.0,179.0,54,-65,119
1241,11,19,2,6,0,925,785,871,1280,881,1099,1374,1336,868,1301,1124,1278,1201.0,1234.0,154,-177,331
278,12,19,2,6,0,191,199,169,178,237,276,329,364,141,291,237,315,276.0,281.0,78,-54,132
1714,13,19,2,6,0,1391,1238,1360,1115,1052,1461,1615,1768,1165,1697,1805,2074,1940.0,1859.0,269,108,161
1413,14,19,2,6,0,913,957,1047,1104,1357,1223,1443,1429,856,1325,1403,1419,1411.0,1382.0,16,78,-62
646,15,19,2,6,0,492,475,404,404,512,747,863,742,356,707,633,707,670.0,682.0,74,-74,148
482,16,19,2,6,0,337,298,379,393,374,473,566,558,262,443,396,470,433.0,436.0,74,-47,121
379,17,19,2,6,0,277,273,291,253,248,418,494,519,230,424,383,397,390.0,401.0,14,-41,55
301,18,19,2,6,0,216,229,183,186,285,325,402,404,188,330,251,340,296.0,307.0,89,-79,168
790,19,19,2,6,0,769,652,721,569,738,644,1082,704,546,870,783,781,782.0,811.0,-2,-87,85
436,20,19,2,6,0,314,254,213,262,251,282,391,433,202,335,319,317,318.0,324.0,-2,-16,14
393,21,19,2,6,0,312,356,360,419,276,346,497,487,257,378,390,460,425.0,409.0,70,12,58
970,22,19,2,6,0,828,639,929,731,657,664,964,785,666,1198,1070,1179,1124.0,1149.0,109,-128,237
632,1,20,1,6,0,1141,897,946,1150,1010,1563,1504,815,447,731,532,612,572.0,625.0,80,-199,279
368,2,20,1,6,0,373,681,595,570,759,692,785,585,277,403,310,422,366.0,378.0,112,-93,205
153,3,20,1,6,0,254,296,333,327,407,342,430,303,110,229,177,183,180.0,196.0,6,-52,58
336,4,20,1,6,0,998,675,772,925,740,925,1127,376,284,427,371,462,416.0,420.0,91,-56,147
772,5,20,1,6,0,903,990,1085,1885,1100,1320,1775,1096,562,764,657,680,668.0,700.0,23,-107,130
605,6,20,1,6,0,725,769,980,1023,1001,1064,1490,952,364,600,581,589,585.0,590.0,8,-19,27
836,7,20,1,6,0,1082,1134,1323,1432,1303,1408,1739,940,501,805,813,957,885.0,858.0,144,8,136
107,8,20,1,6,0,221,257,295,289,333,332,371,229,113,151,138,130,134.0,140.0,-8,-13,5
947,9,20,1,6,0,1114,1097,1195,1320,1463,1644,2216,854,451,986,862,846,854.0,898.0,-16,-124,108
163,10,20,1,6,0,223,187,218,240,280,255,372,218,114,237,155,197,176.0,196.0,42,-82,124
1068,11,20,1,6,0,1433,1571,1947,1897,1872,2263,3132,1586,987,1345,1015,1158,1086.0,1173.0,143,-330,473
444,12,20,1,6,0,661,681,684,855,798,870,1144,754,284,498,430,503,466.0,477.0,73,-68,141
543,13,20,1,6,0,622,676,985,861,883,944,1218,652,442,599,687,716,702.0,667.0,29,88,-59
669,14,20,1,6,0,866,965,1056,1067,1021,1121,1578,856,471,700,719,644,682.0,688.0,-75,19,-94
1037,15,20,1,6,0,1826,1921,2037,2367,2323,2703,3371,1749,893,1369,1150,1156,1153.0,1225.0,6,-219,225
600,16,20,1,6,0,798,730,829,920,1033,988,1333,941,363,579,523,593,558.0,565.0,70,-56,126
562,17,20,1,6,0,770,811,908,1056,973,1081,1561,1003,386,716,610,659,634.0,662.0,49,-106,155
372,18,20,1,6,0,587,681,684,714,853,905,1102,667,370,551,387,534,460.0,491.0,147,-164,311
203,19,20,1,6,0,332,444,478,491,437,403,555,253,188,258,212,206,209.0,225.0,-6,-46,40
303,20,20,1,6,0,448,421,422,477,428,496,740,452,184,293,290,264,277.0,282.0,-26,-3,-23
233,21,20,1,6,0,335,338,351,433,450,479,533,395,223,292,216,328,272.0,279.0,112,-76,188
239,22,20,1,6,0,399,362,461,359,320,352,428,213,219,281,217,259,238.0,252.0,42,-64,106
427,1,21,2,6,0,464,464,563,552,450,685,688,275,231,396,369,368,368.0,378.0,-1,-27,26
368,2,21,2,6,0,509,837,743,640,687,714,1001,409,321,443,427,437,432.0,436.0,10,-16,26
460,3,21,2,6,0,393,509,544,557,650,671,789,370,239,440,455,525,490.0,473.0,70,15,55
491,4,21,2,6,0,1018,1021,1288,1431,1045,1332,1807,402,360,619,496,497,496.0,537.0,1,-123,124
1666,5,21,2,6,0,1748,1887,2009,2921,2017,2913,3590,1589,1106,1523,1538,1537,1538.0,1533.0,-1,15,-16
1070,6,21,2,6,0,1110,1307,1431,1596,1491,1717,1968,921,593,995,1124,1199,1162.0,1106.0,75,129,-54
1738,7,21,2,6,0,1895,2003,2387,2615,2547,2776,3299,1329,945,1856,2083,2108,2096.0,2016.0,25,227,-202
526,8,21,2,6,0,589,641,800,787,813,782,1130,401,261,510,549,610,580.0,556.0,61,39,22
1235,9,21,2,6,0,1093,1029,1303,1438,1702,2171,2397,475,354,1081,908,1044,976.0,1011.0,136,-173,309
274,10,21,2,6,0,295,287,282,358,395,493,595,225,179,348,224,290,257.0,287.0,66,-124,190
2155,11,21,2,6,0,2334,2394,3107,2962,3228,3579,4302,1623,1477,2234,2129,2434,2282.0,2266.0,305,-105,410
548,12,21,2,6,0,503,672,641,755,781,885,1016,398,230,537,551,590,570.0,559.0,39,14,25
2705,13,21,2,6,0,2392,2559,2979,2860,2877,2989,3954,1565,1311,2239,2725,3260,2992.0,2741.0,535,486,49
1780,14,21,2,6,0,1841,2115,2398,2493,2358,2638,3291,1489,872,1684,1948,1801,1874.0,1811.0,-147,264,-411
1417,15,21,2,6,0,1550,1572,1914,1992,2163,2458,2897,961,793,1491,1417,1453,1435.0,1454.0,36,-74,110
762,16,21,2,6,0,848,789,996,1142,948,1247,1304,805,357,634,667,656,662.0,652.0,-11,33,-44
563,17,21,2,6,0,696,720,817,950,757,948,1222,427,264,565,544,561,552.0,557.0,17,-21,38
444,18,21,2,6,0,495,680,640,694,837,946,924,385,327,518,415,620,518.0,518.0,205,-103,308
707,19,21,2,6,0,717,904,1088,1057,1007,1160,1513,414,423,828,916,847,882.0,864.0,-69,88,-157
388,20,21,2,6,0,378,375,374,365,407,493,612,296,209,288,300,336,318.0,308.0,36,12,24
452,21,21,2,6,0,472,701,761,801,945,946,1143,404,239,410,468,587,528.0,488.0,119,58,61
690,22,21,2,6,0,774,757,1154,914,753,1190,1198,462,436,1058,713,772,742.0,848.0,59,-345,404
740,1,22,4,6,0,553,600,670,690,633,790,925,325,455,653,555,624,590.0,611.0,69,-98,167
211,2,22,4,6,0,317,493,447,408,431,527,546,194,218,317,270,316,293.0,301.0,46,-47,93
266,3,22,4,6,0,301,313,341,355,371,359,418,168,163,287,292,335,314.0,305.0,43,5,38
664,4,22,4,6,0,826,879,911,1074,915,1162,1615,471,523,831,698,714,706.0,748.0,16,-133,149
630,5,22,4,6,0,715,745,722,1155,772,961,1167,445,516,738,665,640,652.0,681.0,-25,-73,48
565,6,22,4,6,0,656,677,767,841,878,933,1003,374,418,658,653,606,630.0,639.0,-47,-5,-42
1420,7,22,4,6,0,1685,1638,1852,2308,2307,2370,2766,875,984,1739,1860,1899,1880.0,1833.0,39,121,-82
225,8,22,4,6,0,275,285,300,313,320,355,484,139,184,247,243,229,236.0,240.0,-14,-4,-10
826,9,22,4,6,0,912,937,951,992,1092,1209,1464,402,402,896,629,772,700.0,766.0,143,-267,410
215,10,22,4,6,0,233,260,262,246,259,290,384,118,109,224,157,222,190.0,201.0,65,-67,132
1909,11,22,4,6,0,2016,2112,2209,2679,2595,2801,3241,1057,1612,2234,1953,2227,2090.0,2138.0,274,-281,555
273,12,22,4,6,0,347,434,393,442,498,481,511,213,176,385,307,351,329.0,348.0,44,-78,122
1571,13,22,4,6,0,1298,1298,1461,1525,1603,1929,2115,754,885,1533,1690,1813,1752.0,1679.0,123,157,-34
967,14,22,4,6,0,959,1096,1283,1383,1309,1461,1740,591,724,1200,1228,1058,1143.0,1162.0,-170,28,-198
1525,15,22,4,6,0,1671,1999,1697,1991,2033,2127,2662,818,1237,1764,1676,1729,1702.0,1723.0,53,-88,141
412,16,22,4,6,0,574,499,596,611,603,616,685,305,279,470,356,444,400.0,423.0,88,-114,202
341,17,22,4,6,0,442,503,514,645,501,559,768,256,278,497,347,424,386.0,423.0,77,-150,227
326,18,22,4,6,0,373,503,451,397,473,480,608,216,257,389,262,395,328.0,349.0,133,-127,260
321,19,22,4,6,0,420,483,505,553,489,516,595,169,217,412,408,386,397.0,402.0,-22,-4,-18
180,20,22,4,6,0,198,189,145,189,159,216,258,69,99,133,100,129,114.0,121.0,29,-33,62
301,21,22,4,6,0,321,402,487,425,510,487,657,185,238,361,306,395,350.0,354.0,89,-55,144
359,22,22,4,6,0,454,420,611,511,443,413,533,157,228,535,404,398,401.0,446.0,-6,-131,125
52,1,23,1,6,0,113,83,134,126,104,114,215,76,41,45,61,38,50.0,48.0,-23,16,-39
58,2,23,1,6,0,89,141,121,133,139,121,182,95,41,34,36,31,34.0,34.0,-5,2,-7
76,3,23,1,6,0,111,114,92,121,108,174,205,99,66,95,76,72,74.0,81.0,-4,-19,15
27,4,23,1,6,0,149,201,202,250,161,243,439,74,40,54,53,41,47.0,49.0,-12,-1,-11
150,5,23,1,6,0,301,284,317,459,291,297,513,309,153,136,133,149,141.0,139.0,16,-3,19
314,6,23,1,6,0,526,633,733,655,600,692,1047,578,273,312,307,331,319.0,317.0,24,-5,29
544,7,23,1,6,0,855,1000,1063,1138,1097,1099,1844,902,381,538,572,675,624.0,595.0,103,34,69
217,8,23,1,6,0,143,212,261,250,277,308,545,238,158,237,226,236,231.0,233.0,10,-11,21
96,9,23,1,6,0,223,291,295,282,277,289,373,126,71,118,103,101,102.0,107.0,-2,-15,13
40,10,23,1,6,0,100,108,107,108,100,115,162,93,53,69,35,53,44.0,52.0,18,-34,52
203,11,23,1,6,0,403,402,461,370,406,397,621,300,168,197,206,183,194.0,195.0,-23,9,-32
40,12,23,1,6,0,121,141,112,150,164,143,266,151,36,61,68,60,64.0,63.0,-8,7,-15
401,13,23,1,6,0,455,575,645,742,699,808,1460,748,389,430,459,518,488.0,469.0,59,29,30
254,14,23,1,6,0,453,477,544,566,471,617,1100,524,174,251,240,290,265.0,260.0,50,-11,61
90,15,23,1,6,0,161,194,181,198,211,191,260,101,55,63,66,67,66.0,65.0,1,3,-2
138,16,23,1,6,0,285,274,266,326,324,313,534,275,79,103,125,96,110.0,108.0,-29,22,-51
139,17,23,1,6,0,205,282,273,347,286,335,535,308,119,163,126,142,134.0,144.0,16,-37,53
42,18,23,1,6,0,88,101,114,102,89,87,129,60,25,51,31,35,33.0,39.0,4,-20,24
132,19,23,1,6,0,234,252,331,280,278,265,371,149,91,133,121,130,126.0,128.0,9,-12,21
88,20,23,1,6,0,222,247,251,250,189,199,335,168,84,69,66,80,73.0,72.0,14,-3,17
84,21,23,1,6,0,113,180,161,167,197,186,360,209,62,83,76,106,91.0,88.0,30,-7,37
86,22,23,1,6,0,206,165,264,248,169,223,312,126,95,154,101,143,122.0,133.0,42,-53,95
772,1,24,2,6,0,527,653,687,651,489,558,362,679,494,731,600,672,636.0,668.0,72,-131,203
194,2,24,2,6,0,185,247,209,201,174,160,155,229,130,223,186,188,187.0,199.0,2,-37,39
83,3,24,2,6,0,106,108,130,97,99,82,59,106,63,136,99,113,106.0,116.0,14,-37,51
618,4,24,2,6,0,646,748,847,831,642,654,521,798,532,838,575,694,634.0,702.0,119,-263,382
614,5,24,2,6,0,486,460,559,615,471,430,474,703,394,653,524,606,565.0,594.0,82,-129,211
346,6,24,2,6,0,244,244,344,348,248,228,187,338,203,372,311,341,326.0,341.0,30,-61,91
548,7,24,2,6,0,443,584,549,525,474,421,353,610,362,607,527,608,568.0,581.0,81,-80,161
152,8,24,2,6,0,101,121,154,121,105,117,105,129,94,160,139,138,138.0,146.0,-1,-21,20
1219,9,24,2,6,0,1160,1083,1238,1180,1049,976,1007,1207,847,1361,1093,1267,1180.0,1240.0,174,-268,442
153,10,24,2,6,0,129,142,161,151,126,138,119,159,102,172,121,154,138.0,149.0,33,-51,84
1639,11,24,2,6,0,1469,1509,1821,1585,1270,1186,1077,1735,1066,1713,1523,1554,1538.0,1597.0,31,-190,221
253,12,24,2,6,0,165,198,224,232,164,154,152,242,146,291,216,232,224.0,246.0,16,-75,91
327,13,24,2,6,0,337,350,330,362,307,254,182,340,242,360,379,362,370.0,367.0,-17,19,-36
320,14,24,2,6,0,291,353,389,339,239,284,223,320,199,311,289,319,304.0,306.0,30,-22,52
1501,15,24,2,6,0,1210,1486,1568,1439,1239,1136,1024,1529,973,1602,1326,1507,1416.0,1478.0,181,-276,457
369,16,24,2,6,0,300,346,383,407,272,273,274,370,238,369,296,339,318.0,335.0,43,-73,116
289,17,24,2,6,0,229,257,270,285,213,205,215,305,186,346,275,278,276.0,300.0,3,-71,74
528,18,24,2,6,0,354,394,437,448,353,321,324,518,242,572,350,498,424.0,473.0,148,-222,370
252,19,24,2,6,0,254,291,346,299,229,207,174,292,205,321,225,242,234.0,263.0,17,-96,113
232,20,24,2,6,0,232,259,222,255,197,217,217,267,199,277,240,244,242.0,254.0,4,-37,41
250,21,24,2,6,0,241,238,319,283,263,205,197,285,151,281,203,248,226.0,244.0,45,-78,123
113,22,24,2,6,0,80,75,119,71,81,63,53,93,68,133,85,82,84.0,100.0,-3,-48,45
314,1,25,1,6,0,272,297,303,281,281,247,225,315,160,297,263,287,275.0,282.0,24,-34,58
126,2,25,1,6,0,143,190,187,165,167,133,176,164,108,164,133,153,143.0,150.0,20,-31,51
97,3,25,1,6,0,109,112,117,120,96,85,86,86,62,103,111,102,106.0,105.0,-9,8,-17
257,4,25,1,6,0,362,331,427,429,308,324,417,323,190,356,270,290,280.0,305.0,20,-86,106
316,5,25,1,6,0,380,359,376,389,305,301,337,483,166,411,313,351,332.0,358.0,38,-98,136
172,6,25,1,6,0,187,156,227,205,162,169,174,188,119,173,183,210,196.0,189.0,27,10,17
234,7,25,1,6,0,309,263,302,292,265,227,253,339,160,306,297,331,314.0,311.0,34,-9,43
84,8,25,1,6,0,91,82,103,99,83,81,91,111,56,97,101,97,99.0,98.0,-4,4,-8
562,9,25,1,6,0,522,480,565,575,462,510,512,581,314,531,409,540,474.0,493.0,131,-122,253
114,10,25,1,6,0,124,96,117,108,102,103,109,128,57,103,59,104,82.0,89.0,45,-44,89
643,11,25,1,6,0,698,733,823,757,642,661,734,807,456,741,678,793,736.0,737.0,115,-63,178
118,12,25,1,6,0,139,120,153,155,115,129,138,165,79,158,126,152,139.0,145.0,26,-32,58
175,13,25,1,6,0,197,195,219,226,184,180,178,203,126,201,195,251,223.0,216.0,56,-6,62
156,14,25,1,6,0,189,189,186,187,161,189,173,186,103,191,191,194,192.0,192.0,3,0,3
647,15,25,1,6,0,565,645,709,620,587,599,595,656,382,738,625,720,672.0,694.0,95,-113,208
256,16,25,1,6,0,292,242,319,331,219,258,266,270,142,257,214,255,234.0,242.0,41,-43,84
162,17,25,1,6,0,169,164,219,179,160,168,191,210,114,205,161,191,176.0,186.0,30,-44,74
239,18,25,1,6,0,256,240,260,259,202,201,205,241,127,267,183,283,233.0,244.0,100,-84,184
146,19,25,1,6,0,154,152,161,165,130,138,128,140,90,113,125,138,132.0,125.0,13,12,1
130,20,25,1,6,0,142,148,158,109,123,106,134,131,54,117,102,136,119.0,118.0,34,-15,49
144,21,25,1,6,0,168,161,205,192,172,135,145,159,85,142,119,156,138.0,139.0,37,-23,60
70,22,25,1,6,0,70,67,99,74,50,53,61,68,34,78,65,79,72.0,74.0,14,-13,27
644,1,26,1,6,0,551,438,559,478,428,493,474,835,424,592,562,626,594.0,593.0,64,-30,94
223,2,26,1,6,0,222,190,240,237,204,210,215,310,178,234,223,203,213.0,220.0,-20,-11,-9
105,3,26,1,6,0,81,74,115,91,72,82,74,139,87,116,104,125,114.0,115.0,21,-12,33
726,4,26,1,6,0,717,674,824,853,604,747,817,1033,648,841,763,792,778.0,799.0,29,-78,107
507,5,26,1,6,0,494,344,458,388,382,361,382,695,383,524,456,456,456.0,479.0,0,-68,68
223,6,26,1,6,0,188,148,226,228,183,176,177,354,152,225,259,222,240.0,235.0,-37,34,-71
451,7,26,1,6,0,346,365,453,344,338,348,336,608,328,530,488,475,482.0,498.0,-13,-42,29
142,8,26,1,6,0,102,105,108,108,84,93,100,165,96,130,118,97,108.0,115.0,-21,-12,-9
962,9,26,1,6,0,769,689,886,875,627,766,825,1178,690,1101,964,1020,992.0,1028.0,56,-137,193
136,10,26,1,6,0,100,90,105,124,72,100,114,160,106,163,133,138,136.0,145.0,5,-30,35
1033,11,26,1,6,0,962,857,1124,918,791,915,1007,1591,766,1115,1026,1072,1049.0,1071.0,46,-89,135
168,12,26,1,6,0,125,115,140,155,101,129,108,227,115,167,214,182,198.0,188.0,-32,47,-79
301,13,26,1,6,0,229,221,266,200,202,203,219,376,209,316,289,290,290.0,298.0,1,-27,28
256,14,26,1,6,0,207,254,276,252,194,283,262,357,201,287,304,275,290.0,289.0,-29,17,-46
954,15,26,1,6,0,810,824,880,834,733,849,908,1436,623,970,967,965,966.0,967.0,-2,-3,1
393,16,26,1,6,0,260,260,327,326,230,315,356,436,202,366,316,282,299.0,321.0,-34,-50,16
219,17,26,1,6,0,200,157,190,184,143,174,192,302,179,246,255,226,240.0,242.0,-29,9,-38
330,18,26,1,6,0,265,234,296,266,197,227,256,500,212,338,297,357,327.0,331.0,60,-41,101
263,19,26,1,6,0,254,215,281,225,176,194,227,304,176,286,261,241,251.0,263.0,-20,-25,5
223,20,26,1,6,0,164,192,184,176,151,174,194,265,152,205,197,174,186.0,192.0,-23,-8,-15
252,21,26,1,6,0,206,235,213,228,210,194,216,307,140,222,205,251,228.0,226.0,46,-17,63
127,22,26,1,6,0,97,59,106,77,74,83,85,102,84,125,116,121,118.0,121.0,5,-9,14
142,1,27,4,6,0,149,152,203,190,188,201,262,80,97,160,113,154,134.0,142.0,41,-47,88
51,2,27,4,6,0,43,35,60,52,76,100,59,26,35,34,50,78,64.0,54.0,28,16,12
21,3,27,4,6,0,23,35,33,31,42,40,37,22,17,26,37,25,31.0,29.0,-12,11,-23
94,4,27,4,6,0,192,172,203,232,200,230,226,93,117,153,137,139,138.0,143.0,2,-16,18
128,5,27,4,6,0,94,121,152,216,166,240,223,57,76,90,137,164,150.0,130.0,27,47,-20
76,6,27,4,6,0,85,90,104,106,110,130,121,57,59,72,81,74,78.0,76.0,-7,9,-16
149,7,27,4,6,0,203,199,232,258,215,231,199,113,137,218,152,167,160.0,179.0,15,-66,81
22,8,27,4,6,0,28,32,37,31,31,28,33,16,10,28,22,76,49.0,42.0,54,-6,60
188,9,27,4,6,0,209,182,223,290,309,396,384,120,115,231,223,244,234.0,233.0,21,-8,29
31,10,27,4,6,0,23,25,29,35,34,41,40,20,18,18,25,33,29.0,25.0,8,7,1
329,11,27,4,6,0,345,389,471,447,420,635,591,225,325,414,342,390,366.0,382.0,48,-72,120
37,12,27,4,6,0,31,41,43,50,52,66,85,10,18,37,40,39,40.0,39.0,-1,3,-4
71,13,27,4,6,0,119,127,130,145,141,166,161,78,99,131,131,102,116.0,121.0,-29,0,-29
84,14,27,4,6,0,88,93,86,118,117,128,163,57,77,90,88,75,82.0,84.0,-13,-2,-11
355,15,27,4,6,0,297,361,382,415,422,523,567,168,290,344,386,300,343.0,343.0,-86,42,-128
69,16,27,4,6,0,72,79,106,110,92,120,142,48,54,76,88,66,77.0,77.0,-22,12,-34
46,17,27,4,6,0,48,45,64,96,79,112,124,41,43,61,74,75,74.0,70.0,1,13,-12
58,18,27,4,6,0,59,50,84,61,85,108,127,23,28,50,51,59,55.0,53.0,8,1,7
40,19,27,4,6,0,61,82,88,87,77,106,83,28,38,67,45,65,55.0,59.0,20,-22,42
37,20,27,4,6,0,28,26,35,47,43,77,67,17,20,19,34,34,34.0,29.0,0,15,-15
56,21,27,4,6,0,52,57,82,79,83,68,82,41,52,48,66,99,82.0,71.0,33,18,15
28,22,27,4,6,0,50,44,61,42,40,48,45,18,18,48,30,46,38.0,41.0,16,-18,34
498,1,28,2,6,0,736,581,360,145,129,306,492,378,283,374,311,427,369.0,371.0,116,-63,179
192,2,28,2,6,0,237,221,153,83,75,142,154,140,101,145,149,178,164.0,157.0,29,4,25
140,3,28,2,6,0,131,165,105,47,48,67,109,121,79,109,124,169,146.0,134.0,45,15,30
543,4,28,2,6,0,881,663,502,321,175,311,576,511,299,438,522,580,551.0,513.0,58,84,-26
529,5,28,2,6,0,609,554,488,356,206,340,526,495,291,361,444,497,470.0,434.0,53,83,-30
331,6,28,2,6,0,319,309,208,104,111,219,307,304,148,259,319,271,295.0,283.0,-48,60,-108
520,7,28,2,6,0,672,573,446,246,241,312,378,406,284,400,479,557,518.0,479.0,78,79,-1
99,8,28,2,6,0,145,138,80,47,46,58,83,94,61,99,97,93,95.0,96.0,-4,-2,-2
764,9,28,2,6,0,973,869,740,398,282,593,912,598,355,607,642,701,672.0,650.0,59,35,24
104,10,28,2,6,0,120,85,95,39,30,50,68,74,33,77,72,113,92.0,87.0,41,-5,46
1085,11,28,2,6,0,1500,1116,610,270,351,609,1028,993,652,891,910,1046,978.0,949.0,136,19,117
152,12,28,2,6,0,194,175,130,47,59,107,208,200,69,151,150,175,162.0,159.0,25,-1,26
423,13,28,2,6,0,506,429,351,172,141,298,340,342,250,323,382,440,411.0,382.0,58,59,-1
356,14,28,2,6,0,442,406,206,143,136,170,239,290,184,293,341,325,333.0,320.0,-16,48,-64
1284,15,28,2,6,0,1826,1257,815,643,498,965,1300,996,708,969,1088,1209,1148.0,1089.0,121,119,2
303,16,28,2,6,0,346,286,253,116,101,212,331,334,134,250,279,305,292.0,278.0,26,29,-3
267,17,28,2,6,0,344,325,229,78,92,180,310,284,146,251,271,354,312.0,292.0,83,20,63
221,18,28,2,6,0,285,288,200,69,95,138,176,229,97,153,164,270,217.0,196.0,106,11,95
370,19,28,2,6,0,459,433,291,193,157,189,261,256,190,274,317,341,329.0,311.0,24,43,-19
209,20,28,2,6,0,225,158,135,51,35,76,157,115,82,120,97,175,136.0,131.0,78,-23,101
199,21,28,2,6,0,315,249,241,115,96,127,205,223,136,166,239,247,243.0,217.0,8,73,-65
157,22,28,2,6,0,211,111,123,58,56,108,145,104,92,153,138,145,142.0,145.0,7,-15,22
387,1,29,1,6,0,327,408,528,494,298,341,507,266,214,347,256,335,296.0,313.0,79,-91,170
176,2,29,1,6,0,108,198,213,197,180,169,225,142,99,142,158,164,161.0,155.0,6,16,-10
136,3,29,1,6,0,136,178,178,174,157,121,169,76,74,105,133,145,139.0,128.0,12,28,-16
279,4,29,1,6,0,332,388,450,529,355,417,450,177,170,259,234,290,262.0,261.0,56,-25,81
319,5,29,1,6,0,406,440,533,641,403,433,394,242,224,324,333,361,347.0,339.0,28,9,19
227,6,29,1,6,0,223,244,297,328,172,256,310,160,139,211,231,217,224.0,220.0,-14,20,-34
398,7,29,1,6,0,378,352,487,582,453,469,507,305,251,332,402,428,415.0,387.0,26,70,-44
100,8,29,1,6,0,114,132,168,143,117,124,97,55,43,101,86,111,98.0,99.0,25,-15,40
694,9,29,1,6,0,684,704,813,867,710,821,895,435,271,630,599,641,620.0,623.0,42,-31,73
99,10,29,1,6,0,120,108,129,137,85,114,124,79,66,108,95,119,107.0,107.0,24,-13,37
879,11,29,1,6,0,854,952,1272,1166,688,937,1154,552,589,835,807,903,855.0,848.0,96,-28,124
146,12,29,1,6,0,151,183,202,193,186,189,178,106,91,145,142,176,159.0,154.0,34,-3,37
290,13,29,1,6,0,275,310,427,423,324,327,378,179,188,251,302,319,310.0,291.0,17,51,-34
212,14,29,1,6,0,257,301,336,420,237,276,308,156,143,260,258,238,248.0,252.0,-20,-2,-18
995,15,29,1,6,0,971,1162,1196,1045,917,1072,1169,550,543,759,841,892,866.0,831.0,51,82,-31
264,16,29,1,6,0,352,315,395,429,270,308,378,261,177,285,262,281,272.0,276.0,19,-23,42
222,17,29,1,6,0,286,268,360,359,193,226,309,145,129,251,238,285,262.0,258.0,47,-13,60
233,18,29,1,6,0,238,244,281,263,253,214,293,168,110,183,202,270,236.0,218.0,68,19,49
140,19,29,1,6,0,149,191,241,242,174,177,213,86,85,121,151,164,158.0,145.0,13,30,-17
131,20,29,1,6,0,135,121,146,128,96,89,130,65,59,92,68,101,84.0,87.0,33,-24,57
137,21,29,1,6,0,148,200,229,215,165,164,174,112,81,131,150,180,165.0,154.0,30,19,11
78,22,29,1,6,0,121,92,130,140,82,95,85,44,40,74,82,95,88.0,84.0,13,8,5
485,1,30,1,6,0,576,421,521,504,402,593,748,538,251,456,315,445,380.0,405.0,130,-141,271
290,2,30,1,6,0,204,306,266,231,316,323,344,263,166,191,198,263,230.0,217.0,65,7,58
178,3,30,1,6,0,169,162,217,201,207,206,200,197,109,152,165,213,189.0,177.0,48,13,35
754,4,30,1,6,0,1008,845,898,731,715,939,1050,755,424,693,651,781,716.0,708.0,130,-42,172
547,5,30,1,6,0,748,554,658,1072,583,560,641,624,348,443,468,502,485.0,471.0,34,25,9
317,6,30,1,6,0,300,257,346,329,282,331,409,330,200,229,256,264,260.0,250.0,8,27,-19
523,7,30,1,6,0,623,481,543,678,438,630,646,659,309,458,540,534,537.0,511.0,-6,82,-88
128,8,30,1,6,0,127,114,155,143,139,142,103,120,44,90,120,136,128.0,115.0,16,30,-14
1203,9,30,1,6,0,1303,1074,1237,1342,1295,1408,1829,1269,499,1006,894,1099,996.0,1000.0,205,-112,317
149,10,30,1,6,0,161,124,125,189,162,142,255,213,82,152,117,156,136.0,142.0,39,-35,74
955,11,30,1,6,0,1078,842,1106,1255,1040,1108,1430,1304,649,954,933,1003,968.0,963.0,70,-21,91
203,12,30,1,6,0,228,177,230,275,218,275,247,282,85,186,198,229,214.0,204.0,31,12,19
405,13,30,1,6,0,442,396,476,471,407,417,527,425,254,337,412,434,423.0,394.0,22,75,-53
372,14,30,1,6,0,472,400,422,469,405,382,502,442,251,354,426,325,376.0,368.0,-101,72,-173
1178,15,30,1,6,0,1251,1000,1181,1241,932,1214,1500,938,567,836,888,1017,952.0,914.0,129,52,77
445,16,30,1,6,0,467,358,427,529,447,473,526,572,259,428,363,377,370.0,389.0,14,-65,79
366,17,30,1,6,0,451,322,451,476,369,391,505,374,207,342,370,431,400.0,381.0,61,28,33
238,18,30,1,6,0,272,282,266,282,298,320,358,335,144,206,194,282,238.0,227.0,88,-12,100
277,19,30,1,6,0,340,365,459,418,357,335,454,281,156,268,293,330,312.0,297.0,37,25,12
284,20,30,1,6,0,291,189,230,259,188,209,244,199,108,153,121,186,154.0,153.0,65,-32,97
236,21,30,1,6,0,302,281,312,352,366,242,346,325,174,210,225,299,262.0,245.0,74,15,59
149,22,30,1,6,0,224,175,240,219,123,190,198,139,94,144,137,133,135.0,138.0,-4,-7,3
633,1,31,2,6,0,547,444,607,438,357,513,576,543,384,696,487,649,568.0,611.0,162,-209,371
249,2,31,2,6,0,183,177,213,139,117,236,257,243,199,312,234,314,274.0,287.0,80,-78,158
93,3,31,2,6,0,52,46,43,47,37,60,80,54,43,84,76,64,70.0,75.0,-12,-8,-4
587,4,31,2,6,0,595,494,449,410,328,585,816,536,311,688,527,617,572.0,611.0,90,-161,251
603,5,31,2,6,0,569,444,445,455,290,447,593,591,337,640,478,571,524.0,563.0,93,-162,255
362,6,31,2,6,0,284,251,265,236,233,275,385,322,230,435,350,391,370.0,392.0,41,-85,126
498,7,31,2,6,0,386,382,358,297,285,401,440,468,289,622,538,593,566.0,584.0,55,-84,139
70,8,31,2,6,0,61,45,60,31,30,61,103,57,64,78,79,91,85.0,83.0,12,1,11
1469,9,31,2,6,0,1023,972,1033,800,773,983,1319,1274,618,1449,1061,1394,1228.0,1301.0,333,-388,721
156,10,31,2,6,0,110,112,99,93,94,126,167,115,84,164,123,176,150.0,154.0,53,-41,94
1269,11,31,2,6,0,879,894,893,729,862,988,1160,1203,919,1681,1193,1428,1310.0,1434.0,235,-488,723
201,12,31,2,6,0,160,175,134,144,96,129,200,185,89,224,198,224,211.0,215.0,26,-26,52
423,13,31,2,6,0,287,249,266,194,192,281,283,417,232,460,496,484,490.0,480.0,-12,36,-48
397,14,31,2,6,0,315,276,272,209,174,237,350,258,224,388,425,429,427.0,414.0,4,37,-33
1650,15,31,2,6,0,1389,1189,1547,1208,929,1465,1724,1540,1004,2273,1596,1876,1736.0,1915.0,280,-677,957
353,16,31,2,6,0,266,203,235,199,144,218,283,271,143,325,266,300,283.0,297.0,34,-59,93
363,17,31,2,6,0,336,258,251,209,203,255,374,375,195,380,321,402,362.0,368.0,81,-59,140
307,18,31,2,6,0,252,323,276,236,214,251,346,352,161,369,304,419,362.0,364.0,115,-65,180
240,19,31,2,6,0,205,195,187,133,91,159,186,215,146,225,256,285,270.0,255.0,29,31,-2
315,20,31,2,6,0,227,183,189,132,105,200,253,198,131,290,195,274,234.0,253.0,79,-95,174
212,21,31,2,6,0,182,135,163,159,132,134,174,188,135,235,193,286,240.0,238.0,93,-42,135
90,22,31,2,6,0,66,52,57,23,28,58,76,70,44,104,104,97,100.0,102.0,-7,0,-7
208,1,32,3,6,0,256,328,379,426,299,501,825,333,136,253,217,192,204.0,221.0,-25,-36,11
559,2,32,3,6,0,552,695,707,913,926,928,1393,1050,634,598,559,552,556.0,570.0,-7,-39,32
128,3,32,3,6,0,99,134,132,200,230,272,405,185,132,207,141,156,148.0,168.0,15,-66,81
132,4,32,3,6,0,194,240,313,370,330,446,852,178,127,199,127,128,128.0,151.0,1,-72,73
387,5,32,3,6,0,569,778,755,971,792,934,1509,1063,565,512,413,385,399.0,437.0,-28,-99,71
842,6,32,3,6,0,790,1052,1349,1421,1263,1461,2601,1965,1072,936,771,749,760.0,819.0,-22,-165,143
1539,7,32,3,6,0,1628,2244,2677,2814,2975,3077,5360,2858,1598,1729,1694,1756,1725.0,1726.0,62,-35,97
390,8,32,3,6,0,353,542,640,778,791,803,1442,701,396,447,437,462,450.0,449.0,25,-10,35
2779,9,32,3,6,0,2768,3295,4086,5098,5032,5800,8421,3465,1872,3263,2465,2754,2610.0,2827.0,289,-798,1087
1326,10,32,3,6,0,1690,1981,2497,3110,3025,3479,6171,2981,1510,1845,1206,1444,1325.0,1498.0,238,-639,877
1251,11,32,3,6,0,1272,1577,1829,2045,1978,2153,3757,2028,1542,1465,1325,1301,1313.0,1364.0,-24,-140,116
393,12,32,3,6,0,410,598,635,806,703,736,1319,827,443,434,359,341,350.0,378.0,-18,-75,57
1072,13,32,3,6,0,888,1184,1505,1631,1500,1789,2863,1366,1047,1021,1146,1168,1157.0,1112.0,22,125,-103
2603,14,32,3,6,0,3020,3796,4302,4617,4700,5194,9539,6024,2842,2528,2423,2523,2473.0,2491.0,100,-105,205
621,15,32,3,6,0,799,1096,1291,1435,1528,1653,2646,934,580,745,680,733,706.0,719.0,53,-65,118
397,16,32,3,6,0,488,678,753,891,696,982,1629,1137,521,524,406,468,437.0,466.0,62,-118,180
657,17,32,3,6,0,747,984,1113,1544,1234,1513,2352,1658,771,808,663,615,639.0,695.0,-48,-145,97
319,18,32,3,6,0,360,626,548,706,724,738,1086,453,316,456,314,359,336.0,376.0,45,-142,187
534,19,32,3,6,0,376,528,616,644,644,694,1039,408,313,505,468,482,475.0,485.0,14,-37,51
158,20,32,3,6,0,287,297,277,359,279,304,514,324,210,169,172,136,154.0,159.0,-36,3,-39
436,21,32,3,6,0,358,538,648,785,855,1045,1704,937,403,499,452,488,470.0,480.0,36,-47,83
565,22,32,3,6,0,475,643,791,839,638,832,1045,394,365,562,482,469,476.0,504.0,-13,-80,67
608,1,33,2,6,0,835,1350,1065,2065,1032,1283,1483,389,338,505,521,647,584.0,558.0,126,16,110
198,2,33,2,6,0,208,404,346,402,396,360,567,208,160,208,214,226,220.0,216.0,12,6,6
355,3,33,2,6,0,415,569,575,712,648,698,789,413,215,340,311,387,349.0,346.0,76,-29,105
87,4,33,2,6,0,346,429,397,451,276,389,488,143,102,126,84,102,93.0,104.0,18,-42,60
581,5,33,2,6,0,695,682,820,1286,786,820,1117,531,374,577,521,559,540.0,552.0,38,-56,94
285,6,33,2,6,0,357,477,644,726,594,615,705,385,198,241,246,257,252.0,248.0,11,5,6
824,7,33,2,6,0,1075,1292,1454,1777,1435,1352,1707,803,424,738,843,928,886.0,836.0,85,105,-20
178,8,33,2,6,0,259,310,346,391,347,352,464,131,87,174,169,231,200.0,191.0,62,-5,67
246,9,33,2,6,0,296,248,286,326,342,407,475,130,117,221,195,239,217.0,218.0,44,-26,70
79,10,33,2,6,0,153,106,135,181,167,158,231,93,43,77,54,89,72.0,73.0,35,-23,58
1090,11,33,2,6,0,1504,1598,2024,2099,1880,1868,2181,991,782,1094,1007,1280,1144.0,1127.0,273,-87,360
188,12,33,2,6,0,268,290,349,532,430,438,495,251,128,183,180,217,198.0,193.0,37,-3,40
611,13,33,2,6,0,713,769,1026,1153,782,978,1229,546,360,592,598,847,722.0,679.0,249,6,243
586,14,33,2,6,0,595,849,951,954,750,835,1053,508,259,492,410,471,440.0,458.0,61,-82,143
576,15,33,2,6,0,655,723,773,920,884,1063,1213,348,291,556,450,632,541.0,546.0,182,-106,288
236,16,33,2,6,0,303,273,340,406,336,358,440,200,80,136,138,174,156.0,149.0,36,2,34
284,17,33,2,6,0,388,473,550,688,528,670,749,385,150,254,224,307,266.0,262.0,83,-30,113
240,18,33,2,6,0,207,297,275,314,302,385,408,188,136,178,176,297,236.0,217.0,121,-2,123
71,19,33,2,6,0,151,156,254,246,156,195,210,53,54,81,84,109,96.0,91.0,25,3,22
161,20,33,2,6,0,218,192,205,240,178,181,295,131,85,113,117,117,117.0,116.0,0,4,-4
548,21,33,2,6,0,666,1062,1276,1109,958,1012,1286,412,280,531,610,649,630.0,597.0,39,79,-40
105,22,33,2,6,0,200,199,236,256,202,210,228,66,80,160,104,150,127.0,138.0,46,-56,102
231,1,34,2,6,0,293,265,342,422,337,524,679,950,175,263,226,214,220.0,234.0,-12,-37,25
85,2,34,2,6,0,88,123,129,142,173,215,293,131,118,135,108,106,107.0,116.0,-2,-27,25
45,3,34,2,6,0,57,63,80,87,94,102,118,60,38,63,48,62,55.0,58.0,14,-15,29
108,4,34,2,6,0,157,165,158,241,166,231,280,180,87,167,105,117,111.0,130.0,12,-62,74
156,5,34,2,6,0,134,135,208,419,226,291,404,151,140,210,163,126,144.0,166.0,-37,-47,10
96,6,34,2,6,0,105,84,146,172,127,176,201,116,64,85,74,80,77.0,80.0,6,-11,17
243,7,34,2,6,0,208,207,253,405,274,383,451,230,146,276,296,237,266.0,270.0,-59,20,-79
37,8,34,2,6,0,47,58,68,104,75,85,95,42,23,68,34,43,38.0,48.0,9,-34,43
106,9,34,2,6,0,119,105,149,140,175,225,268,104,54,144,101,111,106.0,119.0,10,-43,53
31,10,34,2,6,0,35,28,43,42,39,42,71,30,28,32,17,42,30.0,30.0,25,-15,40
289,11,34,2,6,0,326,286,477,566,501,644,669,334,279,388,278,361,320.0,342.0,83,-110,193
44,12,34,2,6,0,55,61,72,97,83,104,86,64,32,40,53,58,56.0,50.0,5,13,-8
159,13,34,2,6,0,117,113,185,186,192,206,272,140,97,162,151,190,170.0,168.0,39,-11,50
159,14,34,2,6,0,115,109,191,156,169,219,319,144,90,156,142,133,138.0,144.0,-9,-14,5
184,15,34,2,6,0,199,216,262,293,289,400,452,190,120,235,179,236,208.0,217.0,57,-56,113
47,16,34,2,6,0,47,45,58,71,47,81,82,146,33,61,41,44,42.0,49.0,3,-20,23
92,17,34,2,6,0,93,121,118,158,115,135,228,105,59,115,89,71,80.0,92.0,-18,-26,8
55,18,34,2,6,0,80,72,82,93,107,132,139,77,43,64,62,76,69.0,67.0,14,-2,16
46,19,34,2,6,0,22,42,64,69,52,62,81,42,40,28,19,48,34.0,32.0,29,-9,38
81,20,34,2,6,0,68,61,42,66,46,77,87,44,31,56,52,34,43.0,47.0,-18,-4,-14
99,21,34,2,6,0,92,109,169,208,170,201,238,124,83,169,151,120,136.0,147.0,-31,-18,-13
34,22,34,2,6,0,30,38,60,45,45,56,48,22,17,60,50,40,45.0,50.0,-10,-10,0
247,1,35,2,6,0,138,110,96,130,129,206,317,238,124,175,178,198,188.0,184.0,20,3,17
74,2,35,2,6,0,62,53,48,150,68,61,94,64,55,50,58,59,58.0,56.0,1,8,-7
93,3,35,2,6,0,104,115,80,59,69,77,114,119,58,88,84,113,98.0,95.0,29,-4,33
405,4,35,2,6,0,362,522,549,341,411,466,954,488,303,463,422,404,413.0,430.0,-18,-41,23
356,5,35,2,6,0,313,287,213,226,219,270,560,493,212,308,310,321,316.0,313.0,11,2,9
181,6,35,2,6,0,112,137,105,226,131,164,192,238,108,126,152,161,156.0,146.0,9,26,-17
732,7,35,2,6,0,583,483,376,451,391,462,714,609,352,736,802,743,772.0,760.0,-59,66,-125
155,8,35,2,6,0,121,88,87,81,104,152,230,168,75,152,133,162,148.0,149.0,29,-19,48
1506,9,35,2,6,0,1204,796,688,783,887,1988,1893,1283,554,1157,1342,1371,1356.0,1290.0,29,185,-156
209,10,35,2,6,0,302,238,333,211,167,204,333,316,132,218,179,232,206.0,210.0,53,-39,92
696,11,35,2,6,0,633,614,701,409,489,602,865,785,520,701,575,790,682.0,689.0,215,-126,341
185,12,35,2,6,0,199,120,104,272,168,194,280,264,100,195,178,199,188.0,191.0,21,-17,38
470,13,35,2,6,0,271,278,358,279,275,250,454,387,248,489,372,444,408.0,435.0,72,-117,189
252,14,35,2,6,0,225,287,201,184,168,191,300,319,141,195,250,224,237.0,223.0,-26,55,-81
668,15,35,2,6,0,536,359,406,355,572,795,787,577,391,567,562,623,592.0,584.0,61,-5,66
475,16,35,2,6,0,422,178,222,287,394,374,566,545,193,390,310,389,350.0,363.0,79,-80,159
341,17,35,2,6,0,267,270,181,332,203,423,412,412,410,531,262,352,307.0,382.0,90,-269,359
517,18,35,2,6,0,255,324,353,331,397,363,562,555,242,485,658,692,675.0,612.0,34,173,-139
286,19,35,2,6,0,263,240,234,219,239,228,340,230,163,328,229,232,230.0,263.0,3,-99,102
499,20,35,2,6,0,467,292,184,281,158,348,846,378,203,261,239,256,248.0,252.0,17,-22,39
139,21,35,2,6,0,82,202,64,63,62,99,126,138,68,103,103,121,112.0,109.0,18,0,18
95,22,35,2,6,0,81,71,56,91,46,89,107,57,72,88,195,88,142.0,124.0,-107,107,-214
219,1,36,1,6,0,259,263,265,263,222,276,374,264,140,173,111,133,122.0,139.0,22,-62,84
251,2,36,1,6,0,259,444,328,322,420,444,423,403,246,278,240,349,294.0,289.0,109,-38,147
446,3,36,1,6,0,415,527,467,541,608,505,619,534,251,398,363,397,380.0,386.0,34,-35,69
648,4,36,1,6,0,776,823,803,1019,845,1016,1441,741,459,672,521,645,583.0,613.0,124,-151,275
696,5,36,1,6,0,668,723,668,1080,712,743,1078,940,507,616,610,516,563.0,581.0,-94,-6,-88
178,6,36,1,6,0,209,143,177,210,217,212,273,247,107,152,149,170,160.0,157.0,21,-3,24
628,7,36,1,6,0,666,592,643,866,764,681,1011,688,350,548,657,631,644.0,612.0,-26,109,-135
224,8,36,1,6,0,232,228,276,283,280,288,348,274,115,219,218,272,245.0,236.0,54,-1,55
1898,9,36,1,6,0,1676,1516,1456,1686,2097,2144,2562,1849,777,1549,1067,1547,1307.0,1388.0,480,-482,962
248,10,36,1,6,0,312,289,221,333,376,342,443,364,194,278,172,226,199.0,225.0,54,-106,160
534,11,36,1,6,0,594,521,656,670,713,682,857,658,425,546,407,545,476.0,499.0,138,-139,277
230,12,36,1,6,0,228,226,207,304,324,277,382,334,121,180,176,242,209.0,199.0,66,-4,70
721,13,36,1,6,0,655,636,756,829,875,790,1042,804,407,572,721,849,785.0,714.0,128,149,-21
484,14,36,1,6,0,478,457,520,525,514,567,656,654,303,427,422,450,436.0,433.0,28,-5,33
544,15,36,1,6,0,696,609,628,658,707,687,970,632,338,464,407,503,455.0,458.0,96,-57,153
1121,16,36,1,6,0,1189,812,879,1194,1234,1296,1458,1429,526,890,740,929,834.0,853.0,189,-150,339
496,17,36,1,6,0,432,433,504,586,532,579,879,712,262,444,376,475,426.0,432.0,99,-68,167
355,18,36,1,6,0,254,309,324,331,423,388,523,387,223,336,237,399,318.0,324.0,162,-99,261
583,19,36,1,6,0,717,778,859,919,871,786,1105,571,424,658,595,611,603.0,621.0,16,-63,79
544,20,36,1,6,0,863,400,378,452,406,568,732,616,327,364,351,290,320.0,335.0,-61,-13,-48
419,21,36,1,6,0,401,428,429,480,618,464,618,561,288,381,522,505,514.0,469.0,-17,141,-158
331,22,36,1,6,0,379,393,463,364,346,348,497,267,165,333,307,314,310.0,318.0,7,-26,33
46,1,37,2,6,0,95,119,125,135,111,242,237,68,37,61,48,42,45.0,50.0,-6,-13,7
92,2,37,2,6,0,110,141,143,170,165,182,271,140,100,100,97,72,84.0,90.0,-25,-3,-22
84,3,37,2,6,0,140,118,135,135,144,149,195,78,54,74,78,87,82.0,80.0,9,4,5
45,4,37,2,6,0,156,136,151,163,97,128,205,34,44,59,36,32,34.0,42.0,-4,-23,19
197,5,37,2,6,0,297,273,290,355,284,276,560,275,186,178,154,123,138.0,152.0,-31,-24,-7
125,6,37,2,6,0,164,187,210,258,234,289,496,209,109,109,97,103,100.0,103.0,6,-12,18
211,7,37,2,6,0,398,297,370,455,430,397,599,241,156,188,181,193,187.0,187.0,12,-7,19
81,8,37,2,6,0,136,138,154,165,187,192,226,67,52,65,70,76,73.0,70.0,6,5,1
568,9,37,2,6,0,957,908,969,966,1096,1273,1753,510,290,467,429,504,466.0,467.0,75,-38,113
103,10,37,2,6,0,145,121,133,163,183,209,314,161,76,113,66,89,78.0,89.0,23,-47,70
364,11,37,2,6,0,524,494,659,663,720,808,1176,484,399,360,358,395,376.0,371.0,37,-2,39
138,12,37,2,6,0,179,156,182,243,282,281,556,258,99,139,120,123,122.0,127.0,3,-19,22
178,13,37,2,6,0,278,240,275,311,284,290,435,164,126,133,165,184,174.0,161.0,19,32,-13
248,14,37,2,6,0,353,273,313,316,283,364,562,252,130,136,161,188,174.0,162.0,27,25,2
451,15,37,2,6,0,578,536,581,660,738,799,1102,332,255,331,293,293,293.0,306.0,0,-38,38
129,16,37,2,6,0,274,204,230,271,257,362,526,267,110,92,100,79,90.0,90.0,-21,8,-29
133,17,37,2,6,0,184,208,271,292,260,313,627,286,115,133,96,119,108.0,116.0,23,-37,60
134,18,37,2,6,0,218,246,274,282,315,340,500,185,128,160,130,141,136.0,144.0,11,-30,41
127,19,37,2,6,0,300,311,310,311,260,209,299,101,86,133,111,127,119.0,124.0,16,-22,38
101,20,37,2,6,0,215,160,199,165,151,159,317,179,87,70,59,80,70.0,70.0,21,-11,32
48,21,37,2,6,0,143,116,126,114,163,141,242,89,58,62,55,62,58.0,60.0,7,-7,14
78,22,37,2,6,0,146,135,155,139,103,121,126,60,44,65,66,61,64.0,64.0,-5,1,-6
280,1,38,2,6,0,401,321,346,427,336,1289,571,175,135,300,320,311,316.0,310.0,-9,20,-29
208,2,38,2,6,0,186,247,218,226,257,285,393,160,154,201,154,174,164.0,176.0,20,-47,67
354,3,38,2,6,0,185,198,218,291,326,339,631,236,164,278,287,352,320.0,306.0,65,9,56
344,4,38,2,6,0,663,697,743,797,664,656,980,232,253,315,319,299,309.0,311.0,-20,4,-24
870,5,38,2,6,0,808,786,904,1230,923,1016,1536,609,478,708,677,703,690.0,696.0,26,-31,57
474,6,38,2,6,0,304,319,476,565,666,550,750,358,257,522,447,450,448.0,473.0,3,-75,78
2046,7,38,2,6,0,1935,1835,2200,2915,3148,3502,5481,1788,1203,1635,2012,1985,1998.0,1877.0,-27,377,-404
870,8,38,2,6,0,496,521,585,792,899,919,1474,502,371,567,626,775,700.0,656.0,149,59,90
8612,9,38,2,6,0,8587,8085,9999,11167,12710,12394,15317,5306,3718,8079,6812,7957,7384.0,7616.0,1145,-1267,2412
1613,10,38,2,6,0,1046,1010,1186,1639,1709,1789,2693,1195,777,1366,1087,1463,1275.0,1305.0,376,-279,655
2343,11,38,2,6,0,1362,1273,1726,2274,2226,2622,3296,1247,1529,2148,2087,2259,2173.0,2165.0,172,-61,233
1050,12,38,2,6,0,595,606,715,1083,1277,1265,1764,857,484,797,835,979,907.0,870.0,144,38,106
1815,13,38,2,6,0,1117,1091,1516,1988,2221,2449,3796,1214,995,1259,1697,1832,1764.0,1596.0,135,438,-303
1525,14,38,2,6,0,918,1151,1553,1783,1739,1951,3130,1278,848,1290,1492,1391,1442.0,1391.0,-101,202,-303
1644,15,38,2,6,0,1050,1140,1443,1709,2001,2019,2088,700,801,1246,1369,1509,1439.0,1375.0,140,123,17
1061,16,38,2,6,0,851,689,870,1071,1120,1425,1562,736,376,772,827,842,834.0,814.0,15,55,-40
1476,17,38,2,6,0,1265,1384,1668,1721,1444,1769,3168,1244,677,1105,1093,1503,1298.0,1234.0,410,-12,422
1163,18,38,2,6,0,978,991,1227,1477,1846,1591,1981,769,598,1058,945,1316,1130.0,1106.0,371,-113,484
1822,19,38,2,6,0,2351,2715,3298,3035,2443,2622,3705,1059,1132,1642,1541,1606,1574.0,1596.0,65,-101,166
708,20,38,2,6,0,592,510,660,624,494,548,828,333,235,331,330,400,365.0,354.0,70,-1,71
299,21,38,2,6,0,408,480,451,462,457,402,722,289,175,287,284,326,305.0,299.0,42,-3,45
621,22,38,2,6,0,426,421,630,651,605,913,1064,350,347,604,509,589,549.0,567.0,80,-95,175
131,1,39,1,6,0,232,275,253,330,234,241,272,250,161,224,213,175,194.0,204.0,-38,-11,-27
209,2,39,1,6,0,237,317,281,288,285,282,383,494,162,297,298,329,314.0,308.0,31,1,30
232,3,39,1,6,0,278,346,325,397,353,331,374,412,213,364,399,353,376.0,372.0,-46,35,-81
135,4,39,1,6,0,454,541,459,651,432,527,798,336,255,324,347,230,288.0,300.0,-117,23,-140
108,5,39,1,6,0,365,374,356,560,353,364,502,560,198,280,354,296,325.0,310.0,-58,74,-132
86,6,39,1,6,0,321,347,370,464,369,339,449,378,228,339,365,359,362.0,354.0,-6,26,-32
369,7,39,1,6,0,1036,1063,896,1347,1014,1020,1083,1132,648,948,1214,1085,1150.0,1082.0,-129,266,-395
137,8,39,1,6,0,319,311,334,462,394,347,454,373,276,370,403,345,374.0,373.0,-58,33,-91
1566,9,39,1,6,0,2474,2478,2391,3040,2810,2842,3119,2859,1337,2735,2621,2524,2572.0,2627.0,-97,-114,17
140,10,39,1,6,0,260,273,237,346,287,279,316,376,154,306,255,297,276.0,286.0,42,-51,93
405,11,39,1,6,0,898,914,919,1153,908,905,1057,1012,579,905,787,820,804.0,837.0,33,-118,151
151,12,39,1,6,0,321,370,350,407,325,334,414,397,195,355,439,342,390.0,379.0,-97,84,-181
374,13,39,1,6,0,619,623,691,837,696,646,778,797,602,842,1066,971,1018.0,960.0,-95,224,-319
330,14,39,1,6,0,860,976,801,1165,786,979,1154,954,596,986,1159,919,1039.0,1021.0,-240,173,-413
277,15,39,1,6,0,619,746,631,767,611,709,819,752,388,650,682,669,676.0,667.0,-13,32,-45
674,16,39,1,6,0,1321,1289,1127,1463,1111,1292,1497,1405,549,1164,1131,1057,1094.0,1117.0,-74,-33,-41
218,17,39,1,6,0,693,656,726,776,563,649,953,623,341,556,689,570,630.0,605.0,-119,133,-252
226,18,39,1,6,0,554,655,558,641,586,610,611,627,347,556,479,612,546.0,549.0,133,-77,210
387,19,39,1,6,0,579,727,667,816,696,727,851,758,485,709,730,631,680.0,690.0,-99,21,-120
35,20,39,1,6,0,215,222,181,222,152,145,208,248,87,111,125,128,126.0,121.0,3,14,-11
198,21,39,1,6,0,335,362,360,429,415,400,482,463,229,331,386,360,373.0,359.0,-26,55,-81
268,22,39,1,6,0,545,503,567,621,450,630,549,617,346,607,485,461,473.0,518.0,-24,-122,98
259,1,40,1,6,0,242,256,281,287,238,345,456,114,153,205,172,211,192.0,196.0,39,-33,72
359,2,40,1,6,0,270,381,345,327,285,338,442,406,203,364,347,383,365.0,365.0,36,-17,53
324,3,40,1,6,0,238,235,267,246,282,331,382,195,193,311,298,379,338.0,329.0,81,-13,94
127,4,40,1,6,0,251,253,208,303,262,356,580,121,115,186,128,156,142.0,157.0,28,-58,86
472,5,40,1,6,0,461,453,451,636,487,569,804,459,234,390,378,467,422.0,412.0,89,-12,101
530,6,40,1,6,0,364,377,400,439,428,489,503,403,244,376,434,485,460.0,432.0,51,58,-7
900,7,40,1,6,0,768,778,692,815,855,912,1164,554,505,703,953,906,930.0,854.0,-47,250,-297
314,8,40,1,6,0,230,226,277,310,284,316,428,223,193,301,299,310,304.0,303.0,11,-2,13
3003,9,40,1,6,0,2317,2288,2219,2478,2450,3345,3730,1930,1262,2615,2284,2880,2582.0,2593.0,596,-331,927
332,10,40,1,6,0,262,277,270,290,313,377,417,266,187,309,304,370,337.0,328.0,66,-5,71
1239,11,40,1,6,0,1053,1035,1139,1193,1114,1454,1527,877,754,1069,1130,1243,1186.0,1147.0,113,61,52
498,12,40,1,6,0,324,354,314,340,317,350,507,305,161,323,377,500,438.0,400.0,123,54,69
842,13,40,1,6,0,563,517,521,590,551,574,797,453,434,572,723,877,800.0,724.0,154,151,3
826,14,40,1,6,0,620,657,647,687,548,872,1036,630,391,702,797,764,780.0,754.0,-33,95,-128
1188,15,40,1,6,0,851,928,863,800,942,1151,1258,739,529,861,969,1092,1030.0,974.0,123,108,15
1002,16,40,1,6,0,1022,954,876,1065,918,1189,1511,963,454,719,775,822,798.0,772.0,47,56,-9
484,17,40,1,6,0,412,436,456,456,452,506,737,420,189,443,430,470,450.0,448.0,40,-13,53
677,18,40,1,6,0,509,574,525,556,643,734,779,473,353,640,561,659,610.0,620.0,98,-79,177
466,19,40,1,6,0,359,423,434,437,390,480,602,285,241,431,475,512,494.0,473.0,37,44,-7
233,20,40,1,6,0,256,232,218,203,186,200,305,185,95,179,155,153,154.0,162.0,-2,-24,22
246,21,40,1,6,0,238,303,301,293,309,345,496,293,157,234,292,346,319.0,291.0,54,58,-4
388,22,40,1,6,0,361,360,329,347,306,404,422,214,206,322,309,385,347.0,339.0,76,-13,89
176,1,41,3,6,0,227,228,228,248,166,277,348,224,140,212,313,130,222.0,218.0,-183,101,-284
12,2,41,3,6,0,13,29,23,22,12,22,33,19,19,18,22,20,21.0,20.0,-2,4,-6
19,3,41,3,6,0,22,34,26,20,16,19,22,21,19,29,36,17,26.0,27.0,-19,7,-26
260,4,41,3,6,0,412,397,450,433,353,372,511,424,244,378,320,244,282.0,314.0,-76,-58,-18
34,5,41,3,6,0,50,45,33,53,34,42,64,69,42,47,33,29,31.0,36.0,-4,-14,10
62,6,41,3,6,0,54,58,60,65,52,74,75,83,59,59,57,45,51.0,54.0,-12,-2,-10
237,7,41,3,6,0,323,323,300,349,309,286,341,430,189,295,303,192,248.0,263.0,-111,8,-119
75,8,41,3,6,0,61,83,86,76,58,62,78,105,64,83,78,62,70.0,74.0,-16,-5,-11
865,9,41,3,6,0,824,845,827,959,887,972,1235,1009,443,848,749,579,664.0,725.0,-170,-99,-71
22,10,41,3,6,0,22,15,35,23,23,13,26,34,17,20,12,20,16.0,17.0,8,-8,16
305,11,41,3,6,0,366,390,384,352,323,380,481,397,258,351,301,241,271.0,298.0,-60,-50,-10
30,12,41,3,6,0,35,34,41,44,29,35,37,61,16,26,40,25,32.0,30.0,-15,14,-29
215,13,41,3,6,0,251,231,259,229,234,231,316,308,172,236,271,218,244.0,242.0,-53,35,-88
140,14,41,3,6,0,186,204,209,192,150,188,209,242,134,155,146,105,126.0,135.0,-41,-9,-32
449,15,41,3,6,0,263,302,300,252,293,323,375,353,222,270,371,311,341.0,317.0,-60,101,-161
64,16,41,3,6,0,56,41,58,58,26,64,62,54,47,52,51,39,45.0,47.0,-12,-1,-11
30,17,41,3,6,0,37,54,26,47,25,31,44,54,26,27,28,26,27.0,27.0,-2,1,-3
75,18,41,3,6,0,63,56,64,42,57,83,105,92,41,56,43,37,40.0,45.0,-6,-13,7
148,19,41,3,6,0,177,170,176,181,127,153,187,158,103,124,129,115,122.0,123.0,-14,5,-19
15,20,41,3,6,0,43,25,22,19,17,12,27,22,12,27,12,19,16.0,19.0,7,-15,22
23,21,41,3,6,0,39,32,34,19,25,29,46,61,16,38,37,27,32.0,34.0,-10,-1,-9
56,22,41,3,6,0,107,90,78,77,62,61,65,66,41,61,62,37,50.0,53.0,-25,1,-26
214,1,42,1,6,0,231,222,233,237,260,331,369,161,142,190,140,165,152.0,165.0,25,-50,75
232,2,42,1,6,0,280,397,351,388,519,521,651,386,202,309,233,292,262.0,278.0,59,-76,135
111,3,42,1,6,0,112,115,149,181,185,190,234,146,90,139,127,131,129.0,132.0,4,-12,16
130,4,42,1,6,0,240,223,271,313,223,301,382,210,141,181,149,153,151.0,161.0,4,-32,36
334,5,42,1,6,0,386,408,384,645,492,617,839,509,240,360,342,344,343.0,349.0,2,-18,20
273,6,42,1,6,0,323,371,429,508,453,504,690,387,163,254,266,293,280.0,271.0,27,12,15
507,7,42,1,6,0,569,603,642,825,774,709,964,444,303,464,570,555,562.0,530.0,-15,106,-121
191,8,42,1,6,0,247,194,300,278,277,302,443,175,132,238,204,221,212.0,221.0,17,-34,51
3064,9,42,1,6,0,3034,2769,3466,3967,4449,4901,5547,3229,1517,2906,3040,2996,3018.0,2981.0,-44,134,-178
230,10,42,1,6,0,305,295,375,362,434,458,665,381,181,321,247,278,262.0,282.0,31,-74,105
656,11,42,1,6,0,740,767,910,875,888,974,1139,690,508,722,614,698,656.0,678.0,84,-108,192
252,12,42,1,6,0,306,326,283,440,408,499,625,381,184,276,300,321,310.0,299.0,21,24,-3
400,13,42,1,6,0,437,434,560,591,602,602,830,407,320,433,514,507,510.0,485.0,-7,81,-88
405,14,42,1,6,0,445,414,574,666,620,614,920,507,247,499,530,473,502.0,501.0,-57,31,-88
859,15,42,1,6,0,959,917,968,1148,998,1169,1424,732,558,806,842,817,830.0,822.0,-25,36,-61
540,16,42,1,6,0,730,629,764,987,818,1066,1347,698,270,511,498,504,501.0,504.0,6,-13,19
401,17,42,1,6,0,522,526,503,752,630,700,988,570,203,418,421,498,460.0,446.0,77,3,74
635,18,42,1,6,0,509,603,671,676,754,796,1043,605,368,580,595,656,626.0,610.0,61,15,46
293,19,42,1,6,0,435,473,472,553,433,460,600,253,193,341,357,363,360.0,354.0,6,16,-10
159,20,42,1,6,0,246,168,172,243,227,222,229,139,105,116,140,127,134.0,128.0,-13,24,-37
135,21,42,1,6,0,148,148,164,191,253,229,293,140,96,140,126,155,140.0,140.0,29,-14,43
182,22,42,1,6,0,255,234,372,256,198,199,322,111,123,264,218,232,225.0,238.0,14,-46,60
223,1,43,2,6,0,242,279,368,455,354,457,516,264,193,369,368,312,340.0,350.0,-56,-1,-55
119,2,43,2,6,0,69,134,137,168,236,233,253,206,111,144,116,120,118.0,127.0,4,-28,32
185,3,43,2,6,0,112,170,148,180,212,200,238,219,114,172,145,184,164.0,167.0,39,-27,66
385,4,43,2,6,0,572,614,704,733,603,754,1094,601,390,482,397,375,386.0,418.0,-22,-85,63
270,5,43,2,6,0,241,286,280,498,363,489,543,391,237,325,296,251,274.0,291.0,-45,-29,-16
279,6,43,2,6,0,253,319,361,472,444,568,578,495,153,185,233,254,244.0,224.0,21,48,-27
753,7,43,2,6,0,594,653,771,1001,1018,1094,1221,1031,476,846,727,791,759.0,788.0,64,-119,183
249,8,43,2,6,0,319,310,398,381,370,395,605,316,221,369,335,297,316.0,334.0,-38,-34,-4
2250,9,43,2,6,0,1807,1926,2292,2762,3019,3563,3747,2666,1125,2377,2460,2143,2302.0,2327.0,-317,83,-400
104,10,43,2,6,0,107,105,132,134,146,194,174,193,92,119,101,114,108.0,111.0,13,-18,31
803,11,43,2,6,0,789,884,1139,1155,1292,1491,1524,1070,552,1008,901,895,898.0,935.0,-6,-107,101
165,12,43,2,6,0,142,163,206,280,258,340,409,346,81,166,179,201,190.0,182.0,22,13,9
652,13,43,2,6,0,621,573,819,812,975,971,1119,789,422,734,762,790,776.0,762.0,28,28,0
448,14,43,2,6,0,378,472,519,592,609,805,866,692,326,488,531,450,490.0,490.0,-81,43,-124
1385,15,43,2,6,0,797,1116,1100,1259,1371,1516,1515,1138,549,969,1010,1108,1059.0,1029.0,98,41,57
436,16,43,2,6,0,462,346,475,707,729,779,906,749,253,446,434,381,408.0,420.0,-53,-12,-41
431,17,43,2,6,0,350,381,419,626,645,767,839,710,238,437,402,430,416.0,423.0,28,-35,63
527,18,43,2,6,0,251,400,389,434,571,612,638,509,288,542,508,519,514.0,523.0,11,-34,45
851,19,43,2,6,0,843,1057,1068,1256,1020,1269,1395,898,506,962,872,971,922.0,935.0,99,-90,189
160,20,43,2,6,0,243,183,190,183,170,200,213,159,106,164,130,104,117.0,133.0,-26,-34,8
129,21,43,2,6,0,212,278,246,251,273,309,371,227,159,225,195,179,187.0,200.0,-16,-30,14
306,22,43,2,6,0,440,381,659,536,422,639,783,366,217,537,358,448,403.0,448.0,90,-179,269
208,1,44,1,6,0,143,213,231,263,186,304,291,260,125,252,169,218,194.0,213.0,49,-83,132
43,2,44,1,6,0,40,86,70,45,62,97,95,78,48,59,48,61,54.0,56.0,13,-11,24
55,3,44,1,6,0,30,34,48,53,57,54,64,35,18,51,53,69,61.0,58.0,16,2,14
396,4,44,1,6,0,328,387,431,542,458,551,739,435,233,445,341,391,366.0,392.0,50,-104,154
231,5,44,1,6,0,198,208,192,406,218,246,296,270,133,178,212,190,201.0,193.0,-22,34,-56
70,6,44,1,6,0,68,83,102,108,119,125,125,156,59,89,69,81,75.0,80.0,12,-20,32
179,7,44,1,6,0,189,211,236,259,209,228,356,218,112,223,197,226,212.0,215.0,29,-26,55
35,8,44,1,6,0,37,39,38,29,27,53,51,47,21,35,29,43,36.0,36.0,14,-6,20
497,9,44,1,6,0,315,201,283,319,341,442,572,437,152,310,246,338,292.0,298.0,92,-64,156
35,10,44,1,6,0,44,25,47,48,35,38,46,44,34,25,32,38,35.0,32.0,6,7,-1
189,11,44,1,6,0,160,179,202,235,218,248,301,251,138,200,177,214,196.0,197.0,37,-23,60
51,12,44,1,6,0,46,43,63,74,57,75,92,84,32,51,53,76,64.0,60.0,23,2,21
111,13,44,1,6,0,85,75,106,81,95,123,131,106,79,112,113,144,128.0,123.0,31,1,30
118,14,44,1,6,0,115,120,133,136,137,144,187,131,57,111,155,108,132.0,125.0,-47,44,-91
142,15,44,1,6,0,103,117,123,127,129,149,230,149,78,139,107,108,108.0,118.0,1,-32,33
110,16,44,1,6,0,83,100,88,128,132,148,184,148,61,111,94,101,98.0,102.0,7,-17,24
118,17,44,1,6,0,99,113,129,125,121,157,211,135,74,132,109,108,108.0,116.0,-1,-23,22
95,18,44,1,6,0,85,91,79,63,93,111,124,108,57,77,71,97,84.0,82.0,26,-6,32
67,19,44,1,6,0,94,86,129,93,93,126,129,69,51,75,76,107,92.0,86.0,31,1,30
149,20,44,1,6,0,141,124,91,113,105,132,160,125,77,112,97,87,92.0,99.0,-10,-15,5
117,21,44,1,6,0,93,101,114,118,176,150,182,148,77,137,111,172,142.0,140.0,61,-26,87
51,22,44,1,6,0,77,51,83,64,44,71,77,53,34,68,53,50,52.0,57.0,-3,-15,12
104,1,45,1,6,0,100,120,182,195,186,244,388,154,85,126,92,105,98.0,108.0,13,-34,47
69,2,45,1,6,0,102,132,175,199,190,214,267,194,91,60,53,77,65.0,63.0,24,-7,31
40,3,45,1,6,0,90,86,129,117,180,167,259,127,62,61,62,68,65.0,64.0,6,1,5
23,4,45,1,6,0,132,124,189,195,143,181,370,71,41,51,25,21,23.0,32.0,-4,-26,22
105,5,45,1,6,0,235,259,271,451,335,432,691,448,194,129,110,118,114.0,119.0,8,-19,27
222,6,45,1,6,0,409,457,615,665,719,699,1253,712,250,227,217,259,238.0,234.0,42,-10,52
246,7,45,1,6,0,542,525,598,799,850,792,1449,549,320,297,347,332,340.0,325.0,-15,50,-65
108,8,45,1,6,0,119,112,180,176,226,231,426,153,81,103,83,114,98.0,100.0,31,-20,51
349,9,45,1,6,0,557,570,682,810,953,1204,1628,496,168,342,246,344,295.0,311.0,98,-96,194
23,10,45,1,6,0,74,74,93,96,119,135,240,121,56,54,26,39,32.0,40.0,13,-28,41
371,11,45,1,6,0,558,664,879,928,1050,1083,1908,768,543,404,402,487,444.0,431.0,85,-2,87
126,12,45,1,6,0,238,256,256,368,358,434,733,453,153,150,168,191,180.0,170.0,23,18,5
276,13,45,1,6,0,372,433,513,576,665,667,1158,476,272,257,300,350,325.0,302.0,50,43,7
295,14,45,1,6,0,565,604,728,823,894,1006,1883,910,372,312,380,366,373.0,353.0,-14,68,-82
407,15,45,1,6,0,623,618,806,968,1022,1202,2202,744,430,386,337,361,349.0,361.0,24,-49,73
146,16,45,1,6,0,214,224,236,278,353,409,749,443,143,138,130,145,138.0,138.0,15,-8,23
134,17,45,1,6,0,206,221,263,352,322,439,744,378,131,137,149,138,144.0,141.0,-11,12,-23
127,18,45,1,6,0,163,185,197,242,345,391,594,265,149,173,130,137,134.0,147.0,7,-43,50
47,19,45,1,6,0,127,118,166,151,176,186,256,75,62,80,75,84,80.0,80.0,9,-5,14
27,20,45,1,6,0,103,92,81,101,86,92,172,124,38,29,23,20,22.0,24.0,-3,-6,3
57,21,45,1,6,0,107,108,126,155,205,212,325,144,79,70,64,97,80.0,77.0,33,-6,39
41,22,45,1,6,0,90,66,138,116,107,126,152,43,36,52,38,43,40.0,44.0,5,-14,19
12,1,46,1,6,0,83,70,93,94,69,88,96,65,19,37,175,5,90.0,72.0,-170,138,-308
57,2,46,1,6,0,145,260,181,192,214,209,182,216,75,82,86,83,84.0,84.0,-3,4,-7
41,3,46,1,6,0,132,152,130,174,176,130,141,132,46,66,45,69,57.0,60.0,24,-21,45
26,4,46,1,6,0,203,267,229,259,158,186,277,124,81,65,48,29,38.0,47.0,-19,-17,-2
64,5,46,1,6,0,277,338,249,374,267,205,292,350,117,93,78,81,80.0,84.0,3,-15,18
118,6,46,1,6,0,403,369,409,407,332,341,384,513,121,108,92,90,91.0,97.0,-2,-16,14
175,7,46,1,6,0,534,578,578,669,572,480,596,555,214,153,209,203,206.0,188.0,-6,56,-62
12,8,46,1,6,0,72,80,105,82,89,70,67,66,26,12,22,19,20.0,18.0,-3,10,-13
29,9,46,1,6,0,161,153,130,99,91,101,84,62,19,63,37,30,34.0,43.0,-7,-26,19
2,10,46,1,6,0,56,59,47,57,42,39,50,45,14,26,20,6,13.0,17.0,-14,-6,-8
134,11,46,1,6,0,498,540,652,534,502,474,569,538,214,216,188,191,190.0,198.0,3,-28,31
79,12,46,1,6,0,296,334,361,423,281,274,309,360,94,101,91,90,90.0,94.0,-1,-10,9
131,13,46,1,6,0,331,415,474,378,372,326,383,353,154,150,162,149,156.0,154.0,-13,12,-25
87,14,46,1,6,0,439,537,516,505,471,372,457,538,139,100,129,104,116.0,111.0,-25,29,-54
106,15,46,1,6,0,523,527,619,525,437,429,453,388,129,152,151,108,130.0,137.0,-43,-1,-42
186,16,46,1,6,0,347,357,348,470,379,317,421,474,120,139,119,158,138.0,139.0,39,-20,59
115,17,46,1,6,0,332,369,394,455,353,348,428,459,95,148,114,114,114.0,125.0,0,-34,34
51,18,46,1,6,0,97,156,140,150,148,127,159,136,38,44,37,55,46.0,45.0,18,-7,25
53,19,46,1,6,0,186,211,236,239,216,174,238,151,59,93,137,105,121.0,112.0,-32,44,-76
16,20,46,1,6,0,207,154,160,119,108,151,126,110,41,27,16,19,18.0,21.0,3,-11,14
70,21,46,1,6,0,195,243,241,219,279,210,288,180,80,67,82,94,88.0,81.0,12,15,-3
22,22,46,1,6,0,119,135,185,126,121,118,156,75,46,57,45,34,40.0,45.0,-11,-12,1
267,1,47,2,6,0,184,200,260,330,188,341,384,208,78,136,169,219,194.0,175.0,50,33,17
111,2,47,2,6,0,115,160,152,177,216,186,206,142,56,68,79,116,98.0,88.0,37,11,26
39,3,47,2,6,0,92,95,118,103,121,125,115,74,44,45,52,72,62.0,56.0,20,7,13
198,4,47,2,6,0,404,587,598,646,461,553,771,253,139,206,162,160,161.0,176.0,-2,-44,42
459,5,47,2,6,0,525,529,541,770,548,657,933,673,263,243,304,396,350.0,314.0,92,61,31
609,6,47,2,6,0,812,815,909,849,800,764,993,964,338,340,389,526,458.0,418.0,137,49,88
546,7,47,2,6,0,798,955,1028,1068,979,957,1332,1011,383,430,537,623,580.0,530.0,86,107,-21
137,8,47,2,6,0,158,166,260,200,213,203,275,128,67,102,111,136,124.0,116.0,25,9,16
773,9,47,2,6,0,826,970,1165,1341,1182,1660,1546,767,278,638,579,734,656.0,650.0,155,-59,214
135,10,47,2,6,0,160,138,192,192,181,188,276,186,86,105,86,125,106.0,105.0,39,-19,58
1448,11,47,2,6,0,1549,1784,2086,2054,2015,2022,2642,2094,991,984,1074,1356,1215.0,1138.0,282,90,192
317,12,47,2,6,0,403,446,466,481,368,453,691,614,157,211,274,326,300.0,270.0,52,63,-11
385,13,47,2,6,0,550,679,797,728,665,667,773,530,290,330,342,436,389.0,369.0,94,12,82
1267,14,47,2,6,0,1405,1588,1680,1676,1390,1577,2409,1865,640,650,891,1055,973.0,865.0,164,241,-77
1088,15,47,2,6,0,1267,1405,1649,1572,1696,1832,2222,1022,501,663,715,913,814.0,764.0,198,52,146
333,16,47,2,6,0,470,475,562,525,475,492,661,605,178,211,256,312,284.0,260.0,56,45,11
372,17,47,2,6,0,445,414,541,561,481,547,698,488,170,228,287,352,320.0,289.0,65,59,6
332,18,47,2,6,0,284,350,418,427,469,556,601,361,197,246,246,307,276.0,266.0,61,0,61
137,19,47,2,6,0,226,287,309,335,246,211,328,161,100,120,120,168,144.0,136.0,48,0,48
295,20,47,2,6,0,447,415,439,445,330,373,430,326,140,158,145,189,167.0,164.0,44,-13,57
170,21,47,2,6,0,278,349,407,350,449,347,562,349,119,145,167,210,188.0,174.0,43,22,21
47,22,47,2,6,0,89,128,149,133,82,97,100,69,37,53,48,62,55.0,54.0,14,-5,19
12,1,48,2,6,0,22,13,27,10,4,41,46,32,19,54,17,10,14.0,27.0,-7,-37,30
66,2,48,2,6,0,148,181,200,159,126,119,169,142,104,91,53,62,58.0,69.0,9,-38,47
174,3,48,2,6,0,233,350,323,327,297,353,430,278,168,258,163,176,170.0,199.0,13,-95,108
12,4,48,2,6,0,151,170,121,96,46,78,112,52,38,30,13,7,10.0,17.0,-6,-17,11
143,5,48,2,6,0,834,869,836,723,408,517,641,617,336,250,134,145,140.0,176.0,11,-116,127
88,6,48,2,6,0,322,293,261,211,71,198,190,278,146,119,59,72,66.0,83.0,13,-60,73
650,7,48,2,6,0,1542,1763,1885,1782,1445,1562,2281,1763,885,746,509,752,630.0,669.0,243,-237,480
252,8,48,2,6,0,670,854,973,842,579,768,886,691,295,401,285,317,301.0,334.0,32,-116,148
139,9,48,2,6,0,730,793,791,821,619,710,1008,472,229,471,212,177,194.0,287.0,-35,-259,224
102,10,48,2,6,0,190,169,185,191,132,192,308,251,110,119,55,137,96.0,104.0,82,-64,146
126,11,48,2,6,0,297,299,267,195,95,307,309,370,299,211,106,111,108.0,143.0,5,-105,110
52,12,48,2,6,0,258,215,138,145,60,177,182,224,84,107,42,42,42.0,64.0,0,-65,65
635,13,48,2,6,0,1547,1898,2125,1949,1092,1644,1840,1468,940,941,733,782,758.0,819.0,49,-208,257
281,14,48,2,6,0,817,797,693,546,306,774,911,1101,433,362,211,283,247.0,285.0,72,-151,223
204,15,48,2,6,0,213,216,202,149,42,380,352,327,197,195,168,241,204.0,201.0,73,-27,100
46,16,48,2,6,0,172,121,123,100,46,116,125,211,58,65,32,39,36.0,45.0,7,-33,40
62,17,48,2,6,0,207,195,142,140,74,141,165,230,105,87,42,50,46.0,60.0,8,-45,53
71,18,48,2,6,0,259,254,219,159,110,281,215,204,105,130,66,70,68.0,89.0,4,-64,68
168,19,48,2,6,0,615,791,715,654,384,528,619,375,317,409,425,215,320.0,350.0,-210,16,-226
33,20,48,2,6,0,167,210,170,119,62,80,104,116,61,54,25,34,30.0,38.0,9,-29,38
125,21,48,2,6,0,360,504,331,168,145,214,250,261,108,136,75,123,99.0,111.0,48,-61,109
137,22,48,2,6,0,289,307,328,302,291,350,342,207,144,192,137,117,127.0,149.0,-20,-55,35
272,1,49,1,6,0,190,187,321,371,283,435,596,174,80,151,177,200,188.0,176.0,23,26,-3
235,2,49,1,6,0,278,391,368,477,514,538,699,444,236,185,176,241,208.0,201.0,65,-9,74
182,3,49,1,6,0,182,278,328,337,354,323,485,221,94,125,138,233,186.0,165.0,95,13,82
279,4,49,1,6,0,512,616,785,877,636,879,1517,309,174,289,242,251,246.0,261.0,9,-47,56
363,5,49,1,6,0,519,553,602,1020,712,770,1305,743,339,285,287,359,323.0,310.0,72,2,70
660,6,49,1,6,0,596,658,834,1066,894,964,1597,855,344,344,422,524,473.0,430.0,102,78,24
670,7,49,1,6,0,801,793,998,1278,1160,1107,1740,687,383,327,543,829,686.0,566.0,286,216,70
172,8,49,1,6,0,187,206,301,280,282,301,514,192,100,117,126,207,166.0,150.0,81,9,72
604,9,49,1,6,0,668,710,890,1382,1240,1586,1899,542,186,403,360,460,410.0,408.0,100,-43,143
111,10,49,1,6,0,226,201,232,277,266,309,514,260,96,110,81,120,100.0,104.0,39,-29,68
941,11,49,1,6,0,872,955,1345,1406,1396,1446,2279,939,574,593,645,899,772.0,712.0,254,52,202
289,12,49,1,6,0,279,356,409,638,519,571,900,502,180,199,229,302,266.0,243.0,73,30,43
768,13,49,1,6,0,602,725,929,1066,990,1108,1749,708,414,412,600,843,722.0,618.0,243,188,55
1139,14,49,1,6,0,1021,1208,1438,1525,1493,1622,2735,1331,509,557,792,1003,898.0,784.0,211,235,-24
1179,15,49,1,6,0,1144,1284,1635,1804,1911,2130,3255,1119,581,616,676,899,788.0,730.0,223,60,163
467,16,49,1,6,0,375,419,485,678,560,634,1014,597,202,210,256,309,282.0,258.0,53,46,7
287,17,49,1,6,0,332,374,473,712,546,606,978,498,212,209,272,280,276.0,254.0,8,63,-55
223,18,49,1,6,0,250,238,291,406,499,552,782,311,141,184,131,214,172.0,176.0,83,-53,136
165,19,49,1,6,0,206,229,283,315,299,258,424,127,80,97,131,161,146.0,130.0,30,34,-4
161,20,49,1,6,0,223,193,277,336,267,309,532,260,104,78,93,126,110.0,99.0,33,15,18
204,21,49,1,6,0,227,253,326,373,472,366,620,315,130,154,179,263,221.0,199.0,84,25,59
87,22,49,1,6,0,155,137,237,206,170,232,274,80,52,66,71,97,84.0,78.0,26,5,21
140,1,50,4,6,0,192,187,249,257,239,345,396,369,177,174,163,140,152.0,159.0,-23,-11,-12
199,2,50,4,6,0,289,300,344,358,406,373,334,203,134,207,159,159,159.0,175.0,0,-48,48
31,3,50,4,6,0,58,65,160,123,116,59,90,51,29,42,27,40,34.0,36.0,13,-15,28
47,4,50,4,6,0,141,164,139,203,168,222,242,93,60,87,42,47,44.0,59.0,5,-45,50
406,5,50,4,6,0,455,488,625,731,758,778,781,288,239,321,272,333,302.0,309.0,61,-49,110
289,6,50,4,6,0,370,347,570,630,644,607,661,309,266,301,237,309,273.0,282.0,72,-64,136
395,7,50,4,6,0,584,576,690,772,807,782,994,540,419,572,464,433,448.0,490.0,-31,-108,77
72,8,50,4,6,0,127,162,287,240,200,132,201,88,44,87,60,67,64.0,71.0,7,-27,34
418,9,50,4,6,0,526,486,516,619,721,938,1135,331,231,477,411,394,402.0,427.0,-17,-66,49
161,10,50,4,6,0,230,205,301,268,247,370,403,140,92,140,131,131,131.0,134.0,0,-9,9
693,11,50,4,6,0,791,837,1017,1020,1227,1286,1781,805,710,885,641,740,690.0,755.0,99,-244,343
195,12,50,4,6,0,230,221,285,391,438,444,431,157,97,173,170,210,190.0,184.0,40,-3,43
438,13,50,4,6,0,552,574,734,729,766,589,806,391,375,484,404,455,430.0,448.0,51,-80,131
554,14,50,4,6,0,668,840,854,777,834,729,896,363,334,528,418,445,432.0,464.0,27,-110,137
458,15,50,4,6,0,443,507,510,573,616,797,1044,341,386,475,363,466,414.0,435.0,103,-112,215
177,16,50,4,6,0,303,280,357,375,452,413,461,270,123,194,119,150,134.0,154.0,31,-75,106
184,17,50,4,6,0,250,255,292,394,414,458,478,157,99,182,167,188,178.0,179.0,21,-15,36
228,18,50,4,6,0,290,310,328,339,397,455,593,250,154,266,219,283,251.0,256.0,64,-47,111
84,19,50,4,6,0,118,139,151,144,114,136,149,45,36,75,66,76,71.0,72.0,10,-9,19
225,20,50,4,6,0,459,311,410,422,402,422,475,136,124,148,136,160,148.0,148.0,24,-12,36
186,21,50,4,6,0,320,375,494,446,595,355,464,194,145,188,141,176,158.0,168.0,35,-47,82
48,22,50,4,6,0,125,146,202,237,176,82,87,40,47,82,54,34,44.0,57.0,-20,-28,8
283,1,51,2,6,0,267,258,427,420,355,228,579,371,131,288,266,225,246.0,260.0,-41,-22,-19
169,2,51,2,6,0,118,180,214,200,244,165,338,215,134,179,192,167,180.0,179.0,-25,13,-38
61,3,51,2,6,0,32,43,34,40,41,43,48,41,28,59,37,53,45.0,50.0,16,-22,38
103,4,51,2,6,0,181,202,267,304,268,372,383,131,61,110,108,70,89.0,96.0,-38,-2,-36
497,5,51,2,6,0,336,352,370,632,431,484,820,550,286,428,433,456,444.0,439.0,23,5,18
563,6,51,2,6,0,362,305,443,521,495,362,758,508,322,432,425,545,485.0,467.0,120,-7,127
394,7,51,2,6,0,316,303,357,410,423,383,729,410,227,320,381,388,384.0,363.0,7,61,-54
59,8,51,2,6,0,48,59,51,78,61,91,136,74,57,53,62,47,54.0,54.0,-15,9,-24
1190,9,51,2,6,0,904,879,1153,1298,1305,1034,2232,1023,444,1072,1007,969,988.0,1016.0,-38,-65,27
209,10,51,2,6,0,169,192,217,237,215,191,328,208,107,160,131,178,154.0,156.0,47,-29,76
1040,11,51,2,6,0,877,845,1153,1190,1239,807,1846,1142,747,1023,870,969,920.0,954.0,99,-153,252
237,12,51,2,6,0,165,177,232,306,226,131,436,290,111,237,235,226,230.0,233.0,-9,-2,-7
339,13,51,2,6,0,257,243,316,360,308,272,475,287,194,265,298,335,316.0,299.0,37,33,4
571,14,51,2,6,0,404,405,509,554,543,420,747,459,249,457,513,513,513.0,494.0,0,56,-56
759,15,51,2,6,0,644,614,743,824,856,695,1454,752,503,780,679,725,702.0,728.0,46,-101,147
428,16,51,2,6,0,257,205,250,304,278,190,481,312,158,246,258,251,254.0,252.0,-7,12,-19
308,17,51,2,6,0,226,226,283,329,289,235,425,324,139,263,238,293,266.0,265.0,55,-25,80
506,18,51,2,6,0,293,354,411,469,472,415,699,508,260,395,323,426,374.0,381.0,103,-72,175
102,19,51,2,6,0,118,94,128,154,125,64,125,66,52,82,116,125,120.0,108.0,9,34,-25
378,20,51,2,6,0,316,279,300,389,322,256,548,310,185,288,287,285,286.0,287.0,-2,-1,-1
165,21,51,2,6,0,121,162,175,188,226,181,259,170,96,124,121,134,128.0,126.0,13,-3,16
52,22,51,2,6,0,92,95,86,84,67,65,115,61,52,76,85,53,69.0,71.0,-32,9,-41
297,1,52,1,6,0,308,315,327,336,292,421,473,415,199,338,303,272,288.0,304.0,-31,-35,4
293,2,52,1,6,0,271,381,320,316,363,485,535,500,259,353,295,304,300.0,317.0,9,-58,67
167,3,52,1,6,0,198,210,230,224,233,229,234,273,129,208,180,191,186.0,193.0,11,-28,39
374,4,52,1,6,0,335,454,424,442,429,500,681,534,295,402,398,365,382.0,388.0,-33,-4,-29
553,5,52,1,6,0,508,557,495,659,704,743,849,933,442,540,493,508,500.0,514.0,15,-47,62
206,6,52,1,6,0,204,219,249,314,271,334,368,404,198,210,162,176,169.0,183.0,14,-48,62
596,7,52,1,6,0,531,579,617,771,679,776,936,911,376,595,546,558,552.0,566.0,12,-49,61
104,8,52,1,6,0,128,113,131,135,142,208,244,213,113,141,101,103,102.0,115.0,2,-40,42
1067,9,52,1,6,0,1056,1120,1145,1408,1392,1836,2078,1526,521,1068,875,905,890.0,949.0,30,-193,223
166,10,52,1,6,0,216,203,212,207,208,246,317,323,145,236,156,189,172.0,194.0,33,-80,113
545,11,52,1,6,0,513,553,616,611,660,847,820,821,461,589,458,423,440.0,490.0,-35,-131,96
139,12,52,1,6,0,179,206,215,215,187,249,262,297,113,164,151,133,142.0,149.0,-18,-13,-5
415,13,52,1,6,0,411,475,528,576,625,746,750,758,431,483,470,474,472.0,476.0,4,-13,17
543,14,52,1,6,0,520,548,623,596,604,752,820,826,447,615,567,493,530.0,558.0,-74,-48,-26
325,15,52,1,6,0,330,357,379,387,524,623,684,550,252,401,254,311,282.0,322.0,57,-147,204
274,16,52,1,6,0,280,268,311,346,310,385,425,481,197,299,246,238,242.0,261.0,-8,-53,45
341,17,52,1,6,0,338,350,384,424,364,460,493,505,239,383,321,315,318.0,340.0,-6,-62,56
123,18,52,1,6,0,169,259,222,223,268,329,338,400,163,217,128,161,144.0,169.0,33,-89,122
258,19,52,1,6,0,292,281,324,364,303,369,450,249,117,274,320,298,309.0,297.0,-22,46,-68
439,20,52,1,6,0,440,402,372,406,400,540,575,576,284,403,314,306,310.0,341.0,-8,-89,81
201,21,52,1,6,0,225,299,275,293,365,346,404,376,178,272,285,266,276.0,274.0,-19,13,-32
273,22,52,1,6,0,325,359,356,331,302,341,410,324,206,341,242,239,240.0,274.0,-3,-99,96
253,1,53,2,6,0,413,581,617,628,446,636,846,241,179,180,191,192,192.0,188.0,1,11,-10
128,2,53,2,6,0,143,197,189,278,304,365,493,290,145,117,124,158,141.0,133.0,34,7,27
101,3,53,2,6,0,125,168,136,222,206,310,562,284,123,119,71,119,95.0,103.0,48,-48,96
59,4,53,2,6,0,429,521,473,498,257,444,824,105,71,55,60,50,55.0,55.0,-10,5,-15
436,5,53,2,6,0,636,717,777,1042,762,1080,1730,983,504,400,394,380,387.0,391.0,-14,-6,-8
521,6,53,2,6,0,701,945,973,1078,1023,1260,2243,1186,528,593,566,477,522.0,545.0,-89,-27,-62
651,7,53,2,6,0,1160,1176,1294,1622,1536,1637,2998,1261,553,503,551,645,598.0,566.0,94,48,46
173,8,53,2,6,0,154,257,272,308,299,372,645,313,178,140,164,178,171.0,161.0,14,24,-10
614,9,53,2,6,0,923,1121,1670,1369,1274,1967,3191,905,337,855,959,831,895.0,882.0,-128,104,-232
224,10,53,2,6,0,190,192,188,232,252,337,697,471,179,227,188,213,200.0,209.0,25,-39,64
802,11,53,2,6,0,1724,1702,2067,2163,1918,2283,3836,1631,972,777,763,993,878.0,844.0,230,-14,244
227,12,53,2,6,0,361,411,440,542,547,676,1270,658,229,229,221,283,252.0,244.0,62,-8,70
555,13,53,2,6,0,678,854,909,987,969,1064,2232,950,551,442,578,697,638.0,572.0,119,136,-17
1013,14,53,2,6,0,1091,1257,1337,1548,1431,1720,3243,1894,828,807,1011,1085,1048.0,968.0,74,204,-130
423,15,53,2,6,0,952,886,1003,1067,1140,1205,1850,574,328,328,361,426,394.0,372.0,65,33,32
247,16,53,2,6,0,502,356,435,576,710,866,1354,755,244,256,243,222,232.0,240.0,-21,-13,-8
412,17,53,2,6,0,599,590,709,844,687,982,1756,938,322,403,371,448,410.0,407.0,77,-32,109
238,18,53,2,6,0,357,422,486,645,645,746,1041,462,182,250,215,304,260.0,256.0,89,-35,124
111,19,53,2,6,0,231,300,418,415,275,422,561,181,92,144,178,144,161.0,155.0,-34,34,-68
260,20,53,2,6,0,631,758,749,722,571,643,1136,557,231,195,203,189,196.0,196.0,-14,8,-22
282,21,53,2,6,0,506,811,726,652,682,805,1567,639,298,275,310,369,340.0,318.0,59,35,24
71,22,53,2,6,0,123,259,159,164,109,207,305,102,62,72,62,93,78.0,76.0,31,-10,41
19,1,54,1,6,0,87,88,90,112,64,139,159,95,31,32,33,18,26.0,28.0,-15,1,-16
48,2,54,1,6,0,54,102,103,88,129,116,195,181,91,58,50,67,58.0,58.0,17,-8,25
86,3,54,1,6,0,139,192,148,178,215,227,336,327,113,110,91,126,108.0,109.0,35,-19,54
17,4,54,1,6,0,119,110,107,124,113,153,246,99,35,29,28,28,28.0,28.0,0,-1,1
69,5,54,1,6,0,164,169,165,260,194,267,387,398,155,108,95,80,88.0,94.0,-15,-13,-2
103,6,54,1,6,0,161,192,228,277,262,301,471,484,121,103,101,118,110.0,107.0,17,-2,19
242,7,54,1,6,0,450,433,565,670,629,591,961,723,263,300,312,311,312.0,308.0,-1,12,-13
58,8,54,1,6,0,81,88,106,92,114,133,167,149,66,59,57,51,54.0,56.0,-6,-2,-4
35,9,54,1,6,0,107,99,112,111,142,134,176,97,19,44,38,31,34.0,38.0,-7,-6,-1
9,10,54,1,6,0,61,36,46,27,44,52,62,66,20,31,15,25,20.0,24.0,10,-16,26
95,11,54,1,6,0,291,216,275,222,289,312,450,333,168,137,94,101,98.0,111.0,7,-43,50
66,12,54,1,6,0,110,96,123,158,141,164,252,264,69,58,63,82,72.0,68.0,19,5,14
142,13,54,1,6,0,231,209,251,268,281,338,473,362,182,165,226,205,216.0,199.0,-21,61,-82
190,14,54,1,6,0,420,458,438,436,457,535,679,669,213,223,212,206,209.0,214.0,-6,-11,5
57,15,54,1,6,0,119,117,144,152,167,161,255,131,59,54,69,64,66.0,62.0,-5,15,-20
90,16,54,1,6,0,211,166,169,231,258,278,385,450,105,110,104,89,96.0,101.0,-15,-6,-9
219,17,54,1,6,0,324,322,320,453,378,533,776,857,222,262,247,257,252.0,255.0,10,-15,25
19,18,54,1,6,0,45,47,38,50,51,83,65,41,21,20,20,33,26.0,24.0,13,0,13
46,19,54,1,6,0,82,101,115,152,128,129,166,109,50,66,72,45,58.0,61.0,-27,6,-33
84,20,54,1,6,0,162,125,149,157,175,189,306,256,58,77,65,70,68.0,71.0,5,-12,17
161,21,54,1,6,0,224,270,298,329,421,381,634,493,193,190,176,193,184.0,186.0,17,-14,31
54,22,54,1,6,0,109,132,165,141,126,204,277,131,70,96,70,62,66.0,76.0,-8,-26,18
111,1,55,1,6,0,139,164,176,188,167,211,361,138,71,95,74,75,74.0,81.0,1,-21,22
323,2,55,1,6,0,327,407,402,486,521,434,743,406,299,256,259,276,268.0,264.0,17,3,14
260,3,55,1,6,0,218,256,255,374,366,390,683,304,135,211,181,248,214.0,213.0,67,-30,97
89,4,55,1,6,0,298,365,388,458,302,357,675,173,56,121,79,138,108.0,113.0,59,-42,101
979,5,55,1,6,0,1067,1135,1222,1530,1137,1318,2057,1186,681,782,644,814,729.0,747.0,170,-138,308
345,6,55,1,6,0,292,363,463,479,476,493,865,574,194,213,248,307,278.0,256.0,59,35,24
614,7,55,1,6,0,718,720,875,922,870,894,1538,723,282,412,473,536,504.0,474.0,63,61,2
560,8,55,1,6,0,311,358,454,470,495,510,974,417,214,254,346,509,428.0,370.0,163,92,71
585,9,55,1,6,0,576,557,610,730,702,768,1105,569,259,493,354,430,392.0,426.0,76,-139,215
218,10,55,1,6,0,164,182,175,217,208,212,406,260,101,165,105,174,140.0,148.0,69,-60,129
557,11,55,1,6,0,557,652,768,765,828,786,1332,698,402,409,494,495,494.0,466.0,1,85,-84
298,12,55,1,6,0,262,276,281,350,363,356,774,420,110,193,205,216,210.0,205.0,11,12,-1
983,13,55,1,6,0,614,693,937,936,974,964,2069,891,397,516,929,990,960.0,812.0,61,413,-352
908,14,55,1,6,0,682,796,900,924,913,934,1916,1026,330,387,521,645,583.0,518.0,124,134,-10
395,15,55,1,6,0,492,491,561,604,663,556,982,370,195,281,311,304,308.0,299.0,-7,30,-37
272,16,55,1,6,0,303,276,301,385,300,389,721,401,105,159,186,195,190.0,180.0,9,27,-18
464,17,55,1,6,0,511,551,548,722,567,687,1290,631,205,298,333,363,348.0,331.0,30,35,-5
154,18,55,1,6,0,135,152,178,217,240,253,385,180,95,138,114,150,132.0,134.0,36,-24,60
167,19,55,1,6,0,208,212,251,209,211,226,330,135,104,181,144,138,141.0,154.0,-6,-37,31
631,20,55,1,6,0,935,790,970,909,844,751,1420,661,420,464,477,481,479.0,474.0,4,13,-9
468,21,55,1,6,0,425,496,540,574,623,639,1234,604,184,336,402,415,408.0,384.0,13,66,-53
134,22,55,1,6,0,127,131,146,126,126,150,236,76,111,111,78,108,93.0,99.0,30,-33,63
252,1,56,1,6,0,237,275,484,500,412,620,805,357,95,198,187,218,202.0,201.0,31,-11,42
542,2,56,1,6,0,342,521,806,851,856,921,1249,829,418,522,444,470,457.0,479.0,26,-78,104
499,3,56,1,6,0,265,347,507,500,528,675,925,601,288,415,322,461,392.0,399.0,139,-93,232
253,4,56,1,6,0,384,534,743,672,532,779,1421,437,212,313,278,276,277.0,289.0,-2,-35,33
1247,5,56,1,6,0,922,1077,1757,2178,1620,1861,2915,2183,903,1084,938,1042,990.0,1021.0,104,-146,250
545,6,56,1,6,0,373,395,690,798,757,934,1307,1141,304,330,322,356,339.0,336.0,34,-8,42
776,7,56,1,6,0,593,668,1173,1160,1214,1192,1610,1006,389,569,611,624,618.0,601.0,13,42,-29
503,8,56,1,6,0,235,316,582,505,511,601,970,406,198,368,305,370,338.0,348.0,65,-63,128
1142,9,56,1,6,0,799,758,1347,1576,1507,1902,2685,1203,341,825,879,785,832.0,830.0,-94,54,-148
226,10,56,1,6,0,206,193,394,347,352,440,665,433,149,235,168,197,182.0,200.0,29,-67,96
1280,11,56,1,6,0,861,1014,1794,1646,1598,1955,2752,1481,650,861,854,961,908.0,892.0,107,-7,114
354,12,56,1,6,0,260,281,443,510,475,511,802,624,159,229,268,266,267.0,254.0,-2,39,-41
890,13,56,1,6,0,522,624,985,1009,905,1021,1551,970,478,608,767,810,788.0,728.0,43,159,-116
1415,14,56,1,6,0,679,846,1361,1342,1399,1530,2696,1928,502,672,701,850,776.0,741.0,149,29,120
932,15,56,1,6,0,572,720,1247,1320,1351,1499,2124,704,292,530,641,696,668.0,622.0,55,111,-56
462,16,56,1,6,0,323,347,614,653,620,794,1252,837,201,313,330,347,338.0,330.0,17,17,0
827,17,56,1,6,0,625,741,1241,1383,1339,1478,2360,1657,503,671,579,591,585.0,614.0,12,-92,104
359,18,56,1,6,0,213,231,425,414,399,601,698,428,129,211,219,281,250.0,237.0,62,8,54
248,19,56,1,6,0,200,191,375,331,306,361,459,235,125,226,187,250,218.0,221.0,63,-39,102
1151,20,56,1,6,0,1159,994,1592,1671,1487,1581,2727,1846,758,896,740,908,824.0,848.0,168,-156,324
565,21,56,1,6,0,391,538,758,764,827,896,1319,905,333,426,445,444,444.0,438.0,-1,19,-20
190,22,56,1,6,0,156,136,271,219,256,312,397,173,117,199,155,143,149.0,166.0,-12,-44,32
29,1,57,3,6,0,33,25,37,28,27,30,34,19,29,28,25,38,32.0,30.0,13,-3,16
786,2,57,3,6,0,1170,1342,1395,1639,1736,1547,1939,1680,1190,1187,815,815,815.0,939.0,0,-372,372
60,3,57,3,6,0,81,79,74,107,93,105,108,54,78,117,71,70,70.0,86.0,-1,-46,45
104,4,57,3,6,0,173,229,238,282,198,305,504,106,118,157,120,110,115.0,129.0,-10,-37,27
474,5,57,3,6,0,682,620,742,717,655,773,955,603,645,678,519,472,496.0,556.0,-47,-159,112
149,6,57,3,6,0,207,172,194,197,214,225,272,216,223,191,165,153,159.0,170.0,-12,-26,14
375,7,57,3,6,0,545,644,631,622,551,636,1105,629,541,513,451,400,426.0,455.0,-51,-62,11
113,8,57,3,6,0,114,131,103,137,118,161,233,166,115,127,118,117,118.0,121.0,-1,-9,8
519,9,57,3,6,0,830,568,627,644,624,713,866,346,505,757,513,503,508.0,591.0,-10,-244,234
36,10,57,3,6,0,62,69,50,93,63,75,97,92,50,85,53,57,55.0,65.0,4,-32,36
495,11,57,3,6,0,654,653,752,766,763,871,1150,610,843,857,623,558,590.0,679.0,-65,-234,169
62,12,57,3,6,0,110,121,107,134,92,117,148,132,89,105,90,70,80.0,88.0,-20,-15,-5
500,13,57,3,6,0,506,529,574,561,554,769,983,537,616,685,621,541,581.0,616.0,-80,-64,-16
519,14,57,3,6,0,847,759,825,703,746,952,1314,922,778,753,612,592,602.0,652.0,-20,-141,121
319,15,57,3,6,0,457,405,385,451,456,466,653,312,498,511,368,351,360.0,410.0,-17,-143,126
314,16,57,3,6,0,476,513,518,582,592,590,903,514,438,482,408,403,406.0,431.0,-5,-74,69
377,17,57,3,6,0,429,353,375,366,327,426,575,405,314,375,353,267,310.0,332.0,-86,-22,-64
133,18,57,3,6,0,148,152,164,156,179,175,195,85,140,157,133,146,140.0,145.0,13,-24,37
170,19,57,3,6,0,230,212,192,216,260,281,370,158,187,236,191,184,188.0,204.0,-7,-45,38
498,20,57,3,6,0,668,554,592,643,645,706,955,636,643,771,438,521,480.0,577.0,83,-333,416
132,21,57,3,6,0,187,180,190,227,209,280,324,195,155,198,180,157,168.0,178.0,-23,-18,-5
40,22,57,3,6,0,81,47,88,70,59,76,90,35,48,67,46,41,44.0,51.0,-5,-21,16
81,1,58,2,6,0,134,139,176,218,159,193,281,60,52,74,61,69,65.0,68.0,8,-13,21
125,2,58,2,6,0,132,201,192,241,224,227,356,181,119,130,103,154,128.0,129.0,51,-27,78
55,3,58,2,6,0,103,103,63,86,129,183,244,117,67,81,65,79,72.0,75.0,14,-16,30
144,4,58,2,6,0,501,463,464,472,326,417,805,105,52,132,97,103,100.0,111.0,6,-35,41
491,5,58,2,6,0,715,739,855,1133,824,910,1456,816,454,505,463,516,490.0,495.0,53,-42,95
91,6,58,2,6,0,240,323,314,310,267,287,463,251,96,133,88,118,103.0,113.0,30,-45,75
271,7,58,2,6,0,548,646,773,797,679,738,1182,600,283,311,395,408,402.0,371.0,13,84,-71
144,8,58,2,6,0,121,199,221,226,243,264,497,192,96,135,117,169,143.0,140.0,52,-18,70
278,9,58,2,6,0,384,378,429,596,574,615,869,297,127,271,262,258,260.0,264.0,-4,-9,5
145,10,58,2,6,0,126,161,139,167,205,233,425,254,71,136,107,135,121.0,126.0,28,-29,57
289,11,58,2,6,0,545,683,706,761,731,749,1017,461,270,342,363,373,368.0,359.0,10,21,-11
64,12,58,2,6,0,128,145,145,229,198,198,315,211,60,84,84,68,76.0,79.0,-16,0,-16
419,13,58,2,6,0,501,551,690,771,682,755,1430,754,390,398,481,498,490.0,459.0,17,83,-66
396,14,58,2,6,0,645,779,871,851,876,865,1601,892,268,371,333,363,348.0,356.0,30,-38,68
204,15,58,2,6,0,509,410,370,1437,406,420,845,174,81,170,192,246,219.0,203.0,54,22,32
48,16,58,2,6,0,118,124,88,110,128,133,246,134,39,47,55,60,58.0,54.0,5,8,-3
178,17,58,2,6,0,325,335,319,439,335,447,756,439,130,231,191,211,201.0,211.0,20,-40,60
91,18,58,2,6,0,93,116,102,142,175,166,247,102,51,67,60,67,64.0,65.0,7,-7,14
22,19,58,2,6,0,65,77,81,68,54,102,113,47,21,29,27,30,28.0,29.0,3,-2,5
444,20,58,2,6,0,780,781,1602,764,548,596,1578,630,283,298,337,395,366.0,343.0,58,39,19
226,21,58,2,6,0,347,435,453,455,455,558,938,498,189,261,260,236,248.0,252.0,-24,-1,-23
18,22,58,2,6,0,35,25,28,17,16,45,45,7,10,21,11,20,16.0,17.0,9,-10,19
237,1,59,2,6,0,902,547,590,1049,393,448,746,228,125,223,190,233,212.0,215.0,43,-33,76
100,2,59,2,6,0,183,317,301,410,266,224,235,105,67,68,72,70,71.0,70.0,-2,4,-6
89,3,59,2,6,0,129,178,248,263,289,273,340,208,63,95,64,75,70.0,78.0,11,-31,42
56,4,59,2,6,0,193,216,265,2528,156,179,362,72,29,64,61,50,56.0,58.0,-11,-3,-8
226,5,59,2,6,0,779,942,1243,1666,730,631,1027,542,251,246,265,230,248.0,247.0,-35,19,-54
363,6,59,2,6,0,647,742,968,961,755,678,1434,792,244,232,308,344,326.0,295.0,36,76,-40
362,7,59,2,6,0,1738,2176,2848,2646,1380,1053,1685,823,326,341,453,371,412.0,388.0,-82,112,-194
154,8,59,2,6,0,412,468,657,660,386,479,604,321,126,162,162,182,172.0,169.0,20,0,20
481,9,59,2,6,0,584,546,819,1623,936,1038,1493,451,130,374,366,407,386.0,382.0,41,-8,49
130,10,59,2,6,0,200,234,316,360,349,312,543,250,76,136,99,136,118.0,124.0,37,-37,74
758,11,59,2,6,0,1654,1827,2527,2388,1650,1467,2828,1205,656,751,787,807,797.0,782.0,20,36,-16
250,12,59,2,6,0,351,450,511,752,626,577,1241,549,138,232,271,262,266.0,255.0,-9,39,-48
329,13,59,2,6,0,856,987,1387,1606,840,561,1020,602,249,293,362,351,356.0,335.0,-11,69,-80
721,14,59,2,6,0,1377,1416,1736,1669,959,1021,1584,992,320,512,660,557,608.0,576.0,-103,148,-251
377,15,59,2,6,0,693,717,1019,1203,828,859,1272,386,193,342,341,375,358.0,353.0,34,-1,35
280,16,59,2,6,0,550,430,713,769,691,751,1208,523,161,272,326,270,298.0,289.0,-56,54,-110
268,17,59,2,6,0,580,641,816,847,522,619,891,508,132,232,212,222,217.0,222.0,10,-20,30
115,18,59,2,6,0,142,221,243,304,268,291,431,173,74,106,104,121,112.0,110.0,17,-2,19
42,19,59,2,6,0,157,228,366,291,139,186,225,91,51,75,101,66,84.0,81.0,-35,26,-61
76,20,59,2,6,0,226,215,324,310,182,148,242,128,33,53,51,65,58.0,56.0,14,-2,16
142,21,59,2,6,0,558,687,656,661,278,275,432,182,64,143,136,155,146.0,145.0,19,-7,26
27,22,59,2,6,0,89,97,146,137,83,61,140,53,29,33,28,48,38.0,36.0,20,-5,25
102,1,60,1,6,0,134,141,138,161,113,162,163,142,84,128,99,108,104.0,112.0,9,-29,38
87,2,60,1,6,0,94,141,123,111,95,152,131,146,84,119,80,84,82.0,94.0,4,-39,43
67,3,60,1,6,0,75,84,71,81,97,81,90,83,41,62,87,86,86.0,78.0,-1,25,-26
63,4,60,1,6,0,97,119,87,131,79,100,123,88,65,74,70,62,66.0,69.0,-8,-4,-4
188,5,60,1,6,0,255,232,227,447,284,279,330,341,184,223,201,224,212.0,216.0,23,-22,45
146,6,60,1,6,0,145,138,167,182,170,183,198,254,107,149,150,152,151.0,150.0,2,1,1
117,7,60,1,6,0,181,138,136,198,152,160,191,159,74,162,163,162,162.0,162.0,-1,1,-2
30,8,60,1,6,0,27,30,36,34,32,31,28,41,25,46,41,28,34.0,38.0,-13,-5,-8
437,9,60,1,6,0,470,487,435,593,541,658,638,568,264,527,387,410,398.0,441.0,23,-140,163
152,10,60,1,6,0,160,151,154,208,163,172,213,297,121,197,152,163,158.0,171.0,11,-45,56
284,11,60,1,6,0,325,317,361,402,385,402,439,430,213,408,324,345,334.0,359.0,21,-84,105
82,12,60,1,6,0,70,82,64,94,87,76,120,103,50,101,76,71,74.0,83.0,-5,-25,20
104,13,60,1,6,0,94,88,102,92,82,85,95,109,50,116,95,137,116.0,116.0,42,-21,63
124,14,60,1,6,0,126,120,123,153,141,134,164,130,78,142,114,90,102.0,115.0,-24,-28,4
277,15,60,1,6,0,272,322,299,308,339,364,397,466,185,307,317,322,320.0,315.0,5,10,-5
190,16,60,1,6,0,190,155,179,232,184,244,236,270,129,200,183,140,162.0,174.0,-43,-17,-26
262,17,60,1,6,0,279,299,298,395,308,355,445,519,215,330,301,296,298.0,309.0,-5,-29,24
91,18,60,1,6,0,64,92,91,93,87,125,99,145,57,96,88,101,94.0,95.0,13,-8,21
85,19,60,1,6,0,116,136,158,194,115,126,155,89,59,109,102,100,101.0,104.0,-2,-7,5
264,20,60,1,6,0,304,146,146,203,173,179,214,160,89,140,134,104,119.0,126.0,-30,-6,-24
163,21,60,1,6,0,217,273,229,256,263,252,263,274,154,228,212,258,235.0,233.0,46,-16,62
50,22,60,1,6,0,81,75,75,68,54,66,57,65,35,91,67,47,57.0,68.0,-20,-24,4
240,1,1,1,7,0,260,162,265,228,369,374,305,193,309,264,241,251,246.0,252.0,10,-23,33
362,2,1,1,7,0,419,246,217,310,402,456,434,194,302,243,321,230,276.0,265.0,-91,78,-169
199,3,1,1,7,0,187,153,157,178,204,219,180,128,201,176,192,155,174.0,174.0,-37,16,-53
302,4,1,1,7,0,322,244,337,371,460,563,468,432,472,340,407,314,360.0,354.0,-93,67,-160
304,5,1,1,7,0,335,345,623,350,453,570,500,253,378,337,331,336,334.0,335.0,5,-6,11
155,6,1,1,7,0,108,127,159,136,179,226,198,76,132,155,144,166,155.0,155.0,22,-11,33
449,7,1,1,7,0,339,259,422,394,483,601,468,290,412,484,450,432,441.0,455.0,-18,-34,16
213,8,1,1,7,0,178,189,194,233,215,260,248,146,249,182,251,173,212.0,202.0,-78,69,-147
2582,9,1,1,7,0,2183,1804,2265,2711,3532,3800,2692,1680,2958,2368,2754,2696,2725.0,2606.0,-58,386,-444
309,10,1,1,7,0,276,249,267,349,472,505,425,248,383,277,377,293,335.0,316.0,-84,100,-184
718,11,1,1,7,0,554,569,631,764,871,1010,800,486,817,617,720,689,704.0,675.0,-31,103,-134
156,12,1,1,7,0,136,95,156,166,204,262,236,78,191,154,186,149,168.0,163.0,-37,32,-69
325,13,1,1,7,0,227,235,225,228,291,305,260,190,297,311,328,293,310.0,311.0,-35,17,-52
380,14,1,1,7,0,384,256,301,351,521,505,405,250,355,393,307,297,302.0,332.0,-10,-86,76
624,15,1,1,7,0,457,422,545,702,660,865,633,409,621,561,562,591,576.0,571.0,29,1,28
424,16,1,1,7,0,329,325,381,447,480,474,497,228,445,423,403,455,429.0,427.0,52,-20,72
316,17,1,1,7,0,250,286,299,327,364,474,347,174,297,304,284,259,272.0,282.0,-25,-20,-5
311,18,1,1,7,0,276,226,258,368,331,404,292,181,307,209,324,299,312.0,277.0,-25,115,-140
805,19,1,1,7,0,700,556,721,769,941,997,650,566,775,692,738,626,682.0,685.0,-112,46,-158
135,20,1,1,7,0,131,111,101,120,155,199,115,72,126,107,119,138,128.0,121.0,19,12,7
305,21,1,1,7,0,262,204,187,324,393,440,305,219,295,292,328,285,306.0,302.0,-43,36,-79
313,22,1,1,7,0,194,351,302,310,458,461,292,234,401,305,324,284,304.0,304.0,-40,19,-59
481,1,2,2,7,0,356,410,417,271,639,518,268,263,442,321,383,408,396.0,371.0,25,62,-37
487,2,2,2,7,0,337,266,368,334,609,519,292,264,403,325,415,354,384.0,365.0,-61,90,-151
263,3,2,2,7,0,231,216,208,216,370,337,175,149,316,260,258,252,255.0,257.0,-6,-2,-4
396,4,2,2,7,0,459,464,449,231,675,811,368,359,470,369,376,352,364.0,366.0,-24,7,-31
721,5,2,2,7,0,684,758,1227,469,1053,1125,657,560,806,700,679,724,702.0,701.0,45,-21,66
460,6,2,2,7,0,293,358,325,253,574,507,301,225,317,315,350,352,351.0,339.0,2,35,-33
1342,7,2,2,7,0,990,917,1222,876,1567,1574,775,729,1060,1229,1119,1113,1116.0,1154.0,-6,-110,104
452,8,2,2,7,0,284,382,372,320,590,571,290,239,407,358,384,335,360.0,359.0,-49,26,-75
9110,9,2,2,7,0,8709,10596,10140,6925,13598,11515,5136,4688,10371,8733,8990,9100,9045.0,8941.0,110,257,-147
1075,10,2,2,7,0,792,866,969,642,1386,1258,750,559,1074,832,939,901,920.0,891.0,-38,107,-145
2090,11,2,2,7,0,1827,2216,2075,1763,3112,2877,1445,1635,2184,1828,1916,1948,1932.0,1897.0,32,88,-56
576,12,2,2,7,0,400,420,535,356,595,741,435,311,545,463,483,513,498.0,486.0,30,20,10
1052,13,2,2,7,0,604,569,722,520,1137,974,498,486,847,1025,993,829,911.0,949.0,-164,-32,-132
1153,14,2,2,7,0,718,785,808,565,1273,1234,645,486,968,944,932,1043,988.0,973.0,111,-12,123
2165,15,2,2,7,0,1737,1785,1658,1293,2709,2467,1135,1205,1969,1744,1919,1847,1883.0,1837.0,-72,175,-247
984,16,2,2,7,0,675,883,908,742,1001,1050,703,508,734,619,699,876,788.0,731.0,177,80,97
821,17,2,2,7,0,567,721,958,582,1112,1192,689,445,769,687,748,707,728.0,714.0,-41,61,-102
1522,18,2,2,7,0,1533,1388,1310,817,2205,1578,856,899,1607,1181,1494,1511,1502.0,1395.0,17,313,-296
2218,19,2,2,7,0,2253,2301,1915,1064,2892,2161,1110,1306,1905,1837,1784,1845,1814.0,1822.0,61,-53,114
328,20,2,2,7,0,300,319,331,173,470,398,244,215,285,259,240,371,306.0,290.0,131,-19,150
526,21,2,2,7,0,553,492,462,375,582,607,340,260,369,435,466,394,430.0,432.0,-72,31,-103
957,22,2,2,7,0,670,1107,843,480,1076,1018,447,521,1186,639,827,849,838.0,772.0,22,188,-166
158,1,3,1,7,0,160,159,169,112,163,167,157,101,187,162,155,200,178.0,172.0,45,-7,52
410,2,3,1,7,0,351,309,270,218,354,350,290,213,293,226,236,265,250.0,242.0,29,10,19
306,3,3,1,7,0,261,246,234,155,184,233,279,174,228,241,255,251,253.0,249.0,-4,14,-18
552,4,3,1,7,0,633,554,583,457,611,677,549,387,627,524,389,503,446.0,472.0,114,-135,249
481,5,3,1,7,0,373,319,387,300,411,434,516,235,377,355,370,404,387.0,376.0,34,15,19
151,6,3,1,7,0,118,108,157,129,128,138,176,83,127,116,129,142,136.0,129.0,13,13,0
400,7,3,1,7,0,358,328,376,327,415,400,420,235,353,334,323,407,365.0,355.0,84,-11,95
211,8,3,1,7,0,170,152,135,111,141,197,179,103,189,173,157,177,167.0,169.0,20,-16,36
1828,9,3,1,7,0,1691,1490,1683,1421,1989,1829,1713,1159,1738,1536,1581,1833,1707.0,1650.0,252,45,207
216,10,3,1,7,0,178,141,192,165,181,173,211,121,197,149,174,163,168.0,162.0,-11,25,-36
454,11,3,1,7,0,373,340,401,333,437,427,470,296,446,386,375,444,410.0,402.0,69,-11,80
130,12,3,1,7,0,94,84,108,90,107,109,126,55,113,112,112,126,119.0,117.0,14,0,14
531,13,3,1,7,0,324,321,309,274,302,328,389,251,371,364,437,425,431.0,409.0,-12,73,-85
390,14,3,1,7,0,309,300,327,262,352,337,377,202,331,306,338,396,367.0,347.0,58,32,26
435,15,3,1,7,0,316,352,336,342,428,424,401,264,349,335,366,380,373.0,360.0,14,31,-17
292,16,3,1,7,0,203,201,303,211,267,280,321,189,271,255,230,322,276.0,269.0,92,-25,117
292,17,3,1,7,0,255,193,250,211,244,275,284,146,275,262,250,285,268.0,266.0,35,-12,47
133,18,3,1,7,0,123,95,124,106,151,157,167,81,107,85,111,132,122.0,109.0,21,26,-5
606,19,3,1,7,0,506,466,488,346,464,567,506,316,529,433,489,457,473.0,460.0,-32,56,-88
203,20,3,1,7,0,166,134,169,138,184,155,213,116,188,148,168,179,174.0,165.0,11,20,-9
346,21,3,1,7,0,273,253,271,195,252,267,297,206,288,291,280,277,278.0,283.0,-3,-11,8
304,22,3,1,7,0,293,304,239,208,258,336,315,155,306,267,240,317,278.0,275.0,77,-27,104
167,1,4,2,7,0,229,249,216,166,212,210,117,96,135,131,161,142,152.0,145.0,-19,30,-49
253,2,4,2,7,0,231,232,256,209,270,308,173,110,159,185,191,176,184.0,184.0,-15,6,-21
145,3,4,2,7,0,118,134,193,128,165,176,89,72,136,148,139,117,128.0,135.0,-22,-9,-13
131,4,4,2,7,0,308,309,286,179,246,342,136,109,179,166,96,85,90.0,116.0,-11,-70,59
427,5,4,2,7,0,426,492,712,401,438,436,351,212,361,425,290,324,307.0,346.0,34,-135,169
266,6,4,2,7,0,300,368,358,250,325,348,264,151,204,182,203,195,199.0,193.0,-8,21,-29
377,7,4,2,7,0,399,489,606,454,468,556,225,175,357,467,449,285,367.0,400.0,-164,-18,-146
190,8,4,2,7,0,123,233,187,181,144,181,92,70,148,181,165,127,146.0,158.0,-38,-16,-22
4522,9,4,2,7,0,4020,4618,5211,4012,4216,4195,2391,1639,3992,3988,3668,3906,3787.0,3854.0,238,-320,558
461,10,4,2,7,0,360,409,444,331,432,386,248,166,443,418,434,344,389.0,399.0,-90,16,-106
1072,11,4,2,7,0,892,1148,1130,943,1033,1154,680,651,982,1039,1051,947,999.0,1012.0,-104,12,-116
331,12,4,2,7,0,194,288,380,260,302,351,208,96,254,328,298,271,284.0,299.0,-27,-30,3
559,13,4,2,7,0,475,550,584,385,397,419,248,284,584,570,485,345,415.0,467.0,-140,-85,-55
644,14,4,2,7,0,562,658,673,556,567,651,338,242,578,638,439,516,478.0,531.0,77,-199,276
1522,15,4,2,7,0,1138,1244,1296,1228,1343,1310,747,739,1438,1404,1200,1131,1166.0,1245.0,-69,-204,135
524,16,4,2,7,0,544,655,744,726,677,787,450,226,461,459,468,446,457.0,458.0,-22,9,-31
663,17,4,2,7,0,503,610,619,436,474,674,394,223,436,554,554,548,551.0,552.0,-6,0,-6
737,18,4,2,7,0,546,535,615,563,615,519,231,173,535,612,676,709,692.0,666.0,33,64,-31
596,19,4,2,7,0,867,1031,840,522,652,848,213,233,610,646,562,459,510.0,556.0,-103,-84,-19
140,20,4,2,7,0,324,316,208,150,157,208,123,85,166,157,116,162,139.0,145.0,46,-41,87
279,21,4,2,7,0,272,274,262,219,225,317,148,105,202,242,221,226,224.0,230.0,5,-21,26
236,22,4,2,7,0,232,335,334,222,288,303,90,85,233,244,241,205,223.0,230.0,-36,-3,-33
168,1,5,3,7,0,212,256,234,168,249,477,199,177,267,169,193,170,182.0,177.0,-23,24,-47
2206,2,5,3,7,0,2868,2565,3307,3096,3216,4503,4785,3067,2754,2281,2227,1995,2111.0,2168.0,-232,-54,-178
384,3,5,3,7,0,346,368,502,360,520,675,504,451,680,487,440,356,398.0,428.0,-84,-47,-37
101,4,5,3,7,0,179,202,242,199,305,514,151,92,197,124,132,112,122.0,123.0,-20,8,-28
1018,5,5,3,7,0,1183,1230,1449,1007,1411,1954,1724,1537,1481,1090,1021,990,1006.0,1034.0,-31,-69,38
1072,6,5,3,7,0,1260,1418,1458,1238,1535,2328,2152,1881,1518,1284,1266,1165,1216.0,1238.0,-101,-18,-83
2583,7,5,3,7,0,3398,3600,3519,3268,3907,6576,4483,3060,2839,2545,2879,2279,2579.0,2568.0,-600,334,-934
1154,8,5,3,7,0,1334,1452,1749,1354,1585,2844,2093,1361,1353,1118,1259,955,1107.0,1111.0,-304,141,-445
1409,9,5,3,7,0,1457,1550,1999,1555,2007,3029,1611,1579,2180,1684,1684,1682,1683.0,1683.0,-2,0,-2
1308,10,5,3,7,0,2051,2291,2515,2293,2687,4443,3084,1836,2310,1540,1616,1343,1480.0,1500.0,-273,76,-349
1523,11,5,3,7,0,1776,1799,1764,1493,1942,3067,2165,2419,2029,1601,1578,1375,1476.0,1518.0,-203,-23,-180
537,12,5,3,7,0,885,890,1111,824,980,1510,1290,922,875,668,648,536,592.0,617.0,-112,-20,-92
2789,13,5,3,7,0,2748,3368,3303,2808,3641,6231,3870,3403,2945,3015,3119,2522,2820.0,2885.0,-597,104,-701
2658,14,5,3,7,0,3413,3591,3584,3821,4668,7650,5825,3564,3197,2704,2715,2598,2656.0,2672.0,-117,11,-128
1218,15,5,3,7,0,1206,1016,1295,1112,1294,2062,1260,1629,1592,1156,1224,1121,1172.0,1167.0,-103,68,-171
836,16,5,3,7,0,900,992,1202,958,1353,2198,1919,1140,1262,895,1069,835,952.0,933.0,-234,174,-408
939,17,5,3,7,0,1500,1678,1773,1354,1770,2693,2364,1506,1541,1174,1020,997,1008.0,1064.0,-23,-154,131
389,18,5,3,7,0,512,565,573,523,688,892,592,650,741,463,546,473,510.0,494.0,-73,83,-156
912,19,5,3,7,0,1023,1010,1135,824,1154,1710,924,939,1322,959,988,854,921.0,934.0,-134,29,-163
197,20,5,3,7,0,203,204,284,201,250,357,250,248,235,212,191,173,182.0,192.0,-18,-21,3
1051,21,5,3,7,0,1173,1245,1658,1590,1877,3217,2072,1105,1314,1222,1105,910,1008.0,1079.0,-195,-117,-78
530,22,5,3,7,0,785,835,795,518,816,982,506,518,806,657,585,602,594.0,615.0,17,-72,89
234,1,6,1,7,0,331,445,555,272,582,623,382,114,351,229,285,289,287.0,268.0,4,56,-52
633,2,6,1,7,0,428,409,543,553,546,680,484,300,452,403,419,390,404.0,404.0,-29,16,-45
595,3,6,1,7,0,552,645,831,715,836,832,551,317,489,505,604,525,564.0,545.0,-79,99,-178
130,4,6,1,7,0,345,369,502,362,440,598,212,102,180,142,124,93,108.0,120.0,-31,-18,-13
1020,5,6,1,7,0,1032,1165,1460,1050,1385,1850,1223,671,850,790,838,870,854.0,833.0,32,48,-16
1206,6,6,1,7,0,1058,1409,1565,1256,1491,1666,1515,717,1018,980,1077,1165,1121.0,1074.0,88,97,-9
2192,7,6,1,7,0,1773,2139,2580,2061,2146,2737,1706,842,1734,1902,2031,1983,2007.0,1972.0,-48,129,-177
683,8,6,1,7,0,532,655,690,724,762,993,533,312,595,582,569,606,588.0,586.0,37,-13,50
4899,9,6,1,7,0,5237,6544,8215,6582,6734,6492,5607,2647,5713,4896,5717,5445,5581.0,5353.0,-272,821,-1093
611,10,6,1,7,0,639,680,913,743,853,894,799,409,719,453,603,532,568.0,529.0,-71,150,-221
1850,11,6,1,7,0,1859,2252,2410,2283,2584,2672,1728,1016,1729,1498,1701,1735,1718.0,1645.0,34,203,-169
813,12,6,1,7,0,848,964,1340,1065,1086,1291,1027,356,690,687,838,753,796.0,759.0,-85,151,-236
2914,13,6,1,7,0,2293,2864,3253,2277,2327,2703,2119,1271,2126,2486,2863,2426,2644.0,2592.0,-437,377,-814
3363,14,6,1,7,0,2690,3318,3446,2827,2797,3447,2952,1308,2514,2566,2841,2880,2860.0,2762.0,39,275,-236
1165,15,6,1,7,0,974,1151,1369,1262,1632,1972,795,459,876,905,1141,1077,1109.0,1041.0,-64,236,-300
1293,16,6,1,7,0,1181,1412,1938,1686,1663,2151,1566,597,1095,1029,1047,1133,1090.0,1070.0,86,18,68
1564,17,6,1,7,0,1889,1918,2573,2247,1966,2770,1651,844,1487,1573,1636,1382,1509.0,1530.0,-254,63,-317
348,18,6,1,7,0,301,348,390,371,447,476,264,148,314,267,427,418,422.0,371.0,-9,160,-169
372,19,6,1,7,0,323,369,397,317,403,513,241,211,360,293,362,342,352.0,332.0,-20,69,-89
549,20,6,1,7,0,750,810,888,646,803,1149,803,328,472,453,543,623,583.0,540.0,80,90,-10
566,21,6,1,7,0,502,566,687,665,655,845,620,247,468,497,551,436,494.0,495.0,-115,54,-169
512,22,6,1,7,0,602,652,669,544,740,1032,399,306,506,449,585,503,544.0,512.0,-82,136,-218
1316,1,7,3,7,0,1154,1068,958,710,977,1212,1265,890,1247,1119,1184,1456,1320.0,1253.0,272,65,207
173,2,7,3,7,0,83,62,79,45,66,119,104,63,214,133,132,248,190.0,171.0,116,-1,117
146,3,7,3,7,0,56,51,54,43,56,75,86,64,154,131,164,163,164.0,153.0,-1,33,-34
1367,4,7,3,7,0,1014,976,1027,677,793,1627,1352,1114,1508,1132,1430,1670,1550.0,1411.0,240,298,-58
276,5,7,3,7,0,210,234,199,102,145,321,208,187,254,335,308,285,296.0,309.0,-23,-27,4
311,6,7,3,7,0,157,167,182,145,176,251,253,175,322,340,315,352,334.0,336.0,37,-25,62
1283,7,7,3,7,0,701,698,710,494,739,1047,878,649,1303,1248,1216,1405,1310.0,1290.0,189,-32,221
233,8,7,3,7,0,93,101,121,83,105,184,165,123,244,320,272,242,257.0,278.0,-30,-48,18
994,9,7,3,7,0,479,453,514,463,571,819,762,448,944,1100,1025,1038,1032.0,1054.0,13,-75,88
123,10,7,3,7,0,46,65,36,87,45,96,92,54,103,134,119,86,102.0,113.0,-33,-15,-18
1137,11,7,3,7,0,704,653,923,563,731,1002,974,650,1188,1289,1048,1276,1162.0,1204.0,228,-241,469
165,12,7,3,7,0,83,56,89,43,74,97,118,85,164,140,153,162,158.0,152.0,9,13,-4
656,13,7,3,7,0,288,302,284,232,288,493,470,361,599,660,769,569,669.0,666.0,-200,109,-309
754,14,7,3,7,0,353,356,387,282,366,596,517,345,763,731,685,764,724.0,727.0,79,-46,125
908,15,7,3,7,0,895,578,350,278,533,736,534,424,754,915,865,808,836.0,863.0,-57,-50,-7
272,16,7,3,7,0,108,119,115,66,94,173,151,103,240,253,187,234,210.0,225.0,47,-66,113
192,17,7,3,7,0,68,91,68,60,83,119,101,59,203,163,182,206,194.0,184.0,24,19,5
204,18,7,3,7,0,107,123,99,106,97,170,123,106,206,303,187,204,196.0,231.0,17,-116,133
413,19,7,3,7,0,211,178,184,111,151,300,181,154,357,324,363,378,370.0,355.0,15,39,-24
124,20,7,3,7,0,75,66,120,43,58,100,60,71,130,181,128,151,140.0,153.0,23,-53,76
313,21,7,3,7,0,195,228,164,136,164,313,234,179,320,305,340,358,349.0,334.0,18,35,-17
224,22,7,3,7,0,102,113,130,76,95,177,129,74,323,185,255,260,258.0,233.0,5,70,-65
379,1,8,2,7,0,547,504,605,431,543,697,325,168,288,309,527,516,522.0,451.0,-11,218,-229
75,2,8,2,7,0,86,60,80,64,106,112,40,25,38,54,68,55,62.0,59.0,-13,14,-27
61,3,8,2,7,0,54,65,50,48,60,75,31,18,29,46,51,51,51.0,49.0,0,5,-5
151,4,8,2,7,0,96,105,107,59,86,132,40,51,59,50,54,60,57.0,55.0,6,4,2
209,5,8,2,7,0,192,194,379,187,278,408,216,117,192,175,229,259,244.0,221.0,30,54,-24
445,6,8,2,7,0,284,383,452,363,447,587,357,148,207,278,368,463,416.0,370.0,95,90,5
402,7,8,2,7,0,384,434,524,437,477,555,320,180,373,400,374,355,364.0,376.0,-19,-26,7
71,8,8,2,7,0,53,40,61,59,55,64,30,23,28,38,44,60,52.0,47.0,16,6,10
222,9,8,2,7,0,205,191,284,225,342,408,121,39,166,158,211,185,198.0,185.0,-26,53,-79
56,10,8,2,7,0,48,72,86,66,86,129,68,34,47,50,71,60,66.0,60.0,-11,21,-32
995,11,8,2,7,0,934,1240,1311,1156,1271,1767,893,628,788,879,1067,1002,1034.0,983.0,-65,188,-253
233,12,8,2,7,0,187,201,205,175,224,302,169,92,161,188,202,170,186.0,187.0,-32,14,-46
199,13,8,2,7,0,130,129,149,129,127,215,80,56,93,108,163,149,156.0,140.0,-14,55,-69
262,14,8,2,7,0,222,264,300,257,320,368,183,97,185,329,340,259,300.0,309.0,-81,11,-92
706,15,8,2,7,0,611,791,867,742,941,1163,445,309,478,511,775,845,810.0,710.0,70,264,-194
185,16,8,2,7,0,204,189,253,233,287,401,211,94,172,184,195,243,219.0,207.0,48,11,37
202,17,8,2,7,0,169,202,213,182,259,315,201,83,173,167,198,189,194.0,185.0,-9,31,-40
134,18,8,2,7,0,59,77,86,70,117,145,54,20,51,78,114,140,127.0,111.0,26,36,-10
92,19,8,2,7,0,94,56,78,81,68,104,28,21,52,82,45,37,41.0,55.0,-8,-37,29
92,20,8,2,7,0,45,63,77,40,57,62,28,20,37,37,33,64,48.0,45.0,31,-4,35
102,21,8,2,7,0,102,126,137,141,113,177,107,51,78,83,124,102,113.0,103.0,-22,41,-63
27,22,8,2,7,0,30,29,39,29,28,30,11,11,8,18,20,17,18.0,18.0,-3,2,-5
755,1,9,1,7,0,829,878,839,851,1537,1734,940,540,957,807,919,933,926.0,886.0,14,112,-98
401,2,9,1,7,0,444,406,375,464,639,732,400,288,346,301,327,290,308.0,306.0,-37,26,-63
240,3,9,1,7,0,345,346,426,433,493,573,322,195,323,333,363,302,332.0,333.0,-61,30,-91
503,4,9,1,7,0,551,572,648,532,915,1057,659,394,601,489,595,532,564.0,539.0,-63,106,-169
793,5,9,1,7,0,816,821,1394,1020,1293,1876,1072,611,873,761,808,800,804.0,790.0,-8,47,-55
688,6,9,1,7,0,689,782,938,1018,1287,1597,1015,457,773,664,769,751,760.0,728.0,-18,105,-123
955,7,9,1,7,0,1240,1232,1497,1547,1722,2394,1077,522,1253,1236,1215,1019,1117.0,1157.0,-196,-21,-175
340,8,9,1,7,0,317,365,407,489,581,742,375,248,450,310,404,335,370.0,350.0,-69,94,-163
838,9,9,1,7,0,1023,986,1197,1508,2163,2594,949,463,1024,892,976,1062,1019.0,977.0,86,84,2
257,10,9,1,7,0,308,261,338,373,502,713,341,210,322,222,345,302,324.0,290.0,-43,123,-166
1072,11,9,1,7,0,1141,1497,1413,1635,2059,2647,1466,939,1519,1181,1355,1281,1318.0,1272.0,-74,174,-248
745,12,9,1,7,0,717,687,798,900,1083,1527,753,397,757,746,837,677,757.0,753.0,-160,91,-251
680,13,9,1,7,0,609,745,771,828,1012,1235,691,404,655,694,773,655,714.0,707.0,-118,79,-197
951,14,9,1,7,0,929,998,1228,1191,1470,2122,1000,589,1119,1013,903,937,920.0,951.0,34,-110,144
797,15,9,1,7,0,813,942,1042,1090,1626,2068,1003,537,978,796,1015,879,947.0,897.0,-136,219,-355
835,16,9,1,7,0,785,977,1135,1284,1519,1632,1025,485,1058,873,1015,949,982.0,946.0,-66,142,-208
893,17,9,1,7,0,924,1034,1175,1168,1619,2178,1217,467,1068,962,1084,875,980.0,974.0,-209,122,-331
356,18,9,1,7,0,417,426,426,568,767,913,522,257,433,373,497,408,452.0,426.0,-89,124,-213
262,19,9,1,7,0,315,365,365,407,443,594,254,172,277,329,290,263,276.0,294.0,-27,-39,12
329,20,9,1,7,0,357,329,386,354,500,762,420,252,342,321,324,387,356.0,344.0,63,3,60
447,21,9,1,7,0,316,283,360,444,478,651,365,184,306,238,357,732,544.0,442.0,375,119,256
143,22,9,1,7,0,213,233,201,203,289,372,142,121,207,187,231,186,208.0,201.0,-45,44,-89
1172,1,10,2,7,0,1616,1715,1560,1261,1546,1428,635,513,975,1070,1137,2596,1866.0,1601.0,1459,67,1392
602,2,10,2,7,0,451,462,412,350,412,626,249,167,333,316,408,510,459.0,411.0,102,92,10
440,3,10,2,7,0,313,335,434,451,516,701,285,178,320,330,439,413,426.0,394.0,-26,109,-135
314,4,10,2,7,0,247,248,278,174,264,913,106,74,113,101,453,335,394.0,296.0,-118,352,-470
1996,5,10,2,7,0,1800,1833,2351,1555,1783,2691,1134,763,1522,1501,1649,1954,1802.0,1701.0,305,148,157
2384,6,10,2,7,0,2071,2572,2578,2110,2138,2356,1607,968,1908,2068,2171,2517,2344.0,2252.0,346,103,243
4263,7,10,2,7,0,3185,3623,4079,3911,3787,4830,2048,1323,3138,3779,4223,3954,4088.0,3985.0,-269,444,-713
1017,8,10,2,7,0,635,770,774,678,852,1073,317,283,629,610,883,1085,984.0,859.0,202,273,-71
1964,9,10,2,7,0,2105,2230,2219,1912,2435,2500,695,488,1495,1512,1848,2203,2026.0,1854.0,355,336,19
1021,10,10,2,7,0,467,597,723,646,783,869,475,293,738,554,830,966,898.0,783.0,136,276,-140
4877,11,10,2,7,0,4343,5439,5089,5170,5016,5865,2657,2401,4119,4083,4704,4995,4850.0,4594.0,291,621,-330
1811,12,10,2,7,0,1282,1228,1446,1175,1376,1737,923,549,1502,1828,1895,1662,1778.0,1795.0,-233,67,-300
2856,13,10,2,7,0,1730,2030,2166,1672,1926,2621,900,720,1379,2198,2809,2761,2785.0,2589.0,-48,611,-659
3871,14,10,2,7,0,2569,3033,2794,2644,2874,3243,1683,1042,2558,3199,3067,3400,3234.0,3222.0,333,-132,465
3135,15,10,2,7,0,2644,3079,3258,3003,3295,3490,1289,1038,1965,1876,2506,2778,2642.0,2387.0,272,630,-358
1699,16,10,2,7,0,1388,1694,1779,1500,1547,1624,929,480,1234,1278,1437,1882,1660.0,1532.0,445,159,286
1686,17,10,2,7,0,1464,1556,1793,1457,1585,1952,989,516,1513,1616,1696,1720,1708.0,1677.0,24,80,-56
1258,18,10,2,7,0,1040,913,859,836,1130,958,546,402,859,878,1319,1184,1252.0,1127.0,-135,441,-576
727,19,10,2,7,0,570,710,667,540,619,821,205,149,446,498,474,571,522.0,514.0,97,-24,121
507,20,10,2,7,0,446,463,501,422,419,597,296,163,296,401,429,660,544.0,497.0,231,28,203
1091,21,10,2,7,0,762,830,880,891,912,1151,413,242,475,689,883,1688,1286.0,1087.0,805,194,611
279,22,10,2,7,0,247,332,298,250,347,415,118,130,301,193,254,310,282.0,252.0,56,61,-5
83,1,11,2,7,0,130,170,225,144,225,270,79,27,45,95,103,101,102.0,100.0,-2,8,-10
247,2,11,2,7,0,141,193,215,192,267,384,296,172,285,192,231,213,222.0,212.0,-18,39,-57
181,3,11,2,7,0,165,211,257,237,359,450,248,124,211,203,178,177,178.0,186.0,-1,-25,24
968,4,11,2,7,0,635,596,755,684,938,1287,118,74,556,952,1106,818,962.0,959.0,-288,154,-442
761,5,11,2,7,0,840,1135,1134,707,1002,2805,1326,797,891,676,702,734,718.0,704.0,32,26,6
532,6,11,2,7,0,626,807,752,716,977,1443,903,436,535,520,582,612,597.0,571.0,30,62,-32
1337,7,11,2,7,0,1510,2013,2253,1752,2198,3785,1878,1009,1343,1575,1488,1335,1412.0,1466.0,-153,-87,-66
448,8,11,2,7,0,396,591,635,370,1993,2925,603,248,417,464,574,426,500.0,488.0,-148,110,-258
1038,9,11,2,7,0,1216,1851,1526,1065,2044,2419,914,399,1078,1095,1082,1215,1148.0,1131.0,133,-13,146
474,10,11,2,7,0,373,565,452,368,493,935,666,303,492,403,512,470,491.0,462.0,-42,109,-151
821,11,11,2,7,0,1038,1263,1231,1184,1531,2308,910,648,752,1041,985,944,964.0,990.0,-41,-56,15
469,12,11,2,7,0,591,657,831,701,917,1377,999,364,509,561,555,561,558.0,559.0,6,-6,12
936,13,11,2,7,0,754,991,941,754,1144,2067,1110,641,741,953,1002,876,939.0,944.0,-126,49,-175
1652,14,11,2,7,0,1528,1922,1491,1090,1965,3560,2272,888,1199,1423,1368,1487,1428.0,1426.0,119,-55,174
1700,15,11,2,7,0,1877,2534,1978,2287,3147,4324,1028,639,1114,1097,2340,1882,2111.0,1773.0,-458,1243,-1701
460,16,11,2,7,0,487,636,528,521,941,1534,1004,347,476,456,410,475,442.0,447.0,65,-46,111
659,17,11,2,7,0,1014,1148,1102,762,1142,1719,1133,438,685,688,650,716,683.0,685.0,66,-38,104
602,18,11,2,7,0,710,861,605,468,762,1967,434,268,656,565,712,722,717.0,666.0,10,147,-137
160,19,11,2,7,0,328,373,319,239,291,520,199,149,205,202,188,167,178.0,186.0,-21,-14,-7
280,20,11,2,7,0,383,500,317,253,326,532,432,291,409,310,302,286,294.0,299.0,-16,-8,-8
1155,21,11,2,7,0,984,1191,1013,830,1010,1651,919,422,609,612,587,580,584.0,593.0,-7,-25,18
112,22,11,2,7,0,114,179,154,114,204,257,135,104,114,128,104,132,118.0,121.0,28,-24,52
45,1,12,2,7,0,84,82,78,75,125,158,63,40,60,51,45,46,46.0,47.0,1,-6,7
378,2,12,2,7,0,242,297,409,425,375,535,421,246,288,240,252,266,259.0,253.0,14,12,2
169,3,12,2,7,0,155,186,321,287,448,676,363,164,250,212,180,206,193.0,199.0,26,-32,58
54,4,12,2,7,0,192,229,328,289,360,496,86,74,109,80,71,61,66.0,71.0,-10,-9,-1
654,5,12,2,7,0,612,740,894,870,831,1260,724,451,621,526,535,628,582.0,563.0,93,9,84
322,6,12,2,7,0,360,423,570,478,510,806,576,272,358,315,316,346,331.0,326.0,30,1,29
930,7,12,2,7,0,1067,1385,1544,1660,1778,2915,1529,762,977,1071,1025,958,992.0,1018.0,-67,-46,-21
530,8,12,2,7,0,387,526,657,689,668,1092,615,366,578,543,590,543,566.0,559.0,-47,47,-94
743,9,12,2,7,0,726,1003,987,1170,1384,1437,718,363,821,836,734,867,800.0,812.0,133,-102,235
346,10,12,2,7,0,205,275,336,321,463,659,452,233,370,288,292,316,304.0,299.0,24,4,20
428,11,12,2,7,0,424,503,619,691,743,1008,543,405,518,460,406,448,427.0,438.0,42,-54,96
285,12,12,2,7,0,323,384,576,518,577,816,634,247,323,301,331,301,316.0,311.0,-30,30,-60
1140,13,12,2,7,0,976,1190,1442,1308,1432,2365,1304,951,1023,1070,1210,930,1070.0,1070.0,-280,140,-420
1053,14,12,2,7,0,921,1180,1362,1148,1406,2228,1526,717,888,888,823,850,836.0,854.0,27,-65,92
491,15,12,2,7,0,546,656,656,660,874,1121,438,306,511,460,520,507,514.0,496.0,-13,60,-73
407,16,12,2,7,0,353,445,594,534,655,903,635,255,364,342,325,362,344.0,343.0,37,-17,54
429,17,12,2,7,0,561,665,852,609,763,1216,773,321,479,531,540,517,528.0,529.0,-23,9,-32
212,18,12,2,7,0,218,279,280,218,239,420,249,153,274,195,252,248,250.0,232.0,-4,57,-61
251,19,12,2,7,0,308,361,450,328,514,641,287,222,321,326,279,247,263.0,284.0,-32,-47,15
240,20,12,2,7,0,263,289,325,272,292,402,296,142,238,207,233,232,232.0,224.0,-1,26,-27
470,21,12,2,7,0,562,667,705,729,755,1158,815,410,484,484,492,471,482.0,482.0,-21,8,-29
199,22,12,2,7,0,189,179,249,176,328,336,166,145,205,161,183,216,200.0,187.0,33,22,11
77,1,13,1,7,0,143,149,181,158,314,461,180,102,190,125,145,92,118.0,121.0,-53,20,-73
654,2,13,1,7,0,387,336,447,627,757,1396,1059,575,778,650,682,486,584.0,606.0,-196,32,-228
344,3,13,1,7,0,186,216,287,324,527,720,520,270,473,409,472,356,414.0,412.0,-116,63,-179
41,4,13,1,7,0,137,177,237,199,242,487,101,86,162,127,117,78,98.0,107.0,-39,-10,-29
872,5,13,1,7,0,741,845,1263,1243,1605,2433,1860,1194,1302,1156,1192,925,1058.0,1091.0,-267,36,-303
651,6,13,1,7,0,651,840,1069,1269,1370,2298,1440,720,878,861,934,738,836.0,844.0,-196,73,-269
1432,7,13,1,7,0,927,999,1485,1686,2126,3804,2217,1109,1504,1812,1956,1321,1638.0,1696.0,-635,144,-779
562,8,13,1,7,0,271,379,496,642,748,1215,772,404,591,661,732,531,632.0,641.0,-201,71,-272
663,9,13,1,7,0,550,650,835,848,1467,2021,1040,446,977,1064,948,854,901.0,955.0,-94,-116,22
399,10,13,1,7,0,225,284,342,388,511,880,738,330,660,454,586,385,486.0,475.0,-201,132,-333
913,11,13,1,7,0,762,1001,1116,1451,1816,2525,1540,1130,1441,1246,1265,930,1098.0,1147.0,-335,19,-354
445,12,13,1,7,0,409,440,725,733,889,1320,1015,377,598,631,632,491,562.0,585.0,-141,1,-142
1714,13,13,1,7,0,958,1014,1437,1548,2026,3281,1882,1126,1456,2041,2368,1518,1943.0,1976.0,-850,327,-1177
1362,14,13,1,7,0,857,953,1313,1473,1843,2975,2324,1002,1413,1518,1509,1135,1322.0,1387.0,-374,-9,-365
814,15,13,1,7,0,731,805,1089,1175,1502,2235,958,565,880,893,948,697,822.0,846.0,-251,55,-306
696,16,13,1,7,0,505,669,868,924,1339,1557,1148,463,782,723,758,663,710.0,715.0,-95,35,-130
506,17,13,1,7,0,407,438,633,772,835,1281,1235,439,733,664,655,498,576.0,606.0,-157,-9,-148
328,18,13,1,7,0,234,282,307,414,622,877,518,365,529,461,541,380,460.0,461.0,-161,80,-241
303,19,13,1,7,0,236,231,291,296,396,542,311,224,349,397,405,266,336.0,356.0,-139,8,-147
284,20,13,1,7,0,218,259,311,316,419,666,489,274,346,334,368,358,363.0,353.0,-10,34,-44
487,21,13,1,7,0,303,362,519,627,715,1549,1036,394,463,535,597,405,501.0,512.0,-192,62,-254
592,22,13,1,7,0,336,422,442,411,616,998,401,372,684,679,736,526,631.0,647.0,-210,57,-267
362,1,14,1,7,0,464,522,661,472,781,1047,423,192,279,354,355,429,392.0,379.0,74,1,73
1148,2,14,1,7,0,939,877,1084,1148,1159,1879,1354,680,631,992,1295,955,1125.0,1081.0,-340,303,-643
802,3,14,1,7,0,551,578,725,701,941,1442,814,347,566,786,1042,724,883.0,851.0,-318,256,-574
433,4,14,1,7,0,454,496,664,474,569,1295,274,176,281,280,376,386,381.0,347.0,10,96,-86
1619,5,14,1,7,0,1417,1488,2289,1556,2162,4188,2540,1081,1111,1488,1668,1412,1540.0,1523.0,-256,180,-436
1404,6,14,1,7,0,1412,1803,1996,1889,2073,3650,2495,863,893,1218,1582,1360,1471.0,1387.0,-222,364,-586
3057,7,14,1,7,0,2583,2886,3461,3252,3594,6275,3467,1356,2002,3249,3444,2666,3055.0,3120.0,-778,195,-973
798,8,14,1,7,0,619,652,805,800,914,1576,743,357,500,790,998,720,859.0,836.0,-278,208,-486
2038,9,14,1,7,0,1837,2246,2808,2902,3269,4342,1784,653,1364,1722,2162,2247,2204.0,2044.0,85,440,-355
699,10,14,1,7,0,518,574,670,621,739,1316,892,381,556,538,802,574,688.0,638.0,-228,264,-492
2564,11,14,1,7,0,2600,3230,3453,3560,3776,5864,3032,1760,2316,2607,3244,2604,2924.0,2818.0,-640,637,-1277
902,12,14,1,7,0,839,860,1325,1195,1285,2160,1579,453,603,962,960,811,886.0,911.0,-149,-2,-147
2567,13,14,1,7,0,2024,2258,2481,2298,2594,4551,2375,1231,1427,2467,3049,2213,2631.0,2576.0,-836,582,-1418
2930,14,14,1,7,0,3103,3396,3571,3427,4047,8018,5309,1586,1915,2716,3025,2701,2863.0,2814.0,-324,309,-633
2230,15,14,1,7,0,1897,2229,2579,2724,3014,4336,1679,826,1161,1890,2275,1899,2087.0,2021.0,-376,385,-761
1359,16,14,1,7,0,1304,1341,1747,1512,1848,3179,2049,551,906,1028,1278,1264,1271.0,1190.0,-14,250,-264
1479,17,14,1,7,0,1536,1679,2187,1872,2355,3747,2461,732,1157,1395,1621,1288,1454.0,1435.0,-333,226,-559
740,18,14,1,7,0,626,618,738,859,1140,1306,596,364,463,616,759,757,758.0,711.0,-2,143,-145
1200,19,14,1,7,0,1022,1132,1218,970,1188,1784,769,415,765,1227,1203,969,1086.0,1133.0,-234,-24,-210
619,20,14,1,7,0,635,655,770,622,761,1417,877,373,399,529,594,627,610.0,583.0,33,65,-32
790,21,14,1,7,0,587,654,727,899,841,1546,1008,303,361,648,917,661,789.0,742.0,-256,269,-525
876,22,14,1,7,0,663,777,675,517,944,1290,579,365,604,725,778,831,804.0,778.0,53,53,0
522,1,15,2,7,0,680,720,820,623,807,1293,851,433,764,667,727,689,708.0,694.0,-38,60,-98
443,2,15,2,7,0,468,405,456,394,535,639,509,300,415,361,462,414,438.0,412.0,-48,101,-149
446,3,15,2,7,0,407,480,482,477,451,580,494,276,556,527,562,528,545.0,539.0,-34,35,-69
834,4,15,2,7,0,1062,1143,1276,969,1288,2146,1327,923,1308,982,1002,1096,1049.0,1027.0,94,20,74
776,5,15,2,7,0,585,715,1123,634,781,1105,856,454,680,597,621,651,636.0,623.0,30,24,6
708,6,15,2,7,0,472,667,840,774,803,1070,953,364,644,584,685,706,696.0,658.0,21,101,-80
1319,7,15,2,7,0,988,1162,1315,1224,1513,1837,1329,778,1244,1284,1298,1141,1220.0,1241.0,-157,14,-171
639,8,15,2,7,0,604,750,729,770,798,1203,945,474,746,713,727,660,694.0,700.0,-67,14,-81
389,9,15,2,7,0,313,351,438,425,536,825,423,180,427,549,477,696,586.0,574.0,219,-72,291
137,10,15,2,7,0,93,121,141,135,160,243,179,71,140,141,183,151,167.0,158.0,-32,42,-74
1263,11,15,2,7,0,1276,1793,1838,1848,1951,2643,1820,1058,1565,1288,1340,1313,1326.0,1314.0,-27,52,-79
255,12,15,2,7,0,321,334,419,377,424,571,408,151,325,301,312,293,302.0,302.0,-19,11,-30
1425,13,15,2,7,0,977,1321,1377,1264,1433,1923,1604,884,1377,1523,1631,1539,1585.0,1564.0,-92,108,-200
1125,14,15,2,7,0,834,1010,1081,952,1113,1482,1178,548,1003,1062,1044,1052,1048.0,1053.0,8,-18,26
628,15,15,2,7,0,536,601,733,722,894,1112,767,352,679,681,651,616,634.0,649.0,-35,-30,-5
330,16,15,2,7,0,260,295,373,329,377,483,446,164,271,261,296,275,286.0,277.0,-21,35,-56
395,17,15,2,7,0,339,383,464,438,477,783,487,262,452,359,428,383,406.0,390.0,-45,69,-114
182,18,15,2,7,0,212,189,235,212,345,456,397,140,227,217,291,297,294.0,268.0,6,74,-68
221,19,15,2,7,0,277,296,261,247,251,310,270,165,356,218,179,255,217.0,217.0,76,-39,115
374,20,15,2,7,0,408,414,486,426,491,644,555,263,408,381,378,462,420.0,407.0,84,-3,87
553,21,15,2,7,0,388,413,568,617,622,758,719,361,603,579,645,499,572.0,574.0,-146,66,-212
123,22,15,2,7,0,124,187,159,142,152,169,104,79,149,106,141,121,131.0,123.0,-20,35,-55
123,1,16,2,7,0,46,46,41,395,67,117,63,37,86,109,100,151,126.0,120.0,51,-9,60
1277,2,16,2,7,0,1395,1426,1254,988,1142,1590,946,692,1035,755,884,765,824.0,801.0,-119,129,-248
652,3,16,2,7,0,744,864,895,802,945,982,602,413,714,724,743,629,686.0,699.0,-114,19,-133
278,4,16,2,7,0,716,794,737,477,625,985,300,271,404,282,274,292,283.0,283.0,18,-8,26
2530,5,16,2,7,0,2620,2791,2955,1733,2221,3340,1470,1639,3175,2405,2457,2398,2428.0,2420.0,-59,52,-111
366,6,16,2,7,0,502,552,488,424,410,575,248,260,384,279,286,452,369.0,339.0,166,7,159
2797,7,16,2,7,0,3126,3130,3837,3617,3662,4024,1903,1708,2748,2376,2932,2420,2676.0,2576.0,-512,556,-1068
1028,8,16,2,7,0,993,1217,1561,1243,1188,1616,679,442,672,792,892,815,854.0,833.0,-77,100,-177
1682,9,16,2,7,0,1766,1963,2010,1906,2111,2398,1196,1075,2249,1558,2005,1936,1970.0,1833.0,-69,447,-516
446,10,16,2,7,0,405,319,409,384,459,435,440,301,449,664,501,523,512.0,563.0,22,-163,185
623,11,16,2,7,0,701,745,840,781,777,930,527,626,655,605,586,670,628.0,620.0,84,-19,103
244,12,16,2,7,0,330,358,538,488,482,540,354,189,356,270,359,296,328.0,308.0,-63,89,-152
3242,13,16,2,7,0,3102,3388,3910,3483,3233,4206,2068,1780,2633,2656,3148,2856,3002.0,2887.0,-292,492,-784
1785,14,16,2,7,0,2200,2100,2323,1931,2018,2962,1570,1050,1823,1515,1509,1506,1508.0,1510.0,-3,-6,3
517,15,16,2,7,0,769,777,723,606,634,886,424,422,628,555,606,538,572.0,566.0,-68,51,-119
430,16,16,2,7,0,595,715,725,585,544,920,483,270,442,304,376,403,390.0,361.0,27,72,-45
1149,17,16,2,7,0,1456,1533,1680,1444,1489,2336,1714,653,1232,835,1023,1076,1050.0,978.0,53,188,-135
470,18,16,2,7,0,627,773,710,690,597,622,308,292,460,424,486,428,457.0,446.0,-58,62,-120
1419,19,16,2,7,0,1804,1815,1871,1308,1478,1878,681,691,1319,1119,1215,1237,1226.0,1190.0,22,96,-74
161,20,16,2,7,0,530,502,347,184,172,247,131,105,125,160,126,176,151.0,154.0,50,-34,84
603,21,16,2,7,0,874,1106,695,580,634,1051,558,384,605,487,577,560,568.0,541.0,-17,90,-107
1649,22,16,2,7,0,1193,1427,1562,1308,1636,1781,730,952,1556,1254,1336,1463,1400.0,1351.0,127,82,45
1421,1,17,2,7,0,1180,1500,2397,1674,2362,3060,1909,501,2672,4039,883,4181,2532.0,3034.0,3298,-3156,6454
1300,2,17,2,7,0,884,974,1076,1038,1033,1402,656,504,651,603,785,827,806.0,738.0,42,182,-140
575,3,17,2,7,0,410,446,541,468,630,827,268,214,376,413,543,491,517.0,482.0,-52,130,-182
498,4,17,2,7,0,995,1118,835,516,1494,2145,217,200,2331,1550,280,361,320.0,730.0,81,-1270,1351
1801,5,17,2,7,0,1662,1864,2707,1708,2119,2450,1355,937,1478,2078,1399,1459,1429.0,1645.0,60,-679,739
1947,6,17,2,7,0,2028,2809,2863,2529,2927,3132,1460,775,1436,1362,1591,1598,1594.0,1517.0,7,229,-222
3263,7,17,2,7,0,3147,4018,4409,4129,4087,5401,1885,1225,2010,2269,2615,2569,2592.0,2484.0,-46,346,-392
1670,8,17,2,7,0,1223,1490,1510,1452,1547,2066,692,491,877,974,1192,1135,1164.0,1100.0,-57,218,-275
1515,9,17,2,7,0,1715,2112,2192,2036,2188,2519,625,462,1475,1506,1216,1544,1380.0,1422.0,328,-290,618
518,10,17,2,7,0,413,503,589,568,596,616,308,176,366,289,407,451,429.0,382.0,44,118,-74
4299,11,17,2,7,0,3369,4854,5016,4475,5007,5643,2143,1862,2644,2631,3008,3307,3158.0,2982.0,299,377,-78
1333,12,17,2,7,0,1308,1681,2044,1627,1981,2357,973,442,916,895,1031,1009,1020.0,978.0,-22,136,-158
4091,13,17,2,7,0,2964,3829,3951,3277,3711,5424,1723,1261,2043,2652,2981,2611,2796.0,2748.0,-370,329,-699
4009,14,17,2,7,0,3421,4398,4500,3793,4237,5119,2463,1238,2429,2562,2723,3091,2907.0,2792.0,368,161,207
1767,15,17,2,7,0,2021,2513,2777,2324,2401,2755,895,768,1359,1321,1533,1474,1504.0,1443.0,-59,212,-271
1431,16,17,2,7,0,1120,1591,1818,1296,1466,1985,1002,357,841,848,822,1085,954.0,918.0,263,-26,289
1663,17,17,2,7,0,1583,1906,2187,1670,2078,2533,1085,531,1104,1014,1204,1328,1266.0,1182.0,124,190,-66
1141,18,17,2,7,0,1055,1347,1279,1170,1218,1549,440,400,775,721,1235,973,1104.0,976.0,-262,514,-776
977,19,17,2,7,0,702,806,897,700,869,1098,268,212,386,587,555,690,622.0,611.0,135,-32,167
1027,20,17,2,7,0,987,1230,1171,824,938,1120,617,359,603,607,619,800,710.0,675.0,181,12,169
1691,21,17,2,7,0,1113,1278,1300,1165,1199,1748,631,397,661,1831,842,1735,1288.0,1469.0,893,-989,1882
354,22,17,2,7,0,303,404,404,286,466,480,162,156,276,218,323,452,388.0,331.0,129,105,24
314,1,18,2,7,0,425,535,502,314,574,754,315,362,767,319,351,300,326.0,323.0,-51,32,-83
543,2,18,2,7,0,551,450,435,635,692,866,452,295,448,404,525,442,484.0,457.0,-83,121,-204
504,3,18,2,7,0,380,452,427,495,612,941,427,254,591,556,550,476,513.0,527.0,-74,-6,-68
150,4,18,2,7,0,382,397,346,199,341,546,125,89,159,100,115,114,114.0,110.0,-1,15,-16
878,5,18,2,7,0,1379,1197,903,838,1187,1812,1017,704,1344,1235,1081,1056,1068.0,1124.0,-25,-154,129
733,6,18,2,7,0,1109,958,734,813,952,1669,741,475,869,701,638,694,666.0,678.0,56,-63,119
2825,7,18,2,7,0,3450,3299,2451,2995,3812,5496,2330,1515,2865,2841,2834,2558,2696.0,2744.0,-276,-7,-269
1557,8,18,2,7,0,1462,1588,1052,1126,1234,2626,1165,641,1247,1425,1531,1329,1430.0,1428.0,-202,106,-308
467,9,18,2,7,0,457,448,529,384,525,1055,368,255,433,540,513,805,659.0,619.0,292,-27,319
222,10,18,2,7,0,363,291,255,362,355,448,365,155,240,485,249,405,327.0,380.0,156,-236,392
892,11,18,2,7,0,1353,1085,864,1310,1728,2261,1167,1028,1507,1281,827,792,810.0,967.0,-35,-454,419
242,12,18,2,7,0,365,335,301,356,946,847,641,223,316,236,253,238,246.0,242.0,-15,17,-32
3284,13,18,2,7,0,3210,3609,2265,2586,3058,5478,1932,1551,2981,3513,3250,2524,2887.0,3096.0,-726,-263,-463
1714,14,18,2,7,0,1701,1452,1141,1472,1941,3092,1731,893,1695,1504,1408,1487,1448.0,1466.0,79,-96,175
578,15,18,2,7,0,1000,913,659,638,706,1205,504,467,741,598,514,446,480.0,519.0,-68,-84,16
170,16,18,2,7,0,277,263,202,272,348,657,298,154,273,222,166,164,165.0,184.0,-2,-56,54
484,17,18,2,7,0,962,701,698,568,587,1351,576,253,448,437,409,373,391.0,406.0,-36,-28,-8
231,18,18,2,7,0,356,355,342,307,452,617,215,148,255,232,240,199,220.0,224.0,-41,8,-49
667,19,18,2,7,0,621,716,684,572,853,1026,394,408,768,721,776,679,728.0,725.0,-97,55,-152
249,20,18,2,7,0,558,474,304,408,379,694,353,248,346,329,249,207,228.0,262.0,-42,-80,38
625,21,18,2,7,0,667,832,623,693,804,1400,754,418,791,600,553,553,553.0,569.0,0,-47,47
471,22,18,2,7,0,369,508,307,324,496,710,280,266,503,464,518,466,492.0,483.0,-52,54,-106
254,1,19,2,7,0,201,232,150,148,312,359,339,177,321,249,248,328,288.0,275.0,80,-1,81
430,2,19,2,7,0,388,290,304,344,442,485,409,248,357,375,412,347,380.0,378.0,-65,37,-102
431,3,19,2,7,0,398,348,325,432,401,434,519,319,522,443,583,484,534.0,503.0,-99,140,-239
967,4,19,2,7,0,990,1183,1150,795,1121,1802,1263,877,1267,1047,1549,1033,1291.0,1210.0,-516,502,-1018
845,5,19,2,7,0,623,519,741,610,732,1083,1390,565,951,827,852,794,823.0,824.0,-58,25,-83
581,6,19,2,7,0,381,360,323,440,519,629,667,315,471,534,553,570,562.0,552.0,17,19,-2
1627,7,19,2,7,0,1256,1311,1391,1370,1666,1642,1861,878,1578,1694,1792,1554,1673.0,1680.0,-238,98,-336
431,8,19,2,7,0,316,332,330,480,421,414,426,317,451,395,445,395,420.0,412.0,-50,50,-100
769,9,19,2,7,0,509,516,523,704,995,1243,727,322,827,693,791,804,798.0,763.0,13,98,-85
168,10,19,2,7,0,97,101,156,159,192,214,225,119,204,139,193,190,192.0,174.0,-3,54,-57
1197,11,19,2,7,0,785,871,1280,881,1099,1374,1336,868,1301,1124,1278,1241,1260.0,1214.0,-37,154,-191
285,12,19,2,7,0,199,169,178,237,276,329,364,141,291,237,315,278,296.0,277.0,-37,78,-115
1806,13,19,2,7,0,1238,1360,1115,1052,1461,1615,1768,1165,1697,1805,2074,1714,1894.0,1864.0,-360,269,-629
1478,14,19,2,7,0,957,1047,1104,1357,1223,1443,1429,856,1325,1403,1419,1413,1416.0,1412.0,-6,16,-22
663,15,19,2,7,0,475,404,404,512,747,863,742,356,707,633,707,646,676.0,662.0,-61,74,-135
493,16,19,2,7,0,298,379,393,374,473,566,558,262,443,396,470,482,476.0,449.0,12,74,-62
387,17,19,2,7,0,273,291,253,248,418,494,519,230,424,383,397,379,388.0,386.0,-18,14,-32
284,18,19,2,7,0,229,183,186,285,325,402,404,188,330,251,340,301,320.0,297.0,-39,89,-128
785,19,19,2,7,0,652,721,569,738,644,1082,704,546,870,783,781,790,786.0,785.0,9,-2,11
335,20,19,2,7,0,254,213,262,251,282,391,433,202,335,319,317,436,376.0,357.0,119,-2,121
519,21,19,2,7,0,356,360,419,276,346,497,487,257,378,390,460,393,426.0,414.0,-67,70,-137
890,22,19,2,7,0,639,929,731,657,664,964,785,666,1198,1070,1179,970,1074.0,1073.0,-209,109,-318
552,1,20,1,7,0,897,946,1150,1010,1563,1504,815,447,731,532,612,632,622.0,592.0,20,80,-60
501,2,20,1,7,0,681,595,570,759,692,785,585,277,403,310,422,368,395.0,367.0,-54,112,-166
136,3,20,1,7,0,296,333,327,407,342,430,303,110,229,177,183,153,168.0,171.0,-30,6,-36
275,4,20,1,7,0,675,772,925,740,925,1127,376,284,427,371,462,336,399.0,390.0,-126,91,-217
616,5,20,1,7,0,990,1085,1885,1100,1320,1775,1096,562,764,657,680,772,726.0,703.0,92,23,69
632,6,20,1,7,0,769,980,1023,1001,1064,1490,952,364,600,581,589,605,597.0,592.0,16,8,8
892,7,20,1,7,0,1134,1323,1432,1303,1408,1739,940,501,805,813,957,836,896.0,869.0,-121,144,-265
102,8,20,1,7,0,257,295,289,333,332,371,229,113,151,138,130,107,118.0,125.0,-23,-8,-15
768,9,20,1,7,0,1097,1195,1320,1463,1644,2216,854,451,986,862,846,947,896.0,885.0,101,-16,117
181,10,20,1,7,0,187,218,240,280,255,372,218,114,237,155,197,163,180.0,172.0,-34,42,-76
1086,11,20,1,7,0,1571,1947,1897,1872,2263,3132,1586,987,1345,1015,1158,1068,1113.0,1080.0,-90,143,-233
457,12,20,1,7,0,681,684,855,798,870,1144,754,284,498,430,503,444,474.0,459.0,-59,73,-132
668,13,20,1,7,0,676,985,861,883,944,1218,652,442,599,687,716,543,630.0,649.0,-173,29,-202
703,14,20,1,7,0,965,1056,1067,1021,1121,1578,856,471,700,719,644,669,656.0,677.0,25,-75,100
1172,15,20,1,7,0,1921,2037,2367,2323,2703,3371,1749,893,1369,1150,1156,1037,1096.0,1114.0,-119,6,-125
621,16,20,1,7,0,730,829,920,1033,988,1333,941,363,579,523,593,600,596.0,572.0,7,70,-63
594,17,20,1,7,0,811,908,1056,973,1081,1561,1003,386,716,610,659,562,610.0,610.0,-97,49,-146
366,18,20,1,7,0,681,684,714,853,905,1102,667,370,551,387,534,372,453.0,431.0,-162,147,-309
265,19,20,1,7,0,444,478,491,437,403,555,253,188,258,212,206,203,204.0,207.0,-3,-6,3
274,20,20,1,7,0,421,422,477,428,496,740,452,184,293,290,264,303,284.0,286.0,39,-26,65
285,21,20,1,7,0,338,351,433,450,479,533,395,223,292,216,328,233,280.0,259.0,-95,112,-207
210,22,20,1,7,0,362,461,359,320,352,428,213,219,281,217,259,239,249.0,238.0,-20,42,-62
353,1,21,2,7,0,464,563,552,450,685,688,275,231,396,369,368,427,398.0,388.0,59,-1,60
556,2,21,2,7,0,837,743,640,687,714,1001,409,321,443,427,437,368,402.0,411.0,-69,10,-79
522,3,21,2,7,0,509,544,557,650,671,789,370,239,440,455,525,460,492.0,480.0,-65,70,-135
482,4,21,2,7,0,1021,1288,1431,1045,1332,1807,402,360,619,496,497,491,494.0,495.0,-6,1,-7
1861,5,21,2,7,0,1887,2009,2921,2017,2913,3590,1589,1106,1523,1538,1537,1666,1602.0,1580.0,129,-1,130
1346,6,21,2,7,0,1307,1431,1596,1491,1717,1968,921,593,995,1124,1199,1070,1134.0,1131.0,-129,75,-204
2082,7,21,2,7,0,2003,2387,2615,2547,2776,3299,1329,945,1856,2083,2108,1738,1923.0,1976.0,-370,25,-395
688,8,21,2,7,0,641,800,787,813,782,1130,401,261,510,549,610,526,568.0,562.0,-84,61,-145
994,9,21,2,7,0,1029,1303,1438,1702,2171,2397,475,354,1081,908,1044,1235,1140.0,1062.0,191,136,55
316,10,21,2,7,0,287,282,358,395,493,595,225,179,348,224,290,274,282.0,263.0,-16,66,-82
2485,11,21,2,7,0,2394,3107,2962,3228,3579,4302,1623,1477,2234,2129,2434,2155,2294.0,2239.0,-279,305,-584
652,12,21,2,7,0,672,641,755,781,885,1016,398,230,537,551,590,548,569.0,563.0,-42,39,-81
3344,13,21,2,7,0,2559,2979,2860,2877,2989,3954,1565,1311,2239,2725,3260,2705,2982.0,2897.0,-555,535,-1090
2489,14,21,2,7,0,2115,2398,2493,2358,2638,3291,1489,872,1684,1948,1801,1780,1790.0,1843.0,-21,-147,126
1645,15,21,2,7,0,1572,1914,1992,2163,2458,2897,961,793,1491,1417,1453,1417,1435.0,1429.0,-36,36,-72
898,16,21,2,7,0,789,996,1142,948,1247,1304,805,357,634,667,656,762,709.0,695.0,106,-11,117
728,17,21,2,7,0,720,817,950,757,948,1222,427,264,565,544,561,563,562.0,556.0,2,17,-15
541,18,21,2,7,0,680,640,694,837,946,924,385,327,518,415,620,444,532.0,493.0,-176,205,-381
895,19,21,2,7,0,904,1088,1057,1007,1160,1513,414,423,828,916,847,707,777.0,823.0,-140,-69,-71
329,20,21,2,7,0,375,374,365,407,493,612,296,209,288,300,336,388,362.0,341.0,52,36,16
654,21,21,2,7,0,701,761,801,945,946,1143,404,239,410,468,587,452,520.0,502.0,-135,119,-254
729,22,21,2,7,0,757,1154,914,753,1190,1198,462,436,1058,713,772,690,731.0,725.0,-82,59,-141
612,1,22,4,7,0,600,670,690,633,790,925,325,455,653,555,624,740,682.0,640.0,116,69,47
290,2,22,4,7,0,493,447,408,431,527,546,194,218,317,270,316,211,264.0,266.0,-105,46,-151
288,3,22,4,7,0,313,341,355,371,359,418,168,163,287,292,335,266,300.0,298.0,-69,43,-112
617,4,22,4,7,0,879,911,1074,915,1162,1615,471,523,831,698,714,664,689.0,692.0,-50,16,-66
656,5,22,4,7,0,745,722,1155,772,961,1167,445,516,738,665,640,630,635.0,645.0,-10,-25,15
618,6,22,4,7,0,677,767,841,878,933,1003,374,418,658,653,606,565,586.0,608.0,-41,-47,6
1615,7,22,4,7,0,1638,1852,2308,2307,2370,2766,875,984,1739,1860,1899,1420,1660.0,1726.0,-479,39,-518
247,8,22,4,7,0,285,300,313,320,355,484,139,184,247,243,229,225,227.0,232.0,-4,-14,10
680,9,22,4,7,0,937,951,992,1092,1209,1464,402,402,896,629,772,826,799.0,742.0,54,143,-89
154,10,22,4,7,0,260,262,246,259,290,384,118,109,224,157,222,215,218.0,198.0,-7,65,-72
2048,11,22,4,7,0,2112,2209,2679,2595,2801,3241,1057,1612,2234,1953,2227,1909,2068.0,2030.0,-318,274,-592
345,12,22,4,7,0,434,393,442,498,481,511,213,176,385,307,351,273,312.0,310.0,-78,44,-122
1661,13,22,4,7,0,1298,1461,1525,1603,1929,2115,754,885,1533,1690,1813,1571,1692.0,1691.0,-242,123,-365
1158,14,22,4,7,0,1096,1283,1383,1309,1461,1740,591,724,1200,1228,1058,967,1012.0,1084.0,-91,-170,79
1884,15,22,4,7,0,1999,1697,1991,2033,2127,2662,818,1237,1764,1676,1729,1525,1627.0,1643.0,-204,53,-257
438,16,22,4,7,0,499,596,611,603,616,685,305,279,470,356,444,412,428.0,404.0,-32,88,-120
409,17,22,4,7,0,503,514,645,501,559,768,256,278,497,347,424,341,382.0,371.0,-83,77,-160
356,18,22,4,7,0,503,451,397,473,480,608,216,257,389,262,395,326,360.0,328.0,-69,133,-202
346,19,22,4,7,0,483,505,553,489,516,595,169,217,412,408,386,321,354.0,372.0,-65,-22,-43
126,20,22,4,7,0,189,145,189,159,216,258,69,99,133,100,129,180,154.0,136.0,51,29,22
417,21,22,4,7,0,402,487,425,510,487,657,185,238,361,306,395,301,348.0,334.0,-94,89,-183
345,22,22,4,7,0,420,611,511,443,413,533,157,228,535,404,398,359,378.0,387.0,-39,-6,-33
37,1,23,1,7,0,83,134,126,104,114,215,76,41,45,61,38,52,45.0,50.0,14,-23,37
44,2,23,1,7,0,141,121,133,139,121,182,95,41,34,36,31,58,44.0,42.0,27,-5,32
74,3,23,1,7,0,114,92,121,108,174,205,99,66,95,76,72,76,74.0,75.0,4,-4,8
32,4,23,1,7,0,201,202,250,161,243,439,74,40,54,53,41,27,34.0,40.0,-14,-12,-2
134,5,23,1,7,0,284,317,459,291,297,513,309,153,136,133,149,150,150.0,144.0,1,16,-15
279,6,23,1,7,0,633,733,655,600,692,1047,578,273,312,307,331,314,322.0,317.0,-17,24,-41
536,7,23,1,7,0,1000,1063,1138,1097,1099,1844,902,381,538,572,675,544,610.0,597.0,-131,103,-234
178,8,23,1,7,0,212,261,250,277,308,545,238,158,237,226,236,217,226.0,226.0,-19,10,-29
92,9,23,1,7,0,291,295,282,277,289,373,126,71,118,103,101,96,98.0,100.0,-5,-2,-3
48,10,23,1,7,0,108,107,108,100,115,162,93,53,69,35,53,40,46.0,43.0,-13,18,-31
185,11,23,1,7,0,402,461,370,406,397,621,300,168,197,206,183,203,193.0,197.0,20,-23,43
53,12,23,1,7,0,141,112,150,164,143,266,151,36,61,68,60,40,50.0,56.0,-20,-8,-12
452,13,23,1,7,0,575,645,742,699,808,1460,748,389,430,459,518,401,460.0,459.0,-117,59,-176
290,14,23,1,7,0,477,544,566,471,617,1100,524,174,251,240,290,254,272.0,261.0,-36,50,-86
77,15,23,1,7,0,194,181,198,211,191,260,101,55,63,66,67,90,78.0,74.0,23,1,22
125,16,23,1,7,0,274,266,326,324,313,534,275,79,103,125,96,138,117.0,120.0,42,-29,71
138,17,23,1,7,0,282,273,347,286,335,535,308,119,163,126,142,139,140.0,136.0,-3,16,-19
33,18,23,1,7,0,101,114,102,89,87,129,60,25,51,31,35,42,38.0,36.0,7,4,3
148,19,23,1,7,0,252,331,280,278,265,371,149,91,133,121,130,132,131.0,128.0,2,9,-7
67,20,23,1,7,0,247,251,250,189,199,335,168,84,69,66,80,88,84.0,78.0,8,14,-6
83,21,23,1,7,0,180,161,167,197,186,360,209,62,83,76,106,84,95.0,89.0,-22,30,-52
105,22,23,1,7,0,165,264,248,169,223,312,126,95,154,101,143,86,114.0,110.0,-57,42,-99
704,1,24,2,7,0,653,687,651,489,558,362,679,494,731,600,672,772,722.0,681.0,100,72,28
250,2,24,2,7,0,247,209,201,174,160,155,229,130,223,186,188,194,191.0,189.0,6,2,4
99,3,24,2,7,0,108,130,97,99,82,59,106,63,136,99,113,83,98.0,98.0,-30,14,-44
670,4,24,2,7,0,748,847,831,642,654,521,798,532,838,575,694,618,656.0,629.0,-76,119,-195
549,5,24,2,7,0,460,559,615,471,430,474,703,394,653,524,606,614,610.0,581.0,8,82,-74
340,6,24,2,7,0,244,344,348,248,228,187,338,203,372,311,341,346,344.0,333.0,5,30,-25
531,7,24,2,7,0,584,549,525,474,421,353,610,362,607,527,608,548,578.0,561.0,-60,81,-141
130,8,24,2,7,0,121,154,121,105,117,105,129,94,160,139,138,152,145.0,143.0,14,-1,15
1095,9,24,2,7,0,1083,1238,1180,1049,976,1007,1207,847,1361,1093,1267,1219,1243.0,1193.0,-48,174,-222
137,10,24,2,7,0,142,161,151,126,138,119,159,102,172,121,154,153,154.0,143.0,-1,33,-34
1493,11,24,2,7,0,1509,1821,1585,1270,1186,1077,1735,1066,1713,1523,1554,1639,1596.0,1572.0,85,31,54
206,12,24,2,7,0,198,224,232,164,154,152,242,146,291,216,232,253,242.0,234.0,21,16,5
372,13,24,2,7,0,350,330,362,307,254,182,340,242,360,379,362,327,344.0,356.0,-35,-17,-18
350,14,24,2,7,0,353,389,339,239,284,223,320,199,311,289,319,320,320.0,309.0,1,30,-29
1473,15,24,2,7,0,1486,1568,1439,1239,1136,1024,1529,973,1602,1326,1507,1501,1504.0,1445.0,-6,181,-187
331,16,24,2,7,0,346,383,407,272,273,274,370,238,369,296,339,369,354.0,335.0,30,43,-13
275,17,24,2,7,0,257,270,285,213,205,215,305,186,346,275,278,289,284.0,281.0,11,3,8
403,18,24,2,7,0,394,437,448,353,321,324,518,242,572,350,498,528,513.0,459.0,30,148,-118
295,19,24,2,7,0,291,346,299,229,207,174,292,205,321,225,242,252,247.0,240.0,10,17,-7
258,20,24,2,7,0,259,222,255,197,217,217,267,199,277,240,244,232,238.0,239.0,-12,4,-16
270,21,24,2,7,0,238,319,283,263,205,197,285,151,281,203,248,250,249.0,234.0,2,45,-43
113,22,24,2,7,0,75,119,71,81,63,53,93,68,133,85,82,113,98.0,93.0,31,-3,34
230,1,25,1,7,0,297,303,281,281,247,225,315,160,297,263,287,314,300.0,288.0,27,24,3
180,2,25,1,7,0,190,187,165,167,133,176,164,108,164,133,153,126,140.0,137.0,-27,20,-47
88,3,25,1,7,0,112,117,120,96,85,86,86,62,103,111,102,97,100.0,103.0,-5,-9,4
234,4,25,1,7,0,331,427,429,308,324,417,323,190,356,270,290,257,274.0,272.0,-33,20,-53
288,5,25,1,7,0,359,376,389,305,301,337,483,166,411,313,351,316,334.0,327.0,-35,38,-73
186,6,25,1,7,0,156,227,205,162,169,174,188,119,173,183,210,172,191.0,188.0,-38,27,-65
253,7,25,1,7,0,263,302,292,265,227,253,339,160,306,297,331,234,282.0,287.0,-97,34,-131
91,8,25,1,7,0,82,103,99,83,81,91,111,56,97,101,97,84,90.0,94.0,-13,-4,-9
422,9,25,1,7,0,480,565,575,462,510,512,581,314,531,409,540,562,551.0,504.0,22,131,-109
85,10,25,1,7,0,96,117,108,102,103,109,128,57,103,59,104,114,109.0,92.0,10,45,-35
655,11,25,1,7,0,733,823,757,642,661,734,807,456,741,678,793,643,718.0,705.0,-150,115,-265
104,12,25,1,7,0,120,153,155,115,129,138,165,79,158,126,152,118,135.0,132.0,-34,26,-60
165,13,25,1,7,0,195,219,226,184,180,178,203,126,201,195,251,175,213.0,207.0,-76,56,-132
186,14,25,1,7,0,189,186,187,161,189,173,186,103,191,191,194,156,175.0,180.0,-38,3,-41
584,15,25,1,7,0,645,709,620,587,599,595,656,382,738,625,720,647,684.0,664.0,-73,95,-168
231,16,25,1,7,0,242,319,331,219,258,266,270,142,257,214,255,256,256.0,242.0,1,41,-40
167,17,25,1,7,0,164,219,179,160,168,191,210,114,205,161,191,162,176.0,171.0,-29,30,-59
197,18,25,1,7,0,240,260,259,202,201,205,241,127,267,183,283,239,261.0,235.0,-44,100,-144
129,19,25,1,7,0,152,161,165,130,138,128,140,90,113,125,138,146,142.0,136.0,8,13,-5
124,20,25,1,7,0,148,158,109,123,106,134,131,54,117,102,136,130,133.0,123.0,-6,34,-40
123,21,25,1,7,0,161,205,192,172,135,145,159,85,142,119,156,144,150.0,140.0,-12,37,-49
61,22,25,1,7,0,67,99,74,50,53,61,68,34,78,65,79,70,74.0,71.0,-9,14,-23
634,1,26,1,7,0,438,559,478,428,493,474,835,424,592,562,626,644,635.0,611.0,18,64,-46
258,2,26,1,7,0,190,240,237,204,210,215,310,178,234,223,203,223,213.0,216.0,20,-20,40
116,3,26,1,7,0,74,115,91,72,82,74,139,87,116,104,125,105,115.0,111.0,-20,21,-41
727,4,26,1,7,0,674,824,853,604,747,817,1033,648,841,763,792,726,759.0,760.0,-66,29,-95
479,5,26,1,7,0,344,458,388,382,361,382,695,383,524,456,456,507,482.0,473.0,51,0,51
254,6,26,1,7,0,148,226,228,183,176,177,354,152,225,259,222,223,222.0,235.0,1,-37,38
429,7,26,1,7,0,365,453,344,338,348,336,608,328,530,488,475,451,463.0,471.0,-24,-13,-11
140,8,26,1,7,0,105,108,108,84,93,100,165,96,130,118,97,142,120.0,119.0,45,-21,66
1084,9,26,1,7,0,689,886,875,627,766,825,1178,690,1101,964,1020,962,991.0,982.0,-58,56,-114
134,10,26,1,7,0,90,105,124,72,100,114,160,106,163,133,138,136,137.0,136.0,-2,5,-7
982,11,26,1,7,0,857,1124,918,791,915,1007,1591,766,1115,1026,1072,1033,1052.0,1044.0,-39,46,-85
165,12,26,1,7,0,115,140,155,101,129,108,227,115,167,214,182,168,175.0,188.0,-14,-32,18
301,13,26,1,7,0,221,266,200,202,203,219,376,209,316,289,290,301,296.0,293.0,11,1,10
289,14,26,1,7,0,254,276,252,194,283,262,357,201,287,304,275,256,266.0,278.0,-19,-29,10
954,15,26,1,7,0,824,880,834,733,849,908,1436,623,970,967,965,954,960.0,962.0,-11,-2,-9
360,16,26,1,7,0,260,327,326,230,315,356,436,202,366,316,282,393,338.0,330.0,111,-34,145
246,17,26,1,7,0,157,190,184,143,174,192,302,179,246,255,226,219,222.0,233.0,-7,-29,22
288,18,26,1,7,0,234,296,266,197,227,256,500,212,338,297,357,330,344.0,328.0,-27,60,-87
276,19,26,1,7,0,215,281,225,176,194,227,304,176,286,261,241,263,252.0,255.0,22,-20,42
187,20,26,1,7,0,192,184,176,151,174,194,265,152,205,197,174,223,198.0,198.0,49,-23,72
248,21,26,1,7,0,235,213,228,210,194,216,307,140,222,205,251,252,252.0,236.0,1,46,-45
86,22,26,1,7,0,59,106,77,74,83,85,102,84,125,116,121,127,124.0,121.0,6,5,1
142,1,27,4,7,0,152,203,190,188,201,262,80,97,160,113,154,142,148.0,136.0,-12,41,-53
74,2,27,4,7,0,35,60,52,76,100,59,26,35,34,50,78,51,64.0,60.0,-27,28,-55
17,3,27,4,7,0,35,33,31,42,40,37,22,17,26,37,25,21,23.0,28.0,-4,-12,8
88,4,27,4,7,0,172,203,232,200,230,226,93,117,153,137,139,94,116.0,123.0,-45,2,-47
144,5,27,4,7,0,121,152,216,166,240,223,57,76,90,137,164,128,146.0,143.0,-36,27,-63
100,6,27,4,7,0,90,104,106,110,130,121,57,59,72,81,74,76,75.0,77.0,2,-7,9
160,7,27,4,7,0,199,232,258,215,231,199,113,137,218,152,167,149,158.0,156.0,-18,15,-33
26,8,27,4,7,0,32,37,31,31,28,33,16,10,28,22,76,22,49.0,40.0,-54,54,-108
202,9,27,4,7,0,182,223,290,309,396,384,120,115,231,223,244,188,216.0,218.0,-56,21,-77
30,10,27,4,7,0,25,29,35,34,41,40,20,18,18,25,33,31,32.0,30.0,-2,8,-10
340,11,27,4,7,0,389,471,447,420,635,591,225,325,414,342,390,329,360.0,354.0,-61,48,-109
38,12,27,4,7,0,41,43,50,52,66,85,10,18,37,40,39,37,38.0,39.0,-2,-1,-1
97,13,27,4,7,0,127,130,145,141,166,161,78,99,131,131,102,71,86.0,101.0,-31,-29,-2
92,14,27,4,7,0,93,86,118,117,128,163,57,77,90,88,75,84,80.0,82.0,9,-13,22
415,15,27,4,7,0,361,382,415,422,523,567,168,290,344,386,300,355,328.0,347.0,55,-86,141
75,16,27,4,7,0,79,106,110,92,120,142,48,54,76,88,66,69,68.0,74.0,3,-22,25
72,17,27,4,7,0,45,64,96,79,112,124,41,43,61,74,75,46,60.0,65.0,-29,1,-30
62,18,27,4,7,0,50,84,61,85,108,127,23,28,50,51,59,58,58.0,56.0,-1,8,-9
54,19,27,4,7,0,82,88,87,77,106,83,28,38,67,45,65,40,52.0,50.0,-25,20,-45
30,20,27,4,7,0,26,35,47,43,77,67,17,20,19,34,34,37,36.0,35.0,3,0,3
51,21,27,4,7,0,57,82,79,83,68,82,41,52,48,66,99,56,78.0,74.0,-43,33,-76
19,22,27,4,7,0,44,61,42,40,48,45,18,18,48,30,46,28,37.0,35.0,-18,16,-34
475,1,28,2,7,0,581,360,145,129,306,492,378,283,374,311,427,498,462.0,412.0,71,116,-45
272,2,28,2,7,0,221,153,83,75,142,154,140,101,145,149,178,192,185.0,173.0,14,29,-15
135,3,28,2,7,0,165,105,47,48,67,109,121,79,109,124,169,140,154.0,144.0,-29,45,-74
591,4,28,2,7,0,663,502,321,175,311,576,511,299,438,522,580,543,562.0,548.0,-37,58,-95
571,5,28,2,7,0,554,488,356,206,340,526,495,291,361,444,497,529,513.0,490.0,32,53,-21
363,6,28,2,7,0,309,208,104,111,219,307,304,148,259,319,271,331,301.0,307.0,60,-48,108
550,7,28,2,7,0,573,446,246,241,312,378,406,284,400,479,557,520,538.0,519.0,-37,78,-115
121,8,28,2,7,0,138,80,47,46,58,83,94,61,99,97,93,99,96.0,96.0,6,-4,10
756,9,28,2,7,0,869,740,398,282,593,912,598,355,607,642,701,764,732.0,702.0,63,59,4
139,10,28,2,7,0,85,95,39,30,50,68,74,33,77,72,113,104,108.0,96.0,-9,41,-50
1159,11,28,2,7,0,1116,610,270,351,609,1028,993,652,891,910,1046,1085,1066.0,1014.0,39,136,-97
209,12,28,2,7,0,175,130,47,59,107,208,200,69,151,150,175,152,164.0,159.0,-23,25,-48
438,13,28,2,7,0,429,351,172,141,298,340,342,250,323,382,440,423,432.0,415.0,-17,58,-75
405,14,28,2,7,0,406,206,143,136,170,239,290,184,293,341,325,356,340.0,341.0,31,-16,47
1524,15,28,2,7,0,1257,815,643,498,965,1300,996,708,969,1088,1209,1284,1246.0,1194.0,75,121,-46
339,16,28,2,7,0,286,253,116,101,212,331,334,134,250,279,305,303,304.0,296.0,-2,26,-28
331,17,28,2,7,0,325,229,78,92,180,310,284,146,251,271,354,267,310.0,297.0,-87,83,-170
253,18,28,2,7,0,288,200,69,95,138,176,229,97,153,164,270,221,246.0,218.0,-49,106,-155
440,19,28,2,7,0,433,291,193,157,189,261,256,190,274,317,341,370,356.0,343.0,29,24,5
162,20,28,2,7,0,158,135,51,35,76,157,115,82,120,97,175,209,192.0,160.0,34,78,-44
284,21,28,2,7,0,249,241,115,96,127,205,223,136,166,239,247,199,223.0,228.0,-48,8,-56
161,22,28,2,7,0,111,123,58,56,108,145,104,92,153,138,145,157,151.0,147.0,12,7,5
323,1,29,1,7,0,408,528,494,298,341,507,266,214,347,256,335,387,361.0,326.0,52,79,-27
231,2,29,1,7,0,198,213,197,180,169,225,142,99,142,158,164,176,170.0,166.0,12,6,6
151,3,29,1,7,0,178,178,174,157,121,169,76,74,105,133,145,136,140.0,138.0,-9,12,-21
265,4,29,1,7,0,388,450,529,355,417,450,177,170,259,234,290,279,284.0,268.0,-11,56,-67
358,5,29,1,7,0,440,533,641,403,433,394,242,224,324,333,361,319,340.0,338.0,-42,28,-70
254,6,29,1,7,0,244,297,328,172,256,310,160,139,211,231,217,227,222.0,225.0,10,-14,24
413,7,29,1,7,0,352,487,582,453,469,507,305,251,332,402,428,398,413.0,409.0,-30,26,-56
106,8,29,1,7,0,132,168,143,117,124,97,55,43,101,86,111,100,106.0,99.0,-11,25,-36
710,9,29,1,7,0,704,813,867,710,821,895,435,271,630,599,641,694,668.0,645.0,53,42,11
124,10,29,1,7,0,108,129,137,85,114,124,79,66,108,95,119,99,109.0,104.0,-20,24,-44
877,11,29,1,7,0,952,1272,1166,688,937,1154,552,589,835,807,903,879,891.0,863.0,-24,96,-120
152,12,29,1,7,0,183,202,193,186,189,178,106,91,145,142,176,146,161.0,155.0,-30,34,-64
307,13,29,1,7,0,310,427,423,324,327,378,179,188,251,302,319,290,304.0,304.0,-29,17,-46
252,14,29,1,7,0,301,336,420,237,276,308,156,143,260,258,238,212,225.0,236.0,-26,-20,-6
1035,15,29,1,7,0,1162,1196,1045,917,1072,1169,550,543,759,841,892,995,944.0,909.0,103,51,52
324,16,29,1,7,0,315,395,429,270,308,378,261,177,285,262,281,264,272.0,269.0,-17,19,-36
261,17,29,1,7,0,268,360,359,193,226,309,145,129,251,238,285,222,254.0,248.0,-63,47,-110
236,18,29,1,7,0,244,281,263,253,214,293,168,110,183,202,270,233,252.0,235.0,-37,68,-105
139,19,29,1,7,0,191,241,242,174,177,213,86,85,121,151,164,140,152.0,152.0,-24,13,-37
82,20,29,1,7,0,121,146,128,96,89,130,65,59,92,68,101,131,116.0,100.0,30,33,-3
151,21,29,1,7,0,200,229,215,165,164,174,112,81,131,150,180,137,158.0,156.0,-43,30,-73
104,22,29,1,7,0,92,130,140,82,95,85,44,40,74,82,95,78,86.0,85.0,-17,13,-30
411,1,30,1,7,0,421,521,504,402,593,748,538,251,456,315,445,485,465.0,415.0,40,130,-90
341,2,30,1,7,0,306,266,231,316,323,344,263,166,191,198,263,290,276.0,250.0,27,65,-38
177,3,30,1,7,0,162,217,201,207,206,200,197,109,152,165,213,178,196.0,185.0,-35,48,-83
805,4,30,1,7,0,845,898,731,715,939,1050,755,424,693,651,781,754,768.0,729.0,-27,130,-157
611,5,30,1,7,0,554,658,1072,583,560,641,624,348,443,468,502,547,524.0,506.0,45,34,11
284,6,30,1,7,0,257,346,329,282,331,409,330,200,229,256,264,317,290.0,279.0,53,8,45
541,7,30,1,7,0,481,543,678,438,630,646,659,309,458,540,534,523,528.0,532.0,-11,-6,-5
136,8,30,1,7,0,114,155,143,139,142,103,120,44,90,120,136,128,132.0,128.0,-8,16,-24
1068,9,30,1,7,0,1074,1237,1342,1295,1408,1829,1269,499,1006,894,1099,1203,1151.0,1065.0,104,205,-101
174,10,30,1,7,0,124,125,189,162,142,255,213,82,152,117,156,149,152.0,141.0,-7,39,-46
1112,11,30,1,7,0,842,1106,1255,1040,1108,1430,1304,649,954,933,1003,955,979.0,964.0,-48,70,-118
249,12,30,1,7,0,177,230,275,218,275,247,282,85,186,198,229,203,216.0,210.0,-26,31,-57
458,13,30,1,7,0,396,476,471,407,417,527,425,254,337,412,434,405,420.0,417.0,-29,22,-51
375,14,30,1,7,0,400,422,469,405,382,502,442,251,354,426,325,372,348.0,374.0,47,-101,148
1317,15,30,1,7,0,1000,1181,1241,932,1214,1500,938,567,836,888,1017,1178,1098.0,1028.0,161,129,32
438,16,30,1,7,0,358,427,529,447,473,526,572,259,428,363,377,445,411.0,395.0,68,14,54
451,17,30,1,7,0,322,451,476,369,391,505,374,207,342,370,431,366,398.0,389.0,-65,61,-126
262,18,30,1,7,0,282,266,282,298,320,358,335,144,206,194,282,238,260.0,238.0,-44,88,-132
371,19,30,1,7,0,365,459,418,357,335,454,281,156,268,293,330,277,304.0,300.0,-53,37,-90
146,20,30,1,7,0,189,230,259,188,209,244,199,108,153,121,186,284,235.0,197.0,98,65,33
330,21,30,1,7,0,281,312,352,366,242,346,325,174,210,225,299,236,268.0,253.0,-63,74,-137
128,22,30,1,7,0,175,240,219,123,190,198,139,94,144,137,133,149,141.0,140.0,16,-4,20
685,1,31,2,7,0,444,607,438,357,513,576,543,384,696,487,649,633,641.0,590.0,-16,162,-178
292,2,31,2,7,0,177,213,139,117,236,257,243,199,312,234,314,249,282.0,266.0,-65,80,-145
74,3,31,2,7,0,46,43,47,37,60,80,54,43,84,76,64,93,78.0,78.0,29,-12,41
668,4,31,2,7,0,494,449,410,328,585,816,536,311,688,527,617,587,602.0,577.0,-30,90,-120
551,5,31,2,7,0,444,445,455,290,447,593,591,337,640,478,571,603,587.0,551.0,32,93,-61
386,6,31,2,7,0,251,265,236,233,275,385,322,230,435,350,391,362,376.0,368.0,-29,41,-70
535,7,31,2,7,0,382,358,297,285,401,440,468,289,622,538,593,498,546.0,543.0,-95,55,-150
76,8,31,2,7,0,45,60,31,30,61,103,57,64,78,79,91,70,80.0,80.0,-21,12,-33
1265,9,31,2,7,0,972,1033,800,773,983,1319,1274,618,1449,1061,1394,1469,1432.0,1308.0,75,333,-258
157,10,31,2,7,0,112,99,93,94,126,167,115,84,164,123,176,156,166.0,152.0,-20,53,-73
1375,11,31,2,7,0,894,893,729,862,988,1160,1203,919,1681,1193,1428,1269,1348.0,1297.0,-159,235,-394
206,12,31,2,7,0,175,134,144,96,129,200,185,89,224,198,224,201,212.0,208.0,-23,26,-49
463,13,31,2,7,0,249,266,194,192,281,283,417,232,460,496,484,423,454.0,468.0,-61,-12,-49
410,14,31,2,7,0,276,272,209,174,237,350,258,224,388,425,429,397,413.0,417.0,-32,4,-36
1852,15,31,2,7,0,1189,1547,1208,929,1465,1724,1540,1004,2273,1596,1876,1650,1763.0,1707.0,-226,280,-506
314,16,31,2,7,0,203,235,199,144,218,283,271,143,325,266,300,353,326.0,306.0,53,34,19
372,17,31,2,7,0,258,251,209,203,255,374,375,195,380,321,402,363,382.0,362.0,-39,81,-120
353,18,31,2,7,0,323,276,236,214,251,346,352,161,369,304,419,307,363.0,343.0,-112,115,-227
260,19,31,2,7,0,195,187,133,91,159,186,215,146,225,256,285,240,262.0,260.0,-45,29,-74
277,20,31,2,7,0,183,189,132,105,200,253,198,131,290,195,274,315,294.0,261.0,41,79,-38
215,21,31,2,7,0,135,163,159,132,134,174,188,135,235,193,286,212,249.0,230.0,-74,93,-167
78,22,31,2,7,0,52,57,23,28,58,76,70,44,104,104,97,90,94.0,97.0,-7,-7,0
169,1,32,3,7,0,328,379,426,299,501,825,333,136,253,217,192,208,200.0,206.0,16,-25,41
568,2,32,3,7,0,695,707,913,926,928,1393,1050,634,598,559,552,559,556.0,557.0,7,-7,14
146,3,32,3,7,0,134,132,200,230,272,405,185,132,207,141,156,128,142.0,142.0,-28,15,-43
116,4,32,3,7,0,240,313,370,330,446,852,178,127,199,127,128,132,130.0,129.0,4,1,3
456,5,32,3,7,0,778,755,971,792,934,1509,1063,565,512,413,385,387,386.0,395.0,2,-28,30
897,6,32,3,7,0,1052,1349,1421,1263,1461,2601,1965,1072,936,771,749,842,796.0,787.0,93,-22,115
1936,7,32,3,7,0,2244,2677,2814,2975,3077,5360,2858,1598,1729,1694,1756,1539,1648.0,1663.0,-217,62,-279
470,8,32,3,7,0,542,640,778,791,803,1442,701,396,447,437,462,390,426.0,430.0,-72,25,-97
2551,9,32,3,7,0,3295,4086,5098,5032,5800,8421,3465,1872,3263,2465,2754,2779,2766.0,2666.0,25,289,-264
1376,10,32,3,7,0,1981,2497,3110,3025,3479,6171,2981,1510,1845,1206,1444,1326,1385.0,1325.0,-118,238,-356
1387,11,32,3,7,0,1577,1829,2045,1978,2153,3757,2028,1542,1465,1325,1301,1251,1276.0,1292.0,-50,-24,-26
389,12,32,3,7,0,598,635,806,703,736,1319,827,443,434,359,341,393,367.0,364.0,52,-18,70
1294,13,32,3,7,0,1184,1505,1631,1500,1789,2863,1366,1047,1021,1146,1168,1072,1120.0,1129.0,-96,22,-118
3162,14,32,3,7,0,3796,4302,4617,4700,5194,9539,6024,2842,2528,2423,2523,2603,2563.0,2516.0,80,100,-20
813,15,32,3,7,0,1096,1291,1435,1528,1653,2646,934,580,745,680,733,621,677.0,678.0,-112,53,-165
454,16,32,3,7,0,678,753,891,696,982,1629,1137,521,524,406,468,397,432.0,424.0,-71,62,-133
743,17,32,3,7,0,984,1113,1544,1234,1513,2352,1658,771,808,663,615,657,636.0,645.0,42,-48,90
319,18,32,3,7,0,626,548,706,724,738,1086,453,316,456,314,359,319,339.0,331.0,-40,45,-85
500,19,32,3,7,0,528,616,644,644,694,1039,408,313,505,468,482,534,508.0,495.0,52,14,38
183,20,32,3,7,0,297,277,359,279,304,514,324,210,169,172,136,158,147.0,155.0,22,-36,58
535,21,32,3,7,0,538,648,785,855,1045,1704,937,403,499,452,488,436,462.0,459.0,-52,36,-88
521,22,32,3,7,0,643,791,839,638,832,1045,394,365,562,482,469,565,517.0,505.0,96,-13,109
619,1,33,2,7,0,1350,1065,2065,1032,1283,1483,389,338,505,521,647,608,628.0,592.0,-39,126,-165
297,2,33,2,7,0,404,346,402,396,360,567,208,160,208,214,226,198,212.0,213.0,-28,12,-40
326,3,33,2,7,0,569,575,712,648,698,789,413,215,340,311,387,355,371.0,351.0,-32,76,-108
71,4,33,2,7,0,429,397,451,276,389,488,143,102,126,84,102,87,94.0,91.0,-15,18,-33
527,5,33,2,7,0,682,820,1286,786,820,1117,531,374,577,521,559,581,570.0,554.0,22,38,-16
305,6,33,2,7,0,477,644,726,594,615,705,385,198,241,246,257,285,271.0,263.0,28,11,17
912,7,33,2,7,0,1292,1454,1777,1435,1352,1707,803,424,738,843,928,824,876.0,865.0,-104,85,-189
188,8,33,2,7,0,310,346,391,347,352,464,131,87,174,169,231,178,204.0,193.0,-53,62,-115
184,9,33,2,7,0,248,286,326,342,407,475,130,117,221,195,239,246,242.0,227.0,7,44,-37
95,10,33,2,7,0,106,135,181,167,158,231,93,43,77,54,89,79,84.0,74.0,-10,35,-45
1058,11,33,2,7,0,1598,2024,2099,1880,1868,2181,991,782,1094,1007,1280,1090,1185.0,1126.0,-190,273,-463
232,12,33,2,7,0,290,349,532,430,438,495,251,128,183,180,217,188,202.0,195.0,-29,37,-66
670,13,33,2,7,0,769,1026,1153,782,978,1229,546,360,592,598,847,611,729.0,685.0,-236,249,-485
659,14,33,2,7,0,849,951,954,750,835,1053,508,259,492,410,471,586,528.0,489.0,115,61,54
610,15,33,2,7,0,723,773,920,884,1063,1213,348,291,556,450,632,576,604.0,553.0,-56,182,-238
210,16,33,2,7,0,273,340,406,336,358,440,200,80,136,138,174,236,205.0,183.0,62,36,26
328,17,33,2,7,0,473,550,688,528,670,749,385,150,254,224,307,284,296.0,272.0,-23,83,-106
200,18,33,2,7,0,297,275,314,302,385,408,188,136,178,176,297,240,268.0,238.0,-57,121,-178
94,19,33,2,7,0,156,254,246,156,195,210,53,54,81,84,109,71,90.0,88.0,-38,25,-63
107,20,33,2,7,0,192,205,240,178,181,295,131,85,113,117,117,161,139.0,132.0,44,0,44
736,21,33,2,7,0,1062,1276,1109,958,1012,1286,412,280,531,610,649,548,598.0,602.0,-101,39,-140
113,22,33,2,7,0,199,236,256,202,210,228,66,80,160,104,150,105,128.0,120.0,-45,46,-91
1376,1,34,2,7,0,265,342,422,337,524,679,950,175,263,226,214,231,222.0,224.0,17,-12,29
183,2,34,2,7,0,123,129,142,173,215,293,131,118,135,108,106,85,96.0,100.0,-21,-2,-19
54,3,34,2,7,0,63,80,87,94,102,118,60,38,63,48,62,45,54.0,52.0,-17,14,-31
135,4,34,2,7,0,165,158,241,166,231,280,180,87,167,105,117,108,112.0,110.0,-9,12,-21
158,5,34,2,7,0,135,208,419,226,291,404,151,140,210,163,126,156,141.0,148.0,30,-37,67
91,6,34,2,7,0,84,146,172,127,176,201,116,64,85,74,80,96,88.0,83.0,16,6,10
266,7,34,2,7,0,207,253,405,274,383,451,230,146,276,296,237,243,240.0,259.0,6,-59,65
45,8,34,2,7,0,58,68,104,75,85,95,42,23,68,34,43,37,40.0,38.0,-6,9,-15
100,9,34,2,7,0,105,149,140,175,225,268,104,54,144,101,111,106,108.0,106.0,-5,10,-15
35,10,34,2,7,0,28,43,42,39,42,71,30,28,32,17,42,31,36.0,30.0,-11,25,-36
335,11,34,2,7,0,286,477,566,501,644,669,334,279,388,278,361,289,325.0,309.0,-72,83,-155
58,12,34,2,7,0,61,72,97,83,104,86,64,32,40,53,58,44,51.0,52.0,-14,5,-19
151,13,34,2,7,0,113,185,186,192,206,272,140,97,162,151,190,159,174.0,167.0,-31,39,-70
150,14,34,2,7,0,109,191,156,169,219,319,144,90,156,142,133,159,146.0,145.0,26,-9,35
200,15,34,2,7,0,216,262,293,289,400,452,190,120,235,179,236,184,210.0,200.0,-52,57,-109
128,16,34,2,7,0,45,58,71,47,81,82,146,33,61,41,44,47,46.0,44.0,3,3,0
97,17,34,2,7,0,121,118,158,115,135,228,105,59,115,89,71,92,82.0,84.0,21,-18,39
207,18,34,2,7,0,72,82,93,107,132,139,77,43,64,62,76,55,66.0,64.0,-21,14,-35
42,19,34,2,7,0,42,64,69,52,62,81,42,40,28,19,48,46,47.0,38.0,-2,29,-31
74,20,34,2,7,0,61,42,66,46,77,87,44,31,56,52,34,81,58.0,56.0,47,-18,65
145,21,34,2,7,0,109,169,208,170,201,238,124,83,169,151,120,99,110.0,123.0,-21,-31,10
50,22,34,2,7,0,38,60,45,45,56,48,22,17,60,50,40,34,37.0,41.0,-6,-10,4
172,1,35,2,7,0,110,96,130,129,206,317,238,124,175,178,198,247,222.0,208.0,49,20,29
82,2,35,2,7,0,53,48,150,68,61,94,64,55,50,58,59,74,66.0,64.0,15,1,14
124,3,35,2,7,0,115,80,59,69,77,114,119,58,88,84,113,93,103.0,97.0,-20,29,-49
524,4,35,2,7,0,522,549,341,411,466,954,488,303,463,422,404,405,404.0,410.0,1,-18,19
354,5,35,2,7,0,287,213,226,219,270,560,493,212,308,310,321,356,338.0,329.0,35,11,24
221,6,35,2,7,0,137,105,226,131,164,192,238,108,126,152,161,181,171.0,165.0,20,9,11
752,7,35,2,7,0,483,376,451,391,462,714,609,352,736,802,743,732,738.0,759.0,-11,-59,48
176,8,35,2,7,0,88,87,81,104,152,230,168,75,152,133,162,155,158.0,150.0,-7,29,-36
1365,9,35,2,7,0,796,688,783,887,1988,1893,1283,554,1157,1342,1371,1506,1438.0,1406.0,135,29,106
214,10,35,2,7,0,238,333,211,167,204,333,316,132,218,179,232,209,220.0,207.0,-23,53,-76
727,11,35,2,7,0,614,701,409,489,602,865,785,520,701,575,790,696,743.0,687.0,-94,215,-309
190,12,35,2,7,0,120,104,272,168,194,280,264,100,195,178,199,185,192.0,187.0,-14,21,-35
561,13,35,2,7,0,278,358,279,275,250,454,387,248,489,372,444,470,457.0,429.0,26,72,-46
313,14,35,2,7,0,287,201,184,168,191,300,319,141,195,250,224,252,238.0,242.0,28,-26,54
663,15,35,2,7,0,359,406,355,572,795,787,577,391,567,562,623,668,646.0,618.0,45,61,-16
504,16,35,2,7,0,178,222,287,394,374,566,545,193,390,310,389,475,432.0,391.0,86,79,7
399,17,35,2,7,0,270,181,332,203,423,412,412,410,531,262,352,341,346.0,318.0,-11,90,-101
589,18,35,2,7,0,324,353,331,397,363,562,555,242,485,658,692,517,604.0,622.0,-175,34,-209
261,19,35,2,7,0,240,234,219,239,228,340,230,163,328,229,232,286,259.0,249.0,54,3,51
348,20,35,2,7,0,292,184,281,158,348,846,378,203,261,239,256,499,378.0,331.0,243,17,226
167,21,35,2,7,0,202,64,63,62,99,126,138,68,103,103,121,139,130.0,121.0,18,18,0
117,22,35,2,7,0,71,56,91,46,89,107,57,72,88,195,88,95,92.0,126.0,7,-107,114
252,1,36,1,7,0,263,265,263,222,276,374,264,140,173,111,133,219,176.0,154.0,86,22,64
370,2,36,1,7,0,444,328,322,420,444,423,403,246,278,240,349,251,300.0,280.0,-98,109,-207
439,3,36,1,7,0,527,467,541,608,505,619,534,251,398,363,397,446,422.0,402.0,49,34,15
738,4,36,1,7,0,823,803,1019,845,1016,1441,741,459,672,521,645,648,646.0,605.0,3,124,-121
747,5,36,1,7,0,723,668,1080,712,743,1078,940,507,616,610,516,696,606.0,607.0,180,-94,274
202,6,36,1,7,0,143,177,210,217,212,273,247,107,152,149,170,178,174.0,166.0,8,21,-13
667,7,36,1,7,0,592,643,866,764,681,1011,688,350,548,657,631,628,630.0,639.0,-3,-26,23
246,8,36,1,7,0,228,276,283,280,288,348,274,115,219,218,272,224,248.0,238.0,-48,54,-102
1873,9,36,1,7,0,1516,1456,1686,2097,2144,2562,1849,777,1549,1067,1547,1898,1722.0,1504.0,351,480,-129
272,10,36,1,7,0,289,221,333,376,342,443,364,194,278,172,226,248,237.0,215.0,22,54,-32
592,11,36,1,7,0,521,656,670,713,682,857,658,425,546,407,545,534,540.0,495.0,-11,138,-149
289,12,36,1,7,0,226,207,304,324,277,382,334,121,180,176,242,230,236.0,216.0,-12,66,-78
962,13,36,1,7,0,636,756,829,875,790,1042,804,407,572,721,849,721,785.0,764.0,-128,128,-256
638,14,36,1,7,0,457,520,525,514,567,656,654,303,427,422,450,484,467.0,452.0,34,28,6
617,15,36,1,7,0,609,628,658,707,687,970,632,338,464,407,503,544,524.0,485.0,41,96,-55
1218,16,36,1,7,0,812,879,1194,1234,1296,1458,1429,526,890,740,929,1121,1025.0,930.0,192,189,3
530,17,36,1,7,0,433,504,586,532,579,879,712,262,444,376,475,496,486.0,449.0,21,99,-78
340,18,36,1,7,0,309,324,331,423,388,523,387,223,336,237,399,355,377.0,330.0,-44,162,-206
678,19,36,1,7,0,778,859,919,871,786,1105,571,424,658,595,611,583,597.0,596.0,-28,16,-44
368,20,36,1,7,0,400,378,452,406,568,732,616,327,364,351,290,544,417.0,395.0,254,-61,315
505,21,36,1,7,0,428,429,480,618,464,618,561,288,381,522,505,419,462.0,482.0,-86,-17,-69
413,22,36,1,7,0,393,463,364,346,348,497,267,165,333,307,314,331,322.0,317.0,17,7,10
60,1,37,2,7,0,119,125,135,111,242,237,68,37,61,48,42,46,44.0,45.0,4,-6,10
101,2,37,2,7,0,141,143,170,165,182,271,140,100,100,97,72,92,82.0,87.0,20,-25,45
89,3,37,2,7,0,118,135,135,144,149,195,78,54,74,78,87,84,86.0,83.0,-3,9,-12
41,4,37,2,7,0,136,151,163,97,128,205,34,44,59,36,32,45,38.0,38.0,13,-4,17
155,5,37,2,7,0,273,290,355,284,276,560,275,186,178,154,123,197,160.0,158.0,74,-31,105
123,6,37,2,7,0,187,210,258,234,289,496,209,109,109,97,103,125,114.0,108.0,22,6,16
187,7,37,2,7,0,297,370,455,430,397,599,241,156,188,181,193,211,202.0,195.0,18,12,6
82,8,37,2,7,0,138,154,165,187,192,226,67,52,65,70,76,81,78.0,76.0,5,6,-1
492,9,37,2,7,0,908,969,966,1096,1273,1753,510,290,467,429,504,568,536.0,500.0,64,75,-11
111,10,37,2,7,0,121,133,163,183,209,314,161,76,113,66,89,103,96.0,86.0,14,23,-9
346,11,37,2,7,0,494,659,663,720,808,1176,484,399,360,358,395,364,380.0,372.0,-31,37,-68
130,12,37,2,7,0,156,182,243,282,281,556,258,99,139,120,123,138,130.0,127.0,15,3,12
191,13,37,2,7,0,240,275,311,284,290,435,164,126,133,165,184,178,181.0,176.0,-6,19,-25
234,14,37,2,7,0,273,313,316,283,364,562,252,130,136,161,188,248,218.0,199.0,60,27,33
433,15,37,2,7,0,536,581,660,738,799,1102,332,255,331,293,293,451,372.0,346.0,158,0,158
117,16,37,2,7,0,204,230,271,257,362,526,267,110,92,100,79,129,104.0,103.0,50,-21,71
162,17,37,2,7,0,208,271,292,260,313,627,286,115,133,96,119,133,126.0,116.0,14,23,-9
138,18,37,2,7,0,246,274,282,315,340,500,185,128,160,130,141,134,138.0,135.0,-7,11,-18
138,19,37,2,7,0,311,310,311,260,209,299,101,86,133,111,127,127,127.0,122.0,0,16,-16
84,20,37,2,7,0,160,199,165,151,159,317,179,87,70,59,80,101,90.0,80.0,21,21,0
76,21,37,2,7,0,116,126,114,163,141,242,89,58,62,55,62,48,55.0,55.0,-14,7,-21
87,22,37,2,7,0,135,155,139,103,121,126,60,44,65,66,61,78,70.0,68.0,17,-5,22
332,1,38,2,7,0,321,346,427,336,1289,571,175,135,300,320,311,280,296.0,304.0,-31,-9,-22
237,2,38,2,7,0,247,218,226,257,285,393,160,154,201,154,174,208,191.0,179.0,34,20,14
352,3,38,2,7,0,198,218,291,326,339,631,236,164,278,287,352,354,353.0,331.0,2,65,-63
411,4,38,2,7,0,697,743,797,664,656,980,232,253,315,319,299,344,322.0,321.0,45,-20,65
874,5,38,2,7,0,786,904,1230,923,1016,1536,609,478,708,677,703,870,786.0,750.0,167,26,141
531,6,38,2,7,0,319,476,565,666,550,750,358,257,522,447,450,474,462.0,457.0,24,3,21
2150,7,38,2,7,0,1835,2200,2915,3148,3502,5481,1788,1203,1635,2012,1985,2046,2016.0,2014.0,61,-27,88
822,8,38,2,7,0,521,585,792,899,919,1474,502,371,567,626,775,870,822.0,757.0,95,149,-54
8119,9,38,2,7,0,8085,9999,11167,12710,12394,15317,5306,3718,8079,6812,7957,8612,8284.0,7794.0,655,1145,-490
1736,10,38,2,7,0,1010,1186,1639,1709,1789,2693,1195,777,1366,1087,1463,1613,1538.0,1388.0,150,376,-226
2472,11,38,2,7,0,1273,1726,2274,2226,2622,3296,1247,1529,2148,2087,2259,2343,2301.0,2230.0,84,172,-88
1189,12,38,2,7,0,606,715,1083,1277,1265,1764,857,484,797,835,979,1050,1014.0,955.0,71,144,-73
2279,13,38,2,7,0,1091,1516,1988,2221,2449,3796,1214,995,1259,1697,1832,1815,1824.0,1781.0,-17,135,-152
1910,14,38,2,7,0,1151,1553,1783,1739,1951,3130,1278,848,1290,1492,1391,1525,1458.0,1469.0,134,-101,235
1767,15,38,2,7,0,1140,1443,1709,2001,2019,2088,700,801,1246,1369,1509,1644,1576.0,1507.0,135,140,-5
1101,16,38,2,7,0,689,870,1071,1120,1425,1562,736,376,772,827,842,1061,952.0,910.0,219,15,204
1786,17,38,2,7,0,1384,1668,1721,1444,1769,3168,1244,677,1105,1093,1503,1476,1490.0,1357.0,-27,410,-437
1316,18,38,2,7,0,991,1227,1477,1846,1591,1981,769,598,1058,945,1316,1163,1240.0,1141.0,-153,371,-524
1931,19,38,2,7,0,2715,3298,3035,2443,2622,3705,1059,1132,1642,1541,1606,1822,1714.0,1656.0,216,65,151
364,20,38,2,7,0,510,660,624,494,548,828,333,235,331,330,400,708,554.0,479.0,308,70,238
382,21,38,2,7,0,480,451,462,457,402,722,289,175,287,284,326,299,312.0,303.0,-27,42,-69
701,22,38,2,7,0,421,630,651,605,913,1064,350,347,604,509,589,621,605.0,573.0,32,80,-48
62,1,39,1,7,0,275,253,330,234,241,272,250,161,224,213,175,131,153.0,173.0,-44,-38,-6
81,2,39,1,7,0,317,281,288,285,282,383,494,162,297,298,329,209,269.0,279.0,-120,31,-151
84,3,39,1,7,0,346,325,397,353,331,374,412,213,364,399,353,232,292.0,328.0,-121,-46,-75
126,4,39,1,7,0,541,459,651,432,527,798,336,255,324,347,230,135,182.0,237.0,-95,-117,22
64,5,39,1,7,0,374,356,560,353,364,502,560,198,280,354,296,108,202.0,253.0,-188,-58,-130
125,6,39,1,7,0,347,370,464,369,339,449,378,228,339,365,359,86,222.0,270.0,-273,-6,-267
273,7,39,1,7,0,1063,896,1347,1014,1020,1083,1132,648,948,1214,1085,369,727.0,889.0,-716,-129,-587
148,8,39,1,7,0,311,334,462,394,347,454,373,276,370,403,345,137,241.0,295.0,-208,-58,-150
594,9,39,1,7,0,2478,2391,3040,2810,2842,3119,2859,1337,2735,2621,2524,1566,2045.0,2237.0,-958,-97,-861
103,10,39,1,7,0,273,237,346,287,279,316,376,154,306,255,297,140,218.0,231.0,-157,42,-199
226,11,39,1,7,0,914,919,1153,908,905,1057,1012,579,905,787,820,405,612.0,671.0,-415,33,-448
95,12,39,1,7,0,370,350,407,325,334,414,397,195,355,439,342,151,246.0,311.0,-191,-97,-94
253,13,39,1,7,0,623,691,837,696,646,778,797,602,842,1066,971,374,672.0,804.0,-597,-95,-502
428,14,39,1,7,0,976,801,1165,786,979,1154,954,596,986,1159,919,330,624.0,803.0,-589,-240,-349
191,15,39,1,7,0,746,631,767,611,709,819,752,388,650,682,669,277,473.0,543.0,-392,-13,-379
316,16,39,1,7,0,1289,1127,1463,1111,1292,1497,1405,549,1164,1131,1057,674,866.0,954.0,-383,-74,-309
194,17,39,1,7,0,656,726,776,563,649,953,623,341,556,689,570,218,394.0,492.0,-352,-119,-233
137,18,39,1,7,0,655,558,641,586,610,611,627,347,556,479,612,226,419.0,439.0,-386,133,-519
271,19,39,1,7,0,727,667,816,696,727,851,758,485,709,730,631,387,509.0,583.0,-244,-99,-145
39,20,39,1,7,0,222,181,222,152,145,208,248,87,111,125,128,35,82.0,96.0,-93,3,-96
125,21,39,1,7,0,362,360,429,415,400,482,463,229,331,386,360,198,279.0,315.0,-162,-26,-136
130,22,39,1,7,0,503,567,621,450,630,549,617,346,607,485,461,268,364.0,405.0,-193,-24,-169
235,1,40,1,7,0,256,281,287,238,345,456,114,153,205,172,211,259,235.0,214.0,48,39,9
548,2,40,1,7,0,381,345,327,285,338,442,406,203,364,347,383,359,371.0,363.0,-24,36,-60
426,3,40,1,7,0,235,267,246,282,331,382,195,193,311,298,379,324,352.0,334.0,-55,81,-136
143,4,40,1,7,0,253,208,303,262,356,580,121,115,186,128,156,127,142.0,137.0,-29,28,-57
512,5,40,1,7,0,453,451,636,487,569,804,459,234,390,378,467,472,470.0,439.0,5,89,-84
589,6,40,1,7,0,377,400,439,428,489,503,403,244,376,434,485,530,508.0,483.0,45,51,-6
978,7,40,1,7,0,778,692,815,855,912,1164,554,505,703,953,906,900,903.0,920.0,-6,-47,41
437,8,40,1,7,0,226,277,310,284,316,428,223,193,301,299,310,314,312.0,308.0,4,11,-7
3073,9,40,1,7,0,2288,2219,2478,2450,3345,3730,1930,1262,2615,2284,2880,3003,2942.0,2722.0,123,596,-473
440,10,40,1,7,0,277,270,290,313,377,417,266,187,309,304,370,332,351.0,335.0,-38,66,-104
1359,11,40,1,7,0,1035,1139,1193,1114,1454,1527,877,754,1069,1130,1243,1239,1241.0,1204.0,-4,113,-117
505,12,40,1,7,0,354,314,340,317,350,507,305,161,323,377,500,498,499.0,458.0,-2,123,-125
1076,13,40,1,7,0,517,521,590,551,574,797,453,434,572,723,877,842,860.0,814.0,-35,154,-189
1251,14,40,1,7,0,657,647,687,548,872,1036,630,391,702,797,764,826,795.0,796.0,62,-33,95
1336,15,40,1,7,0,928,863,800,942,1151,1258,739,529,861,969,1092,1188,1140.0,1083.0,96,123,-27
1247,16,40,1,7,0,954,876,1065,918,1189,1511,963,454,719,775,822,1002,912.0,866.0,180,47,133
597,17,40,1,7,0,436,456,456,452,506,737,420,189,443,430,470,484,477.0,461.0,14,40,-26
791,18,40,1,7,0,574,525,556,643,734,779,473,353,640,561,659,677,668.0,632.0,18,98,-80
627,19,40,1,7,0,423,434,437,390,480,602,285,241,431,475,512,466,489.0,484.0,-46,37,-83
211,20,40,1,7,0,232,218,203,186,200,305,185,95,179,155,153,233,193.0,180.0,80,-2,82
352,21,40,1,7,0,303,301,293,309,345,496,293,157,234,292,346,246,296.0,295.0,-100,54,-154
444,22,40,1,7,0,360,329,347,306,404,422,214,206,322,309,385,388,386.0,361.0,3,76,-73
126,1,41,3,7,0,228,228,248,166,277,348,224,140,212,313,130,176,153.0,206.0,46,-183,229
9,2,41,3,7,0,29,23,22,12,22,33,19,19,18,22,20,12,16.0,18.0,-8,-2,-6
26,3,41,3,7,0,34,26,20,16,19,22,21,19,29,36,17,19,18.0,24.0,2,-19,21
250,4,41,3,7,0,397,450,433,353,372,511,424,244,378,320,244,260,252.0,275.0,16,-76,92
13,5,41,3,7,0,45,33,53,34,42,64,69,42,47,33,29,34,32.0,32.0,5,-4,9
31,6,41,3,7,0,58,60,65,52,74,75,83,59,59,57,45,62,54.0,55.0,17,-12,29
256,7,41,3,7,0,323,300,349,309,286,341,430,189,295,303,192,237,214.0,244.0,45,-111,156
85,8,41,3,7,0,83,86,76,58,62,78,105,64,83,78,62,75,68.0,72.0,13,-16,29
757,9,41,3,7,0,845,827,959,887,972,1235,1009,443,848,749,579,865,722.0,731.0,286,-170,456
16,10,41,3,7,0,15,35,23,23,13,26,34,17,20,12,20,22,21.0,18.0,2,8,-6
301,11,41,3,7,0,390,384,352,323,380,481,397,258,351,301,241,305,273.0,282.0,64,-60,124
32,12,41,3,7,0,34,41,44,29,35,37,61,16,26,40,25,30,28.0,32.0,5,-15,20
233,13,41,3,7,0,231,259,229,234,231,316,308,172,236,271,218,215,216.0,235.0,-3,-53,50
155,14,41,3,7,0,204,209,192,150,188,209,242,134,155,146,105,140,122.0,130.0,35,-41,76
354,15,41,3,7,0,302,300,252,293,323,375,353,222,270,371,311,449,380.0,377.0,138,-60,198
44,16,41,3,7,0,41,58,58,26,64,62,54,47,52,51,39,64,52.0,51.0,25,-12,37
22,17,41,3,7,0,54,26,47,25,31,44,54,26,27,28,26,30,28.0,28.0,4,-2,6
57,18,41,3,7,0,56,64,42,57,83,105,92,41,56,43,37,75,56.0,52.0,38,-6,44
126,19,41,3,7,0,170,176,181,127,153,187,158,103,124,129,115,148,132.0,131.0,33,-14,47
18,20,41,3,7,0,25,22,19,17,12,27,22,12,27,12,19,15,17.0,15.0,-4,7,-11
27,21,41,3,7,0,32,34,19,25,29,46,61,16,38,37,27,23,25.0,29.0,-4,-10,6
42,22,41,3,7,0,90,78,77,62,61,65,66,41,61,62,37,56,46.0,52.0,19,-25,44
189,1,42,1,7,0,222,233,237,260,331,369,161,142,190,140,165,214,190.0,173.0,49,25,24
382,2,42,1,7,0,397,351,388,519,521,651,386,202,309,233,292,232,262.0,252.0,-60,59,-119
141,3,42,1,7,0,115,149,181,185,190,234,146,90,139,127,131,111,121.0,123.0,-20,4,-24
100,4,42,1,7,0,223,271,313,223,301,382,210,141,181,149,153,130,142.0,144.0,-23,4,-27
430,5,42,1,7,0,408,384,645,492,617,839,509,240,360,342,344,334,339.0,340.0,-10,2,-12
348,6,42,1,7,0,371,429,508,453,504,690,387,163,254,266,293,273,283.0,277.0,-20,27,-47
649,7,42,1,7,0,603,642,825,774,709,964,444,303,464,570,555,507,531.0,544.0,-48,-15,-33
257,8,42,1,7,0,194,300,278,277,302,443,175,132,238,204,221,191,206.0,205.0,-30,17,-47
2940,9,42,1,7,0,2769,3466,3967,4449,4901,5547,3229,1517,2906,3040,2996,3064,3030.0,3033.0,68,-44,112
271,10,42,1,7,0,295,375,362,434,458,665,381,181,321,247,278,230,254.0,252.0,-48,31,-79
855,11,42,1,7,0,767,910,875,888,974,1139,690,508,722,614,698,656,677.0,656.0,-42,84,-126
286,12,42,1,7,0,326,283,440,408,499,625,381,184,276,300,321,252,286.0,291.0,-69,21,-90
601,13,42,1,7,0,434,560,591,602,602,830,407,320,433,514,507,400,454.0,474.0,-107,-7,-100
626,14,42,1,7,0,414,574,666,620,614,920,507,247,499,530,473,405,439.0,469.0,-68,-57,-11
969,15,42,1,7,0,917,968,1148,998,1169,1424,732,558,806,842,817,859,838.0,839.0,42,-25,67
672,16,42,1,7,0,629,764,987,818,1066,1347,698,270,511,498,504,540,522.0,514.0,36,6,30
577,17,42,1,7,0,526,503,752,630,700,988,570,203,418,421,498,401,450.0,440.0,-97,77,-174
615,18,42,1,7,0,603,671,676,754,796,1043,605,368,580,595,656,635,646.0,629.0,-21,61,-82
369,19,42,1,7,0,473,472,553,433,460,600,253,193,341,357,363,293,328.0,338.0,-70,6,-76
132,20,42,1,7,0,168,172,243,227,222,229,139,105,116,140,127,159,143.0,142.0,32,-13,45
199,21,42,1,7,0,148,164,191,253,229,293,140,96,140,126,155,135,145.0,139.0,-20,29,-49
233,22,42,1,7,0,234,372,256,198,199,322,111,123,264,218,232,182,207.0,211.0,-50,14,-64
311,1,43,2,7,0,279,368,455,354,457,516,264,193,369,368,312,223,268.0,301.0,-89,-56,-33
120,2,43,2,7,0,134,137,168,236,233,253,206,111,144,116,120,119,120.0,118.0,-1,4,-5
176,3,43,2,7,0,170,148,180,212,200,238,219,114,172,145,184,185,184.0,171.0,1,39,-38
359,4,43,2,7,0,614,704,733,603,754,1094,601,390,482,397,375,385,380.0,386.0,10,-22,32
231,5,43,2,7,0,286,280,498,363,489,543,391,237,325,296,251,270,260.0,272.0,19,-45,64
190,6,43,2,7,0,319,361,472,444,568,578,495,153,185,233,254,279,266.0,255.0,25,21,4
709,7,43,2,7,0,653,771,1001,1018,1094,1221,1031,476,846,727,791,753,772.0,757.0,-38,64,-102
379,8,43,2,7,0,310,398,381,370,395,605,316,221,369,335,297,249,273.0,294.0,-48,-38,-10
2148,9,43,2,7,0,1926,2292,2762,3019,3563,3747,2666,1125,2377,2460,2143,2250,2196.0,2284.0,107,-317,424
103,10,43,2,7,0,105,132,134,146,194,174,193,92,119,101,114,104,109.0,106.0,-10,13,-23
803,11,43,2,7,0,884,1139,1155,1292,1491,1524,1070,552,1008,901,895,803,849.0,866.0,-92,-6,-86
187,12,43,2,7,0,163,206,280,258,340,409,346,81,166,179,201,165,183.0,182.0,-36,22,-58
806,13,43,2,7,0,573,819,812,975,971,1119,789,422,734,762,790,652,721.0,735.0,-138,28,-166
469,14,43,2,7,0,472,519,592,609,805,866,692,326,488,531,450,448,449.0,476.0,-2,-81,79
1507,15,43,2,7,0,1116,1100,1259,1371,1516,1515,1138,549,969,1010,1108,1385,1246.0,1168.0,277,98,179
412,16,43,2,7,0,346,475,707,729,779,906,749,253,446,434,381,436,408.0,417.0,55,-53,108
398,17,43,2,7,0,381,419,626,645,767,839,710,238,437,402,430,431,430.0,421.0,1,28,-27
327,18,43,2,7,0,400,389,434,571,612,638,509,288,542,508,519,527,523.0,518.0,8,11,-3
914,19,43,2,7,0,1057,1068,1256,1020,1269,1395,898,506,962,872,971,851,911.0,898.0,-120,99,-219
133,20,43,2,7,0,183,190,183,170,200,213,159,106,164,130,104,160,132.0,131.0,56,-26,82
173,21,43,2,7,0,278,246,251,273,309,371,227,159,225,195,179,129,154.0,168.0,-50,-16,-34
533,22,43,2,7,0,381,659,536,422,639,783,366,217,537,358,448,306,377.0,371.0,-142,90,-232
195,1,44,1,7,0,213,231,263,186,304,291,260,125,252,169,218,208,213.0,198.0,-10,49,-59
79,2,44,1,7,0,86,70,45,62,97,95,78,48,59,48,61,43,52.0,51.0,-18,13,-31
61,3,44,1,7,0,34,48,53,57,54,64,35,18,51,53,69,55,62.0,59.0,-14,16,-30
426,4,44,1,7,0,387,431,542,458,551,739,435,233,445,341,391,396,394.0,376.0,5,50,-45
208,5,44,1,7,0,208,192,406,218,246,296,270,133,178,212,190,231,210.0,211.0,41,-22,63
72,6,44,1,7,0,83,102,108,119,125,125,156,59,89,69,81,70,76.0,73.0,-11,12,-23
193,7,44,1,7,0,211,236,259,209,228,356,218,112,223,197,226,179,202.0,201.0,-47,29,-76
45,8,44,1,7,0,39,38,29,27,53,51,47,21,35,29,43,35,39.0,36.0,-8,14,-22
305,9,44,1,7,0,201,283,319,341,442,572,437,152,310,246,338,497,418.0,360.0,159,92,67
50,10,44,1,7,0,25,47,48,35,38,46,44,34,25,32,38,35,36.0,35.0,-3,6,-9
187,11,44,1,7,0,179,202,235,218,248,301,251,138,200,177,214,189,202.0,193.0,-25,37,-62
70,12,44,1,7,0,43,63,74,57,75,92,84,32,51,53,76,51,64.0,60.0,-25,23,-48
129,13,44,1,7,0,75,106,81,95,123,131,106,79,112,113,144,111,128.0,123.0,-33,31,-64
135,14,44,1,7,0,120,133,136,137,144,187,131,57,111,155,108,118,113.0,127.0,10,-47,57
110,15,44,1,7,0,117,123,127,129,149,230,149,78,139,107,108,142,125.0,119.0,34,1,33
110,16,44,1,7,0,100,88,128,132,148,184,148,61,111,94,101,110,106.0,102.0,9,7,2
96,17,44,1,7,0,113,129,125,121,157,211,135,74,132,109,108,118,113.0,112.0,10,-1,11
75,18,44,1,7,0,91,79,63,93,111,124,108,57,77,71,97,95,96.0,88.0,-2,26,-28
96,19,44,1,7,0,86,129,93,93,126,129,69,51,75,76,107,67,87.0,83.0,-40,31,-71
112,20,44,1,7,0,124,91,113,105,132,160,125,77,112,97,87,149,118.0,111.0,62,-10,72
112,21,44,1,7,0,101,114,118,176,150,182,148,77,137,111,172,117,144.0,133.0,-55,61,-116
50,22,44,1,7,0,51,83,64,44,71,77,53,34,68,53,50,51,50.0,51.0,1,-3,4
90,1,45,1,7,0,120,182,195,186,244,388,154,85,126,92,105,104,104.0,100.0,-1,13,-14
54,2,45,1,7,0,132,175,199,190,214,267,194,91,60,53,77,69,73.0,66.0,-8,24,-32
53,3,45,1,7,0,86,129,117,180,167,259,127,62,61,62,68,40,54.0,57.0,-28,6,-34
21,4,45,1,7,0,124,189,195,143,181,370,71,41,51,25,21,23,22.0,23.0,2,-4,6
113,5,45,1,7,0,259,271,451,335,432,691,448,194,129,110,118,105,112.0,111.0,-13,8,-21
209,6,45,1,7,0,457,615,665,719,699,1253,712,250,227,217,259,222,240.0,233.0,-37,42,-79
290,7,45,1,7,0,525,598,799,850,792,1449,549,320,297,347,332,246,289.0,308.0,-86,-15,-71
86,8,45,1,7,0,112,180,176,226,231,426,153,81,103,83,114,108,111.0,102.0,-6,31,-37
247,9,45,1,7,0,570,682,810,953,1204,1628,496,168,342,246,344,349,346.0,313.0,5,98,-93
31,10,45,1,7,0,74,93,96,119,135,240,121,56,54,26,39,23,31.0,29.0,-16,13,-29
340,11,45,1,7,0,664,879,928,1050,1083,1908,768,543,404,402,487,371,429.0,420.0,-116,85,-201
131,12,45,1,7,0,256,256,368,358,434,733,453,153,150,168,191,126,158.0,162.0,-65,23,-88
304,13,45,1,7,0,433,513,576,665,667,1158,476,272,257,300,350,276,313.0,309.0,-74,50,-124
321,14,45,1,7,0,604,728,823,894,1006,1883,910,372,312,380,366,295,330.0,347.0,-71,-14,-57
360,15,45,1,7,0,618,806,968,1022,1202,2202,744,430,386,337,361,407,384.0,368.0,46,24,22
117,16,45,1,7,0,224,236,278,353,409,749,443,143,138,130,145,146,146.0,140.0,1,15,-14
113,17,45,1,7,0,221,263,352,322,439,744,378,131,137,149,138,134,136.0,140.0,-4,-11,7
100,18,45,1,7,0,185,197,242,345,391,594,265,149,173,130,137,127,132.0,131.0,-10,7,-17
39,19,45,1,7,0,118,166,151,176,186,256,75,62,80,75,84,47,66.0,69.0,-37,9,-46
17,20,45,1,7,0,92,81,101,86,92,172,124,38,29,23,20,27,24.0,23.0,7,-3,10
67,21,45,1,7,0,108,126,155,205,212,325,144,79,70,64,97,57,77.0,73.0,-40,33,-73
34,22,45,1,7,0,66,138,116,107,126,152,43,36,52,38,43,41,42.0,41.0,-2,5,-7
7,1,46,1,7,0,70,93,94,69,88,96,65,19,37,175,5,12,8.0,64.0,7,-170,177
67,2,46,1,7,0,260,181,192,214,209,182,216,75,82,86,83,57,70.0,75.0,-26,-3,-23
38,3,46,1,7,0,152,130,174,176,130,141,132,46,66,45,69,41,55.0,52.0,-28,24,-52
33,4,46,1,7,0,267,229,259,158,186,277,124,81,65,48,29,26,28.0,34.0,-3,-19,16
97,5,46,1,7,0,338,249,374,267,205,292,350,117,93,78,81,64,72.0,74.0,-17,3,-20
107,6,46,1,7,0,369,409,407,332,341,384,513,121,108,92,90,118,104.0,100.0,28,-2,30
145,7,46,1,7,0,578,578,669,572,480,596,555,214,153,209,203,175,189.0,196.0,-28,-6,-22
23,8,46,1,7,0,80,105,82,89,70,67,66,26,12,22,19,12,16.0,18.0,-7,-3,-4
26,9,46,1,7,0,153,130,99,91,101,84,62,19,63,37,30,29,30.0,32.0,-1,-7,6
8,10,46,1,7,0,59,47,57,42,39,50,45,14,26,20,6,2,4.0,9.0,-4,-14,10
129,11,46,1,7,0,540,652,534,502,474,569,538,214,216,188,191,134,162.0,171.0,-57,3,-60
82,12,46,1,7,0,334,361,423,281,274,309,360,94,101,91,90,79,84.0,87.0,-11,-1,-10
144,13,46,1,7,0,415,474,378,372,326,383,353,154,150,162,149,131,140.0,147.0,-18,-13,-5
70,14,46,1,7,0,537,516,505,471,372,457,538,139,100,129,104,87,96.0,107.0,-17,-25,8
91,15,46,1,7,0,527,619,525,437,429,453,388,129,152,151,108,106,107.0,122.0,-2,-43,41
109,16,46,1,7,0,357,348,470,379,317,421,474,120,139,119,158,186,172.0,154.0,28,39,-11
100,17,46,1,7,0,369,394,455,353,348,428,459,95,148,114,114,115,114.0,114.0,1,0,1
15,18,46,1,7,0,156,140,150,148,127,159,136,38,44,37,55,51,53.0,48.0,-4,18,-22
60,19,46,1,7,0,211,236,239,216,174,238,151,59,93,137,105,53,79.0,98.0,-52,-32,-20
22,20,46,1,7,0,154,160,119,108,151,126,110,41,27,16,19,16,18.0,17.0,-3,3,-6
81,21,46,1,7,0,243,241,219,279,210,288,180,80,67,82,94,70,82.0,82.0,-24,12,-36
28,22,46,1,7,0,135,185,126,121,118,156,75,46,57,45,34,22,28.0,34.0,-12,-11,-1
195,1,47,2,7,0,200,260,330,188,341,384,208,78,136,169,219,267,243.0,218.0,48,50,-2
106,2,47,2,7,0,160,152,177,216,186,206,142,56,68,79,116,111,114.0,102.0,-5,37,-42
48,3,47,2,7,0,95,118,103,121,125,115,74,44,45,52,72,39,56.0,54.0,-33,20,-53
159,4,47,2,7,0,587,598,646,461,553,771,253,139,206,162,160,198,179.0,173.0,38,-2,40
464,5,47,2,7,0,529,541,770,548,657,933,673,263,243,304,396,459,428.0,386.0,63,92,-29
640,6,47,2,7,0,815,909,849,800,764,993,964,338,340,389,526,609,568.0,508.0,83,137,-54
597,7,47,2,7,0,955,1028,1068,979,957,1332,1011,383,430,537,623,546,584.0,569.0,-77,86,-163
121,8,47,2,7,0,166,260,200,213,203,275,128,67,102,111,136,137,136.0,128.0,1,25,-24
669,9,47,2,7,0,970,1165,1341,1182,1660,1546,767,278,638,579,734,773,754.0,695.0,39,155,-116
129,10,47,2,7,0,138,192,192,181,188,276,186,86,105,86,125,135,130.0,115.0,10,39,-29
1465,11,47,2,7,0,1784,2086,2054,2015,2022,2642,2094,991,984,1074,1356,1448,1402.0,1293.0,92,282,-190
295,12,47,2,7,0,446,466,481,368,453,691,614,157,211,274,326,317,322.0,306.0,-9,52,-61
393,13,47,2,7,0,679,797,728,665,667,773,530,290,330,342,436,385,410.0,388.0,-51,94,-145
1138,14,47,2,7,0,1588,1680,1676,1390,1577,2409,1865,640,650,891,1055,1267,1161.0,1071.0,212,164,48
1232,15,47,2,7,0,1405,1649,1572,1696,1832,2222,1022,501,663,715,913,1088,1000.0,905.0,175,198,-23
394,16,47,2,7,0,475,562,525,475,492,661,605,178,211,256,312,333,322.0,300.0,21,56,-35
388,17,47,2,7,0,414,541,561,481,547,698,488,170,228,287,352,372,362.0,337.0,20,65,-45
263,18,47,2,7,0,350,418,427,469,556,601,361,197,246,246,307,332,320.0,295.0,25,61,-36
149,19,47,2,7,0,287,309,335,246,211,328,161,100,120,120,168,137,152.0,142.0,-31,48,-79
272,20,47,2,7,0,415,439,445,330,373,430,326,140,158,145,189,295,242.0,210.0,106,44,62
185,21,47,2,7,0,349,407,350,449,347,562,349,119,145,167,210,170,190.0,182.0,-40,43,-83
72,22,47,2,7,0,128,149,133,82,97,100,69,37,53,48,62,47,54.0,52.0,-15,14,-29
11,1,48,2,7,0,13,27,10,4,41,46,32,19,54,17,10,12,11.0,13.0,2,-7,9
54,2,48,2,7,0,181,200,159,126,119,169,142,104,91,53,62,66,64.0,60.0,4,9,-5
153,3,48,2,7,0,350,323,327,297,353,430,278,168,258,163,176,174,175.0,171.0,-2,13,-15
11,4,48,2,7,0,170,121,96,46,78,112,52,38,30,13,7,12,10.0,11.0,5,-6,11
161,5,48,2,7,0,869,836,723,408,517,641,617,336,250,134,145,143,144.0,141.0,-2,11,-13
63,6,48,2,7,0,293,261,211,71,198,190,278,146,119,59,72,88,80.0,73.0,16,13,3
656,7,48,2,7,0,1763,1885,1782,1445,1562,2281,1763,885,746,509,752,650,701.0,637.0,-102,243,-345
283,8,48,2,7,0,854,973,842,579,768,886,691,295,401,285,317,252,284.0,285.0,-65,32,-97
130,9,48,2,7,0,793,791,821,619,710,1008,472,229,471,212,177,139,158.0,176.0,-38,-35,-3
134,10,48,2,7,0,169,185,191,132,192,308,251,110,119,55,137,102,120.0,98.0,-35,82,-117
119,11,48,2,7,0,299,267,195,95,307,309,370,299,211,106,111,126,118.0,114.0,15,5,10
41,12,48,2,7,0,215,138,145,60,177,182,224,84,107,42,42,52,47.0,45.0,10,0,10
713,13,48,2,7,0,1898,2125,1949,1092,1644,1840,1468,940,941,733,782,635,708.0,717.0,-147,49,-196
280,14,48,2,7,0,797,693,546,306,774,911,1101,433,362,211,283,281,282.0,258.0,-2,72,-74
240,15,48,2,7,0,216,202,149,42,380,352,327,197,195,168,241,204,222.0,204.0,-37,73,-110
41,16,48,2,7,0,121,123,100,46,116,125,211,58,65,32,39,46,42.0,39.0,7,7,0
55,17,48,2,7,0,195,142,140,74,141,165,230,105,87,42,50,62,56.0,51.0,12,8,4
48,18,48,2,7,0,254,219,159,110,281,215,204,105,130,66,70,71,70.0,69.0,1,4,-3
173,19,48,2,7,0,791,715,654,384,528,619,375,317,409,425,215,168,192.0,269.0,-47,-210,163
27,20,48,2,7,0,210,170,119,62,80,104,116,61,54,25,34,33,34.0,31.0,-1,9,-10
148,21,48,2,7,0,504,331,168,145,214,250,261,108,136,75,123,125,124.0,108.0,2,48,-46
97,22,48,2,7,0,307,328,302,291,350,342,207,144,192,137,117,137,127.0,130.0,20,-20,40
204,1,49,1,7,0,187,321,371,283,435,596,174,80,151,177,200,272,236.0,216.0,72,23,49
239,2,49,1,7,0,391,368,477,514,538,699,444,236,185,176,241,235,238.0,217.0,-6,65,-71
202,3,49,1,7,0,278,328,337,354,323,485,221,94,125,138,233,182,208.0,184.0,-51,95,-146
287,4,49,1,7,0,616,785,877,636,879,1517,309,174,289,242,251,279,265.0,257.0,28,9,19
364,5,49,1,7,0,553,602,1020,712,770,1305,743,339,285,287,359,363,361.0,336.0,4,72,-68
677,6,49,1,7,0,658,834,1066,894,964,1597,855,344,344,422,524,660,592.0,535.0,136,102,34
841,7,49,1,7,0,793,998,1278,1160,1107,1740,687,383,327,543,829,670,750.0,681.0,-159,286,-445
186,8,49,1,7,0,206,301,280,282,301,514,192,100,117,126,207,172,190.0,168.0,-35,81,-116
483,9,49,1,7,0,710,890,1382,1240,1586,1899,542,186,403,360,460,604,532.0,475.0,144,100,44
123,10,49,1,7,0,201,232,277,266,309,514,260,96,110,81,120,111,116.0,104.0,-9,39,-48
918,11,49,1,7,0,955,1345,1406,1396,1446,2279,939,574,593,645,899,941,920.0,828.0,42,254,-212
342,12,49,1,7,0,356,409,638,519,571,900,502,180,199,229,302,289,296.0,273.0,-13,73,-86
843,13,49,1,7,0,725,929,1066,990,1108,1749,708,414,412,600,843,768,806.0,737.0,-75,243,-318
1208,14,49,1,7,0,1208,1438,1525,1493,1622,2735,1331,509,557,792,1003,1139,1071.0,978.0,136,211,-75
1212,15,49,1,7,0,1284,1635,1804,1911,2130,3255,1119,581,616,676,899,1179,1039.0,918.0,280,223,57
354,16,49,1,7,0,419,485,678,560,634,1014,597,202,210,256,309,467,388.0,344.0,158,53,105
311,17,49,1,7,0,374,473,712,546,606,978,498,212,209,272,280,287,284.0,280.0,7,8,-1
160,18,49,1,7,0,238,291,406,499,552,782,311,141,184,131,214,223,218.0,189.0,9,83,-74
176,19,49,1,7,0,229,283,315,299,258,424,127,80,97,131,161,165,163.0,152.0,4,30,-26
148,20,49,1,7,0,193,277,336,267,309,532,260,104,78,93,126,161,144.0,127.0,35,33,2
263,21,49,1,7,0,253,326,373,472,366,620,315,130,154,179,263,204,234.0,215.0,-59,84,-143
91,22,49,1,7,0,137,237,206,170,232,274,80,52,66,71,97,87,92.0,85.0,-10,26,-36
130,1,50,4,7,0,187,249,257,239,345,396,369,177,174,163,140,140,140.0,148.0,0,-23,23
202,2,50,4,7,0,300,344,358,406,373,334,203,134,207,159,159,199,179.0,172.0,40,0,40
39,3,50,4,7,0,65,160,123,116,59,90,51,29,42,27,40,31,36.0,33.0,-9,13,-22
40,4,50,4,7,0,164,139,203,168,222,242,93,60,87,42,47,47,47.0,45.0,0,5,-5
352,5,50,4,7,0,488,625,731,758,778,781,288,239,321,272,333,406,370.0,337.0,73,61,12
297,6,50,4,7,0,347,570,630,644,607,661,309,266,301,237,309,289,299.0,278.0,-20,72,-92
383,7,50,4,7,0,576,690,772,807,782,994,540,419,572,464,433,395,414.0,431.0,-38,-31,-7
87,8,50,4,7,0,162,287,240,200,132,201,88,44,87,60,67,72,70.0,66.0,5,7,-2
380,9,50,4,7,0,486,516,619,721,938,1135,331,231,477,411,394,418,406.0,408.0,24,-17,41
121,10,50,4,7,0,205,301,268,247,370,403,140,92,140,131,131,161,146.0,141.0,30,0,30
656,11,50,4,7,0,837,1017,1020,1227,1286,1781,805,710,885,641,740,693,716.0,691.0,-47,99,-146
175,12,50,4,7,0,221,285,391,438,444,431,157,97,173,170,210,195,202.0,192.0,-15,40,-55
404,13,50,4,7,0,574,734,729,766,589,806,391,375,484,404,455,438,446.0,432.0,-17,51,-68
381,14,50,4,7,0,840,854,777,834,729,896,363,334,528,418,445,554,500.0,472.0,109,27,82
443,15,50,4,7,0,507,510,573,616,797,1044,341,386,475,363,466,458,462.0,429.0,-8,103,-111
181,16,50,4,7,0,280,357,375,452,413,461,270,123,194,119,150,177,164.0,149.0,27,31,-4
200,17,50,4,7,0,255,292,394,414,458,478,157,99,182,167,188,184,186.0,180.0,-4,21,-25
214,18,50,4,7,0,310,328,339,397,455,593,250,154,266,219,283,228,256.0,243.0,-55,64,-119
71,19,50,4,7,0,139,151,144,114,136,149,45,36,75,66,76,84,80.0,75.0,8,10,-2
137,20,50,4,7,0,311,410,422,402,422,475,136,124,148,136,160,225,192.0,174.0,65,24,41
164,21,50,4,7,0,375,494,446,595,355,464,194,145,188,141,176,186,181.0,168.0,10,35,-25
39,22,50,4,7,0,146,202,237,176,82,87,40,47,82,54,34,48,41.0,45.0,14,-20,34
286,1,51,2,7,0,258,427,420,355,228,579,371,131,288,266,225,283,254.0,258.0,58,-41,99
217,2,51,2,7,0,180,214,200,244,165,338,215,134,179,192,167,169,168.0,176.0,2,-25,27
54,3,51,2,7,0,43,34,40,41,43,48,41,28,59,37,53,61,57.0,50.0,8,16,-8
89,4,51,2,7,0,202,267,304,268,372,383,131,61,110,108,70,103,86.0,94.0,33,-38,71
476,5,51,2,7,0,352,370,632,431,484,820,550,286,428,433,456,497,476.0,462.0,41,23,18
499,6,51,2,7,0,305,443,521,495,362,758,508,322,432,425,545,563,554.0,511.0,18,120,-102
345,7,51,2,7,0,303,357,410,423,383,729,410,227,320,381,388,394,391.0,388.0,6,7,-1
62,8,51,2,7,0,59,51,78,61,91,136,74,57,53,62,47,59,53.0,56.0,12,-15,27
954,9,51,2,7,0,879,1153,1298,1305,1034,2232,1023,444,1072,1007,969,1190,1080.0,1055.0,221,-38,259
223,10,51,2,7,0,192,217,237,215,191,328,208,107,160,131,178,209,194.0,173.0,31,47,-16
1045,11,51,2,7,0,845,1153,1190,1239,807,1846,1142,747,1023,870,969,1040,1004.0,960.0,71,99,-28
243,12,51,2,7,0,177,232,306,226,131,436,290,111,237,235,226,237,232.0,233.0,11,-9,20
355,13,51,2,7,0,243,316,360,308,272,475,287,194,265,298,335,339,337.0,324.0,4,37,-33
508,14,51,2,7,0,405,509,554,543,420,747,459,249,457,513,513,571,542.0,532.0,58,0,58
836,15,51,2,7,0,614,743,824,856,695,1454,752,503,780,679,725,759,742.0,721.0,34,46,-12
347,16,51,2,7,0,205,250,304,278,190,481,312,158,246,258,251,428,340.0,312.0,177,-7,184
308,17,51,2,7,0,226,283,329,289,235,425,324,139,263,238,293,308,300.0,280.0,15,55,-40
406,18,51,2,7,0,354,411,469,472,415,699,508,260,395,323,426,506,466.0,418.0,80,103,-23
110,19,51,2,7,0,94,128,154,125,64,125,66,52,82,116,125,102,114.0,114.0,-23,9,-32
280,20,51,2,7,0,279,300,389,322,256,548,310,185,288,287,285,378,332.0,317.0,93,-2,95
167,21,51,2,7,0,162,175,188,226,181,259,170,96,124,121,134,165,150.0,140.0,31,13,18
53,22,51,2,7,0,95,86,84,67,65,115,61,52,76,85,53,52,52.0,63.0,-1,-32,31
230,1,52,1,7,0,315,327,336,292,421,473,415,199,338,303,272,297,284.0,291.0,25,-31,56
320,2,52,1,7,0,381,320,316,363,485,535,500,259,353,295,304,293,298.0,297.0,-11,9,-20
194,3,52,1,7,0,210,230,224,233,229,234,273,129,208,180,191,167,179.0,179.0,-24,11,-35
341,4,52,1,7,0,454,424,442,429,500,681,534,295,402,398,365,374,370.0,379.0,9,-33,42
476,5,52,1,7,0,557,495,659,704,743,849,933,442,540,493,508,553,530.0,518.0,45,15,30
197,6,52,1,7,0,219,249,314,271,334,368,404,198,210,162,176,206,191.0,181.0,30,14,16
483,7,52,1,7,0,579,617,771,679,776,936,911,376,595,546,558,596,577.0,567.0,38,12,26
107,8,52,1,7,0,113,131,135,142,208,244,213,113,141,101,103,104,104.0,103.0,1,2,-1
825,9,52,1,7,0,1120,1145,1408,1392,1836,2078,1526,521,1068,875,905,1067,986.0,949.0,162,30,132
140,10,52,1,7,0,203,212,207,208,246,317,323,145,236,156,189,166,178.0,170.0,-23,33,-56
436,11,52,1,7,0,553,616,611,660,847,820,821,461,589,458,423,545,484.0,475.0,122,-35,157
150,12,52,1,7,0,206,215,215,187,249,262,297,113,164,151,133,139,136.0,141.0,6,-18,24
495,13,52,1,7,0,475,528,576,625,746,750,758,431,483,470,474,415,444.0,453.0,-59,4,-63
423,14,52,1,7,0,548,623,596,604,752,820,826,447,615,567,493,543,518.0,534.0,50,-74,124
307,15,52,1,7,0,357,379,387,524,623,684,550,252,401,254,311,325,318.0,297.0,14,57,-43
238,16,52,1,7,0,268,311,346,310,385,425,481,197,299,246,238,274,256.0,253.0,36,-8,44
325,17,52,1,7,0,350,384,424,364,460,493,505,239,383,321,315,341,328.0,326.0,26,-6,32
141,18,52,1,7,0,259,222,223,268,329,338,400,163,217,128,161,123,142.0,137.0,-38,33,-71
236,19,52,1,7,0,281,324,364,303,369,450,249,117,274,320,298,258,278.0,292.0,-40,-22,-18
296,20,52,1,7,0,402,372,406,400,540,575,576,284,403,314,306,439,372.0,353.0,133,-8,141
203,21,52,1,7,0,299,275,293,365,346,404,376,178,272,285,266,201,234.0,251.0,-65,-19,-46
292,22,52,1,7,0,359,356,331,302,341,410,324,206,341,242,239,273,256.0,251.0,34,-3,37
247,1,53,2,7,0,581,617,628,446,636,846,241,179,180,191,192,253,222.0,212.0,61,1,60
183,2,53,2,7,0,197,189,278,304,365,493,290,145,117,124,158,128,143.0,137.0,-30,34,-64
97,3,53,2,7,0,168,136,222,206,310,562,284,123,119,71,119,101,110.0,97.0,-18,48,-66
51,4,53,2,7,0,521,473,498,257,444,824,105,71,55,60,50,59,54.0,56.0,9,-10,19
516,5,53,2,7,0,717,777,1042,762,1080,1730,983,504,400,394,380,436,408.0,403.0,56,-14,70
594,6,53,2,7,0,945,973,1078,1023,1260,2243,1186,528,593,566,477,521,499.0,521.0,44,-89,133
724,7,53,2,7,0,1176,1294,1622,1536,1637,2998,1261,553,503,551,645,651,648.0,616.0,6,94,-88
195,8,53,2,7,0,257,272,308,299,372,645,313,178,140,164,178,173,176.0,172.0,-5,14,-19
794,9,53,2,7,0,1121,1670,1369,1274,1967,3191,905,337,855,959,831,614,722.0,801.0,-217,-128,-89
204,10,53,2,7,0,192,188,232,252,337,697,471,179,227,188,213,224,218.0,208.0,11,25,-14
889,11,53,2,7,0,1702,2067,2163,1918,2283,3836,1631,972,777,763,993,802,898.0,853.0,-191,230,-421
273,12,53,2,7,0,411,440,542,547,676,1270,658,229,229,221,283,227,255.0,244.0,-56,62,-118
544,13,53,2,7,0,854,909,987,969,1064,2232,950,551,442,578,697,555,626.0,610.0,-142,119,-261
1189,14,53,2,7,0,1257,1337,1548,1431,1720,3243,1894,828,807,1011,1085,1013,1049.0,1036.0,-72,74,-146
467,15,53,2,7,0,886,1003,1067,1140,1205,1850,574,328,328,361,426,423,424.0,403.0,-3,65,-68
223,16,53,2,7,0,356,435,576,710,866,1354,755,244,256,243,222,247,234.0,237.0,25,-21,46
466,17,53,2,7,0,590,709,844,687,982,1756,938,322,403,371,448,412,430.0,410.0,-36,77,-113
233,18,53,2,7,0,422,486,645,645,746,1041,462,182,250,215,304,238,271.0,252.0,-66,89,-155
123,19,53,2,7,0,300,418,415,275,422,561,181,92,144,178,144,111,128.0,144.0,-33,-34,1
190,20,53,2,7,0,758,749,722,571,643,1136,557,231,195,203,189,260,224.0,217.0,71,-14,85
381,21,53,2,7,0,811,726,652,682,805,1567,639,298,275,310,369,282,326.0,320.0,-87,59,-146
101,22,53,2,7,0,259,159,164,109,207,305,102,62,72,62,93,71,82.0,75.0,-22,31,-53
21,1,54,1,7,0,88,90,112,64,139,159,95,31,32,33,18,19,18.0,23.0,1,-15,16
56,2,54,1,7,0,102,103,88,129,116,195,181,91,58,50,67,48,58.0,55.0,-19,17,-36
83,3,54,1,7,0,192,148,178,215,227,336,327,113,110,91,126,86,106.0,101.0,-40,35,-75
19,4,54,1,7,0,110,107,124,113,153,246,99,35,29,28,28,17,22.0,24.0,-11,0,-11
76,5,54,1,7,0,169,165,260,194,267,387,398,155,108,95,80,69,74.0,81.0,-11,-15,4
101,6,54,1,7,0,192,228,277,262,301,471,484,121,103,101,118,103,110.0,107.0,-15,17,-32
273,7,54,1,7,0,433,565,670,629,591,961,723,263,300,312,311,242,276.0,288.0,-69,-1,-68
45,8,54,1,7,0,88,106,92,114,133,167,149,66,59,57,51,58,54.0,55.0,7,-6,13
30,9,54,1,7,0,99,112,111,142,134,176,97,19,44,38,31,35,33.0,35.0,4,-7,11
23,10,54,1,7,0,36,46,27,44,52,62,66,20,31,15,25,9,17.0,16.0,-16,10,-26
97,11,54,1,7,0,216,275,222,289,312,450,333,168,137,94,101,95,98.0,97.0,-6,7,-13
58,12,54,1,7,0,96,123,158,141,164,252,264,69,58,63,82,66,74.0,70.0,-16,19,-35
157,13,54,1,7,0,209,251,268,281,338,473,362,182,165,226,205,142,174.0,191.0,-63,-21,-42
239,14,54,1,7,0,458,438,436,457,535,679,669,213,223,212,206,190,198.0,203.0,-16,-6,-10
47,15,54,1,7,0,117,144,152,167,161,255,131,59,54,69,64,57,60.0,63.0,-7,-5,-2
81,16,54,1,7,0,166,169,231,258,278,385,450,105,110,104,89,90,90.0,94.0,1,-15,16
243,17,54,1,7,0,322,320,453,378,533,776,857,222,262,247,257,219,238.0,241.0,-38,10,-48
21,18,54,1,7,0,47,38,50,51,83,65,41,21,20,20,33,19,26.0,24.0,-14,13,-27
43,19,54,1,7,0,101,115,152,128,129,166,109,50,66,72,45,46,46.0,54.0,1,-27,28
67,20,54,1,7,0,125,149,157,175,189,306,256,58,77,65,70,84,77.0,73.0,14,5,9
204,21,54,1,7,0,270,298,329,421,381,634,493,193,190,176,193,161,177.0,177.0,-32,17,-49
66,22,54,1,7,0,132,165,141,126,204,277,131,70,96,70,62,54,58.0,62.0,-8,-8,0
81,1,55,1,7,0,164,176,188,167,211,361,138,71,95,74,75,111,93.0,87.0,36,1,35
373,2,55,1,7,0,407,402,486,521,434,743,406,299,256,259,276,323,300.0,286.0,47,17,30
314,3,55,1,7,0,256,255,374,366,390,683,304,135,211,181,248,260,254.0,230.0,12,67,-55
102,4,55,1,7,0,365,388,458,302,357,675,173,56,121,79,138,89,114.0,102.0,-49,59,-108
1044,5,55,1,7,0,1135,1222,1530,1137,1318,2057,1186,681,782,644,814,979,896.0,812.0,165,170,-5
317,6,55,1,7,0,363,463,479,476,493,865,574,194,213,248,307,345,326.0,300.0,38,59,-21
680,7,55,1,7,0,720,875,922,870,894,1538,723,282,412,473,536,614,575.0,541.0,78,63,15
656,8,55,1,7,0,358,454,470,495,510,974,417,214,254,346,509,560,534.0,472.0,51,163,-112
484,9,55,1,7,0,557,610,730,702,768,1105,569,259,493,354,430,585,508.0,456.0,155,76,79
194,10,55,1,7,0,182,175,217,208,212,406,260,101,165,105,174,218,196.0,166.0,44,69,-25
550,11,55,1,7,0,652,768,765,828,786,1332,698,402,409,494,495,557,526.0,515.0,62,1,61
283,12,55,1,7,0,276,281,350,363,356,774,420,110,193,205,216,298,257.0,240.0,82,11,71
1137,13,55,1,7,0,693,937,936,974,964,2069,891,397,516,929,990,983,986.0,967.0,-7,61,-68
946,14,55,1,7,0,796,900,924,913,934,1916,1026,330,387,521,645,908,776.0,691.0,263,124,139
371,15,55,1,7,0,491,561,604,663,556,982,370,195,281,311,304,395,350.0,337.0,91,-7,98
290,16,55,1,7,0,276,301,385,300,389,721,401,105,159,186,195,272,234.0,218.0,77,9,68
424,17,55,1,7,0,551,548,722,567,687,1290,631,205,298,333,363,464,414.0,387.0,101,30,71
163,18,55,1,7,0,152,178,217,240,253,385,180,95,138,114,150,154,152.0,139.0,4,36,-32
145,19,55,1,7,0,212,251,209,211,226,330,135,104,181,144,138,167,152.0,150.0,29,-6,35
557,20,55,1,7,0,790,970,909,844,751,1420,661,420,464,477,481,631,556.0,530.0,150,4,146
687,21,55,1,7,0,496,540,574,623,639,1234,604,184,336,402,415,468,442.0,428.0,53,13,40
127,22,55,1,7,0,131,146,126,126,150,236,76,111,111,78,108,134,121.0,107.0,26,30,-4
286,1,56,1,7,0,275,484,500,412,620,805,357,95,198,187,218,252,235.0,219.0,34,31,3
766,2,56,1,7,0,521,806,851,856,921,1249,829,418,522,444,470,542,506.0,485.0,72,26,46
595,3,56,1,7,0,347,507,500,528,675,925,601,288,415,322,461,499,480.0,427.0,38,139,-101
302,4,56,1,7,0,534,743,672,532,779,1421,437,212,313,278,276,253,264.0,269.0,-23,-2,-21
1538,5,56,1,7,0,1077,1757,2178,1620,1861,2915,2183,903,1084,938,1042,1247,1144.0,1076.0,205,104,101
585,6,56,1,7,0,395,690,798,757,934,1307,1141,304,330,322,356,545,450.0,408.0,189,34,155
1014,7,56,1,7,0,668,1173,1160,1214,1192,1610,1006,389,569,611,624,776,700.0,670.0,152,13,139
552,8,56,1,7,0,316,582,505,511,601,970,406,198,368,305,370,503,436.0,393.0,133,65,68
1134,9,56,1,7,0,758,1347,1576,1507,1902,2685,1203,341,825,879,785,1142,964.0,935.0,357,-94,451
296,10,56,1,7,0,193,394,347,352,440,665,433,149,235,168,197,226,212.0,197.0,29,29,0
1420,11,56,1,7,0,1014,1794,1646,1598,1955,2752,1481,650,861,854,961,1280,1120.0,1032.0,319,107,212
440,12,56,1,7,0,281,443,510,475,511,802,624,159,229,268,266,354,310.0,296.0,88,-2,90
1254,13,56,1,7,0,624,985,1009,905,1021,1551,970,478,608,767,810,890,850.0,822.0,80,43,37
1787,14,56,1,7,0,846,1361,1342,1399,1530,2696,1928,502,672,701,850,1415,1132.0,989.0,565,149,416
1254,15,56,1,7,0,720,1247,1320,1351,1499,2124,704,292,530,641,696,932,814.0,756.0,236,55,181
609,16,56,1,7,0,347,614,653,620,794,1252,837,201,313,330,347,462,404.0,380.0,115,17,98
934,17,56,1,7,0,741,1241,1383,1339,1478,2360,1657,503,671,579,591,827,709.0,666.0,236,12,224
378,18,56,1,7,0,231,425,414,399,601,698,428,129,211,219,281,359,320.0,286.0,78,62,16
334,19,56,1,7,0,191,375,331,306,361,459,235,125,226,187,250,248,249.0,228.0,-2,63,-65
1313,20,56,1,7,0,994,1592,1671,1487,1581,2727,1846,758,896,740,908,1151,1030.0,933.0,243,168,75
798,21,56,1,7,0,538,758,764,827,896,1319,905,333,426,445,444,565,504.0,485.0,121,-1,122
253,22,56,1,7,0,136,271,219,256,312,397,173,117,199,155,143,190,166.0,163.0,47,-12,59
32,1,57,3,7,0,25,37,28,27,30,34,19,29,28,25,38,29,34.0,31.0,-9,13,-22
875,2,57,3,7,0,1342,1395,1639,1736,1547,1939,1680,1190,1187,815,815,786,800.0,805.0,-29,0,-29
56,3,57,3,7,0,79,74,107,93,105,108,54,78,117,71,70,60,65.0,67.0,-10,-1,-9
70,4,57,3,7,0,229,238,282,198,305,504,106,118,157,120,110,104,107.0,111.0,-6,-10,4
468,5,57,3,7,0,620,742,717,655,773,955,603,645,678,519,472,474,473.0,488.0,2,-47,49
145,6,57,3,7,0,172,194,197,214,225,272,216,223,191,165,153,149,151.0,156.0,-4,-12,8
388,7,57,3,7,0,644,631,622,551,636,1105,629,541,513,451,400,375,388.0,409.0,-25,-51,26
93,8,57,3,7,0,131,103,137,118,161,233,166,115,127,118,117,113,115.0,116.0,-4,-1,-3
390,9,57,3,7,0,568,627,644,624,713,866,346,505,757,513,503,519,511.0,512.0,16,-10,26
20,10,57,3,7,0,69,50,93,63,75,97,92,50,85,53,57,36,46.0,49.0,-21,4,-25
522,11,57,3,7,0,653,752,766,763,871,1150,610,843,857,623,558,495,526.0,559.0,-63,-65,2
87,12,57,3,7,0,121,107,134,92,117,148,132,89,105,90,70,62,66.0,74.0,-8,-20,12
570,13,57,3,7,0,529,574,561,554,769,983,537,616,685,621,541,500,520.0,554.0,-41,-80,39
715,14,57,3,7,0,759,825,703,746,952,1314,922,778,753,612,592,519,556.0,574.0,-73,-20,-53
353,15,57,3,7,0,405,385,451,456,466,653,312,498,511,368,351,319,335.0,346.0,-32,-17,-15
306,16,57,3,7,0,513,518,582,592,590,903,514,438,482,408,403,314,358.0,375.0,-89,-5,-84
276,17,57,3,7,0,353,375,366,327,426,575,405,314,375,353,267,377,322.0,332.0,110,-86,196
94,18,57,3,7,0,152,164,156,179,175,195,85,140,157,133,146,133,140.0,137.0,-13,13,-26
200,19,57,3,7,0,212,192,216,260,281,370,158,187,236,191,184,170,177.0,182.0,-14,-7,-7
470,20,57,3,7,0,554,592,643,645,706,955,636,643,771,438,521,498,510.0,486.0,-23,83,-106
131,21,57,3,7,0,180,190,227,209,280,324,195,155,198,180,157,132,144.0,156.0,-25,-23,-2
28,22,57,3,7,0,47,88,70,59,76,90,35,48,67,46,41,40,40.0,42.0,-1,-5,4
59,1,58,2,7,0,139,176,218,159,193,281,60,52,74,61,69,81,75.0,70.0,12,8,4
106,2,58,2,7,0,201,192,241,224,227,356,181,119,130,103,154,125,140.0,127.0,-29,51,-80
51,3,58,2,7,0,103,63,86,129,183,244,117,67,81,65,79,55,67.0,66.0,-24,14,-38
172,4,58,2,7,0,463,464,472,326,417,805,105,52,132,97,103,144,124.0,115.0,41,6,35
453,5,58,2,7,0,739,855,1133,824,910,1456,816,454,505,463,516,491,504.0,490.0,-25,53,-78
110,6,58,2,7,0,323,314,310,267,287,463,251,96,133,88,118,91,104.0,99.0,-27,30,-57
332,7,58,2,7,0,646,773,797,679,738,1182,600,283,311,395,408,271,340.0,358.0,-137,13,-150
132,8,58,2,7,0,199,221,226,243,264,497,192,96,135,117,169,144,156.0,143.0,-25,52,-77
238,9,58,2,7,0,378,429,596,574,615,869,297,127,271,262,258,278,268.0,266.0,20,-4,24
104,10,58,2,7,0,161,139,167,205,233,425,254,71,136,107,135,145,140.0,129.0,10,28,-18
260,11,58,2,7,0,683,706,761,731,749,1017,461,270,342,363,373,289,331.0,342.0,-84,10,-94
78,12,58,2,7,0,145,145,229,198,198,315,211,60,84,84,68,64,66.0,72.0,-4,-16,12
459,13,58,2,7,0,551,690,771,682,755,1430,754,390,398,481,498,419,458.0,466.0,-79,17,-96
440,14,58,2,7,0,779,871,851,876,865,1601,892,268,371,333,363,396,380.0,364.0,33,30,3
243,15,58,2,7,0,410,370,1437,406,420,845,174,81,170,192,246,204,225.0,214.0,-42,54,-96
51,16,58,2,7,0,124,88,110,128,133,246,134,39,47,55,60,48,54.0,54.0,-12,5,-17
177,17,58,2,7,0,335,319,439,335,447,756,439,130,231,191,211,178,194.0,193.0,-33,20,-53
79,18,58,2,7,0,116,102,142,175,166,247,102,51,67,60,67,91,79.0,73.0,24,7,17
21,19,58,2,7,0,77,81,68,54,102,113,47,21,29,27,30,22,26.0,26.0,-8,3,-11
428,20,58,2,7,0,781,1602,764,548,596,1578,630,283,298,337,395,444,420.0,392.0,49,58,-9
286,21,58,2,7,0,435,453,455,455,558,938,498,189,261,260,236,226,231.0,241.0,-10,-24,14
12,22,58,2,7,0,25,28,17,16,45,45,7,10,21,11,20,18,19.0,16.0,-2,9,-11
1154,1,59,2,7,0,547,590,1049,393,448,746,228,125,223,190,233,237,235.0,220.0,4,43,-39
79,2,59,2,7,0,317,301,410,266,224,235,105,67,68,72,70,100,85.0,81.0,30,-2,32
75,3,59,2,7,0,178,248,263,289,273,340,208,63,95,64,75,89,82.0,76.0,14,11,3
417,4,59,2,7,0,216,265,2528,156,179,362,72,29,64,61,50,56,53.0,56.0,6,-11,17
834,5,59,2,7,0,942,1243,1666,730,631,1027,542,251,246,265,230,226,228.0,240.0,-4,-35,31
315,6,59,2,7,0,742,968,961,755,678,1434,792,244,232,308,344,363,354.0,338.0,19,36,-17
372,7,59,2,7,0,2176,2848,2646,1380,1053,1685,823,326,341,453,371,362,366.0,395.0,-9,-82,73
558,8,59,2,7,0,468,657,660,386,479,604,321,126,162,162,182,154,168.0,166.0,-28,20,-48
329,9,59,2,7,0,546,819,1623,936,1038,1493,451,130,374,366,407,481,444.0,418.0,74,41,33
103,10,59,2,7,0,234,316,360,349,312,543,250,76,136,99,136,130,133.0,122.0,-6,37,-43
1395,11,59,2,7,0,1827,2527,2388,1650,1467,2828,1205,656,751,787,807,758,782.0,784.0,-49,20,-69
268,12,59,2,7,0,450,511,752,626,577,1241,549,138,232,271,262,250,256.0,261.0,-12,-9,-3
285,13,59,2,7,0,987,1387,1606,840,561,1020,602,249,293,362,351,329,340.0,347.0,-22,-11,-11
719,14,59,2,7,0,1416,1736,1669,959,1021,1584,992,320,512,660,557,721,639.0,646.0,164,-103,267
337,15,59,2,7,0,717,1019,1203,828,859,1272,386,193,342,341,375,377,376.0,364.0,2,34,-32
775,16,59,2,7,0,430,713,769,691,751,1208,523,161,272,326,270,280,275.0,292.0,10,-56,66
261,17,59,2,7,0,641,816,847,522,619,891,508,132,232,212,222,268,245.0,234.0,46,10,36
77,18,59,2,7,0,221,243,304,268,291,431,173,74,106,104,121,115,118.0,113.0,-6,17,-23
52,19,59,2,7,0,228,366,291,139,186,225,91,51,75,101,66,42,54.0,70.0,-24,-35,11
57,20,59,2,7,0,215,324,310,182,148,242,128,33,53,51,65,76,70.0,64.0,11,14,-3
754,21,59,2,7,0,687,656,661,278,275,432,182,64,143,136,155,142,148.0,144.0,-13,19,-32
21,22,59,2,7,0,97,146,137,83,61,140,53,29,33,28,48,27,38.0,34.0,-21,20,-41
143,1,60,1,7,0,141,138,161,113,162,163,142,84,128,99,108,102,105.0,103.0,-6,9,-15
136,2,60,1,7,0,141,123,111,95,152,131,146,84,119,80,84,87,86.0,84.0,3,4,-1
58,3,60,1,7,0,84,71,81,97,81,90,83,41,62,87,86,67,76.0,80.0,-19,-1,-18
53,4,60,1,7,0,119,87,131,79,100,123,88,65,74,70,62,63,62.0,65.0,1,-8,9
192,5,60,1,7,0,232,227,447,284,279,330,341,184,223,201,224,188,206.0,204.0,-36,23,-59
136,6,60,1,7,0,138,167,182,170,183,198,254,107,149,150,152,146,149.0,149.0,-6,2,-8
116,7,60,1,7,0,138,136,198,152,160,191,159,74,162,163,162,117,140.0,147.0,-45,-1,-44
28,8,60,1,7,0,30,36,34,32,31,28,41,25,46,41,28,30,29.0,33.0,2,-13,15
440,9,60,1,7,0,487,435,593,541,658,638,568,264,527,387,410,437,424.0,411.0,27,23,4
143,10,60,1,7,0,151,154,208,163,172,213,297,121,197,152,163,152,158.0,156.0,-11,11,-22
373,11,60,1,7,0,317,361,402,385,402,439,430,213,408,324,345,284,314.0,318.0,-61,21,-82
82,12,60,1,7,0,82,64,94,87,76,120,103,50,101,76,71,82,76.0,76.0,11,-5,16
134,13,60,1,7,0,88,102,92,82,85,95,109,50,116,95,137,104,120.0,112.0,-33,42,-75
140,14,60,1,7,0,120,123,153,141,134,164,130,78,142,114,90,124,107.0,109.0,34,-24,58
351,15,60,1,7,0,322,299,308,339,364,397,466,185,307,317,322,277,300.0,305.0,-45,5,-50
186,16,60,1,7,0,155,179,232,184,244,236,270,129,200,183,140,190,165.0,171.0,50,-43,93
319,17,60,1,7,0,299,298,395,308,355,445,519,215,330,301,296,262,279.0,286.0,-34,-5,-29
78,18,60,1,7,0,92,91,93,87,125,99,145,57,96,88,101,91,96.0,93.0,-10,13,-23
79,19,60,1,7,0,136,158,194,115,126,155,89,59,109,102,100,85,92.0,96.0,-15,-2,-13
151,20,60,1,7,0,146,146,203,173,179,214,160,89,140,134,104,264,184.0,167.0,160,-30,190
256,21,60,1,7,0,273,229,256,263,252,263,274,154,228,212,258,163,210.0,211.0,-95,46,-141
39,22,60,1,7,0,75,75,68,54,66,57,65,35,91,67,47,50,48.0,55.0,3,-20,23
298,1,1,1,8,0,162,265,228,369,374,305,193,309,264,241,251,240,246.0,244.0,-11,10,-21
323,2,1,1,8,0,246,217,310,402,456,434,194,302,243,321,230,362,296.0,304.0,132,-91,223
170,3,1,1,8,0,153,157,178,204,219,180,128,201,176,192,155,199,177.0,182.0,44,-37,81
310,4,1,1,8,0,244,337,371,460,563,468,432,472,340,407,314,302,308.0,341.0,-12,-93,81
330,5,1,1,8,0,345,623,350,453,570,500,253,378,337,331,336,304,320.0,324.0,-32,5,-37
166,6,1,1,8,0,127,159,136,179,226,198,76,132,155,144,166,155,160.0,155.0,-11,22,-33
413,7,1,1,8,0,259,422,394,483,601,468,290,412,484,450,432,449,440.0,444.0,17,-18,35
197,8,1,1,8,0,189,194,233,215,260,248,146,249,182,251,173,213,193.0,212.0,40,-78,118
2782,9,1,1,8,0,1804,2265,2711,3532,3800,2692,1680,2958,2368,2754,2696,2582,2639.0,2677.0,-114,-58,-56
331,10,1,1,8,0,249,267,349,472,505,425,248,383,277,377,293,309,301.0,326.0,16,-84,100
682,11,1,1,8,0,569,631,764,871,1010,800,486,817,617,720,689,718,704.0,709.0,29,-31,60
168,12,1,1,8,0,95,156,166,204,262,236,78,191,154,186,149,156,152.0,164.0,7,-37,44
352,13,1,1,8,0,235,225,228,291,305,260,190,297,311,328,293,325,309.0,315.0,32,-35,67
309,14,1,1,8,0,256,301,351,521,505,405,250,355,393,307,297,380,338.0,328.0,83,-10,93
669,15,1,1,8,0,422,545,702,660,865,633,409,621,561,562,591,624,608.0,592.0,33,29,4
361,16,1,1,8,0,325,381,447,480,474,497,228,445,423,403,455,424,440.0,427.0,-31,52,-83
280,17,1,1,8,0,286,299,327,364,474,347,174,297,304,284,259,316,288.0,286.0,57,-25,82
316,18,1,1,8,0,226,258,368,331,404,292,181,307,209,324,299,311,305.0,311.0,12,-25,37
715,19,1,1,8,0,556,721,769,941,997,650,566,775,692,738,626,805,716.0,723.0,179,-112,291
104,20,1,1,8,0,111,101,120,155,199,115,72,126,107,119,138,135,136.0,131.0,-3,19,-22
307,21,1,1,8,0,204,187,324,393,440,305,219,295,292,328,285,305,295.0,306.0,20,-43,63
335,22,1,1,8,0,351,302,310,458,461,292,234,401,305,324,284,313,298.0,307.0,29,-40,69
506,1,2,2,8,0,410,417,271,639,518,268,263,442,321,383,408,481,444.0,424.0,73,25,48
506,2,2,2,8,0,266,368,334,609,519,292,264,403,325,415,354,487,420.0,419.0,133,-61,194
332,3,2,2,8,0,216,208,216,370,337,175,149,316,260,258,252,263,258.0,258.0,11,-6,17
326,4,2,2,8,0,464,449,231,675,811,368,359,470,369,376,352,396,374.0,375.0,44,-24,68
901,5,2,2,8,0,758,1227,469,1053,1125,657,560,806,700,679,724,721,722.0,708.0,-3,45,-48
517,6,2,2,8,0,358,325,253,574,507,301,225,317,315,350,352,460,406.0,387.0,108,2,106
1502,7,2,2,8,0,917,1222,876,1567,1574,775,729,1060,1229,1119,1113,1342,1228.0,1191.0,229,-6,235
519,8,2,2,8,0,382,372,320,590,571,290,239,407,358,384,335,452,394.0,390.0,117,-49,166
10367,9,2,2,8,0,10596,10140,6925,13598,11515,5136,4688,10371,8733,8990,9100,9110,9105.0,9067.0,10,110,-100
1222,10,2,2,8,0,866,969,642,1386,1258,750,559,1074,832,939,901,1075,988.0,972.0,174,-38,212
2406,11,2,2,8,0,2216,2075,1763,3112,2877,1445,1635,2184,1828,1916,1948,2090,2019.0,1985.0,142,32,110
577,12,2,2,8,0,420,535,356,595,741,435,311,545,463,483,513,576,544.0,524.0,63,30,33
1183,13,2,2,8,0,569,722,520,1137,974,498,486,847,1025,993,829,1052,940.0,958.0,223,-164,387
1163,14,2,2,8,0,785,808,565,1273,1234,645,486,968,944,932,1043,1153,1098.0,1043.0,110,111,-1
2419,15,2,2,8,0,1785,1658,1293,2709,2467,1135,1205,1969,1744,1919,1847,2165,2006.0,1977.0,318,-72,390
989,16,2,2,8,0,883,908,742,1001,1050,703,508,734,619,699,876,984,930.0,853.0,108,177,-69
1006,17,2,2,8,0,721,958,582,1112,1192,689,445,769,687,748,707,821,764.0,759.0,114,-41,155
1699,18,2,2,8,0,1388,1310,817,2205,1578,856,899,1607,1181,1494,1511,1522,1516.0,1509.0,11,17,-6
2361,19,2,2,8,0,2301,1915,1064,2892,2161,1110,1306,1905,1837,1784,1845,2218,2032.0,1949.0,373,61,312
317,20,2,2,8,0,319,331,173,470,398,244,215,285,259,240,371,328,350.0,313.0,-43,131,-174
525,21,2,2,8,0,492,462,375,582,607,340,260,369,435,466,394,526,460.0,462.0,132,-72,204
1229,22,2,2,8,0,1107,843,480,1076,1018,447,521,1186,639,827,849,957,903.0,878.0,108,22,86
195,1,3,1,8,0,159,169,112,163,167,157,101,187,162,155,200,158,179.0,171.0,-42,45,-87
329,2,3,1,8,0,309,270,218,354,350,290,213,293,226,236,265,410,338.0,304.0,145,29,116
251,3,3,1,8,0,246,234,155,184,233,279,174,228,241,255,251,306,278.0,271.0,55,-4,59
475,4,3,1,8,0,554,583,457,611,677,549,387,627,524,389,503,552,528.0,481.0,49,114,-65
373,5,3,1,8,0,319,387,300,411,434,516,235,377,355,370,404,481,442.0,418.0,77,34,43
124,6,3,1,8,0,108,157,129,128,138,176,83,127,116,129,142,151,146.0,141.0,9,13,-4
410,7,3,1,8,0,328,376,327,415,400,420,235,353,334,323,407,400,404.0,377.0,-7,84,-91
167,8,3,1,8,0,152,135,111,141,197,179,103,189,173,157,177,211,194.0,182.0,34,20,14
1593,9,3,1,8,0,1490,1683,1421,1989,1829,1713,1159,1738,1536,1581,1833,1828,1830.0,1747.0,-5,252,-257
133,10,3,1,8,0,141,192,165,181,173,211,121,197,149,174,163,216,190.0,184.0,53,-11,64
461,11,3,1,8,0,340,401,333,437,427,470,296,446,386,375,444,454,449.0,424.0,10,69,-59
154,12,3,1,8,0,84,108,90,107,109,126,55,113,112,112,126,130,128.0,123.0,4,14,-10
444,13,3,1,8,0,321,309,274,302,328,389,251,371,364,437,425,531,478.0,464.0,106,-12,118
320,14,3,1,8,0,300,327,262,352,337,377,202,331,306,338,396,390,393.0,375.0,-6,58,-64
444,15,3,1,8,0,352,336,342,428,424,401,264,349,335,366,380,435,408.0,394.0,55,14,41
267,16,3,1,8,0,201,303,211,267,280,321,189,271,255,230,322,292,307.0,281.0,-30,92,-122
286,17,3,1,8,0,193,250,211,244,275,284,146,275,262,250,285,292,288.0,276.0,7,35,-28
94,18,3,1,8,0,95,124,106,151,157,167,81,107,85,111,132,133,132.0,125.0,1,21,-20
708,19,3,1,8,0,466,488,346,464,567,506,316,529,433,489,457,606,532.0,517.0,149,-32,181
176,20,3,1,8,0,134,169,138,184,155,213,116,188,148,168,179,203,191.0,183.0,24,11,13
254,21,3,1,8,0,253,271,195,252,267,297,206,288,291,280,277,346,312.0,301.0,69,-3,72
316,22,3,1,8,0,304,239,208,258,336,315,155,306,267,240,317,304,310.0,287.0,-13,77,-90
201,1,4,2,8,0,249,216,166,212,210,117,96,135,131,161,142,167,154.0,157.0,25,-19,44
332,2,4,2,8,0,232,256,209,270,308,173,110,159,185,191,176,253,214.0,207.0,77,-15,92
167,3,4,2,8,0,134,193,128,165,176,89,72,136,148,139,117,145,131.0,134.0,28,-22,50
159,4,4,2,8,0,309,286,179,246,342,136,109,179,166,96,85,131,108.0,104.0,46,-11,57
553,5,4,2,8,0,492,712,401,438,436,351,212,361,425,290,324,427,376.0,347.0,103,34,69
313,6,4,2,8,0,368,358,250,325,348,264,151,204,182,203,195,266,230.0,221.0,71,-8,79
522,7,4,2,8,0,489,606,454,468,556,225,175,357,467,449,285,377,331.0,370.0,92,-164,256
198,8,4,2,8,0,233,187,181,144,181,92,70,148,181,165,127,190,158.0,161.0,63,-38,101
4949,9,4,2,8,0,4618,5211,4012,4216,4195,2391,1639,3992,3988,3668,3906,4522,4214.0,4032.0,616,238,378
540,10,4,2,8,0,409,444,331,432,386,248,166,443,418,434,344,461,402.0,413.0,117,-90,207
1268,11,4,2,8,0,1148,1130,943,1033,1154,680,651,982,1039,1051,947,1072,1010.0,1023.0,125,-104,229
451,12,4,2,8,0,288,380,260,302,351,208,96,254,328,298,271,331,301.0,300.0,60,-27,87
623,13,4,2,8,0,550,584,385,397,419,248,284,584,570,485,345,559,452.0,463.0,214,-140,354
816,14,4,2,8,0,658,673,556,567,651,338,242,578,638,439,516,644,580.0,533.0,128,77,51
1730,15,4,2,8,0,1244,1296,1228,1343,1310,747,739,1438,1404,1200,1131,1522,1326.0,1284.0,391,-69,460
665,16,4,2,8,0,655,744,726,677,787,450,226,461,459,468,446,524,485.0,479.0,78,-22,100
787,17,4,2,8,0,610,619,436,474,674,394,223,436,554,554,548,663,606.0,588.0,115,-6,121
966,18,4,2,8,0,535,615,563,615,519,231,173,535,612,676,709,737,723.0,707.0,28,33,-5
792,19,4,2,8,0,1031,840,522,652,848,213,233,610,646,562,459,596,528.0,539.0,137,-103,240
173,20,4,2,8,0,316,208,150,157,208,123,85,166,157,116,162,140,151.0,139.0,-22,46,-68
358,21,4,2,8,0,274,262,219,225,317,148,105,202,242,221,226,279,252.0,242.0,53,5,48
349,22,4,2,8,0,335,334,222,288,303,90,85,233,244,241,205,236,220.0,227.0,31,-36,67
208,1,5,3,8,0,256,234,168,249,477,199,177,267,169,193,170,168,169.0,177.0,-2,-23,21
1981,2,5,3,8,0,2565,3307,3096,3216,4503,4785,3067,2754,2281,2227,1995,2206,2100.0,2143.0,211,-232,443
433,3,5,3,8,0,368,502,360,520,675,504,451,680,487,440,356,384,370.0,393.0,28,-84,112
80,4,5,3,8,0,202,242,199,305,514,151,92,197,124,132,112,101,106.0,115.0,-11,-20,9
1119,5,5,3,8,0,1230,1449,1007,1411,1954,1724,1537,1481,1090,1021,990,1018,1004.0,1010.0,28,-31,59
1126,6,5,3,8,0,1418,1458,1238,1535,2328,2152,1881,1518,1284,1266,1165,1072,1118.0,1168.0,-93,-101,8
2917,7,5,3,8,0,3600,3519,3268,3907,6576,4483,3060,2839,2545,2879,2279,2583,2431.0,2580.0,304,-600,904
1235,8,5,3,8,0,1452,1749,1354,1585,2844,2093,1361,1353,1118,1259,955,1154,1054.0,1123.0,199,-304,503
1573,9,5,3,8,0,1550,1999,1555,2007,3029,1611,1579,2180,1684,1684,1682,1409,1546.0,1592.0,-273,-2,-271
1943,10,5,3,8,0,2291,2515,2293,2687,4443,3084,1836,2310,1540,1616,1343,1308,1326.0,1422.0,-35,-273,238
1501,11,5,3,8,0,1799,1764,1493,1942,3067,2165,2419,2029,1601,1578,1375,1523,1449.0,1492.0,148,-203,351
656,12,5,3,8,0,890,1111,824,980,1510,1290,922,875,668,648,536,537,536.0,574.0,1,-112,113
2808,13,5,3,8,0,3368,3303,2808,3641,6231,3870,3403,2945,3015,3119,2522,2789,2656.0,2810.0,267,-597,864
2563,14,5,3,8,0,3591,3584,3821,4668,7650,5825,3564,3197,2704,2715,2598,2658,2628.0,2657.0,60,-117,177
1188,15,5,3,8,0,1016,1295,1112,1294,2062,1260,1629,1592,1156,1224,1121,1218,1170.0,1188.0,97,-103,200
949,16,5,3,8,0,992,1202,958,1353,2198,1919,1140,1262,895,1069,835,836,836.0,913.0,1,-234,235
1035,17,5,3,8,0,1678,1773,1354,1770,2693,2364,1506,1541,1174,1020,997,939,968.0,985.0,-58,-23,-35
402,18,5,3,8,0,565,573,523,688,892,592,650,741,463,546,473,389,431.0,469.0,-84,-73,-11
964,19,5,3,8,0,1010,1135,824,1154,1710,924,939,1322,959,988,854,912,883.0,918.0,58,-134,192
218,20,5,3,8,0,204,284,201,250,357,250,248,235,212,191,173,197,185.0,187.0,24,-18,42
1117,21,5,3,8,0,1245,1658,1590,1877,3217,2072,1105,1314,1222,1105,910,1051,980.0,1022.0,141,-195,336
544,22,5,3,8,0,835,795,518,816,982,506,518,806,657,585,602,530,566.0,572.0,-72,17,-89
347,1,6,1,8,0,445,555,272,582,623,382,114,351,229,285,289,234,262.0,269.0,-55,4,-59
639,2,6,1,8,0,409,543,553,546,680,484,300,452,403,419,390,633,512.0,481.0,243,-29,272
623,3,6,1,8,0,645,831,715,836,832,551,317,489,505,604,525,595,560.0,575.0,70,-79,149
133,4,6,1,8,0,369,502,362,440,598,212,102,180,142,124,93,130,112.0,116.0,37,-31,68
1346,5,6,1,8,0,1165,1460,1050,1385,1850,1223,671,850,790,838,870,1020,945.0,909.0,150,32,118
1280,6,6,1,8,0,1409,1565,1256,1491,1666,1515,717,1018,980,1077,1165,1206,1186.0,1149.0,41,88,-47
2226,7,6,1,8,0,2139,2580,2061,2146,2737,1706,842,1734,1902,2031,1983,2192,2088.0,2069.0,209,-48,257
717,8,6,1,8,0,655,690,724,762,993,533,312,595,582,569,606,683,644.0,619.0,77,37,40
5914,9,6,1,8,0,6544,8215,6582,6734,6492,5607,2647,5713,4896,5717,5445,4899,5172.0,5354.0,-546,-272,-274
719,10,6,1,8,0,680,913,743,853,894,799,409,719,453,603,532,611,572.0,582.0,79,-71,150
1857,11,6,1,8,0,2252,2410,2283,2584,2672,1728,1016,1729,1498,1701,1735,1850,1792.0,1762.0,115,34,81
1041,12,6,1,8,0,964,1340,1065,1086,1291,1027,356,690,687,838,753,813,783.0,801.0,60,-85,145
2989,13,6,1,8,0,2864,3253,2277,2327,2703,2119,1271,2126,2486,2863,2426,2914,2670.0,2734.0,488,-437,925
3319,14,6,1,8,0,3318,3446,2827,2797,3447,2952,1308,2514,2566,2841,2880,3363,3122.0,3028.0,483,39,444
1379,15,6,1,8,0,1151,1369,1262,1632,1972,795,459,876,905,1141,1077,1165,1121.0,1128.0,88,-64,152
1344,16,6,1,8,0,1412,1938,1686,1663,2151,1566,597,1095,1029,1047,1133,1293,1213.0,1158.0,160,86,74
1802,17,6,1,8,0,1918,2573,2247,1966,2770,1651,844,1487,1573,1636,1382,1564,1473.0,1527.0,182,-254,436
436,18,6,1,8,0,348,390,371,447,476,264,148,314,267,427,418,348,383.0,398.0,-70,-9,-61
462,19,6,1,8,0,369,397,317,403,513,241,211,360,293,362,342,372,357.0,359.0,30,-20,50
633,20,6,1,8,0,810,888,646,803,1149,803,328,472,453,543,623,549,586.0,572.0,-74,80,-154
577,21,6,1,8,0,566,687,665,655,845,620,247,468,497,551,436,566,501.0,518.0,130,-115,245
594,22,6,1,8,0,652,669,544,740,1032,399,306,506,449,585,503,512,508.0,533.0,9,-82,91
1194,1,7,3,8,0,1068,958,710,977,1212,1265,890,1247,1119,1184,1456,1316,1386.0,1319.0,-140,272,-412
187,2,7,3,8,0,62,79,45,66,119,104,63,214,133,132,248,173,210.0,184.0,-75,116,-191
193,3,7,3,8,0,51,54,43,56,75,86,64,154,131,164,163,146,154.0,158.0,-17,-1,-16
1416,4,7,3,8,0,976,1027,677,793,1627,1352,1114,1508,1132,1430,1670,1367,1518.0,1489.0,-303,240,-543
420,5,7,3,8,0,234,199,102,145,321,208,187,254,335,308,285,276,280.0,290.0,-9,-23,14
384,6,7,3,8,0,167,182,145,176,251,253,175,322,340,315,352,311,332.0,326.0,-41,37,-78
1284,7,7,3,8,0,698,710,494,739,1047,878,649,1303,1248,1216,1405,1283,1344.0,1301.0,-122,189,-311
292,8,7,3,8,0,101,121,83,105,184,165,123,244,320,272,242,233,238.0,249.0,-9,-30,21
984,9,7,3,8,0,453,514,463,571,819,762,448,944,1100,1025,1038,994,1016.0,1019.0,-44,13,-57
99,10,7,3,8,0,65,36,87,45,96,92,54,103,134,119,86,123,104.0,109.0,37,-33,70
1253,11,7,3,8,0,653,923,563,731,1002,974,650,1188,1289,1048,1276,1137,1206.0,1154.0,-139,228,-367
154,12,7,3,8,0,56,89,43,74,97,118,85,164,140,153,162,165,164.0,160.0,3,9,-6
773,13,7,3,8,0,302,284,232,288,493,470,361,599,660,769,569,656,612.0,665.0,87,-200,287
849,14,7,3,8,0,356,387,282,366,596,517,345,763,731,685,764,754,759.0,734.0,-10,79,-89
999,15,7,3,8,0,578,350,278,533,736,534,424,754,915,865,808,908,858.0,860.0,100,-57,157
286,16,7,3,8,0,119,115,66,94,173,151,103,240,253,187,234,272,253.0,231.0,38,47,-9
239,17,7,3,8,0,91,68,60,83,119,101,59,203,163,182,206,192,199.0,193.0,-14,24,-38
249,18,7,3,8,0,123,99,106,97,170,123,106,206,303,187,204,204,204.0,198.0,0,17,-17
435,19,7,3,8,0,178,184,111,151,300,181,154,357,324,363,378,413,396.0,385.0,35,15,20
150,20,7,3,8,0,66,120,43,58,100,60,71,130,181,128,151,124,138.0,134.0,-27,23,-50
390,21,7,3,8,0,228,164,136,164,313,234,179,320,305,340,358,313,336.0,337.0,-45,18,-63
227,22,7,3,8,0,113,130,76,95,177,129,74,323,185,255,260,224,242.0,246.0,-36,5,-41
272,1,8,2,8,0,504,605,431,543,697,325,168,288,309,527,516,379,448.0,474.0,-137,-11,-126
116,2,8,2,8,0,60,80,64,106,112,40,25,38,54,68,55,75,65.0,66.0,20,-13,33
78,3,8,2,8,0,65,50,48,60,75,31,18,29,46,51,51,61,56.0,54.0,10,0,10
111,4,8,2,8,0,105,107,59,86,132,40,51,59,50,54,60,151,106.0,88.0,91,6,85
437,5,8,2,8,0,194,379,187,278,408,216,117,192,175,229,259,209,234.0,232.0,-50,30,-80
401,6,8,2,8,0,383,452,363,447,587,357,148,207,278,368,463,445,454.0,425.0,-18,95,-113
517,7,8,2,8,0,434,524,437,477,555,320,180,373,400,374,355,402,378.0,377.0,47,-19,66
103,8,8,2,8,0,40,61,59,55,64,30,23,28,38,44,60,71,66.0,58.0,11,16,-5
453,9,8,2,8,0,191,284,225,342,408,121,39,166,158,211,185,222,204.0,206.0,37,-26,63
125,10,8,2,8,0,72,86,66,86,129,68,34,47,50,71,60,56,58.0,62.0,-4,-11,7
690,11,8,2,8,0,1240,1311,1156,1271,1767,893,628,788,879,1067,1002,995,998.0,1021.0,-7,-65,58
263,12,8,2,8,0,201,205,175,224,302,169,92,161,188,202,170,233,202.0,202.0,63,-32,95
289,13,8,2,8,0,129,149,129,127,215,80,56,93,108,163,149,199,174.0,170.0,50,-14,64
298,14,8,2,8,0,264,300,257,320,368,183,97,185,329,340,259,262,260.0,287.0,3,-81,84
532,15,8,2,8,0,791,867,742,941,1163,445,309,478,511,775,845,706,776.0,775.0,-139,70,-209
256,16,8,2,8,0,189,253,233,287,401,211,94,172,184,195,243,185,214.0,208.0,-58,48,-106
231,17,8,2,8,0,202,213,182,259,315,201,83,173,167,198,189,202,196.0,196.0,13,-9,22
168,18,8,2,8,0,77,86,70,117,145,54,20,51,78,114,140,134,137.0,129.0,-6,26,-32
119,19,8,2,8,0,56,78,81,68,104,28,21,52,82,45,37,92,64.0,58.0,55,-8,63
101,20,8,2,8,0,63,77,40,57,62,28,20,37,37,33,64,92,78.0,63.0,28,31,-3
142,21,8,2,8,0,126,137,141,113,177,107,51,78,83,124,102,102,102.0,109.0,0,-22,22
60,22,8,2,8,0,29,39,29,28,30,11,11,8,18,20,17,27,22.0,21.0,10,-3,13
914,1,9,1,8,0,878,839,851,1537,1734,940,540,957,807,919,933,755,844.0,869.0,-178,14,-192
329,2,9,1,8,0,406,375,464,639,732,400,288,346,301,327,290,401,346.0,339.0,111,-37,148
293,3,9,1,8,0,346,426,433,493,573,322,195,323,333,363,302,240,271.0,302.0,-62,-61,-1
449,4,9,1,8,0,572,648,532,915,1057,659,394,601,489,595,532,503,518.0,543.0,-29,-63,34
898,5,9,1,8,0,821,1394,1020,1293,1876,1072,611,873,761,808,800,793,796.0,800.0,-7,-8,1
875,6,9,1,8,0,782,938,1018,1287,1597,1015,457,773,664,769,751,688,720.0,736.0,-63,-18,-45
1078,7,9,1,8,0,1232,1497,1547,1722,2394,1077,522,1253,1236,1215,1019,955,987.0,1063.0,-64,-196,132
378,8,9,1,8,0,365,407,489,581,742,375,248,450,310,404,335,340,338.0,360.0,5,-69,74
972,9,9,1,8,0,986,1197,1508,2163,2594,949,463,1024,892,976,1062,838,950.0,959.0,-224,86,-310
262,10,9,1,8,0,261,338,373,502,713,341,210,322,222,345,302,257,280.0,301.0,-45,-43,-2
1305,11,9,1,8,0,1497,1413,1635,2059,2647,1466,939,1519,1181,1355,1281,1072,1176.0,1236.0,-209,-74,-135
886,12,9,1,8,0,687,798,900,1083,1527,753,397,757,746,837,677,745,711.0,753.0,68,-160,228
691,13,9,1,8,0,745,771,828,1012,1235,691,404,655,694,773,655,680,668.0,703.0,25,-118,143
1080,14,9,1,8,0,998,1228,1191,1470,2122,1000,589,1119,1013,903,937,951,944.0,930.0,14,34,-20
986,15,9,1,8,0,942,1042,1090,1626,2068,1003,537,978,796,1015,879,797,838.0,897.0,-82,-136,54
965,16,9,1,8,0,977,1135,1284,1519,1632,1025,485,1058,873,1015,949,835,892.0,933.0,-114,-66,-48
959,17,9,1,8,0,1034,1175,1168,1619,2178,1217,467,1068,962,1084,875,893,884.0,951.0,18,-209,227
398,18,9,1,8,0,426,426,568,767,913,522,257,433,373,497,408,356,382.0,420.0,-52,-89,37
428,19,9,1,8,0,365,365,407,443,594,254,172,277,329,290,263,262,262.0,272.0,-1,-27,26
286,20,9,1,8,0,329,386,354,500,762,420,252,342,321,324,387,329,358.0,347.0,-58,63,-121
312,21,9,1,8,0,283,360,444,478,651,365,184,306,238,357,732,447,590.0,512.0,-285,375,-660
232,22,9,1,8,0,233,201,203,289,372,142,121,207,187,231,186,143,164.0,187.0,-43,-45,2
1207,1,10,2,8,0,1715,1560,1261,1546,1428,635,513,975,1070,1137,2596,1172,1884.0,1635.0,-1424,1459,-2883
649,2,10,2,8,0,462,412,350,412,626,249,167,333,316,408,510,602,556.0,507.0,92,102,-10
575,3,10,2,8,0,335,434,451,516,701,285,178,320,330,439,413,440,426.0,431.0,27,-26,53
124,4,10,2,8,0,248,278,174,264,913,106,74,113,101,453,335,314,324.0,367.0,-21,-118,97
2318,5,10,2,8,0,1833,2351,1555,1783,2691,1134,763,1522,1501,1649,1954,1996,1975.0,1866.0,42,305,-263
2828,6,10,2,8,0,2572,2578,2110,2138,2356,1607,968,1908,2068,2171,2517,2384,2450.0,2357.0,-133,346,-479
5234,7,10,2,8,0,3623,4079,3911,3787,4830,2048,1323,3138,3779,4223,3954,4263,4108.0,4147.0,309,-269,578
1391,8,10,2,8,0,770,774,678,852,1073,317,283,629,610,883,1085,1017,1051.0,995.0,-68,202,-270
2643,9,10,2,8,0,2230,2219,1912,2435,2500,695,488,1495,1512,1848,2203,1964,2084.0,2005.0,-239,355,-594
1065,10,10,2,8,0,597,723,646,783,869,475,293,738,554,830,966,1021,994.0,939.0,55,136,-81
5866,11,10,2,8,0,5439,5089,5170,5016,5865,2657,2401,4119,4083,4704,4995,4877,4936.0,4859.0,-118,291,-409
1988,12,10,2,8,0,1228,1446,1175,1376,1737,923,549,1502,1828,1895,1662,1811,1736.0,1789.0,149,-233,382
3219,13,10,2,8,0,2030,2166,1672,1926,2621,900,720,1379,2198,2809,2761,2856,2808.0,2809.0,95,-48,143
4333,14,10,2,8,0,3033,2794,2644,2874,3243,1683,1042,2558,3199,3067,3400,3871,3636.0,3446.0,471,333,138
3712,15,10,2,8,0,3079,3258,3003,3295,3490,1289,1038,1965,1876,2506,2778,3135,2956.0,2806.0,357,272,85
1835,16,10,2,8,0,1694,1779,1500,1547,1624,929,480,1234,1278,1437,1882,1699,1790.0,1673.0,-183,445,-628
2057,17,10,2,8,0,1556,1793,1457,1585,1952,989,516,1513,1616,1696,1720,1686,1703.0,1701.0,-34,24,-58
1327,18,10,2,8,0,913,859,836,1130,958,546,402,859,878,1319,1184,1258,1221.0,1254.0,74,-135,209
964,19,10,2,8,0,710,667,540,619,821,205,149,446,498,474,571,727,649.0,591.0,156,97,59
590,20,10,2,8,0,463,501,422,419,597,296,163,296,401,429,660,507,584.0,532.0,-153,231,-384
1205,21,10,2,8,0,830,880,891,912,1151,413,242,475,689,883,1688,1091,1390.0,1221.0,-597,805,-1402
412,22,10,2,8,0,332,298,250,347,415,118,130,301,193,254,310,279,294.0,281.0,-31,56,-87
103,1,11,2,8,0,170,225,144,225,270,79,27,45,95,103,101,83,92.0,96.0,-18,-2,-16
282,2,11,2,8,0,193,215,192,267,384,296,172,285,192,231,213,247,230.0,230.0,34,-18,52
202,3,11,2,8,0,211,257,237,359,450,248,124,211,203,178,177,181,179.0,179.0,4,-1,5
836,4,11,2,8,0,596,755,684,938,1287,118,74,556,952,1106,818,968,893.0,964.0,150,-288,438
905,5,11,2,8,0,1135,1134,707,1002,2805,1326,797,891,676,702,734,761,748.0,732.0,27,32,-5
660,6,11,2,8,0,807,752,716,977,1443,903,436,535,520,582,612,532,572.0,575.0,-80,30,-110
1747,7,11,2,8,0,2013,2253,1752,2198,3785,1878,1009,1343,1575,1488,1335,1337,1336.0,1387.0,2,-153,155
540,8,11,2,8,0,591,635,370,1993,2925,603,248,417,464,574,426,448,437.0,483.0,22,-148,170
1245,9,11,2,8,0,1851,1526,1065,2044,2419,914,399,1078,1095,1082,1215,1038,1126.0,1112.0,-177,133,-310
495,10,11,2,8,0,565,452,368,493,935,666,303,492,403,512,470,474,472.0,485.0,4,-42,46
908,11,11,2,8,0,1263,1231,1184,1531,2308,910,648,752,1041,985,944,821,882.0,917.0,-123,-41,-82
643,12,11,2,8,0,657,831,701,917,1377,999,364,509,561,555,561,469,515.0,528.0,-92,6,-98
1050,13,11,2,8,0,991,941,754,1144,2067,1110,641,741,953,1002,876,936,906.0,938.0,60,-126,186
1740,14,11,2,8,0,1922,1491,1090,1965,3560,2272,888,1199,1423,1368,1487,1652,1570.0,1502.0,165,119,46
2222,15,11,2,8,0,2534,1978,2287,3147,4324,1028,639,1114,1097,2340,1882,1700,1791.0,1974.0,-182,-458,276
525,16,11,2,8,0,636,528,521,941,1534,1004,347,476,456,410,475,460,468.0,448.0,-15,65,-80
750,17,11,2,8,0,1148,1102,762,1142,1719,1133,438,685,688,650,716,659,688.0,675.0,-57,66,-123
609,18,11,2,8,0,861,605,468,762,1967,434,268,656,565,712,722,602,662.0,679.0,-120,10,-130
157,19,11,2,8,0,373,319,239,291,520,199,149,205,202,188,167,160,164.0,172.0,-7,-21,14
366,20,11,2,8,0,500,317,253,326,532,432,291,409,310,302,286,280,283.0,289.0,-6,-16,10
818,21,11,2,8,0,1191,1013,830,1010,1651,919,422,609,612,587,580,1155,868.0,774.0,575,-7,582
136,22,11,2,8,0,179,154,114,204,257,135,104,114,128,104,132,112,122.0,116.0,-20,28,-48
48,1,12,2,8,0,82,78,75,125,158,63,40,60,51,45,46,45,46.0,45.0,-1,1,-2
341,2,12,2,8,0,297,409,425,375,535,421,246,288,240,252,266,378,322.0,299.0,112,14,98
180,3,12,2,8,0,186,321,287,448,676,363,164,250,212,180,206,169,188.0,185.0,-37,26,-63
68,4,12,2,8,0,229,328,289,360,496,86,74,109,80,71,61,54,58.0,62.0,-7,-10,3
720,5,12,2,8,0,740,894,870,831,1260,724,451,621,526,535,628,654,641.0,606.0,26,93,-67
391,6,12,2,8,0,423,570,478,510,806,576,272,358,315,316,346,322,334.0,328.0,-24,30,-54
1153,7,12,2,8,0,1385,1544,1660,1778,2915,1529,762,977,1071,1025,958,930,944.0,971.0,-28,-67,39
702,8,12,2,8,0,526,657,689,668,1092,615,366,578,543,590,543,530,536.0,554.0,-13,-47,34
867,9,12,2,8,0,1003,987,1170,1384,1437,718,363,821,836,734,867,743,805.0,781.0,-124,133,-257
373,10,12,2,8,0,275,336,321,463,659,452,233,370,288,292,316,346,331.0,318.0,30,24,6
481,11,12,2,8,0,503,619,691,743,1008,543,405,518,460,406,448,428,438.0,427.0,-20,42,-62
348,12,12,2,8,0,384,576,518,577,816,634,247,323,301,331,301,285,293.0,306.0,-16,-30,14
1221,13,12,2,8,0,1190,1442,1308,1432,2365,1304,951,1023,1070,1210,930,1140,1035.0,1093.0,210,-280,490
1131,14,12,2,8,0,1180,1362,1148,1406,2228,1526,717,888,888,823,850,1053,952.0,909.0,203,27,176
573,15,12,2,8,0,656,656,660,874,1121,438,306,511,460,520,507,491,499.0,506.0,-16,-13,-3
342,16,12,2,8,0,445,594,534,655,903,635,255,364,342,325,362,407,384.0,365.0,45,37,8
513,17,12,2,8,0,665,852,609,763,1216,773,321,479,531,540,517,429,473.0,495.0,-88,-23,-65
300,18,12,2,8,0,279,280,218,239,420,249,153,274,195,252,248,212,230.0,237.0,-36,-4,-32
291,19,12,2,8,0,361,450,328,514,641,287,222,321,326,279,247,251,249.0,259.0,4,-32,36
260,20,12,2,8,0,289,325,272,292,402,296,142,238,207,233,232,240,236.0,235.0,8,-1,9
664,21,12,2,8,0,667,705,729,755,1158,815,410,484,484,492,471,470,470.0,478.0,-1,-21,20
211,22,12,2,8,0,179,249,176,328,336,166,145,205,161,183,216,199,208.0,199.0,-17,33,-50
83,1,13,1,8,0,149,181,158,314,461,180,102,190,125,145,92,77,84.0,105.0,-15,-53,38
573,2,13,1,8,0,336,447,627,757,1396,1059,575,778,650,682,486,654,570.0,607.0,168,-196,364
415,3,13,1,8,0,216,287,324,527,720,520,270,473,409,472,356,344,350.0,391.0,-12,-116,104
43,4,13,1,8,0,177,237,199,242,487,101,86,162,127,117,78,41,60.0,79.0,-37,-39,2
1055,5,13,1,8,0,845,1263,1243,1605,2433,1860,1194,1302,1156,1192,925,872,898.0,996.0,-53,-267,214
739,6,13,1,8,0,840,1069,1269,1370,2298,1440,720,878,861,934,738,651,694.0,774.0,-87,-196,109
1563,7,13,1,8,0,999,1485,1686,2126,3804,2217,1109,1504,1812,1956,1321,1432,1376.0,1570.0,111,-635,746
597,8,13,1,8,0,379,496,642,748,1215,772,404,591,661,732,531,562,546.0,608.0,31,-201,232
649,9,13,1,8,0,650,835,848,1467,2021,1040,446,977,1064,948,854,663,758.0,822.0,-191,-94,-97
303,10,13,1,8,0,284,342,388,511,880,738,330,660,454,586,385,399,392.0,457.0,14,-201,215
863,11,13,1,8,0,1001,1116,1451,1816,2525,1540,1130,1441,1246,1265,930,913,922.0,1036.0,-17,-335,318
477,12,13,1,8,0,440,725,733,889,1320,1015,377,598,631,632,491,445,468.0,523.0,-46,-141,95
1628,13,13,1,8,0,1014,1437,1548,2026,3281,1882,1126,1456,2041,2368,1518,1714,1616.0,1867.0,196,-850,1046
1395,14,13,1,8,0,953,1313,1473,1843,2975,2324,1002,1413,1518,1509,1135,1362,1248.0,1335.0,227,-374,601
804,15,13,1,8,0,805,1089,1175,1502,2235,958,565,880,893,948,697,814,756.0,820.0,117,-251,368
627,16,13,1,8,0,669,868,924,1339,1557,1148,463,782,723,758,663,696,680.0,706.0,33,-95,128
508,17,13,1,8,0,438,633,772,835,1281,1235,439,733,664,655,498,506,502.0,553.0,8,-157,165
306,18,13,1,8,0,282,307,414,622,877,518,365,529,461,541,380,328,354.0,416.0,-52,-161,109
286,19,13,1,8,0,231,291,296,396,542,311,224,349,397,405,266,303,284.0,325.0,37,-139,176
258,20,13,1,8,0,259,311,316,419,666,489,274,346,334,368,358,284,321.0,337.0,-74,-10,-64
551,21,13,1,8,0,362,519,627,715,1549,1036,394,463,535,597,405,487,446.0,496.0,82,-192,274
672,22,13,1,8,0,422,442,411,616,998,401,372,684,679,736,526,592,559.0,618.0,66,-210,276
376,1,14,1,8,0,522,661,472,781,1047,423,192,279,354,355,429,362,396.0,382.0,-67,74,-141
1036,2,14,1,8,0,877,1084,1148,1159,1879,1354,680,631,992,1295,955,1148,1052.0,1133.0,193,-340,533
839,3,14,1,8,0,578,725,701,941,1442,814,347,566,786,1042,724,802,763.0,856.0,78,-318,396
291,4,14,1,8,0,496,664,474,569,1295,274,176,281,280,376,386,433,410.0,398.0,47,10,37
1860,5,14,1,8,0,1488,2289,1556,2162,4188,2540,1081,1111,1488,1668,1412,1619,1516.0,1566.0,207,-256,463
1555,6,14,1,8,0,1803,1996,1889,2073,3650,2495,863,893,1218,1582,1360,1404,1382.0,1449.0,44,-222,266
2942,7,14,1,8,0,2886,3461,3252,3594,6275,3467,1356,2002,3249,3444,2666,3057,2862.0,3056.0,391,-778,1169
855,8,14,1,8,0,652,805,800,914,1576,743,357,500,790,998,720,798,759.0,839.0,78,-278,356
2128,9,14,1,8,0,2246,2808,2902,3269,4342,1784,653,1364,1722,2162,2247,2038,2142.0,2149.0,-209,85,-294
609,10,14,1,8,0,574,670,621,739,1316,892,381,556,538,802,574,699,636.0,692.0,125,-228,353
2570,11,14,1,8,0,3230,3453,3560,3776,5864,3032,1760,2316,2607,3244,2604,2564,2584.0,2804.0,-40,-640,600
887,12,14,1,8,0,860,1325,1195,1285,2160,1579,453,603,962,960,811,902,856.0,891.0,91,-149,240
2481,13,14,1,8,0,2258,2481,2298,2594,4551,2375,1231,1427,2467,3049,2213,2567,2390.0,2610.0,354,-836,1190
3143,14,14,1,8,0,3396,3571,3427,4047,8018,5309,1586,1915,2716,3025,2701,2930,2816.0,2885.0,229,-324,553
2234,15,14,1,8,0,2229,2579,2724,3014,4336,1679,826,1161,1890,2275,1899,2230,2064.0,2135.0,331,-376,707
1217,16,14,1,8,0,1341,1747,1512,1848,3179,2049,551,906,1028,1278,1264,1359,1312.0,1300.0,95,-14,109
1482,17,14,1,8,0,1679,2187,1872,2355,3747,2461,732,1157,1395,1621,1288,1479,1384.0,1463.0,191,-333,524
708,18,14,1,8,0,618,738,859,1140,1306,596,364,463,616,759,757,740,748.0,752.0,-17,-2,-15
1102,19,14,1,8,0,1132,1218,970,1188,1784,769,415,765,1227,1203,969,1200,1084.0,1124.0,231,-234,465
620,20,14,1,8,0,655,770,622,761,1417,877,373,399,529,594,627,619,623.0,613.0,-8,33,-41
773,21,14,1,8,0,654,727,899,841,1546,1008,303,361,648,917,661,790,726.0,789.0,129,-256,385
865,22,14,1,8,0,777,675,517,944,1290,579,365,604,725,778,831,876,854.0,828.0,45,53,-8
968,1,15,2,8,0,720,820,623,807,1293,851,433,764,667,727,689,522,606.0,646.0,-167,-38,-129
436,2,15,2,8,0,405,456,394,535,639,509,300,415,361,462,414,443,428.0,440.0,29,-48,77
576,3,15,2,8,0,480,482,477,451,580,494,276,556,527,562,528,446,487.0,512.0,-82,-34,-48
1075,4,15,2,8,0,1143,1276,969,1288,2146,1327,923,1308,982,1002,1096,834,965.0,977.0,-262,94,-356
861,5,15,2,8,0,715,1123,634,781,1105,856,454,680,597,621,651,776,714.0,683.0,125,30,95
895,6,15,2,8,0,667,840,774,803,1070,953,364,644,584,685,706,708,707.0,700.0,2,21,-19
1334,7,15,2,8,0,1162,1315,1224,1513,1837,1329,778,1244,1284,1298,1141,1319,1230.0,1253.0,178,-157,335
991,8,15,2,8,0,750,729,770,798,1203,945,474,746,713,727,660,639,650.0,675.0,-21,-67,46
618,9,15,2,8,0,351,438,425,536,825,423,180,427,549,477,696,389,542.0,521.0,-307,219,-526
141,10,15,2,8,0,121,141,135,160,243,179,71,140,141,183,151,137,144.0,157.0,-14,-32,18
1676,11,15,2,8,0,1793,1838,1848,1951,2643,1820,1058,1565,1288,1340,1313,1263,1288.0,1305.0,-50,-27,-23
351,12,15,2,8,0,334,419,377,424,571,408,151,325,301,312,293,255,274.0,287.0,-38,-19,-19
1590,13,15,2,8,0,1321,1377,1264,1433,1923,1604,884,1377,1523,1631,1539,1425,1482.0,1532.0,-114,-92,-22
1238,14,15,2,8,0,1010,1081,952,1113,1482,1178,548,1003,1062,1044,1052,1125,1088.0,1074.0,73,8,65
814,15,15,2,8,0,601,733,722,894,1112,767,352,679,681,651,616,628,622.0,632.0,12,-35,47
388,16,15,2,8,0,295,373,329,377,483,446,164,271,261,296,275,330,302.0,300.0,55,-21,76
447,17,15,2,8,0,383,464,438,477,783,487,262,452,359,428,383,395,389.0,402.0,12,-45,57
259,18,15,2,8,0,189,235,212,345,456,397,140,227,217,291,297,182,240.0,257.0,-115,6,-121
255,19,15,2,8,0,296,261,247,251,310,270,165,356,218,179,255,221,238.0,218.0,-34,76,-110
447,20,15,2,8,0,414,486,426,491,644,555,263,408,381,378,462,374,418.0,405.0,-88,84,-172
624,21,15,2,8,0,413,568,617,622,758,719,361,603,579,645,499,553,526.0,566.0,54,-146,200
121,22,15,2,8,0,187,159,142,152,169,104,79,149,106,141,121,123,122.0,128.0,2,-20,22
42,1,16,2,8,0,46,41,395,67,117,63,37,86,109,100,151,123,137.0,125.0,-28,51,-79
1207,2,16,2,8,0,1426,1254,988,1142,1590,946,692,1035,755,884,765,1277,1021.0,975.0,512,-119,631
1139,3,16,2,8,0,864,895,802,945,982,602,413,714,724,743,629,652,640.0,675.0,23,-114,137
289,4,16,2,8,0,794,737,477,625,985,300,271,404,282,274,292,278,285.0,281.0,-14,18,-32
2754,5,16,2,8,0,2791,2955,1733,2221,3340,1470,1639,3175,2405,2457,2398,2530,2464.0,2462.0,132,-59,191
371,6,16,2,8,0,552,488,424,410,575,248,260,384,279,286,452,366,409.0,368.0,-86,166,-252
3096,7,16,2,8,0,3130,3837,3617,3662,4024,1903,1708,2748,2376,2932,2420,2797,2608.0,2716.0,377,-512,889
1189,8,16,2,8,0,1217,1561,1243,1188,1616,679,442,672,792,892,815,1028,922.0,912.0,213,-77,290
1885,9,16,2,8,0,1963,2010,1906,2111,2398,1196,1075,2249,1558,2005,1936,1682,1809.0,1874.0,-254,-69,-185
573,10,16,2,8,0,319,409,384,459,435,440,301,449,664,501,523,446,484.0,490.0,-77,22,-99
694,11,16,2,8,0,745,840,781,777,930,527,626,655,605,586,670,623,646.0,626.0,-47,84,-131
355,12,16,2,8,0,358,538,488,482,540,354,189,356,270,359,296,244,270.0,300.0,-52,-63,11
3648,13,16,2,8,0,3388,3910,3483,3233,4206,2068,1780,2633,2656,3148,2856,3242,3049.0,3082.0,386,-292,678
1836,14,16,2,8,0,2100,2323,1931,2018,2962,1570,1050,1823,1515,1509,1506,1785,1646.0,1600.0,279,-3,282
542,15,16,2,8,0,777,723,606,634,886,424,422,628,555,606,538,517,528.0,554.0,-21,-68,47
440,16,16,2,8,0,715,725,585,544,920,483,270,442,304,376,403,430,416.0,403.0,27,27,0
1284,17,16,2,8,0,1533,1680,1444,1489,2336,1714,653,1232,835,1023,1076,1149,1112.0,1083.0,73,53,20
413,18,16,2,8,0,773,710,690,597,622,308,292,460,424,486,428,470,449.0,461.0,42,-58,100
1601,19,16,2,8,0,1815,1871,1308,1478,1878,681,691,1319,1119,1215,1237,1419,1328.0,1290.0,182,22,160
199,20,16,2,8,0,502,347,184,172,247,131,105,125,160,126,176,161,168.0,154.0,-15,50,-65
780,21,16,2,8,0,1106,695,580,634,1051,558,384,605,487,577,560,603,582.0,580.0,43,-17,60
2283,22,16,2,8,0,1427,1562,1308,1636,1781,730,952,1556,1254,1336,1463,1649,1556.0,1483.0,186,127,59
1782,1,17,2,8,0,1500,2397,1674,2362,3060,1909,501,2672,4039,883,4181,1421,2801.0,2162.0,-2760,3298,-6058
1307,2,17,2,8,0,974,1076,1038,1033,1402,656,504,651,603,785,827,1300,1064.0,971.0,473,42,431
777,3,17,2,8,0,446,541,468,630,827,268,214,376,413,543,491,575,533.0,536.0,84,-52,136
297,4,17,2,8,0,1118,835,516,1494,2145,217,200,2331,1550,280,361,498,430.0,380.0,137,81,56
2351,5,17,2,8,0,1864,2707,1708,2119,2450,1355,937,1478,2078,1399,1459,1801,1630.0,1553.0,342,60,282
2510,6,17,2,8,0,2809,2863,2529,2927,3132,1460,775,1436,1362,1591,1598,1947,1772.0,1712.0,349,7,342
3929,7,17,2,8,0,4018,4409,4129,4087,5401,1885,1225,2010,2269,2615,2569,3263,2916.0,2816.0,694,-46,740
2019,8,17,2,8,0,1490,1510,1452,1547,2066,692,491,877,974,1192,1135,1670,1402.0,1332.0,535,-57,592
1754,9,17,2,8,0,2112,2192,2036,2188,2519,625,462,1475,1506,1216,1544,1515,1530.0,1425.0,-29,328,-357
551,10,17,2,8,0,503,589,568,596,616,308,176,366,289,407,451,518,484.0,459.0,67,44,23
4173,11,17,2,8,0,4854,5016,4475,5007,5643,2143,1862,2644,2631,3008,3307,4299,3803.0,3538.0,992,299,693
1810,12,17,2,8,0,1681,2044,1627,1981,2357,973,442,916,895,1031,1009,1333,1171.0,1124.0,324,-22,346
4869,13,17,2,8,0,3829,3951,3277,3711,5424,1723,1261,2043,2652,2981,2611,4091,3351.0,3228.0,1480,-370,1850
4961,14,17,2,8,0,4398,4500,3793,4237,5119,2463,1238,2429,2562,2723,3091,4009,3550.0,3274.0,918,368,550
2205,15,17,2,8,0,2513,2777,2324,2401,2755,895,768,1359,1321,1533,1474,1767,1620.0,1591.0,293,-59,352
1415,16,17,2,8,0,1591,1818,1296,1466,1985,1002,357,841,848,822,1085,1431,1258.0,1113.0,346,263,83
1969,17,17,2,8,0,1906,2187,1670,2078,2533,1085,531,1104,1014,1204,1328,1663,1496.0,1398.0,335,124,211
1223,18,17,2,8,0,1347,1279,1170,1218,1549,440,400,775,721,1235,973,1141,1057.0,1116.0,168,-262,430
861,19,17,2,8,0,806,897,700,869,1098,268,212,386,587,555,690,977,834.0,741.0,287,135,152
1072,20,17,2,8,0,1230,1171,824,938,1120,617,359,603,607,619,800,1027,914.0,815.0,227,181,46
1436,21,17,2,8,0,1278,1300,1165,1199,1748,631,397,661,1831,842,1735,1691,1713.0,1423.0,-44,893,-937
467,22,17,2,8,0,404,404,286,466,480,162,156,276,218,323,452,354,403.0,376.0,-98,129,-227
334,1,18,2,8,0,535,502,314,574,754,315,362,767,319,351,300,314,307.0,322.0,14,-51,65
578,2,18,2,8,0,450,435,635,692,866,452,295,448,404,525,442,543,492.0,503.0,101,-83,184
704,3,18,2,8,0,452,427,495,612,941,427,254,591,556,550,476,504,490.0,510.0,28,-74,102
110,4,18,2,8,0,397,346,199,341,546,125,89,159,100,115,114,150,132.0,126.0,36,-1,37
1050,5,18,2,8,0,1197,903,838,1187,1812,1017,704,1344,1235,1081,1056,878,967.0,1005.0,-178,-25,-153
857,6,18,2,8,0,958,734,813,952,1669,741,475,869,701,638,694,733,714.0,688.0,39,56,-17
3266,7,18,2,8,0,3299,2451,2995,3812,5496,2330,1515,2865,2841,2834,2558,2825,2692.0,2739.0,267,-276,543
1538,8,18,2,8,0,1588,1052,1126,1234,2626,1165,641,1247,1425,1531,1329,1557,1443.0,1472.0,228,-202,430
681,9,18,2,8,0,448,529,384,525,1055,368,255,433,540,513,805,467,636.0,595.0,-338,292,-630
128,10,18,2,8,0,291,255,362,355,448,365,155,240,485,249,405,222,314.0,292.0,-183,156,-339
955,11,18,2,8,0,1085,864,1310,1728,2261,1167,1028,1507,1281,827,792,892,842.0,837.0,100,-35,135
217,12,18,2,8,0,335,301,356,946,847,641,223,316,236,253,238,242,240.0,244.0,4,-15,19
3386,13,18,2,8,0,3609,2265,2586,3058,5478,1932,1551,2981,3513,3250,2524,3284,2904.0,3019.0,760,-726,1486
1721,14,18,2,8,0,1452,1141,1472,1941,3092,1731,893,1695,1504,1408,1487,1714,1600.0,1536.0,227,79,148
432,15,18,2,8,0,913,659,638,706,1205,504,467,741,598,514,446,578,512.0,513.0,132,-68,200
172,16,18,2,8,0,263,202,272,348,657,298,154,273,222,166,164,170,167.0,167.0,6,-2,8
393,17,18,2,8,0,701,698,568,587,1351,576,253,448,437,409,373,484,428.0,422.0,111,-36,147
301,18,18,2,8,0,355,342,307,452,617,215,148,255,232,240,199,231,215.0,223.0,32,-41,73
892,19,18,2,8,0,716,684,572,853,1026,394,408,768,721,776,679,667,673.0,707.0,-12,-97,85
199,20,18,2,8,0,474,304,408,379,694,353,248,346,329,249,207,249,228.0,235.0,42,-42,84
614,21,18,2,8,0,832,623,693,804,1400,754,418,791,600,553,553,625,589.0,577.0,72,0,72
859,22,18,2,8,0,508,307,324,496,710,280,266,503,464,518,466,471,468.0,485.0,5,-52,57
307,1,19,2,8,0,232,150,148,312,359,339,177,321,249,248,328,254,291.0,277.0,-74,80,-154
418,2,19,2,8,0,290,304,344,442,485,409,248,357,375,412,347,430,388.0,396.0,83,-65,148
411,3,19,2,8,0,348,325,432,401,434,519,319,522,443,583,484,431,458.0,499.0,-53,-99,46
860,4,19,2,8,0,1183,1150,795,1121,1802,1263,877,1267,1047,1549,1033,967,1000.0,1183.0,-66,-516,450
1009,5,19,2,8,0,519,741,610,732,1083,1390,565,951,827,852,794,845,820.0,830.0,51,-58,109
499,6,19,2,8,0,360,323,440,519,629,667,315,471,534,553,570,581,576.0,568.0,11,17,-6
1927,7,19,2,8,0,1311,1391,1370,1666,1642,1861,878,1578,1694,1792,1554,1627,1590.0,1658.0,73,-238,311
409,8,19,2,8,0,332,330,480,421,414,426,317,451,395,445,395,431,413.0,424.0,36,-50,86
839,9,19,2,8,0,516,523,704,995,1243,727,322,827,693,791,804,769,786.0,788.0,-35,13,-48
192,10,19,2,8,0,101,156,159,192,214,225,119,204,139,193,190,168,179.0,184.0,-22,-3,-19
1296,11,19,2,8,0,871,1280,881,1099,1374,1336,868,1301,1124,1278,1241,1197,1219.0,1239.0,-44,-37,-7
309,12,19,2,8,0,169,178,237,276,329,364,141,291,237,315,278,285,282.0,293.0,7,-37,44
1864,13,19,2,8,0,1360,1115,1052,1461,1615,1768,1165,1697,1805,2074,1714,1806,1760.0,1865.0,92,-360,452
1579,14,19,2,8,0,1047,1104,1357,1223,1443,1429,856,1325,1403,1419,1413,1478,1446.0,1437.0,65,-6,71
732,15,19,2,8,0,404,404,512,747,863,742,356,707,633,707,646,663,654.0,672.0,17,-61,78
546,16,19,2,8,0,379,393,374,473,566,558,262,443,396,470,482,493,488.0,482.0,11,12,-1
399,17,19,2,8,0,291,253,248,418,494,519,230,424,383,397,379,387,383.0,388.0,8,-18,26
315,18,19,2,8,0,183,186,285,325,402,404,188,330,251,340,301,284,292.0,308.0,-17,-39,22
765,19,19,2,8,0,721,569,738,644,1082,704,546,870,783,781,790,785,788.0,785.0,-5,9,-14
381,20,19,2,8,0,213,262,251,282,391,433,202,335,319,317,436,335,386.0,363.0,-101,119,-220
500,21,19,2,8,0,360,419,276,346,497,487,257,378,390,460,393,519,456.0,457.0,126,-67,193
1044,22,19,2,8,0,929,731,657,664,964,785,666,1198,1070,1179,970,890,930.0,1013.0,-80,-209,129
602,1,20,1,8,0,946,1150,1010,1563,1504,815,447,731,532,612,632,552,592.0,599.0,-80,20,-100
439,2,20,1,8,0,595,570,759,692,785,585,277,403,310,422,368,501,434.0,430.0,133,-54,187
170,3,20,1,8,0,333,327,407,342,430,303,110,229,177,183,153,136,144.0,157.0,-17,-30,13
270,4,20,1,8,0,772,925,740,925,1127,376,284,427,371,462,336,275,306.0,358.0,-61,-126,65
717,5,20,1,8,0,1085,1885,1100,1320,1775,1096,562,764,657,680,772,616,694.0,689.0,-156,92,-248
685,6,20,1,8,0,980,1023,1001,1064,1490,952,364,600,581,589,605,632,618.0,609.0,27,16,11
940,7,20,1,8,0,1323,1432,1303,1408,1739,940,501,805,813,957,836,892,864.0,895.0,56,-121,177
135,8,20,1,8,0,295,289,333,332,371,229,113,151,138,130,107,102,104.0,113.0,-5,-23,18
780,9,20,1,8,0,1195,1320,1463,1644,2216,854,451,986,862,846,947,768,858.0,854.0,-179,101,-280
169,10,20,1,8,0,218,240,280,255,372,218,114,237,155,197,163,181,172.0,180.0,18,-34,52
1181,11,20,1,8,0,1947,1897,1872,2263,3132,1586,987,1345,1015,1158,1068,1086,1077.0,1104.0,18,-90,108
461,12,20,1,8,0,684,855,798,870,1144,754,284,498,430,503,444,457,450.0,468.0,13,-59,72
679,13,20,1,8,0,985,861,883,944,1218,652,442,599,687,716,543,668,606.0,642.0,125,-173,298
653,14,20,1,8,0,1056,1067,1021,1121,1578,856,471,700,719,644,669,703,686.0,672.0,34,25,9
1334,15,20,1,8,0,2037,2367,2323,2703,3371,1749,893,1369,1150,1156,1037,1172,1104.0,1122.0,135,-119,254
519,16,20,1,8,0,829,920,1033,988,1333,941,363,579,523,593,600,621,610.0,605.0,21,7,14
642,17,20,1,8,0,908,1056,973,1081,1561,1003,386,716,610,659,562,594,578.0,605.0,32,-97,129
372,18,20,1,8,0,684,714,853,905,1102,667,370,551,387,534,372,366,369.0,424.0,-6,-162,156
272,19,20,1,8,0,478,491,437,403,555,253,188,258,212,206,203,265,234.0,225.0,62,-3,65
250,20,20,1,8,0,422,477,428,496,740,452,184,293,290,264,303,274,288.0,280.0,-29,39,-68
238,21,20,1,8,0,351,433,450,479,533,395,223,292,216,328,233,285,259.0,282.0,52,-95,147
238,22,20,1,8,0,461,359,320,352,428,213,219,281,217,259,239,210,224.0,236.0,-29,-20,-9
607,1,21,2,8,0,563,552,450,685,688,275,231,396,369,368,427,353,390.0,383.0,-74,59,-133
556,2,21,2,8,0,743,640,687,714,1001,409,321,443,427,437,368,556,462.0,454.0,188,-69,257
607,3,21,2,8,0,544,557,650,671,789,370,239,440,455,525,460,522,491.0,502.0,62,-65,127
542,4,21,2,8,0,1288,1431,1045,1332,1807,402,360,619,496,497,491,482,486.0,490.0,-9,-6,-3
2475,5,21,2,8,0,2009,2921,2017,2913,3590,1589,1106,1523,1538,1537,1666,1861,1764.0,1688.0,195,129,66
1713,6,21,2,8,0,1431,1596,1491,1717,1968,921,593,995,1124,1199,1070,1346,1208.0,1205.0,276,-129,405
2655,7,21,2,8,0,2387,2615,2547,2776,3299,1329,945,1856,2083,2108,1738,2082,1910.0,1976.0,344,-370,714
866,8,21,2,8,0,800,787,813,782,1130,401,261,510,549,610,526,688,607.0,608.0,162,-84,246
1368,9,21,2,8,0,1303,1438,1702,2171,2397,475,354,1081,908,1044,1235,994,1114.0,1091.0,-241,191,-432
397,10,21,2,8,0,282,358,395,493,595,225,179,348,224,290,274,316,295.0,293.0,42,-16,58
3088,11,21,2,8,0,3107,2962,3228,3579,4302,1623,1477,2234,2129,2434,2155,2485,2320.0,2358.0,330,-279,609
808,12,21,2,8,0,641,755,781,885,1016,398,230,537,551,590,548,652,600.0,597.0,104,-42,146
4173,13,21,2,8,0,2979,2860,2877,2989,3954,1565,1311,2239,2725,3260,2705,3344,3024.0,3103.0,639,-555,1194
2996,14,21,2,8,0,2398,2493,2358,2638,3291,1489,872,1684,1948,1801,1780,2489,2134.0,2023.0,709,-21,730
2472,15,21,2,8,0,1914,1992,2163,2458,2897,961,793,1491,1417,1453,1417,1645,1531.0,1505.0,228,-36,264
966,16,21,2,8,0,996,1142,948,1247,1304,805,357,634,667,656,762,898,830.0,772.0,136,106,30
991,17,21,2,8,0,817,950,757,948,1222,427,264,565,544,561,563,728,646.0,617.0,165,2,163
690,18,21,2,8,0,640,694,837,946,924,385,327,518,415,620,444,541,492.0,535.0,97,-176,273
1272,19,21,2,8,0,1088,1057,1007,1160,1513,414,423,828,916,847,707,895,801.0,816.0,188,-140,328
435,20,21,2,8,0,374,365,407,493,612,296,209,288,300,336,388,329,358.0,351.0,-59,52,-111
835,21,21,2,8,0,761,801,945,946,1143,404,239,410,468,587,452,654,553.0,564.0,202,-135,337
1100,22,21,2,8,0,1154,914,753,1190,1198,462,436,1058,713,772,690,729,710.0,730.0,39,-82,121
758,1,22,4,8,0,670,690,633,790,925,325,455,653,555,624,740,612,676.0,659.0,-128,116,-244
290,2,22,4,8,0,447,408,431,527,546,194,218,317,270,316,211,290,250.0,272.0,79,-105,184
328,3,22,4,8,0,341,355,371,359,418,168,163,287,292,335,266,288,277.0,296.0,22,-69,91
559,4,22,4,8,0,911,1074,915,1162,1615,471,523,831,698,714,664,617,640.0,665.0,-47,-50,3
820,5,22,4,8,0,722,1155,772,961,1167,445,516,738,665,640,630,656,643.0,642.0,26,-10,36
791,6,22,4,8,0,767,841,878,933,1003,374,418,658,653,606,565,618,592.0,596.0,53,-41,94
2002,7,22,4,8,0,1852,2308,2307,2370,2766,875,984,1739,1860,1899,1420,1615,1518.0,1645.0,195,-479,674
307,8,22,4,8,0,300,313,320,355,484,139,184,247,243,229,225,247,236.0,234.0,22,-4,26
829,9,22,4,8,0,951,992,1092,1209,1464,402,402,896,629,772,826,680,753.0,759.0,-146,54,-200
183,10,22,4,8,0,262,246,259,290,384,118,109,224,157,222,215,154,184.0,197.0,-61,-7,-54
2422,11,22,4,8,0,2209,2679,2595,2801,3241,1057,1612,2234,1953,2227,1909,2048,1978.0,2061.0,139,-318,457
404,12,22,4,8,0,393,442,498,481,511,213,176,385,307,351,273,345,309.0,323.0,72,-78,150
1916,13,22,4,8,0,1461,1525,1603,1929,2115,754,885,1533,1690,1813,1571,1661,1616.0,1682.0,90,-242,332
1211,14,22,4,8,0,1283,1383,1309,1461,1740,591,724,1200,1228,1058,967,1158,1062.0,1061.0,191,-91,282
2258,15,22,4,8,0,1697,1991,2033,2127,2662,818,1237,1764,1676,1729,1525,1884,1704.0,1713.0,359,-204,563
504,16,22,4,8,0,596,611,603,616,685,305,279,470,356,444,412,438,425.0,431.0,26,-32,58
480,17,22,4,8,0,514,645,501,559,768,256,278,497,347,424,341,409,375.0,391.0,68,-83,151
356,18,22,4,8,0,451,397,473,480,608,216,257,389,262,395,326,356,341.0,359.0,30,-69,99
352,19,22,4,8,0,505,553,489,516,595,169,217,412,408,386,321,346,334.0,351.0,25,-65,90
116,20,22,4,8,0,145,189,159,216,258,69,99,133,100,129,180,126,153.0,145.0,-54,51,-105
437,21,22,4,8,0,487,425,510,487,657,185,238,361,306,395,301,417,359.0,371.0,116,-94,210
475,22,22,4,8,0,611,511,443,413,533,157,228,535,404,398,359,345,352.0,367.0,-14,-39,25
39,1,23,1,8,0,134,126,104,114,215,76,41,45,61,38,52,37,44.0,42.0,-15,14,-29
55,2,23,1,8,0,121,133,139,121,182,95,41,34,36,31,58,44,51.0,44.0,-14,27,-41
85,3,23,1,8,0,92,121,108,174,205,99,66,95,76,72,76,74,75.0,74.0,-2,4,-6
51,4,23,1,8,0,202,250,161,243,439,74,40,54,53,41,27,32,30.0,33.0,5,-14,19
136,5,23,1,8,0,317,459,291,297,513,309,153,136,133,149,150,134,142.0,144.0,-16,1,-17
347,6,23,1,8,0,733,655,600,692,1047,578,273,312,307,331,314,279,296.0,308.0,-35,-17,-18
649,7,23,1,8,0,1063,1138,1097,1099,1844,902,381,538,572,675,544,536,540.0,585.0,-8,-131,123
237,8,23,1,8,0,261,250,277,308,545,238,158,237,226,236,217,178,198.0,210.0,-39,-19,-20
121,9,23,1,8,0,295,282,277,289,373,126,71,118,103,101,96,92,94.0,96.0,-4,-5,1
50,10,23,1,8,0,107,108,100,115,162,93,53,69,35,53,40,48,44.0,47.0,8,-13,21
213,11,23,1,8,0,461,370,406,397,621,300,168,197,206,183,203,185,194.0,190.0,-18,20,-38
57,12,23,1,8,0,112,150,164,143,266,151,36,61,68,60,40,53,46.0,51.0,13,-20,33
524,13,23,1,8,0,645,742,699,808,1460,748,389,430,459,518,401,452,426.0,457.0,51,-117,168
316,14,23,1,8,0,544,566,471,617,1100,524,174,251,240,290,254,290,272.0,278.0,36,-36,72
72,15,23,1,8,0,181,198,211,191,260,101,55,63,66,67,90,77,84.0,78.0,-13,23,-36
127,16,23,1,8,0,266,326,324,313,534,275,79,103,125,96,138,125,132.0,120.0,-13,42,-55
161,17,23,1,8,0,273,347,286,335,535,308,119,163,126,142,139,138,138.0,140.0,-1,-3,2
28,18,23,1,8,0,114,102,89,87,129,60,25,51,31,35,42,33,38.0,37.0,-9,7,-16
200,19,23,1,8,0,331,280,278,265,371,149,91,133,121,130,132,148,140.0,137.0,16,2,14
79,20,23,1,8,0,251,250,189,199,335,168,84,69,66,80,88,67,78.0,78.0,-21,8,-29
85,21,23,1,8,0,161,167,197,186,360,209,62,83,76,106,84,83,84.0,91.0,-1,-22,21
123,22,23,1,8,0,264,248,169,223,312,126,95,154,101,143,86,105,96.0,111.0,19,-57,76
727,1,24,2,8,0,687,651,489,558,362,679,494,731,600,672,772,704,738.0,716.0,-68,100,-168
267,2,24,2,8,0,209,201,174,160,155,229,130,223,186,188,194,250,222.0,211.0,56,6,50
112,3,24,2,8,0,130,97,99,82,59,106,63,136,99,113,83,99,91.0,98.0,16,-30,46
630,4,24,2,8,0,847,831,642,654,521,798,532,838,575,694,618,670,644.0,661.0,52,-76,128
576,5,24,2,8,0,559,615,471,430,474,703,394,653,524,606,614,549,582.0,590.0,-65,8,-73
353,6,24,2,8,0,344,348,248,228,187,338,203,372,311,341,346,340,343.0,342.0,-6,5,-11
526,7,24,2,8,0,549,525,474,421,353,610,362,607,527,608,548,531,540.0,562.0,-17,-60,43
124,8,24,2,8,0,154,121,105,117,105,129,94,160,139,138,152,130,141.0,140.0,-22,14,-36
1304,9,24,2,8,0,1238,1180,1049,976,1007,1207,847,1361,1093,1267,1219,1095,1157.0,1194.0,-124,-48,-76
153,10,24,2,8,0,161,151,126,138,119,159,102,172,121,154,153,137,145.0,148.0,-16,-1,-15
1583,11,24,2,8,0,1821,1585,1270,1186,1077,1735,1066,1713,1523,1554,1639,1493,1566.0,1562.0,-146,85,-231
215,12,24,2,8,0,224,232,164,154,152,242,146,291,216,232,253,206,230.0,230.0,-47,21,-68
362,13,24,2,8,0,330,362,307,254,182,340,242,360,379,362,327,372,350.0,354.0,45,-35,80
407,14,24,2,8,0,389,339,239,284,223,320,199,311,289,319,320,350,335.0,330.0,30,1,29
1537,15,24,2,8,0,1568,1439,1239,1136,1024,1529,973,1602,1326,1507,1501,1473,1487.0,1494.0,-28,-6,-22
321,16,24,2,8,0,383,407,272,273,274,370,238,369,296,339,369,331,350.0,346.0,-38,30,-68
275,17,24,2,8,0,270,285,213,205,215,305,186,346,275,278,289,275,282.0,281.0,-14,11,-25
477,18,24,2,8,0,437,448,353,321,324,518,242,572,350,498,528,403,466.0,476.0,-125,30,-155
316,19,24,2,8,0,346,299,229,207,174,292,205,321,225,242,252,295,274.0,263.0,43,10,33
263,20,24,2,8,0,222,255,197,217,217,267,199,277,240,244,232,258,245.0,245.0,26,-12,38
252,21,24,2,8,0,319,283,263,205,197,285,151,281,203,248,250,270,260.0,256.0,20,2,18
134,22,24,2,8,0,119,71,81,63,53,93,68,133,85,82,113,113,113.0,103.0,0,31,-31
299,1,25,1,8,0,303,281,281,247,225,315,160,297,263,287,314,230,272.0,277.0,-84,27,-111
169,2,25,1,8,0,187,165,167,133,176,164,108,164,133,153,126,180,153.0,153.0,54,-27,81
89,3,25,1,8,0,117,120,96,85,86,86,62,103,111,102,97,88,92.0,96.0,-9,-5,-4
246,4,25,1,8,0,427,429,308,324,417,323,190,356,270,290,257,234,246.0,260.0,-23,-33,10
271,5,25,1,8,0,376,389,305,301,337,483,166,411,313,351,316,288,302.0,318.0,-28,-35,7
222,6,25,1,8,0,227,205,162,169,174,188,119,173,183,210,172,186,179.0,189.0,14,-38,52
292,7,25,1,8,0,302,292,265,227,253,339,160,306,297,331,234,253,244.0,273.0,19,-97,116
94,8,25,1,8,0,103,99,83,81,91,111,56,97,101,97,84,91,88.0,91.0,7,-13,20
478,9,25,1,8,0,565,575,462,510,512,581,314,531,409,540,562,422,492.0,508.0,-140,22,-162
94,10,25,1,8,0,117,108,102,103,109,128,57,103,59,104,114,85,100.0,101.0,-29,10,-39
701,11,25,1,8,0,823,757,642,661,734,807,456,741,678,793,643,655,649.0,697.0,12,-150,162
127,12,25,1,8,0,153,155,115,129,138,165,79,158,126,152,118,104,111.0,125.0,-14,-34,20
222,13,25,1,8,0,219,226,184,180,178,203,126,201,195,251,175,165,170.0,197.0,-10,-76,66
216,14,25,1,8,0,186,187,161,189,173,186,103,191,191,194,156,186,171.0,179.0,30,-38,68
732,15,25,1,8,0,709,620,587,599,595,656,382,738,625,720,647,584,616.0,650.0,-63,-73,10
241,16,25,1,8,0,319,331,219,258,266,270,142,257,214,255,256,231,244.0,247.0,-25,1,-26
198,17,25,1,8,0,219,179,160,168,191,210,114,205,161,191,162,167,164.0,173.0,5,-29,34
201,18,25,1,8,0,260,259,202,201,205,241,127,267,183,283,239,197,218.0,240.0,-42,-44,2
145,19,25,1,8,0,161,165,130,138,128,140,90,113,125,138,146,129,138.0,138.0,-17,8,-25
110,20,25,1,8,0,158,109,123,106,134,131,54,117,102,136,130,124,127.0,130.0,-6,-6,0
140,21,25,1,8,0,205,192,172,135,145,159,85,142,119,156,144,123,134.0,141.0,-21,-12,-9
83,22,25,1,8,0,99,74,50,53,61,68,34,78,65,79,70,61,66.0,70.0,-9,-9,0
694,1,26,1,8,0,559,478,428,493,474,835,424,592,562,626,644,634,639.0,635.0,-10,18,-28
250,2,26,1,8,0,240,237,204,210,215,310,178,234,223,203,223,258,240.0,228.0,35,20,15
128,3,26,1,8,0,115,91,72,82,74,139,87,116,104,125,105,116,110.0,115.0,11,-20,31
824,4,26,1,8,0,824,853,604,747,817,1033,648,841,763,792,726,727,726.0,748.0,1,-66,67
440,5,26,1,8,0,458,388,382,361,382,695,383,524,456,456,507,479,493.0,481.0,-28,51,-79
259,6,26,1,8,0,226,228,183,176,177,354,152,225,259,222,223,254,238.0,233.0,31,1,30
468,7,26,1,8,0,453,344,338,348,336,608,328,530,488,475,451,429,440.0,452.0,-22,-24,2
152,8,26,1,8,0,108,108,84,93,100,165,96,130,118,97,142,140,141.0,126.0,-2,45,-47
1109,9,26,1,8,0,886,875,627,766,825,1178,690,1101,964,1020,962,1084,1023.0,1022.0,122,-58,180
129,10,26,1,8,0,105,124,72,100,114,160,106,163,133,138,136,134,135.0,136.0,-2,-2,0
1080,11,26,1,8,0,1124,918,791,915,1007,1591,766,1115,1026,1072,1033,982,1008.0,1029.0,-51,-39,-12
197,12,26,1,8,0,140,155,101,129,108,227,115,167,214,182,168,165,166.0,172.0,-3,-14,11
298,13,26,1,8,0,266,200,202,203,219,376,209,316,289,290,301,301,301.0,297.0,0,11,-11
287,14,26,1,8,0,276,252,194,283,262,357,201,287,304,275,256,289,272.0,273.0,33,-19,52
1063,15,26,1,8,0,880,834,733,849,908,1436,623,970,967,965,954,954,954.0,958.0,0,-11,11
384,16,26,1,8,0,327,326,230,315,356,436,202,366,316,282,393,360,376.0,345.0,-33,111,-144
249,17,26,1,8,0,190,184,143,174,192,302,179,246,255,226,219,246,232.0,230.0,27,-7,34
330,18,26,1,8,0,296,266,197,227,256,500,212,338,297,357,330,288,309.0,325.0,-42,-27,-15
299,19,26,1,8,0,281,225,176,194,227,304,176,286,261,241,263,276,270.0,260.0,13,22,-9
198,20,26,1,8,0,184,176,151,174,194,265,152,205,197,174,223,187,205.0,195.0,-36,49,-85
224,21,26,1,8,0,213,228,210,194,216,307,140,222,205,251,252,248,250.0,250.0,-4,1,-5
123,22,26,1,8,0,106,77,74,83,85,102,84,125,116,121,127,86,106.0,111.0,-41,6,-47
182,1,27,4,8,0,203,190,188,201,262,80,97,160,113,154,142,142,142.0,146.0,0,-12,12
46,2,27,4,8,0,60,52,76,100,59,26,35,34,50,78,51,74,62.0,68.0,23,-27,50
27,3,27,4,8,0,33,31,42,40,37,22,17,26,37,25,21,17,19.0,21.0,-4,-4,0
112,4,27,4,8,0,203,232,200,230,226,93,117,153,137,139,94,88,91.0,107.0,-6,-45,39
184,5,27,4,8,0,152,216,166,240,223,57,76,90,137,164,128,144,136.0,145.0,16,-36,52
108,6,27,4,8,0,104,106,110,130,121,57,59,72,81,74,76,100,88.0,83.0,24,2,22
180,7,27,4,8,0,232,258,215,231,199,113,137,218,152,167,149,160,154.0,159.0,11,-18,29
27,8,27,4,8,0,37,31,31,28,33,16,10,28,22,76,22,26,24.0,41.0,4,-54,58
225,9,27,4,8,0,223,290,309,396,384,120,115,231,223,244,188,202,195.0,211.0,14,-56,70
38,10,27,4,8,0,29,35,34,41,40,20,18,18,25,33,31,30,30.0,31.0,-1,-2,1
426,11,27,4,8,0,471,447,420,635,591,225,325,414,342,390,329,340,334.0,353.0,11,-61,72
50,12,27,4,8,0,43,50,52,66,85,10,18,37,40,39,37,38,38.0,38.0,1,-2,3
118,13,27,4,8,0,130,145,141,166,161,78,99,131,131,102,71,97,84.0,90.0,26,-31,57
121,14,27,4,8,0,86,118,117,128,163,57,77,90,88,75,84,92,88.0,84.0,8,9,-1
511,15,27,4,8,0,382,415,422,523,567,168,290,344,386,300,355,415,385.0,357.0,60,55,5
103,16,27,4,8,0,106,110,92,120,142,48,54,76,88,66,69,75,72.0,70.0,6,3,3
85,17,27,4,8,0,64,96,79,112,124,41,43,61,74,75,46,72,59.0,64.0,26,-29,55
64,18,27,4,8,0,84,61,85,108,127,23,28,50,51,59,58,62,60.0,60.0,4,-1,5
75,19,27,4,8,0,88,87,77,106,83,28,38,67,45,65,40,54,47.0,53.0,14,-25,39
40,20,27,4,8,0,35,47,43,77,67,17,20,19,34,34,37,30,34.0,34.0,-7,3,-10
90,21,27,4,8,0,82,79,83,68,82,41,52,48,66,99,56,51,54.0,69.0,-5,-43,38
30,22,27,4,8,0,61,42,40,48,45,18,18,48,30,46,28,19,24.0,31.0,-9,-18,9
609,1,28,2,8,0,360,145,129,306,492,378,283,374,311,427,498,475,486.0,467.0,-23,71,-94
277,2,28,2,8,0,153,83,75,142,154,140,101,145,149,178,192,272,232.0,214.0,80,14,66
176,3,28,2,8,0,105,47,48,67,109,121,79,109,124,169,140,135,138.0,148.0,-5,-29,24
697,4,28,2,8,0,502,321,175,311,576,511,299,438,522,580,543,591,567.0,571.0,48,-37,85
643,5,28,2,8,0,488,356,206,340,526,495,291,361,444,497,529,571,550.0,532.0,42,32,10
453,6,28,2,8,0,208,104,111,219,307,304,148,259,319,271,331,363,347.0,322.0,32,60,-28
741,7,28,2,8,0,446,246,241,312,378,406,284,400,479,557,520,550,535.0,542.0,30,-37,67
177,8,28,2,8,0,80,47,46,58,83,94,61,99,97,93,99,121,110.0,104.0,22,6,16
899,9,28,2,8,0,740,398,282,593,912,598,355,607,642,701,764,756,760.0,740.0,-8,63,-71
145,10,28,2,8,0,95,39,30,50,68,74,33,77,72,113,104,139,122.0,119.0,35,-9,44
1451,11,28,2,8,0,610,270,351,609,1028,993,652,891,910,1046,1085,1159,1122.0,1097.0,74,39,35
258,12,28,2,8,0,130,47,59,107,208,200,69,151,150,175,152,209,180.0,179.0,57,-23,80
563,13,28,2,8,0,351,172,141,298,340,342,250,323,382,440,423,438,430.0,434.0,15,-17,32
492,14,28,2,8,0,206,143,136,170,239,290,184,293,341,325,356,405,380.0,362.0,49,31,18
1958,15,28,2,8,0,815,643,498,965,1300,996,708,969,1088,1209,1284,1524,1404.0,1339.0,240,75,165
437,16,28,2,8,0,253,116,101,212,331,334,134,250,279,305,303,339,321.0,316.0,36,-2,38
429,17,28,2,8,0,229,78,92,180,310,284,146,251,271,354,267,331,299.0,317.0,64,-87,151
308,18,28,2,8,0,200,69,95,138,176,229,97,153,164,270,221,253,237.0,248.0,32,-49,81
648,19,28,2,8,0,291,193,157,189,261,256,190,274,317,341,370,440,405.0,384.0,70,29,41
190,20,28,2,8,0,135,51,35,76,157,115,82,120,97,175,209,162,186.0,182.0,-47,34,-81
366,21,28,2,8,0,241,115,96,127,205,223,136,166,239,247,199,284,242.0,243.0,85,-48,133
240,22,28,2,8,0,123,58,56,108,145,104,92,153,138,145,157,161,159.0,154.0,4,12,-8
471,1,29,1,8,0,528,494,298,341,507,266,214,347,256,335,387,323,355.0,348.0,-64,52,-116
206,2,29,1,8,0,213,197,180,169,225,142,99,142,158,164,176,231,204.0,190.0,55,12,43
168,3,29,1,8,0,178,174,157,121,169,76,74,105,133,145,136,151,144.0,144.0,15,-9,24
274,4,29,1,8,0,450,529,355,417,450,177,170,259,234,290,279,265,272.0,278.0,-14,-11,-3
452,5,29,1,8,0,533,641,403,433,394,242,224,324,333,361,319,358,338.0,346.0,39,-42,81
298,6,29,1,8,0,297,328,172,256,310,160,139,211,231,217,227,254,240.0,233.0,27,10,17
574,7,29,1,8,0,487,582,453,469,507,305,251,332,402,428,398,413,406.0,413.0,15,-30,45
169,8,29,1,8,0,168,143,117,124,97,55,43,101,86,111,100,106,103.0,106.0,6,-11,17
772,9,29,1,8,0,813,867,710,821,895,435,271,630,599,641,694,710,702.0,682.0,16,53,-37
137,10,29,1,8,0,129,137,85,114,124,79,66,108,95,119,99,124,112.0,114.0,25,-20,45
1098,11,29,1,8,0,1272,1166,688,937,1154,552,589,835,807,903,879,877,878.0,886.0,-2,-24,22
202,12,29,1,8,0,202,193,186,189,178,106,91,145,142,176,146,152,149.0,158.0,6,-30,36
411,13,29,1,8,0,427,423,324,327,378,179,188,251,302,319,290,307,298.0,305.0,17,-29,46
290,14,29,1,8,0,336,420,237,276,308,156,143,260,258,238,212,252,232.0,234.0,40,-26,66
1285,15,29,1,8,0,1196,1045,917,1072,1169,550,543,759,841,892,995,1035,1015.0,974.0,40,103,-63
372,16,29,1,8,0,395,429,270,308,378,261,177,285,262,281,264,324,294.0,290.0,60,-17,77
332,17,29,1,8,0,360,359,193,226,309,145,129,251,238,285,222,261,242.0,256.0,39,-63,102
280,18,29,1,8,0,281,263,253,214,293,168,110,183,202,270,233,236,234.0,246.0,3,-37,40
209,19,29,1,8,0,241,242,174,177,213,86,85,121,151,164,140,139,140.0,148.0,-1,-24,23
96,20,29,1,8,0,146,128,96,89,130,65,59,92,68,101,131,82,106.0,105.0,-49,30,-79
189,21,29,1,8,0,229,215,165,164,174,112,81,131,150,180,137,151,144.0,156.0,14,-43,57
128,22,29,1,8,0,130,140,82,95,85,44,40,74,82,95,78,104,91.0,92.0,26,-17,43
558,1,30,1,8,0,521,504,402,593,748,538,251,456,315,445,485,411,448.0,447.0,-74,40,-114
252,2,30,1,8,0,266,231,316,323,344,263,166,191,198,263,290,341,316.0,298.0,51,27,24
172,3,30,1,8,0,217,201,207,206,200,197,109,152,165,213,178,177,178.0,189.0,-1,-35,34
949,4,30,1,8,0,898,731,715,939,1050,755,424,693,651,781,754,805,780.0,780.0,51,-27,78
673,5,30,1,8,0,658,1072,583,560,641,624,348,443,468,502,547,611,579.0,553.0,64,45,19
317,6,30,1,8,0,346,329,282,331,409,330,200,229,256,264,317,284,300.0,288.0,-33,53,-86
632,7,30,1,8,0,543,678,438,630,646,659,309,458,540,534,523,541,532.0,533.0,18,-11,29
187,8,30,1,8,0,155,143,139,142,103,120,44,90,120,136,128,136,132.0,133.0,8,-8,16
1323,9,30,1,8,0,1237,1342,1295,1408,1829,1269,499,1006,894,1099,1203,1068,1136.0,1123.0,-135,104,-239
198,10,30,1,8,0,125,189,162,142,255,213,82,152,117,156,149,174,162.0,160.0,25,-7,32
1268,11,30,1,8,0,1106,1255,1040,1108,1430,1304,649,954,933,1003,955,1112,1034.0,1023.0,157,-48,205
256,12,30,1,8,0,230,275,218,275,247,282,85,186,198,229,203,249,226.0,227.0,46,-26,72
546,13,30,1,8,0,476,471,407,417,527,425,254,337,412,434,405,458,432.0,432.0,53,-29,82
398,14,30,1,8,0,422,469,405,382,502,442,251,354,426,325,372,375,374.0,357.0,3,47,-44
1460,15,30,1,8,0,1181,1241,932,1214,1500,938,567,836,888,1017,1178,1317,1248.0,1171.0,139,161,-22
468,16,30,1,8,0,427,529,447,473,526,572,259,428,363,377,445,438,442.0,420.0,-7,68,-75
421,17,30,1,8,0,451,476,369,391,505,374,207,342,370,431,366,451,408.0,416.0,85,-65,150
319,18,30,1,8,0,266,282,298,320,358,335,144,206,194,282,238,262,250.0,261.0,24,-44,68
482,19,30,1,8,0,459,418,357,335,454,281,156,268,293,330,277,371,324.0,326.0,94,-53,147
224,20,30,1,8,0,230,259,188,209,244,199,108,153,121,186,284,146,215.0,205.0,-138,98,-236
298,21,30,1,8,0,312,352,366,242,346,325,174,210,225,299,236,330,283.0,288.0,94,-63,157
210,22,30,1,8,0,240,219,123,190,198,139,94,144,137,133,149,128,138.0,137.0,-21,16,-37
664,1,31,2,8,0,607,438,357,513,576,543,384,696,487,649,633,685,659.0,656.0,52,-16,68
267,2,31,2,8,0,213,139,117,236,257,243,199,312,234,314,249,292,270.0,285.0,43,-65,108
68,3,31,2,8,0,43,47,37,60,80,54,43,84,76,64,93,74,84.0,77.0,-19,29,-48
640,4,31,2,8,0,449,410,328,585,816,536,311,688,527,617,587,668,628.0,624.0,81,-30,111
645,5,31,2,8,0,445,455,290,447,593,591,337,640,478,571,603,551,577.0,575.0,-52,32,-84
364,6,31,2,8,0,265,236,233,275,385,322,230,435,350,391,362,386,374.0,380.0,24,-29,53
586,7,31,2,8,0,358,297,285,401,440,468,289,622,538,593,498,535,516.0,542.0,37,-95,132
114,8,31,2,8,0,60,31,30,61,103,57,64,78,79,91,70,76,73.0,79.0,6,-21,27
1360,9,31,2,8,0,1033,800,773,983,1319,1274,618,1449,1061,1394,1469,1265,1367.0,1376.0,-204,75,-279
172,10,31,2,8,0,99,93,94,126,167,115,84,164,123,176,156,157,156.0,163.0,1,-20,21
1458,11,31,2,8,0,893,729,862,988,1160,1203,919,1681,1193,1428,1269,1375,1322.0,1357.0,106,-159,265
230,12,31,2,8,0,134,144,96,129,200,185,89,224,198,224,201,206,204.0,210.0,5,-23,28
437,13,31,2,8,0,266,194,192,281,283,417,232,460,496,484,423,463,443.0,457.0,40,-61,101
418,14,31,2,8,0,272,209,174,237,350,258,224,388,425,429,397,410,404.0,412.0,13,-32,45
1906,15,31,2,8,0,1547,1208,929,1465,1724,1540,1004,2273,1596,1876,1650,1852,1751.0,1793.0,202,-226,428
383,16,31,2,8,0,235,199,144,218,283,271,143,325,266,300,353,314,334.0,322.0,-39,53,-92
409,17,31,2,8,0,251,209,203,255,374,375,195,380,321,402,363,372,368.0,379.0,9,-39,48
366,18,31,2,8,0,276,236,214,251,346,352,161,369,304,419,307,353,330.0,360.0,46,-112,158
305,19,31,2,8,0,187,133,91,159,186,215,146,225,256,285,240,260,250.0,262.0,20,-45,65
268,20,31,2,8,0,189,132,105,200,253,198,131,290,195,274,315,277,296.0,289.0,-38,41,-79
219,21,31,2,8,0,163,159,132,134,174,188,135,235,193,286,212,215,214.0,238.0,3,-74,77
104,22,31,2,8,0,57,23,28,58,76,70,44,104,104,97,90,78,84.0,88.0,-12,-7,-5
209,1,32,3,8,0,379,426,299,501,825,333,136,253,217,192,208,169,188.0,190.0,-39,16,-55
496,2,32,3,8,0,707,913,926,928,1393,1050,634,598,559,552,559,568,564.0,560.0,9,7,2
189,3,32,3,8,0,132,200,230,272,405,185,132,207,141,156,128,146,137.0,143.0,18,-28,46
105,4,32,3,8,0,313,370,330,446,852,178,127,199,127,128,132,116,124.0,125.0,-16,4,-20
447,5,32,3,8,0,755,971,792,934,1509,1063,565,512,413,385,387,456,422.0,409.0,69,2,67
904,6,32,3,8,0,1349,1421,1263,1461,2601,1965,1072,936,771,749,842,897,870.0,829.0,55,93,-38
1912,7,32,3,8,0,2677,2814,2975,3077,5360,2858,1598,1729,1694,1756,1539,1936,1738.0,1744.0,397,-217,614
484,8,32,3,8,0,640,778,791,803,1442,701,396,447,437,462,390,470,430.0,441.0,80,-72,152
2831,9,32,3,8,0,4086,5098,5032,5800,8421,3465,1872,3263,2465,2754,2779,2551,2665.0,2695.0,-228,25,-253
2120,10,32,3,8,0,2497,3110,3025,3479,6171,2981,1510,1845,1206,1444,1326,1376,1351.0,1382.0,50,-118,168
1382,11,32,3,8,0,1829,2045,1978,2153,3757,2028,1542,1465,1325,1301,1251,1387,1319.0,1313.0,136,-50,186
426,12,32,3,8,0,635,806,703,736,1319,827,443,434,359,341,393,389,391.0,374.0,-4,52,-56
1269,13,32,3,8,0,1505,1631,1500,1789,2863,1366,1047,1021,1146,1168,1072,1294,1183.0,1178.0,222,-96,318
2973,14,32,3,8,0,4302,4617,4700,5194,9539,6024,2842,2528,2423,2523,2603,3162,2882.0,2763.0,559,80,479
822,15,32,3,8,0,1291,1435,1528,1653,2646,934,580,745,680,733,621,813,717.0,722.0,192,-112,304
447,16,32,3,8,0,753,891,696,982,1629,1137,521,524,406,468,397,454,426.0,440.0,57,-71,128
779,17,32,3,8,0,1113,1544,1234,1513,2352,1658,771,808,663,615,657,743,700.0,672.0,86,42,44
322,18,32,3,8,0,548,706,724,738,1086,453,316,456,314,359,319,319,319.0,332.0,0,-40,40
483,19,32,3,8,0,616,644,644,694,1039,408,313,505,468,482,534,500,517.0,505.0,-34,52,-86
160,20,32,3,8,0,277,359,279,304,514,324,210,169,172,136,158,183,170.0,159.0,25,22,3
576,21,32,3,8,0,648,785,855,1045,1704,937,403,499,452,488,436,535,486.0,486.0,99,-52,151
543,22,32,3,8,0,791,839,638,832,1045,394,365,562,482,469,565,521,543.0,518.0,-44,96,-140
726,1,33,2,8,0,1065,2065,1032,1283,1483,389,338,505,521,647,608,619,614.0,625.0,11,-39,50
263,2,33,2,8,0,346,402,396,360,567,208,160,208,214,226,198,297,248.0,240.0,99,-28,127
370,3,33,2,8,0,575,712,648,698,789,413,215,340,311,387,355,326,340.0,356.0,-29,-32,3
101,4,33,2,8,0,397,451,276,389,488,143,102,126,84,102,87,71,79.0,87.0,-16,-15,-1
664,5,33,2,8,0,820,1286,786,820,1117,531,374,577,521,559,581,527,554.0,556.0,-54,22,-76
420,6,33,2,8,0,644,726,594,615,705,385,198,241,246,257,285,305,295.0,282.0,20,28,-8
1138,7,33,2,8,0,1454,1777,1435,1352,1707,803,424,738,843,928,824,912,868.0,888.0,88,-104,192
345,8,33,2,8,0,346,391,347,352,464,131,87,174,169,231,178,188,183.0,199.0,10,-53,63
249,9,33,2,8,0,286,326,342,407,475,130,117,221,195,239,246,184,215.0,223.0,-62,7,-69
76,10,33,2,8,0,135,181,167,158,231,93,43,77,54,89,79,95,87.0,88.0,16,-10,26
1318,11,33,2,8,0,2024,2099,1880,1868,2181,991,782,1094,1007,1280,1090,1058,1074.0,1143.0,-32,-190,158
281,12,33,2,8,0,349,532,430,438,495,251,128,183,180,217,188,232,210.0,212.0,44,-29,73
860,13,33,2,8,0,1026,1153,782,978,1229,546,360,592,598,847,611,670,640.0,709.0,59,-236,295
755,14,33,2,8,0,951,954,750,835,1053,508,259,492,410,471,586,659,622.0,572.0,73,115,-42
714,15,33,2,8,0,773,920,884,1063,1213,348,291,556,450,632,576,610,593.0,606.0,34,-56,90
228,16,33,2,8,0,340,406,336,358,440,200,80,136,138,174,236,210,223.0,207.0,-26,62,-88
398,17,33,2,8,0,550,688,528,670,749,385,150,254,224,307,284,328,306.0,306.0,44,-23,67
252,18,33,2,8,0,275,314,302,385,408,188,136,178,176,297,240,200,220.0,246.0,-40,-57,17
144,19,33,2,8,0,254,246,156,195,210,53,54,81,84,109,71,94,82.0,91.0,23,-38,61
136,20,33,2,8,0,205,240,178,181,295,131,85,113,117,117,161,107,134.0,128.0,-54,44,-98
763,21,33,2,8,0,1276,1109,958,1012,1286,412,280,531,610,649,548,736,642.0,644.0,188,-101,289
153,22,33,2,8,0,236,256,202,210,228,66,80,160,104,150,105,113,109.0,123.0,8,-45,53
364,1,34,2,8,0,342,422,337,524,679,950,175,263,226,214,231,1376,804.0,607.0,1145,17,1128
133,2,34,2,8,0,129,142,173,215,293,131,118,135,108,106,85,183,134.0,125.0,98,-21,119
52,3,34,2,8,0,80,87,94,102,118,60,38,63,48,62,45,54,50.0,54.0,9,-17,26
120,4,34,2,8,0,158,241,166,231,280,180,87,167,105,117,108,135,122.0,120.0,27,-9,36
240,5,34,2,8,0,208,419,226,291,404,151,140,210,163,126,156,158,157.0,147.0,2,30,-28
141,6,34,2,8,0,146,172,127,176,201,116,64,85,74,80,96,91,94.0,89.0,-5,16,-21
313,7,34,2,8,0,253,405,274,383,451,230,146,276,296,237,243,266,254.0,249.0,23,6,17
67,8,34,2,8,0,68,104,75,85,95,42,23,68,34,43,37,45,41.0,42.0,8,-6,14
115,9,34,2,8,0,149,140,175,225,268,104,54,144,101,111,106,100,103.0,106.0,-6,-5,-1
34,10,34,2,8,0,43,42,39,42,71,30,28,32,17,42,31,35,33.0,36.0,4,-11,15
427,11,34,2,8,0,477,566,501,644,669,334,279,388,278,361,289,335,312.0,328.0,46,-72,118
62,12,34,2,8,0,72,97,83,104,86,64,32,40,53,58,44,58,51.0,53.0,14,-14,28
222,13,34,2,8,0,185,186,192,206,272,140,97,162,151,190,159,151,155.0,167.0,-8,-31,23
253,14,34,2,8,0,191,156,169,219,319,144,90,156,142,133,159,150,154.0,147.0,-9,26,-35
265,15,34,2,8,0,262,293,289,400,452,190,120,235,179,236,184,200,192.0,207.0,16,-52,68
75,16,34,2,8,0,58,71,47,81,82,146,33,61,41,44,47,128,88.0,73.0,81,3,78
142,17,34,2,8,0,118,158,115,135,228,105,59,115,89,71,92,97,94.0,87.0,5,21,-16
71,18,34,2,8,0,82,93,107,132,139,77,43,64,62,76,55,207,131.0,113.0,152,-21,173
41,19,34,2,8,0,64,69,52,62,81,42,40,28,19,48,46,42,44.0,45.0,-4,-2,-2
75,20,34,2,8,0,42,66,46,77,87,44,31,56,52,34,81,74,78.0,63.0,-7,47,-54
151,21,34,2,8,0,169,208,170,201,238,124,83,169,151,120,99,145,122.0,121.0,46,-21,67
39,22,34,2,8,0,60,45,45,56,48,22,17,60,50,40,34,50,42.0,41.0,16,-6,22
229,1,35,2,8,0,96,130,129,206,317,238,124,175,178,198,247,172,210.0,206.0,-75,49,-124
64,2,35,2,8,0,48,150,68,61,94,64,55,50,58,59,74,82,78.0,72.0,8,15,-7
126,3,35,2,8,0,80,59,69,77,114,119,58,88,84,113,93,124,108.0,110.0,31,-20,51
536,4,35,2,8,0,549,341,411,466,954,488,303,463,422,404,405,524,464.0,444.0,119,1,118
476,5,35,2,8,0,213,226,219,270,560,493,212,308,310,321,356,354,355.0,344.0,-2,35,-37
244,6,35,2,8,0,105,226,131,164,192,238,108,126,152,161,181,221,201.0,188.0,40,20,20
968,7,35,2,8,0,376,451,391,462,714,609,352,736,802,743,732,752,742.0,742.0,20,-11,31
214,8,35,2,8,0,87,81,104,152,230,168,75,152,133,162,155,176,166.0,164.0,21,-7,28
1632,9,35,2,8,0,688,783,887,1988,1893,1283,554,1157,1342,1371,1506,1365,1436.0,1414.0,-141,135,-276
240,10,35,2,8,0,333,211,167,204,333,316,132,218,179,232,209,214,212.0,218.0,5,-23,28
808,11,35,2,8,0,701,409,489,602,865,785,520,701,575,790,696,727,712.0,738.0,31,-94,125
228,12,35,2,8,0,104,272,168,194,280,264,100,195,178,199,185,190,188.0,191.0,5,-14,19
546,13,35,2,8,0,358,279,275,250,454,387,248,489,372,444,470,561,516.0,492.0,91,26,65
287,14,35,2,8,0,201,184,168,191,300,319,141,195,250,224,252,313,282.0,263.0,61,28,33
739,15,35,2,8,0,406,355,572,795,787,577,391,567,562,623,668,663,666.0,651.0,-5,45,-50
667,16,35,2,8,0,222,287,394,374,566,545,193,390,310,389,475,504,490.0,456.0,29,86,-57
402,17,35,2,8,0,181,332,203,423,412,412,410,531,262,352,341,399,370.0,364.0,58,-11,69
652,18,35,2,8,0,353,331,397,363,562,555,242,485,658,692,517,589,553.0,599.0,72,-175,247
346,19,35,2,8,0,234,219,239,228,340,230,163,328,229,232,286,261,274.0,260.0,-25,54,-79
265,20,35,2,8,0,184,281,158,348,846,378,203,261,239,256,499,348,424.0,368.0,-151,243,-394
222,21,35,2,8,0,64,63,62,99,126,138,68,103,103,121,139,167,153.0,142.0,28,18,10
126,22,35,2,8,0,56,91,46,89,107,57,72,88,195,88,95,117,106.0,100.0,22,7,15
305,1,36,1,8,0,265,263,222,276,374,264,140,173,111,133,219,252,236.0,201.0,33,86,-53
328,2,36,1,8,0,328,322,420,444,423,403,246,278,240,349,251,370,310.0,323.0,119,-98,217
554,3,36,1,8,0,467,541,608,505,619,534,251,398,363,397,446,439,442.0,427.0,-7,49,-56
710,4,36,1,8,0,803,1019,845,1016,1441,741,459,672,521,645,648,738,693.0,677.0,90,3,87
853,5,36,1,8,0,668,1080,712,743,1078,940,507,616,610,516,696,747,722.0,653.0,51,180,-129
240,6,36,1,8,0,177,210,217,212,273,247,107,152,149,170,178,202,190.0,183.0,24,8,16
792,7,36,1,8,0,643,866,764,681,1011,688,350,548,657,631,628,667,648.0,642.0,39,-3,42
326,8,36,1,8,0,276,283,280,288,348,274,115,219,218,272,224,246,235.0,247.0,22,-48,70
2104,9,36,1,8,0,1456,1686,2097,2144,2562,1849,777,1549,1067,1547,1898,1873,1886.0,1773.0,-25,351,-376
340,10,36,1,8,0,221,333,376,342,443,364,194,278,172,226,248,272,260.0,249.0,24,22,2
698,11,36,1,8,0,656,670,713,682,857,658,425,546,407,545,534,592,563.0,557.0,58,-11,69
241,12,36,1,8,0,207,304,324,277,382,334,121,180,176,242,230,289,260.0,254.0,59,-12,71
1094,13,36,1,8,0,756,829,875,790,1042,804,407,572,721,849,721,962,842.0,844.0,241,-128,369
714,14,36,1,8,0,520,525,514,567,656,654,303,427,422,450,484,638,561.0,524.0,154,34,120
739,15,36,1,8,0,628,658,707,687,970,632,338,464,407,503,544,617,580.0,555.0,73,41,32
1196,16,36,1,8,0,879,1194,1234,1296,1458,1429,526,890,740,929,1121,1218,1170.0,1089.0,97,192,-95
587,17,36,1,8,0,504,586,532,579,879,712,262,444,376,475,496,530,513.0,500.0,34,21,13
322,18,36,1,8,0,324,331,423,388,523,387,223,336,237,399,355,340,348.0,365.0,-15,-44,29
909,19,36,1,8,0,859,919,871,786,1105,571,424,658,595,611,583,678,630.0,624.0,95,-28,123
383,20,36,1,8,0,378,452,406,568,732,616,327,364,351,290,544,368,456.0,401.0,-176,254,-430
615,21,36,1,8,0,429,480,618,464,618,561,288,381,522,505,419,505,462.0,476.0,86,-86,172
428,22,36,1,8,0,463,364,346,348,497,267,165,333,307,314,331,413,372.0,353.0,82,17,65
56,1,37,2,8,0,125,135,111,242,237,68,37,61,48,42,46,60,53.0,49.0,14,4,10
116,2,37,2,8,0,143,170,165,182,271,140,100,100,97,72,92,101,96.0,88.0,9,20,-11
105,3,37,2,8,0,135,135,144,149,195,78,54,74,78,87,84,89,86.0,87.0,5,-3,8
40,4,37,2,8,0,151,163,97,128,205,34,44,59,36,32,45,41,43.0,39.0,-4,13,-17
287,5,37,2,8,0,290,355,284,276,560,275,186,178,154,123,197,155,176.0,158.0,-42,74,-116
120,6,37,2,8,0,210,258,234,289,496,209,109,109,97,103,125,123,124.0,117.0,-2,22,-24
260,7,37,2,8,0,370,455,430,397,599,241,156,188,181,193,211,187,199.0,197.0,-24,18,-42
108,8,37,2,8,0,154,165,187,192,226,67,52,65,70,76,81,82,82.0,80.0,1,5,-4
615,9,37,2,8,0,969,966,1096,1273,1753,510,290,467,429,504,568,492,530.0,521.0,-76,64,-140
120,10,37,2,8,0,133,163,183,209,314,161,76,113,66,89,103,111,107.0,101.0,8,14,-6
423,11,37,2,8,0,659,663,720,808,1176,484,399,360,358,395,364,346,355.0,368.0,-18,-31,13
192,12,37,2,8,0,182,243,282,281,556,258,99,139,120,123,138,130,134.0,130.0,-8,15,-23
217,13,37,2,8,0,275,311,284,290,435,164,126,133,165,184,178,191,184.0,184.0,13,-6,19
365,14,37,2,8,0,313,316,283,364,562,252,130,136,161,188,248,234,241.0,223.0,-14,60,-74
549,15,37,2,8,0,581,660,738,799,1102,332,255,331,293,293,451,433,442.0,392.0,-18,158,-176
148,16,37,2,8,0,230,271,257,362,526,267,110,92,100,79,129,117,123.0,108.0,-12,50,-62
229,17,37,2,8,0,271,292,260,313,627,286,115,133,96,119,133,162,148.0,138.0,29,14,15
134,18,37,2,8,0,274,282,315,340,500,185,128,160,130,141,134,138,136.0,138.0,4,-7,11
164,19,37,2,8,0,310,311,260,209,299,101,86,133,111,127,127,138,132.0,131.0,11,0,11
95,20,37,2,8,0,199,165,151,159,317,179,87,70,59,80,101,84,92.0,88.0,-17,21,-38
86,21,37,2,8,0,126,114,163,141,242,89,58,62,55,62,48,76,62.0,62.0,28,-14,42
93,22,37,2,8,0,155,139,103,121,126,60,44,65,66,61,78,87,82.0,75.0,9,17,-8
341,1,38,2,8,0,346,427,336,1289,571,175,135,300,320,311,280,332,306.0,308.0,52,-31,83
210,2,38,2,8,0,218,226,257,285,393,160,154,201,154,174,208,237,222.0,206.0,29,34,-5
396,3,38,2,8,0,218,291,326,339,631,236,164,278,287,352,354,352,353.0,353.0,-2,2,-4
421,4,38,2,8,0,743,797,664,656,980,232,253,315,319,299,344,411,378.0,351.0,67,45,22
1179,5,38,2,8,0,904,1230,923,1016,1536,609,478,708,677,703,870,874,872.0,816.0,4,167,-163
638,6,38,2,8,0,476,565,666,550,750,358,257,522,447,450,474,531,502.0,485.0,57,24,33
2770,7,38,2,8,0,2200,2915,3148,3502,5481,1788,1203,1635,2012,1985,2046,2150,2098.0,2060.0,104,61,43
1077,8,38,2,8,0,585,792,899,919,1474,502,371,567,626,775,870,822,846.0,822.0,-48,95,-143
10514,9,38,2,8,0,9999,11167,12710,12394,15317,5306,3718,8079,6812,7957,8612,8119,8366.0,8229.0,-493,655,-1148
2291,10,38,2,8,0,1186,1639,1709,1789,2693,1195,777,1366,1087,1463,1613,1736,1674.0,1604.0,123,150,-27
2603,11,38,2,8,0,1726,2274,2226,2622,3296,1247,1529,2148,2087,2259,2343,2472,2408.0,2358.0,129,84,45
1342,12,38,2,8,0,715,1083,1277,1265,1764,857,484,797,835,979,1050,1189,1120.0,1073.0,139,71,68
2449,13,38,2,8,0,1516,1988,2221,2449,3796,1214,995,1259,1697,1832,1815,2279,2047.0,1975.0,464,-17,481
2272,14,38,2,8,0,1553,1783,1739,1951,3130,1278,848,1290,1492,1391,1525,1910,1718.0,1609.0,385,134,251
1896,15,38,2,8,0,1443,1709,2001,2019,2088,700,801,1246,1369,1509,1644,1767,1706.0,1640.0,123,135,-12
1051,16,38,2,8,0,870,1071,1120,1425,1562,736,376,772,827,842,1061,1101,1081.0,1001.0,40,219,-179
1858,17,38,2,8,0,1668,1721,1444,1769,3168,1244,677,1105,1093,1503,1476,1786,1631.0,1588.0,310,-27,337
1476,18,38,2,8,0,1227,1477,1846,1591,1981,769,598,1058,945,1316,1163,1316,1240.0,1265.0,153,-153,306
2151,19,38,2,8,0,3298,3035,2443,2622,3705,1059,1132,1642,1541,1606,1822,1931,1876.0,1786.0,109,216,-107
385,20,38,2,8,0,660,624,494,548,828,333,235,331,330,400,708,364,536.0,491.0,-344,308,-652
387,21,38,2,8,0,451,462,457,402,722,289,175,287,284,326,299,382,340.0,336.0,83,-27,110
1075,22,38,2,8,0,630,651,605,913,1064,350,347,604,509,589,621,701,661.0,637.0,80,32,48
223,1,39,1,8,0,253,330,234,241,272,250,161,224,213,175,131,62,96.0,123.0,-69,-44,-25
389,2,39,1,8,0,281,288,285,282,383,494,162,297,298,329,209,81,145.0,206.0,-128,-120,-8
339,3,39,1,8,0,325,397,353,331,374,412,213,364,399,353,232,84,158.0,223.0,-148,-121,-27
317,4,39,1,8,0,459,651,432,527,798,336,255,324,347,230,135,126,130.0,164.0,-9,-95,86
382,5,39,1,8,0,356,560,353,364,502,560,198,280,354,296,108,64,86.0,156.0,-44,-188,144
393,6,39,1,8,0,370,464,369,339,449,378,228,339,365,359,86,125,106.0,190.0,39,-273,312
1000,7,39,1,8,0,896,1347,1014,1020,1083,1132,648,948,1214,1085,369,273,321.0,576.0,-96,-716,620
396,8,39,1,8,0,334,462,394,347,454,373,276,370,403,345,137,148,142.0,210.0,11,-208,219
2431,9,39,1,8,0,2391,3040,2810,2842,3119,2859,1337,2735,2621,2524,1566,594,1080.0,1561.0,-972,-958,-14
277,10,39,1,8,0,237,346,287,279,316,376,154,306,255,297,140,103,122.0,180.0,-37,-157,120
838,11,39,1,8,0,919,1153,908,905,1057,1012,579,905,787,820,405,226,316.0,484.0,-179,-415,236
317,12,39,1,8,0,350,407,325,334,414,397,195,355,439,342,151,95,123.0,196.0,-56,-191,135
922,13,39,1,8,0,691,837,696,646,778,797,602,842,1066,971,374,253,314.0,533.0,-121,-597,476
1111,14,39,1,8,0,801,1165,786,979,1154,954,596,986,1159,919,330,428,379.0,559.0,98,-589,687
789,15,39,1,8,0,631,767,611,709,819,752,388,650,682,669,277,191,234.0,379.0,-86,-392,306
1053,16,39,1,8,0,1127,1463,1111,1292,1497,1405,549,1164,1131,1057,674,316,495.0,682.0,-358,-383,25
551,17,39,1,8,0,726,776,563,649,953,623,341,556,689,570,218,194,206.0,327.0,-24,-352,328
543,18,39,1,8,0,558,641,586,610,611,627,347,556,479,612,226,137,182.0,325.0,-89,-386,297
733,19,39,1,8,0,667,816,696,727,851,758,485,709,730,631,387,271,329.0,430.0,-116,-244,128
154,20,39,1,8,0,181,222,152,145,208,248,87,111,125,128,35,39,37.0,67.0,4,-93,97
357,21,39,1,8,0,360,429,415,400,482,463,229,331,386,360,198,125,162.0,228.0,-73,-162,89
519,22,39,1,8,0,567,621,450,630,549,617,346,607,485,461,268,130,199.0,286.0,-138,-193,55
234,1,40,1,8,0,281,287,238,345,456,114,153,205,172,211,259,235,247.0,235.0,-24,48,-72
448,2,40,1,8,0,345,327,285,338,442,406,203,364,347,383,359,548,454.0,430.0,189,-24,213
353,3,40,1,8,0,267,246,282,331,382,195,193,311,298,379,324,426,375.0,376.0,102,-55,157
113,4,40,1,8,0,208,303,262,356,580,121,115,186,128,156,127,143,135.0,142.0,16,-29,45
561,5,40,1,8,0,451,636,487,569,804,459,234,390,378,467,472,512,492.0,484.0,40,5,35
548,6,40,1,8,0,400,439,428,489,503,403,244,376,434,485,530,589,560.0,535.0,59,45,14
952,7,40,1,8,0,692,815,855,912,1164,554,505,703,953,906,900,978,939.0,928.0,78,-6,84
371,8,40,1,8,0,277,310,284,316,428,223,193,301,299,310,314,437,376.0,354.0,123,4,119
3157,9,40,1,8,0,2219,2478,2450,3345,3730,1930,1262,2615,2284,2880,3003,3073,3038.0,2985.0,70,123,-53
396,10,40,1,8,0,270,290,313,377,417,266,187,309,304,370,332,440,386.0,381.0,108,-38,146
1276,11,40,1,8,0,1139,1193,1114,1454,1527,877,754,1069,1130,1243,1239,1359,1299.0,1280.0,120,-4,124
477,12,40,1,8,0,314,340,317,350,507,305,161,323,377,500,498,505,502.0,501.0,7,-2,9
876,13,40,1,8,0,521,590,551,574,797,453,434,572,723,877,842,1076,959.0,932.0,234,-35,269
974,14,40,1,8,0,647,687,548,872,1036,630,391,702,797,764,826,1251,1038.0,947.0,425,62,363
1191,15,40,1,8,0,863,800,942,1151,1258,739,529,861,969,1092,1188,1336,1262.0,1205.0,148,96,52
1129,16,40,1,8,0,876,1065,918,1189,1511,963,454,719,775,822,1002,1247,1124.0,1024.0,245,180,65
615,17,40,1,8,0,456,456,452,506,737,420,189,443,430,470,484,597,540.0,517.0,113,14,99
724,18,40,1,8,0,525,556,643,734,779,473,353,640,561,659,677,791,734.0,709.0,114,18,96
589,19,40,1,8,0,434,437,390,480,602,285,241,431,475,512,466,627,546.0,535.0,161,-46,207
194,20,40,1,8,0,218,203,186,200,305,185,95,179,155,153,233,211,222.0,199.0,-22,80,-102
406,21,40,1,8,0,301,293,309,345,496,293,157,234,292,346,246,352,299.0,315.0,106,-100,206
380,22,40,1,8,0,329,347,306,404,422,214,206,322,309,385,388,444,416.0,406.0,56,3,53
150,1,41,3,8,0,228,248,166,277,348,224,140,212,313,130,176,126,151.0,144.0,-50,46,-96
9,2,41,3,8,0,23,22,12,22,33,19,19,18,22,20,12,9,10.0,14.0,-3,-8,5
22,3,41,3,8,0,26,20,16,19,22,21,19,29,36,17,19,26,22.0,21.0,7,2,5
268,4,41,3,8,0,450,433,353,372,511,424,244,378,320,244,260,250,255.0,251.0,-10,16,-26
37,5,41,3,8,0,33,53,34,42,64,69,42,47,33,29,34,13,24.0,25.0,-21,5,-26
45,6,41,3,8,0,60,65,52,74,75,83,59,59,57,45,62,31,46.0,46.0,-31,17,-48
222,7,41,3,8,0,300,349,309,286,341,430,189,295,303,192,237,256,246.0,228.0,19,45,-26
83,8,41,3,8,0,86,76,58,62,78,105,64,83,78,62,75,85,80.0,74.0,10,13,-3
844,9,41,3,8,0,827,959,887,972,1235,1009,443,848,749,579,865,757,811.0,734.0,-108,286,-394
21,10,41,3,8,0,35,23,23,13,26,34,17,20,12,20,22,16,19.0,19.0,-6,2,-8
319,11,41,3,8,0,384,352,323,380,481,397,258,351,301,241,305,301,303.0,282.0,-4,64,-68
20,12,41,3,8,0,41,44,29,35,37,61,16,26,40,25,30,32,31.0,29.0,2,5,-3
230,13,41,3,8,0,259,229,234,231,316,308,172,236,271,218,215,233,224.0,222.0,18,-3,21
161,14,41,3,8,0,209,192,150,188,209,242,134,155,146,105,140,155,148.0,133.0,15,35,-20
283,15,41,3,8,0,300,252,293,323,375,353,222,270,371,311,449,354,402.0,371.0,-95,138,-233
59,16,41,3,8,0,58,58,26,64,62,54,47,52,51,39,64,44,54.0,49.0,-20,25,-45
38,17,41,3,8,0,26,47,25,31,44,54,26,27,28,26,30,22,26.0,26.0,-8,4,-12
57,18,41,3,8,0,64,42,57,83,105,92,41,56,43,37,75,57,66.0,56.0,-18,38,-56
163,19,41,3,8,0,176,181,127,153,187,158,103,124,129,115,148,126,137.0,130.0,-22,33,-55
21,20,41,3,8,0,22,19,17,12,27,22,12,27,12,19,15,18,16.0,17.0,3,-4,7
20,21,41,3,8,0,34,19,25,29,46,61,16,38,37,27,23,27,25.0,26.0,4,-4,8
70,22,41,3,8,0,78,77,62,61,65,66,41,61,62,37,56,42,49.0,45.0,-14,19,-33
313,1,42,1,8,0,233,237,260,331,369,161,142,190,140,165,214,189,202.0,189.0,-25,49,-74
379,2,42,1,8,0,351,388,519,521,651,386,202,309,233,292,232,382,307.0,302.0,150,-60,210
187,3,42,1,8,0,149,181,185,190,234,146,90,139,127,131,111,141,126.0,128.0,30,-20,50
130,4,42,1,8,0,271,313,223,301,382,210,141,181,149,153,130,100,115.0,128.0,-30,-23,-7
617,5,42,1,8,0,384,645,492,617,839,509,240,360,342,344,334,430,382.0,369.0,96,-10,106
415,6,42,1,8,0,429,508,453,504,690,387,163,254,266,293,273,348,310.0,305.0,75,-20,95
847,7,42,1,8,0,642,825,774,709,964,444,303,464,570,555,507,649,578.0,570.0,142,-48,190
331,8,42,1,8,0,300,278,277,302,443,175,132,238,204,221,191,257,224.0,223.0,66,-30,96
3296,9,42,1,8,0,3466,3967,4449,4901,5547,3229,1517,2906,3040,2996,3064,2940,3002.0,3000.0,-124,68,-192
353,10,42,1,8,0,375,362,434,458,665,381,181,321,247,278,230,271,250.0,260.0,41,-48,89
923,11,42,1,8,0,910,875,888,974,1139,690,508,722,614,698,656,855,756.0,736.0,199,-42,241
354,12,42,1,8,0,283,440,408,499,625,381,184,276,300,321,252,286,269.0,286.0,34,-69,103
794,13,42,1,8,0,560,591,602,602,830,407,320,433,514,507,400,601,500.0,503.0,201,-107,308
853,14,42,1,8,0,574,666,620,614,920,507,247,499,530,473,405,626,516.0,501.0,221,-68,289
1255,15,42,1,8,0,968,1148,998,1169,1424,732,558,806,842,817,859,969,914.0,882.0,110,42,68
774,16,42,1,8,0,764,987,818,1066,1347,698,270,511,498,504,540,672,606.0,572.0,132,36,96
729,17,42,1,8,0,503,752,630,700,988,570,203,418,421,498,401,577,489.0,492.0,176,-97,273
765,18,42,1,8,0,671,676,754,796,1043,605,368,580,595,656,635,615,625.0,635.0,-20,-21,1
581,19,42,1,8,0,472,553,433,460,600,253,193,341,357,363,293,369,331.0,342.0,76,-70,146
163,20,42,1,8,0,172,243,227,222,229,139,105,116,140,127,159,132,146.0,139.0,-27,32,-59
252,21,42,1,8,0,164,191,253,229,293,140,96,140,126,155,135,199,167.0,163.0,64,-20,84
390,22,42,1,8,0,372,256,198,199,322,111,123,264,218,232,182,233,208.0,216.0,51,-50,101
325,1,43,2,8,0,368,455,354,457,516,264,193,369,368,312,223,311,267.0,282.0,88,-89,177
92,2,43,2,8,0,137,168,236,233,253,206,111,144,116,120,119,120,120.0,120.0,1,-1,2
175,3,43,2,8,0,148,180,212,200,238,219,114,172,145,184,185,176,180.0,182.0,-9,1,-10
390,4,43,2,8,0,704,733,603,754,1094,601,390,482,397,375,385,359,372.0,373.0,-26,10,-36
353,5,43,2,8,0,280,498,363,489,543,391,237,325,296,251,270,231,250.0,251.0,-39,19,-58
233,6,43,2,8,0,361,472,444,568,578,495,153,185,233,254,279,190,234.0,241.0,-89,25,-114
746,7,43,2,8,0,771,1001,1018,1094,1221,1031,476,846,727,791,753,709,731.0,751.0,-44,-38,-6
331,8,43,2,8,0,398,381,370,395,605,316,221,369,335,297,249,379,314.0,308.0,130,-48,178
2251,9,43,2,8,0,2292,2762,3019,3563,3747,2666,1125,2377,2460,2143,2250,2148,2199.0,2180.0,-102,107,-209
130,10,43,2,8,0,132,134,146,194,174,193,92,119,101,114,104,103,104.0,107.0,-1,-10,9
813,11,43,2,8,0,1139,1155,1292,1491,1524,1070,552,1008,901,895,803,803,803.0,834.0,0,-92,92
208,12,43,2,8,0,206,280,258,340,409,346,81,166,179,201,165,187,176.0,184.0,22,-36,58
800,13,43,2,8,0,819,812,975,971,1119,789,422,734,762,790,652,806,729.0,749.0,154,-138,292
417,14,43,2,8,0,519,592,609,805,866,692,326,488,531,450,448,469,458.0,456.0,21,-2,23
1239,15,43,2,8,0,1100,1259,1371,1516,1515,1138,549,969,1010,1108,1385,1507,1446.0,1333.0,122,277,-155
489,16,43,2,8,0,475,707,729,779,906,749,253,446,434,381,436,412,424.0,410.0,-24,55,-79
373,17,43,2,8,0,419,626,645,767,839,710,238,437,402,430,431,398,414.0,420.0,-33,1,-34
322,18,43,2,8,0,389,434,571,612,638,509,288,542,508,519,527,327,427.0,458.0,-200,8,-208
875,19,43,2,8,0,1068,1256,1020,1269,1395,898,506,962,872,971,851,914,882.0,912.0,63,-120,183
125,20,43,2,8,0,190,183,170,200,213,159,106,164,130,104,160,133,146.0,132.0,-27,56,-83
160,21,43,2,8,0,246,251,273,309,371,227,159,225,195,179,129,173,151.0,160.0,44,-50,94
522,22,43,2,8,0,659,536,422,639,783,366,217,537,358,448,306,533,420.0,429.0,227,-142,369
239,1,44,1,8,0,231,263,186,304,291,260,125,252,169,218,208,195,202.0,207.0,-13,-10,-3
64,2,44,1,8,0,70,45,62,97,95,78,48,59,48,61,43,79,61.0,61.0,36,-18,54
64,3,44,1,8,0,48,53,57,54,64,35,18,51,53,69,55,61,58.0,62.0,6,-14,20
482,4,44,1,8,0,431,542,458,551,739,435,233,445,341,391,396,426,411.0,404.0,30,5,25
233,5,44,1,8,0,192,406,218,246,296,270,133,178,212,190,231,208,220.0,210.0,-23,41,-64
75,6,44,1,8,0,102,108,119,125,125,156,59,89,69,81,70,72,71.0,74.0,2,-11,13
249,7,44,1,8,0,236,259,209,228,356,218,112,223,197,226,179,193,186.0,199.0,14,-47,61
44,8,44,1,8,0,38,29,27,53,51,47,21,35,29,43,35,45,40.0,41.0,10,-8,18
362,9,44,1,8,0,283,319,341,442,572,437,152,310,246,338,497,305,401.0,380.0,-192,159,-351
44,10,44,1,8,0,47,48,35,38,46,44,34,25,32,38,35,50,42.0,41.0,15,-3,18
223,11,44,1,8,0,202,235,218,248,301,251,138,200,177,214,189,187,188.0,197.0,-2,-25,23
67,12,44,1,8,0,63,74,57,75,92,84,32,51,53,76,51,70,60.0,66.0,19,-25,44
162,13,44,1,8,0,106,81,95,123,131,106,79,112,113,144,111,129,120.0,128.0,18,-33,51
163,14,44,1,8,0,133,136,137,144,187,131,57,111,155,108,118,135,126.0,120.0,17,10,7
130,15,44,1,8,0,123,127,129,149,230,149,78,139,107,108,142,110,126.0,120.0,-32,34,-66
157,16,44,1,8,0,88,128,132,148,184,148,61,111,94,101,110,110,110.0,107.0,0,9,-9
135,17,44,1,8,0,129,125,121,157,211,135,74,132,109,108,118,96,107.0,107.0,-22,10,-32
85,18,44,1,8,0,79,63,93,111,124,108,57,77,71,97,95,75,85.0,89.0,-20,-2,-18
152,19,44,1,8,0,129,93,93,126,129,69,51,75,76,107,67,96,82.0,90.0,29,-40,69
142,20,44,1,8,0,91,113,105,132,160,125,77,112,97,87,149,112,130.0,116.0,-37,62,-99
144,21,44,1,8,0,114,118,176,150,182,148,77,137,111,172,117,112,114.0,134.0,-5,-55,50
100,22,44,1,8,0,83,64,44,71,77,53,34,68,53,50,51,50,50.0,50.0,-1,1,-2
95,1,45,1,8,0,182,195,186,244,388,154,85,126,92,105,104,90,97.0,100.0,-14,-1,-13
60,2,45,1,8,0,175,199,190,214,267,194,91,60,53,77,69,54,62.0,67.0,-15,-8,-7
87,3,45,1,8,0,129,117,180,167,259,127,62,61,62,68,40,53,46.0,54.0,13,-28,41
16,4,45,1,8,0,189,195,143,181,370,71,41,51,25,21,23,21,22.0,22.0,-2,2,-4
152,5,45,1,8,0,271,451,335,432,691,448,194,129,110,118,105,113,109.0,112.0,8,-13,21
229,6,45,1,8,0,615,665,719,699,1253,712,250,227,217,259,222,209,216.0,230.0,-13,-37,24
297,7,45,1,8,0,598,799,850,792,1449,549,320,297,347,332,246,290,268.0,289.0,44,-86,130
92,8,45,1,8,0,180,176,226,231,426,153,81,103,83,114,108,86,97.0,103.0,-22,-6,-16
271,9,45,1,8,0,682,810,953,1204,1628,496,168,342,246,344,349,247,298.0,313.0,-102,5,-107
45,10,45,1,8,0,93,96,119,135,240,121,56,54,26,39,23,31,27.0,31.0,8,-16,24
347,11,45,1,8,0,879,928,1050,1083,1908,768,543,404,402,487,371,340,356.0,399.0,-31,-116,85
163,12,45,1,8,0,256,368,358,434,733,453,153,150,168,191,126,131,128.0,149.0,5,-65,70
321,13,45,1,8,0,513,576,665,667,1158,476,272,257,300,350,276,304,290.0,310.0,28,-74,102
290,14,45,1,8,0,728,823,894,1006,1883,910,372,312,380,366,295,321,308.0,327.0,26,-71,97
410,15,45,1,8,0,806,968,1022,1202,2202,744,430,386,337,361,407,360,384.0,376.0,-47,46,-93
118,16,45,1,8,0,236,278,353,409,749,443,143,138,130,145,146,117,132.0,136.0,-29,1,-30
150,17,45,1,8,0,263,352,322,439,744,378,131,137,149,138,134,113,124.0,128.0,-21,-4,-17
127,18,45,1,8,0,197,242,345,391,594,265,149,173,130,137,127,100,114.0,121.0,-27,-10,-17
66,19,45,1,8,0,166,151,176,186,256,75,62,80,75,84,47,39,43.0,57.0,-8,-37,29
21,20,45,1,8,0,81,101,86,92,172,124,38,29,23,20,27,17,22.0,21.0,-10,7,-17
82,21,45,1,8,0,126,155,205,212,325,144,79,70,64,97,57,67,62.0,74.0,10,-40,50
44,22,45,1,8,0,138,116,107,126,152,43,36,52,38,43,41,34,38.0,39.0,-7,-2,-5
8,1,46,1,8,0,93,94,69,88,96,65,19,37,175,5,12,7,10.0,8.0,-5,7,-12
66,2,46,1,8,0,181,192,214,209,182,216,75,82,86,83,57,67,62.0,69.0,10,-26,36
46,3,46,1,8,0,130,174,176,130,141,132,46,66,45,69,41,38,40.0,49.0,-3,-28,25
15,4,46,1,8,0,229,259,158,186,277,124,81,65,48,29,26,33,30.0,29.0,7,-3,10
44,5,46,1,8,0,249,374,267,205,292,350,117,93,78,81,64,97,80.0,81.0,33,-17,50
99,6,46,1,8,0,409,407,332,341,384,513,121,108,92,90,118,107,112.0,105.0,-11,28,-39
127,7,46,1,8,0,578,669,572,480,596,555,214,153,209,203,175,145,160.0,174.0,-30,-28,-2
3,8,46,1,8,0,105,82,89,70,67,66,26,12,22,19,12,23,18.0,18.0,11,-7,18
25,9,46,1,8,0,130,99,91,101,84,62,19,63,37,30,29,26,28.0,28.0,-3,-1,-2
5,10,46,1,8,0,47,57,42,39,50,45,14,26,20,6,2,8,5.0,5.0,6,-4,10
86,11,46,1,8,0,652,534,502,474,569,538,214,216,188,191,134,129,132.0,151.0,-5,-57,52
62,12,46,1,8,0,361,423,281,274,309,360,94,101,91,90,79,82,80.0,84.0,3,-11,14
91,13,46,1,8,0,474,378,372,326,383,353,154,150,162,149,131,144,138.0,141.0,13,-18,31
63,14,46,1,8,0,516,505,471,372,457,538,139,100,129,104,87,70,78.0,87.0,-17,-17,0
89,15,46,1,8,0,619,525,437,429,453,388,129,152,151,108,106,91,98.0,102.0,-15,-2,-13
65,16,46,1,8,0,348,470,379,317,421,474,120,139,119,158,186,109,148.0,151.0,-77,28,-105
92,17,46,1,8,0,394,455,353,348,428,459,95,148,114,114,115,100,108.0,110.0,-15,1,-16
28,18,46,1,8,0,140,150,148,127,159,136,38,44,37,55,51,15,33.0,40.0,-36,-4,-32
48,19,46,1,8,0,236,239,216,174,238,151,59,93,137,105,53,60,56.0,73.0,7,-52,59
15,20,46,1,8,0,160,119,108,151,126,110,41,27,16,19,16,22,19.0,19.0,6,-3,9
86,21,46,1,8,0,241,219,279,210,288,180,80,67,82,94,70,81,76.0,82.0,11,-24,35
31,22,46,1,8,0,185,126,121,118,156,75,46,57,45,34,22,28,25.0,28.0,6,-12,18
272,1,47,2,8,0,260,330,188,341,384,208,78,136,169,219,267,195,231.0,227.0,-72,48,-120
126,2,47,2,8,0,152,177,216,186,206,142,56,68,79,116,111,106,108.0,111.0,-5,-5,0
70,3,47,2,8,0,118,103,121,125,115,74,44,45,52,72,39,48,44.0,53.0,9,-33,42
181,4,47,2,8,0,598,646,461,553,771,253,139,206,162,160,198,159,178.0,172.0,-39,38,-77
505,5,47,2,8,0,541,770,548,657,933,673,263,243,304,396,459,464,462.0,440.0,5,63,-58
679,6,47,2,8,0,909,849,800,764,993,964,338,340,389,526,609,640,624.0,592.0,31,83,-52
690,7,47,2,8,0,1028,1068,979,957,1332,1011,383,430,537,623,546,597,572.0,589.0,51,-77,128
130,8,47,2,8,0,260,200,213,203,275,128,67,102,111,136,137,121,129.0,131.0,-16,1,-17
732,9,47,2,8,0,1165,1341,1182,1660,1546,767,278,638,579,734,773,669,721.0,725.0,-104,39,-143
121,10,47,2,8,0,192,192,181,188,276,186,86,105,86,125,135,129,132.0,130.0,-6,10,-16
1619,11,47,2,8,0,2086,2054,2015,2022,2642,2094,991,984,1074,1356,1448,1465,1456.0,1423.0,17,92,-75
445,12,47,2,8,0,466,481,368,453,691,614,157,211,274,326,317,295,306.0,313.0,-22,-9,-13
514,13,47,2,8,0,797,728,665,667,773,530,290,330,342,436,385,393,389.0,405.0,8,-51,59
1176,14,47,2,8,0,1680,1676,1390,1577,2409,1865,640,650,891,1055,1267,1138,1202.0,1153.0,-129,212,-341
1489,15,47,2,8,0,1649,1572,1696,1832,2222,1022,501,663,715,913,1088,1232,1160.0,1078.0,144,175,-31
414,16,47,2,8,0,562,525,475,492,661,605,178,211,256,312,333,394,364.0,346.0,61,21,40
447,17,47,2,8,0,541,561,481,547,698,488,170,228,287,352,372,388,380.0,371.0,16,20,-4
303,18,47,2,8,0,418,427,469,556,601,361,197,246,246,307,332,263,298.0,301.0,-69,25,-94
154,19,47,2,8,0,309,335,246,211,328,161,100,120,120,168,137,149,143.0,151.0,12,-31,43
251,20,47,2,8,0,439,445,330,373,430,326,140,158,145,189,295,272,284.0,252.0,-23,106,-129
229,21,47,2,8,0,407,350,449,347,562,349,119,145,167,210,170,185,178.0,188.0,15,-40,55
53,22,47,2,8,0,149,133,82,97,100,69,37,53,48,62,47,72,60.0,60.0,25,-15,40
6,1,48,2,8,0,27,10,4,41,46,32,19,54,17,10,12,11,12.0,11.0,-1,2,-3
100,2,48,2,8,0,200,159,126,119,169,142,104,91,53,62,66,54,60.0,61.0,-12,4,-16
161,3,48,2,8,0,323,327,297,353,430,278,168,258,163,176,174,153,164.0,168.0,-21,-2,-19
3,4,48,2,8,0,121,96,46,78,112,52,38,30,13,7,12,11,12.0,10.0,-1,5,-6
174,5,48,2,8,0,836,723,408,517,641,617,336,250,134,145,143,161,152.0,150.0,18,-2,20
82,6,48,2,8,0,261,211,71,198,190,278,146,119,59,72,88,63,76.0,74.0,-25,16,-41
635,7,48,2,8,0,1885,1782,1445,1562,2281,1763,885,746,509,752,650,656,653.0,686.0,6,-102,108
337,8,48,2,8,0,973,842,579,768,886,691,295,401,285,317,252,283,268.0,284.0,31,-65,96
131,9,48,2,8,0,791,821,619,710,1008,472,229,471,212,177,139,130,134.0,149.0,-9,-38,29
127,10,48,2,8,0,185,191,132,192,308,251,110,119,55,137,102,134,118.0,124.0,32,-35,67
95,11,48,2,8,0,267,195,95,307,309,370,299,211,106,111,126,119,122.0,119.0,-7,15,-22
45,12,48,2,8,0,138,145,60,177,182,224,84,107,42,42,52,41,46.0,45.0,-11,10,-21
852,13,48,2,8,0,2125,1949,1092,1644,1840,1468,940,941,733,782,635,713,674.0,710.0,78,-147,225
284,14,48,2,8,0,693,546,306,774,911,1101,433,362,211,283,281,280,280.0,281.0,-1,-2,1
223,15,48,2,8,0,202,149,42,380,352,327,197,195,168,241,204,240,222.0,228.0,36,-37,73
44,16,48,2,8,0,123,100,46,116,125,211,58,65,32,39,46,41,44.0,42.0,-5,7,-12
47,17,48,2,8,0,142,140,74,141,165,230,105,87,42,50,62,55,58.0,56.0,-7,12,-19
58,18,48,2,8,0,219,159,110,281,215,204,105,130,66,70,71,48,60.0,63.0,-23,1,-24
244,19,48,2,8,0,715,654,384,528,619,375,317,409,425,215,168,173,170.0,185.0,5,-47,52
26,20,48,2,8,0,170,119,62,80,104,116,61,54,25,34,33,27,30.0,31.0,-6,-1,-5
123,21,48,2,8,0,331,168,145,214,250,261,108,136,75,123,125,148,136.0,132.0,23,2,21
118,22,48,2,8,0,328,302,291,350,342,207,144,192,137,117,137,97,117.0,117.0,-40,20,-60
286,1,49,1,8,0,321,371,283,435,596,174,80,151,177,200,272,204,238.0,225.0,-68,72,-140
233,2,49,1,8,0,368,477,514,538,699,444,236,185,176,241,235,239,237.0,238.0,4,-6,10
244,3,49,1,8,0,328,337,354,323,485,221,94,125,138,233,182,202,192.0,206.0,20,-51,71
271,4,49,1,8,0,785,877,636,879,1517,309,174,289,242,251,279,287,283.0,272.0,8,28,-20
444,5,49,1,8,0,602,1020,712,770,1305,743,339,285,287,359,363,364,364.0,362.0,1,4,-3
843,6,49,1,8,0,834,1066,894,964,1597,855,344,344,422,524,660,677,668.0,620.0,17,136,-119
808,7,49,1,8,0,998,1278,1160,1107,1740,687,383,327,543,829,670,841,756.0,780.0,171,-159,330
212,8,49,1,8,0,301,280,282,301,514,192,100,117,126,207,172,186,179.0,188.0,14,-35,49
479,9,49,1,8,0,890,1382,1240,1586,1899,542,186,403,360,460,604,483,544.0,516.0,-121,144,-265
118,10,49,1,8,0,232,277,266,309,514,260,96,110,81,120,111,123,117.0,118.0,12,-9,21
876,11,49,1,8,0,1345,1406,1396,1446,2279,939,574,593,645,899,941,918,930.0,919.0,-23,42,-65
439,12,49,1,8,0,409,638,519,571,900,502,180,199,229,302,289,342,316.0,311.0,53,-13,66
1013,13,49,1,8,0,929,1066,990,1108,1749,708,414,412,600,843,768,843,806.0,818.0,75,-75,150
1046,14,49,1,8,0,1438,1525,1493,1622,2735,1331,509,557,792,1003,1139,1208,1174.0,1117.0,69,136,-67
1449,15,49,1,8,0,1635,1804,1911,2130,3255,1119,581,616,676,899,1179,1212,1196.0,1097.0,33,280,-247
417,16,49,1,8,0,485,678,560,634,1014,597,202,210,256,309,467,354,410.0,377.0,-113,158,-271
368,17,49,1,8,0,473,712,546,606,978,498,212,209,272,280,287,311,299.0,293.0,24,7,17
193,18,49,1,8,0,291,406,499,552,782,311,141,184,131,214,223,160,192.0,199.0,-63,9,-72
170,19,49,1,8,0,283,315,299,258,424,127,80,97,131,161,165,176,170.0,167.0,11,4,7
159,20,49,1,8,0,277,336,267,309,532,260,104,78,93,126,161,148,154.0,145.0,-13,35,-48
363,21,49,1,8,0,326,373,472,366,620,315,130,154,179,263,204,263,234.0,243.0,59,-59,118
116,22,49,1,8,0,237,206,170,232,274,80,52,66,71,97,87,91,89.0,92.0,4,-10,14
154,1,50,4,8,0,249,257,239,345,396,369,177,174,163,140,140,130,135.0,137.0,-10,0,-10
227,2,50,4,8,0,344,358,406,373,334,203,134,207,159,159,199,202,200.0,187.0,3,40,-37
40,3,50,4,8,0,160,123,116,59,90,51,29,42,27,40,31,39,35.0,37.0,8,-9,17
41,4,50,4,8,0,139,203,168,222,242,93,60,87,42,47,47,40,44.0,45.0,-7,0,-7
417,5,50,4,8,0,625,731,758,778,781,288,239,321,272,333,406,352,379.0,364.0,-54,73,-127
345,6,50,4,8,0,570,630,644,607,661,309,266,301,237,309,289,297,293.0,298.0,8,-20,28
432,7,50,4,8,0,690,772,807,782,994,540,419,572,464,433,395,383,389.0,404.0,-12,-38,26
105,8,50,4,8,0,287,240,200,132,201,88,44,87,60,67,72,87,80.0,75.0,15,5,10
461,9,50,4,8,0,516,619,721,938,1135,331,231,477,411,394,418,380,399.0,397.0,-38,24,-62
124,10,50,4,8,0,301,268,247,370,403,140,92,140,131,131,161,121,141.0,138.0,-40,30,-70
701,11,50,4,8,0,1017,1020,1227,1286,1781,805,710,885,641,740,693,656,674.0,696.0,-37,-47,10
219,12,50,4,8,0,285,391,438,444,431,157,97,173,170,210,195,175,185.0,193.0,-20,-15,-5
455,13,50,4,8,0,734,729,766,589,806,391,375,484,404,455,438,404,421.0,432.0,-34,-17,-17
446,14,50,4,8,0,854,777,834,729,896,363,334,528,418,445,554,381,468.0,460.0,-173,109,-282
473,15,50,4,8,0,510,573,616,797,1044,341,386,475,363,466,458,443,450.0,456.0,-15,-8,-7
200,16,50,4,8,0,357,375,452,413,461,270,123,194,119,150,177,181,179.0,169.0,4,27,-23
195,17,50,4,8,0,292,394,414,458,478,157,99,182,167,188,184,200,192.0,191.0,16,-4,20
225,18,50,4,8,0,328,339,397,455,593,250,154,266,219,283,228,214,221.0,242.0,-14,-55,41
67,19,50,4,8,0,151,144,114,136,149,45,36,75,66,76,84,71,78.0,77.0,-13,8,-21
123,20,50,4,8,0,410,422,402,422,475,136,124,148,136,160,225,137,181.0,174.0,-88,65,-153
204,21,50,4,8,0,494,446,595,355,464,194,145,188,141,176,186,164,175.0,175.0,-22,10,-32
38,22,50,4,8,0,202,237,176,82,87,40,47,82,54,34,48,39,44.0,40.0,-9,14,-23
352,1,51,2,8,0,427,420,355,228,579,371,131,288,266,225,283,286,284.0,265.0,3,58,-55
170,2,51,2,8,0,214,200,244,165,338,215,134,179,192,167,169,217,193.0,184.0,48,2,46
60,3,51,2,8,0,34,40,41,43,48,41,28,59,37,53,61,54,58.0,56.0,-7,8,-15
94,4,51,2,8,0,267,304,268,372,383,131,61,110,108,70,103,89,96.0,87.0,-14,33,-47
571,5,51,2,8,0,370,632,431,484,820,550,286,428,433,456,497,476,486.0,476.0,-21,41,-62
558,6,51,2,8,0,443,521,495,362,758,508,322,432,425,545,563,499,531.0,536.0,-64,18,-82
413,7,51,2,8,0,357,410,423,383,729,410,227,320,381,388,394,345,370.0,376.0,-49,6,-55
56,8,51,2,8,0,51,78,61,91,136,74,57,53,62,47,59,62,60.0,56.0,3,12,-9
1225,9,51,2,8,0,1153,1298,1305,1034,2232,1023,444,1072,1007,969,1190,954,1072.0,1038.0,-236,221,-457
211,10,51,2,8,0,217,237,215,191,328,208,107,160,131,178,209,223,216.0,203.0,14,31,-17
1132,11,51,2,8,0,1153,1190,1239,807,1846,1142,747,1023,870,969,1040,1045,1042.0,1018.0,5,71,-66
304,12,51,2,8,0,232,306,226,131,436,290,111,237,235,226,237,243,240.0,235.0,6,11,-5
444,13,51,2,8,0,316,360,308,272,475,287,194,265,298,335,339,355,347.0,343.0,16,4,12
547,14,51,2,8,0,509,554,543,420,747,459,249,457,513,513,571,508,540.0,531.0,-63,58,-121
1202,15,51,2,8,0,743,824,856,695,1454,752,503,780,679,725,759,836,798.0,773.0,77,34,43
390,16,51,2,8,0,250,304,278,190,481,312,158,246,258,251,428,347,388.0,342.0,-81,177,-258
344,17,51,2,8,0,283,329,289,235,425,324,139,263,238,293,308,308,308.0,303.0,0,15,-15
485,18,51,2,8,0,411,469,472,415,699,508,260,395,323,426,506,406,456.0,446.0,-100,80,-180
143,19,51,2,8,0,128,154,125,64,125,66,52,82,116,125,102,110,106.0,112.0,8,-23,31
285,20,51,2,8,0,300,389,322,256,548,310,185,288,287,285,378,280,329.0,314.0,-98,93,-191
184,21,51,2,8,0,175,188,226,181,259,170,96,124,121,134,165,167,166.0,155.0,2,31,-29
68,22,51,2,8,0,86,84,67,65,115,61,52,76,85,53,52,53,52.0,53.0,1,-1,2
306,1,52,1,8,0,327,336,292,421,473,415,199,338,303,272,297,230,264.0,266.0,-67,25,-92
299,2,52,1,8,0,320,316,363,485,535,500,259,353,295,304,293,320,306.0,306.0,27,-11,38
197,3,52,1,8,0,230,224,233,229,234,273,129,208,180,191,167,194,180.0,184.0,27,-24,51
360,4,52,1,8,0,424,442,429,500,681,534,295,402,398,365,374,341,358.0,360.0,-33,9,-42
460,5,52,1,8,0,495,659,704,743,849,933,442,540,493,508,553,476,514.0,512.0,-77,45,-122
185,6,52,1,8,0,249,314,271,334,368,404,198,210,162,176,206,197,202.0,193.0,-9,30,-39
522,7,52,1,8,0,617,771,679,776,936,911,376,595,546,558,596,483,540.0,546.0,-113,38,-151
143,8,52,1,8,0,131,135,142,208,244,213,113,141,101,103,104,107,106.0,105.0,3,1,2
969,9,52,1,8,0,1145,1408,1392,1836,2078,1526,521,1068,875,905,1067,825,946.0,932.0,-242,162,-404
172,10,52,1,8,0,212,207,208,246,317,323,145,236,156,189,166,140,153.0,165.0,-26,-23,-3
500,11,52,1,8,0,616,611,660,847,820,821,461,589,458,423,545,436,490.0,468.0,-109,122,-231
149,12,52,1,8,0,215,215,187,249,262,297,113,164,151,133,139,150,144.0,141.0,11,6,5
501,13,52,1,8,0,528,576,625,746,750,758,431,483,470,474,415,495,455.0,461.0,80,-59,139
493,14,52,1,8,0,623,596,604,752,820,826,447,615,567,493,543,423,483.0,486.0,-120,50,-170
322,15,52,1,8,0,379,387,524,623,684,550,252,401,254,311,325,307,316.0,314.0,-18,14,-32
273,16,52,1,8,0,311,346,310,385,425,481,197,299,246,238,274,238,256.0,250.0,-36,36,-72
336,17,52,1,8,0,384,424,364,460,493,505,239,383,321,315,341,325,333.0,327.0,-16,26,-42
139,18,52,1,8,0,222,223,268,329,338,400,163,217,128,161,123,141,132.0,142.0,18,-38,56
274,19,52,1,8,0,324,364,303,369,450,249,117,274,320,298,258,236,247.0,264.0,-22,-40,18
285,20,52,1,8,0,372,406,400,540,575,576,284,403,314,306,439,296,368.0,347.0,-143,133,-276
229,21,52,1,8,0,275,293,365,346,404,376,178,272,285,266,201,203,202.0,223.0,2,-65,67
251,22,52,1,8,0,356,331,302,341,410,324,206,341,242,239,273,292,282.0,268.0,19,34,-15
261,1,53,2,8,0,617,628,446,636,846,241,179,180,191,192,253,247,250.0,231.0,-6,61,-67
166,2,53,2,8,0,189,278,304,365,493,290,145,117,124,158,128,183,156.0,156.0,55,-30,85
110,3,53,2,8,0,136,222,206,310,562,284,123,119,71,119,101,97,99.0,106.0,-4,-18,14
57,4,53,2,8,0,473,498,257,444,824,105,71,55,60,50,59,51,55.0,53.0,-8,9,-17
607,5,53,2,8,0,777,1042,762,1080,1730,983,504,400,394,380,436,516,476.0,444.0,80,56,24
770,6,53,2,8,0,973,1078,1023,1260,2243,1186,528,593,566,477,521,594,558.0,531.0,73,44,29
836,7,53,2,8,0,1294,1622,1536,1637,2998,1261,553,503,551,645,651,724,688.0,673.0,73,6,67
230,8,53,2,8,0,272,308,299,372,645,313,178,140,164,178,173,195,184.0,182.0,22,-5,27
1007,9,53,2,8,0,1670,1369,1274,1967,3191,905,337,855,959,831,614,794,704.0,746.0,180,-217,397
252,10,53,2,8,0,188,232,252,337,697,471,179,227,188,213,224,204,214.0,214.0,-20,11,-31
897,11,53,2,8,0,2067,2163,1918,2283,3836,1631,972,777,763,993,802,889,846.0,895.0,87,-191,278
344,12,53,2,8,0,440,542,547,676,1270,658,229,229,221,283,227,273,250.0,261.0,46,-56,102
666,13,53,2,8,0,909,987,969,1064,2232,950,551,442,578,697,555,544,550.0,599.0,-11,-142,131
1300,14,53,2,8,0,1337,1548,1431,1720,3243,1894,828,807,1011,1085,1013,1189,1101.0,1096.0,176,-72,248
565,15,53,2,8,0,1003,1067,1140,1205,1850,574,328,328,361,426,423,467,445.0,439.0,44,-3,47
230,16,53,2,8,0,435,576,710,866,1354,755,244,256,243,222,247,223,235.0,231.0,-24,25,-49
511,17,53,2,8,0,709,844,687,982,1756,938,322,403,371,448,412,466,439.0,442.0,54,-36,90
338,18,53,2,8,0,486,645,645,746,1041,462,182,250,215,304,238,233,236.0,258.0,-5,-66,61
123,19,53,2,8,0,418,415,275,422,561,181,92,144,178,144,111,123,117.0,126.0,12,-33,45
212,20,53,2,8,0,749,722,571,643,1136,557,231,195,203,189,260,190,225.0,213.0,-70,71,-141
491,21,53,2,8,0,726,652,682,805,1567,639,298,275,310,369,282,381,332.0,344.0,99,-87,186
93,22,53,2,8,0,159,164,109,207,305,102,62,72,62,93,71,101,86.0,88.0,30,-22,52
31,1,54,1,8,0,90,112,64,139,159,95,31,32,33,18,19,21,20.0,19.0,2,1,1
60,2,54,1,8,0,103,88,129,116,195,181,91,58,50,67,48,56,52.0,57.0,8,-19,27
105,3,54,1,8,0,148,178,215,227,336,327,113,110,91,126,86,83,84.0,98.0,-3,-40,37
21,4,54,1,8,0,107,124,113,153,246,99,35,29,28,28,17,19,18.0,21.0,2,-11,13
114,5,54,1,8,0,165,260,194,267,387,398,155,108,95,80,69,76,72.0,75.0,7,-11,18
112,6,54,1,8,0,228,277,262,301,471,484,121,103,101,118,103,101,102.0,107.0,-2,-15,13
332,7,54,1,8,0,565,670,629,591,961,723,263,300,312,311,242,273,258.0,275.0,31,-69,100
92,8,54,1,8,0,106,92,114,133,167,149,66,59,57,51,58,45,52.0,51.0,-13,7,-20
38,9,54,1,8,0,112,111,142,134,176,97,19,44,38,31,35,30,32.0,32.0,-5,4,-9
18,10,54,1,8,0,46,27,44,52,62,66,20,31,15,25,9,23,16.0,19.0,14,-16,30
80,11,54,1,8,0,275,222,289,312,450,333,168,137,94,101,95,97,96.0,98.0,2,-6,8
86,12,54,1,8,0,123,158,141,164,252,264,69,58,63,82,66,58,62.0,69.0,-8,-16,8
221,13,54,1,8,0,251,268,281,338,473,362,182,165,226,205,142,157,150.0,168.0,15,-63,78
237,14,54,1,8,0,438,436,457,535,679,669,213,223,212,206,190,239,214.0,212.0,49,-16,65
53,15,54,1,8,0,144,152,167,161,255,131,59,54,69,64,57,47,52.0,56.0,-10,-7,-3
127,16,54,1,8,0,169,231,258,278,385,450,105,110,104,89,90,81,86.0,87.0,-9,1,-10
308,17,54,1,8,0,320,453,378,533,776,857,222,262,247,257,219,243,231.0,240.0,24,-38,62
25,18,54,1,8,0,38,50,51,83,65,41,21,20,20,33,19,21,20.0,24.0,2,-14,16
59,19,54,1,8,0,115,152,128,129,166,109,50,66,72,45,46,43,44.0,45.0,-3,1,-4
84,20,54,1,8,0,149,157,175,189,306,256,58,77,65,70,84,67,76.0,74.0,-17,14,-31
222,21,54,1,8,0,298,329,421,381,634,493,193,190,176,193,161,204,182.0,186.0,43,-32,75
59,22,54,1,8,0,165,141,126,204,277,131,70,96,70,62,54,66,60.0,61.0,12,-8,20
104,1,55,1,8,0,176,188,167,211,361,138,71,95,74,75,111,81,96.0,89.0,-30,36,-66
379,2,55,1,8,0,402,486,521,434,743,406,299,256,259,276,323,373,348.0,324.0,50,47,3
339,3,55,1,8,0,255,374,366,390,683,304,135,211,181,248,260,314,287.0,274.0,54,12,42
103,4,55,1,8,0,388,458,302,357,675,173,56,121,79,138,89,102,96.0,110.0,13,-49,62
1182,5,55,1,8,0,1222,1530,1137,1318,2057,1186,681,782,644,814,979,1044,1012.0,946.0,65,165,-100
346,6,55,1,8,0,463,479,476,493,865,574,194,213,248,307,345,317,331.0,323.0,-28,38,-66
774,7,55,1,8,0,875,922,870,894,1538,723,282,412,473,536,614,680,647.0,610.0,66,78,-12
816,8,55,1,8,0,454,470,495,510,974,417,214,254,346,509,560,656,608.0,575.0,96,51,45
578,9,55,1,8,0,610,730,702,768,1105,569,259,493,354,430,585,484,534.0,500.0,-101,155,-256
217,10,55,1,8,0,175,217,208,212,406,260,101,165,105,174,218,194,206.0,195.0,-24,44,-68
609,11,55,1,8,0,768,765,828,786,1332,698,402,409,494,495,557,550,554.0,534.0,-7,62,-69
295,12,55,1,8,0,281,350,363,356,774,420,110,193,205,216,298,283,290.0,266.0,-15,82,-97
1295,13,55,1,8,0,937,936,974,964,2069,891,397,516,929,990,983,1137,1060.0,1037.0,154,-7,161
966,14,55,1,8,0,900,924,913,934,1916,1026,330,387,521,645,908,946,927.0,833.0,38,263,-225
467,15,55,1,8,0,561,604,663,556,982,370,195,281,311,304,395,371,383.0,357.0,-24,91,-115
243,16,55,1,8,0,301,385,300,389,721,401,105,159,186,195,272,290,281.0,252.0,18,77,-59
425,17,55,1,8,0,548,722,567,687,1290,631,205,298,333,363,464,424,444.0,417.0,-40,101,-141
198,18,55,1,8,0,178,217,240,253,385,180,95,138,114,150,154,163,158.0,156.0,9,4,5
200,19,55,1,8,0,251,209,211,226,330,135,104,181,144,138,167,145,156.0,150.0,-22,29,-51
639,20,55,1,8,0,970,909,844,751,1420,661,420,464,477,481,631,557,594.0,556.0,-74,150,-224
690,21,55,1,8,0,540,574,623,639,1234,604,184,336,402,415,468,687,578.0,523.0,219,53,166
165,22,55,1,8,0,146,126,126,150,236,76,111,111,78,108,134,127,130.0,123.0,-7,26,-33
379,1,56,1,8,0,484,500,412,620,805,357,95,198,187,218,252,286,269.0,252.0,34,34,0
801,2,56,1,8,0,806,851,856,921,1249,829,418,522,444,470,542,766,654.0,593.0,224,72,152
688,3,56,1,8,0,507,500,528,675,925,601,288,415,322,461,499,595,547.0,518.0,96,38,58
320,4,56,1,8,0,743,672,532,779,1421,437,212,313,278,276,253,302,278.0,277.0,49,-23,72
1846,5,56,1,8,0,1757,2178,1620,1861,2915,2183,903,1084,938,1042,1247,1538,1392.0,1276.0,291,205,86
712,6,56,1,8,0,690,798,757,934,1307,1141,304,330,322,356,545,585,565.0,495.0,40,189,-149
1189,7,56,1,8,0,1173,1160,1214,1192,1610,1006,389,569,611,624,776,1014,895.0,805.0,238,152,86
733,8,56,1,8,0,582,505,511,601,970,406,198,368,305,370,503,552,528.0,475.0,49,133,-84
1550,9,56,1,8,0,1347,1576,1507,1902,2685,1203,341,825,879,785,1142,1134,1138.0,1020.0,-8,357,-365
330,10,56,1,8,0,394,347,352,440,665,433,149,235,168,197,226,296,261.0,240.0,70,29,41
1671,11,56,1,8,0,1794,1646,1598,1955,2752,1481,650,861,854,961,1280,1420,1350.0,1220.0,140,319,-179
475,12,56,1,8,0,443,510,475,511,802,624,159,229,268,266,354,440,397.0,353.0,86,88,-2
1423,13,56,1,8,0,985,1009,905,1021,1551,970,478,608,767,810,890,1254,1072.0,985.0,364,80,284
1789,14,56,1,8,0,1361,1342,1399,1530,2696,1928,502,672,701,850,1415,1787,1601.0,1351.0,372,565,-193
1486,15,56,1,8,0,1247,1320,1351,1499,2124,704,292,530,641,696,932,1254,1093.0,961.0,322,236,86
643,16,56,1,8,0,614,653,620,794,1252,837,201,313,330,347,462,609,536.0,473.0,147,115,32
1043,17,56,1,8,0,1241,1383,1339,1478,2360,1657,503,671,579,591,827,934,880.0,784.0,107,236,-129
470,18,56,1,8,0,425,414,399,601,698,428,129,211,219,281,359,378,368.0,339.0,19,78,-59
351,19,56,1,8,0,375,331,306,361,459,235,125,226,187,250,248,334,291.0,277.0,86,-2,88
1405,20,56,1,8,0,1592,1671,1487,1581,2727,1846,758,896,740,908,1151,1313,1232.0,1124.0,162,243,-81
975,21,56,1,8,0,758,764,827,896,1319,905,333,426,445,444,565,798,682.0,602.0,233,121,112
271,22,56,1,8,0,271,219,256,312,397,173,117,199,155,143,190,253,222.0,195.0,63,47,16
29,1,57,3,8,0,37,28,27,30,34,19,29,28,25,38,29,32,30.0,33.0,3,-9,12
755,2,57,3,8,0,1395,1639,1736,1547,1939,1680,1190,1187,815,815,786,875,830.0,825.0,89,-29,118
65,3,57,3,8,0,74,107,93,105,108,54,78,117,71,70,60,56,58.0,62.0,-4,-10,6
81,4,57,3,8,0,238,282,198,305,504,106,118,157,120,110,104,70,87.0,95.0,-34,-6,-28
514,5,57,3,8,0,742,717,655,773,955,603,645,678,519,472,474,468,471.0,471.0,-6,2,-8
130,6,57,3,8,0,194,197,214,225,272,216,223,191,165,153,149,145,147.0,149.0,-4,-4,0
431,7,57,3,8,0,631,622,551,636,1105,629,541,513,451,400,375,388,382.0,388.0,13,-25,38
103,8,57,3,8,0,103,137,118,161,233,166,115,127,118,117,113,93,103.0,108.0,-20,-4,-16
440,9,57,3,8,0,627,644,624,713,866,346,505,757,513,503,519,390,454.0,471.0,-129,16,-145
17,10,57,3,8,0,50,93,63,75,97,92,50,85,53,57,36,20,28.0,38.0,-16,-21,5
542,11,57,3,8,0,752,766,763,871,1150,610,843,857,623,558,495,522,508.0,525.0,27,-63,90
69,12,57,3,8,0,107,134,92,117,148,132,89,105,90,70,62,87,74.0,73.0,25,-8,33
609,13,57,3,8,0,574,561,554,769,983,537,616,685,621,541,500,570,535.0,537.0,70,-41,111
609,14,57,3,8,0,825,703,746,952,1314,922,778,753,612,592,519,715,617.0,609.0,196,-73,269
307,15,57,3,8,0,385,451,456,466,653,312,498,511,368,351,319,353,336.0,341.0,34,-32,66
325,16,57,3,8,0,518,582,592,590,903,514,438,482,408,403,314,306,310.0,341.0,-8,-89,81
257,17,57,3,8,0,375,366,327,426,575,405,314,375,353,267,377,276,326.0,307.0,-101,110,-211
101,18,57,3,8,0,164,156,179,175,195,85,140,157,133,146,133,94,114.0,124.0,-39,-13,-26
162,19,57,3,8,0,192,216,260,281,370,158,187,236,191,184,170,200,185.0,185.0,30,-14,44
463,20,57,3,8,0,592,643,645,706,955,636,643,771,438,521,498,470,484.0,496.0,-28,-23,-5
161,21,57,3,8,0,190,227,209,280,324,195,155,198,180,157,132,131,132.0,140.0,-1,-25,24
43,22,57,3,8,0,88,70,59,76,90,35,48,67,46,41,40,28,34.0,36.0,-12,-1,-11
68,1,58,2,8,0,176,218,159,193,281,60,52,74,61,69,81,59,70.0,70.0,-22,12,-34
113,2,58,2,8,0,192,241,224,227,356,181,119,130,103,154,125,106,116.0,128.0,-19,-29,10
79,3,58,2,8,0,63,86,129,183,244,117,67,81,65,79,55,51,53.0,62.0,-4,-24,20
170,4,58,2,8,0,464,472,326,417,805,105,52,132,97,103,144,172,158.0,140.0,28,41,-13
624,5,58,2,8,0,855,1133,824,910,1456,816,454,505,463,516,491,453,472.0,487.0,-38,-25,-13
111,6,58,2,8,0,314,310,267,287,463,251,96,133,88,118,91,110,100.0,106.0,19,-27,46
415,7,58,2,8,0,773,797,679,738,1182,600,283,311,395,408,271,332,302.0,337.0,61,-137,198
175,8,58,2,8,0,221,226,243,264,497,192,96,135,117,169,144,132,138.0,148.0,-12,-25,13
265,9,58,2,8,0,429,596,574,615,869,297,127,271,262,258,278,238,258.0,258.0,-40,20,-60
103,10,58,2,8,0,139,167,205,233,425,254,71,136,107,135,145,104,124.0,128.0,-41,10,-51
265,11,58,2,8,0,706,761,731,749,1017,461,270,342,363,373,289,260,274.0,307.0,-29,-84,55
105,12,58,2,8,0,145,229,198,198,315,211,60,84,84,68,64,78,71.0,70.0,14,-4,18
630,13,58,2,8,0,690,771,682,755,1430,754,390,398,481,498,419,459,439.0,459.0,40,-79,119
436,14,58,2,8,0,871,851,876,865,1601,892,268,371,333,363,396,440,418.0,400.0,44,33,11
235,15,58,2,8,0,370,1437,406,420,845,174,81,170,192,246,204,243,224.0,231.0,39,-42,81
63,16,58,2,8,0,88,110,128,133,246,134,39,47,55,60,48,51,50.0,53.0,3,-12,15
209,17,58,2,8,0,319,439,335,447,756,439,130,231,191,211,178,177,178.0,189.0,-1,-33,32
101,18,58,2,8,0,102,142,175,166,247,102,51,67,60,67,91,79,85.0,79.0,-12,24,-36
21,19,58,2,8,0,81,68,54,102,113,47,21,29,27,30,22,21,22.0,24.0,-1,-8,7
519,20,58,2,8,0,1602,764,548,596,1578,630,283,298,337,395,444,428,436.0,422.0,-16,49,-65
349,21,58,2,8,0,453,455,455,558,938,498,189,261,260,236,226,286,256.0,249.0,60,-10,70
17,22,58,2,8,0,28,17,16,45,45,7,10,21,11,20,18,12,15.0,17.0,-6,-2,-4
290,1,59,2,8,0,590,1049,393,448,746,228,125,223,190,233,237,1154,696.0,541.0,917,4,913
62,2,59,2,8,0,301,410,266,224,235,105,67,68,72,70,100,79,90.0,83.0,-21,30,-51
89,3,59,2,8,0,248,263,289,273,340,208,63,95,64,75,89,75,82.0,80.0,-14,14,-28
666,4,59,2,8,0,265,2528,156,179,362,72,29,64,61,50,56,417,236.0,174.0,361,6,355
315,5,59,2,8,0,1243,1666,730,631,1027,542,251,246,265,230,226,834,530.0,430.0,608,-4,612
452,6,59,2,8,0,968,961,755,678,1434,792,244,232,308,344,363,315,339.0,341.0,-48,19,-67
520,7,59,2,8,0,2848,2646,1380,1053,1685,823,326,341,453,371,362,372,367.0,368.0,10,-9,19
292,8,59,2,8,0,657,660,386,479,604,321,126,162,162,182,154,558,356.0,298.0,404,-28,432
409,9,59,2,8,0,819,1623,936,1038,1493,451,130,374,366,407,481,329,405.0,406.0,-152,74,-226
145,10,59,2,8,0,316,360,349,312,543,250,76,136,99,136,130,103,116.0,123.0,-27,-6,-21
929,11,59,2,8,0,2527,2388,1650,1467,2828,1205,656,751,787,807,758,1395,1076.0,987.0,637,-49,686
377,12,59,2,8,0,511,752,626,577,1241,549,138,232,271,262,250,268,259.0,260.0,18,-12,30
374,13,59,2,8,0,1387,1606,840,561,1020,602,249,293,362,351,329,285,307.0,322.0,-44,-22,-22
991,14,59,2,8,0,1736,1669,959,1021,1584,992,320,512,660,557,721,719,720.0,666.0,-2,164,-166
402,15,59,2,8,0,1019,1203,828,859,1272,386,193,342,341,375,377,337,357.0,363.0,-40,2,-42
316,16,59,2,8,0,713,769,691,751,1208,523,161,272,326,270,280,775,528.0,442.0,495,10,485
329,17,59,2,8,0,816,847,522,619,891,508,132,232,212,222,268,261,264.0,250.0,-7,46,-53
91,18,59,2,8,0,243,304,268,291,431,173,74,106,104,121,115,77,96.0,104.0,-38,-6,-32
68,19,59,2,8,0,366,291,139,186,225,91,51,75,101,66,42,52,47.0,53.0,10,-24,34
46,20,59,2,8,0,324,310,182,148,242,128,33,53,51,65,76,57,66.0,66.0,-19,11,-30
199,21,59,2,8,0,656,661,278,275,432,182,64,143,136,155,142,754,448.0,350.0,612,-13,625
28,22,59,2,8,0,146,137,83,61,140,53,29,33,28,48,27,21,24.0,32.0,-6,-21,15
141,1,60,1,8,0,138,161,113,162,163,142,84,128,99,108,102,143,122.0,118.0,41,-6,47
120,2,60,1,8,0,123,111,95,152,131,146,84,119,80,84,87,136,112.0,102.0,49,3,46
68,3,60,1,8,0,71,81,97,81,90,83,41,62,87,86,67,58,62.0,70.0,-9,-19,10
50,4,60,1,8,0,87,131,79,100,123,88,65,74,70,62,63,53,58.0,59.0,-10,1,-11
262,5,60,1,8,0,227,447,284,279,330,341,184,223,201,224,188,192,190.0,201.0,4,-36,40
174,6,60,1,8,0,167,182,170,183,198,254,107,149,150,152,146,136,141.0,145.0,-10,-6,-4
158,7,60,1,8,0,136,198,152,160,191,159,74,162,163,162,117,116,116.0,132.0,-1,-45,44
32,8,60,1,8,0,36,34,32,31,28,41,25,46,41,28,30,28,29.0,29.0,-2,2,-4
502,9,60,1,8,0,435,593,541,658,638,568,264,527,387,410,437,440,438.0,429.0,3,27,-24
162,10,60,1,8,0,154,208,163,172,213,297,121,197,152,163,152,143,148.0,153.0,-9,-11,2
290,11,60,1,8,0,361,402,385,402,439,430,213,408,324,345,284,373,328.0,334.0,89,-61,150
105,12,60,1,8,0,64,94,87,76,120,103,50,101,76,71,82,82,82.0,78.0,0,11,-11
131,13,60,1,8,0,102,92,82,85,95,109,50,116,95,137,104,134,119.0,125.0,30,-33,63
149,14,60,1,8,0,123,153,141,134,164,130,78,142,114,90,124,140,132.0,118.0,16,34,-18
327,15,60,1,8,0,299,308,339,364,397,466,185,307,317,322,277,351,314.0,317.0,74,-45,119
222,16,60,1,8,0,179,232,184,244,236,270,129,200,183,140,190,186,188.0,172.0,-4,50,-54
373,17,60,1,8,0,298,395,308,355,445,519,215,330,301,296,262,319,290.0,292.0,57,-34,91
106,18,60,1,8,0,91,93,87,125,99,145,57,96,88,101,91,78,84.0,90.0,-13,-10,-3
140,19,60,1,8,0,158,194,115,126,155,89,59,109,102,100,85,79,82.0,88.0,-6,-15,9
136,20,60,1,8,0,146,203,173,179,214,160,89,140,134,104,264,151,208.0,173.0,-113,160,-273
338,21,60,1,8,0,229,256,263,252,263,274,154,228,212,258,163,256,210.0,226.0,93,-95,188
70,22,60,1,8,0,75,68,54,66,57,65,35,91,67,47,50,39,44.0,45.0,-11,3,-14
308,1,1,1,9,0,265,228,369,374,305,193,309,264,241,251,240,298,269.0,263.0,58,-11,69
306,2,1,1,9,0,217,310,402,456,434,194,302,243,321,230,362,323,342.0,305.0,-39,132,-171
176,3,1,1,9,0,157,178,204,219,180,128,201,176,192,155,199,170,184.0,175.0,-29,44,-73
293,4,1,1,9,0,337,371,460,563,468,432,472,340,407,314,302,310,306.0,309.0,8,-12,20
449,5,1,1,9,0,623,350,453,570,500,253,378,337,331,336,304,330,317.0,323.0,26,-32,58
192,6,1,1,9,0,159,136,179,226,198,76,132,155,144,166,155,166,160.0,162.0,11,-11,22
563,7,1,1,9,0,422,394,483,601,468,290,412,484,450,432,449,413,431.0,431.0,-36,17,-53
239,8,1,1,9,0,194,233,215,260,248,146,249,182,251,173,213,197,205.0,194.0,-16,40,-56
2822,9,1,1,9,0,2265,2711,3532,3800,2692,1680,2958,2368,2754,2696,2582,2782,2682.0,2687.0,200,-114,314
402,10,1,1,9,0,267,349,472,505,425,248,383,277,377,293,309,331,320.0,311.0,22,16,6
759,11,1,1,9,0,631,764,871,1010,800,486,817,617,720,689,718,682,700.0,696.0,-36,29,-65
164,12,1,1,9,0,156,166,204,262,236,78,191,154,186,149,156,168,162.0,158.0,12,7,5
363,13,1,1,9,0,225,228,291,305,260,190,297,311,328,293,325,352,338.0,323.0,27,32,-5
344,14,1,1,9,0,301,351,521,505,405,250,355,393,307,297,380,309,344.0,329.0,-71,83,-154
649,15,1,1,9,0,545,702,660,865,633,409,621,561,562,591,624,669,646.0,628.0,45,33,12
409,16,1,1,9,0,381,447,480,474,497,228,445,423,403,455,424,361,392.0,413.0,-63,-31,-32
304,17,1,1,9,0,299,327,364,474,347,174,297,304,284,259,316,280,298.0,285.0,-36,57,-93
288,18,1,1,9,0,258,368,331,404,292,181,307,209,324,299,311,316,314.0,309.0,5,12,-7
744,19,1,1,9,0,721,769,941,997,650,566,775,692,738,626,805,715,760.0,715.0,-90,179,-269
119,20,1,1,9,0,101,120,155,199,115,72,126,107,119,138,135,104,120.0,126.0,-31,-3,-28
293,21,1,1,9,0,187,324,393,440,305,219,295,292,328,285,305,307,306.0,299.0,2,20,-18
248,22,1,1,9,0,302,310,458,461,292,234,401,305,324,284,313,335,324.0,311.0,22,29,-7
615,1,2,2,9,0,417,271,639,518,268,263,442,321,383,408,481,506,494.0,465.0,25,73,-48
484,2,2,2,9,0,368,334,609,519,292,264,403,325,415,354,487,506,496.0,449.0,19,133,-114
312,3,2,2,9,0,208,216,370,337,175,149,316,260,258,252,263,332,298.0,282.0,69,11,58
421,4,2,2,9,0,449,231,675,811,368,359,470,369,376,352,396,326,361.0,358.0,-70,44,-114
1021,5,2,2,9,0,1227,469,1053,1125,657,560,806,700,679,724,721,901,811.0,782.0,180,-3,183
524,6,2,2,9,0,325,253,574,507,301,225,317,315,350,352,460,517,488.0,443.0,57,108,-51
1693,7,2,2,9,0,1222,876,1567,1574,775,729,1060,1229,1119,1113,1342,1502,1422.0,1319.0,160,229,-69
543,8,2,2,9,0,372,320,590,571,290,239,407,358,384,335,452,519,486.0,435.0,67,117,-50
11177,9,2,2,9,0,10140,6925,13598,11515,5136,4688,10371,8733,8990,9100,9110,10367,9738.0,9526.0,1257,10,1247
1237,10,2,2,9,0,969,642,1386,1258,750,559,1074,832,939,901,1075,1222,1148.0,1066.0,147,174,-27
2465,11,2,2,9,0,2075,1763,3112,2877,1445,1635,2184,1828,1916,1948,2090,2406,2248.0,2148.0,316,142,174
634,12,2,2,9,0,535,356,595,741,435,311,545,463,483,513,576,577,576.0,555.0,1,63,-62
1231,13,2,2,9,0,722,520,1137,974,498,486,847,1025,993,829,1052,1183,1118.0,1021.0,131,223,-92
1133,14,2,2,9,0,808,565,1273,1234,645,486,968,944,932,1043,1153,1163,1158.0,1120.0,10,110,-100
2373,15,2,2,9,0,1658,1293,2709,2467,1135,1205,1969,1744,1919,1847,2165,2419,2292.0,2144.0,254,318,-64
1033,16,2,2,9,0,908,742,1001,1050,703,508,734,619,699,876,984,989,986.0,950.0,5,108,-103
917,17,2,2,9,0,958,582,1112,1192,689,445,769,687,748,707,821,1006,914.0,845.0,185,114,71
1828,18,2,2,9,0,1310,817,2205,1578,856,899,1607,1181,1494,1511,1522,1699,1610.0,1577.0,177,11,166
2147,19,2,2,9,0,1915,1064,2892,2161,1110,1306,1905,1837,1784,1845,2218,2361,2290.0,2141.0,143,373,-230
303,20,2,2,9,0,331,173,470,398,244,215,285,259,240,371,328,317,322.0,339.0,-11,-43,32
529,21,2,2,9,0,462,375,582,607,340,260,369,435,466,394,526,525,526.0,482.0,-1,132,-133
987,22,2,2,9,0,843,480,1076,1018,447,521,1186,639,827,849,957,1229,1093.0,1012.0,272,108,164
163,1,3,1,9,0,169,112,163,167,157,101,187,162,155,200,158,195,176.0,184.0,37,-42,79
332,2,3,1,9,0,270,218,354,350,290,213,293,226,236,265,410,329,370.0,335.0,-81,145,-226
232,3,3,1,9,0,234,155,184,233,279,174,228,241,255,251,306,251,278.0,269.0,-55,55,-110
412,4,3,1,9,0,583,457,611,677,549,387,627,524,389,503,552,475,514.0,510.0,-77,49,-126
432,5,3,1,9,0,387,300,411,434,516,235,377,355,370,404,481,373,427.0,419.0,-108,77,-185
165,6,3,1,9,0,157,129,128,138,176,83,127,116,129,142,151,124,138.0,139.0,-27,9,-36
471,7,3,1,9,0,376,327,415,400,420,235,353,334,323,407,400,410,405.0,406.0,10,-7,17
160,8,3,1,9,0,135,111,141,197,179,103,189,173,157,177,211,167,189.0,185.0,-44,34,-78
1985,9,3,1,9,0,1683,1421,1989,1829,1713,1159,1738,1536,1581,1833,1828,1593,1710.0,1751.0,-235,-5,-230
185,10,3,1,9,0,192,165,181,173,211,121,197,149,174,163,216,133,174.0,171.0,-83,53,-136
476,11,3,1,9,0,401,333,437,427,470,296,446,386,375,444,454,461,458.0,453.0,7,10,-3
177,12,3,1,9,0,108,90,107,109,126,55,113,112,112,126,130,154,142.0,137.0,24,4,20
375,13,3,1,9,0,309,274,302,328,389,251,371,364,437,425,531,444,488.0,467.0,-87,106,-193
382,14,3,1,9,0,327,262,352,337,377,202,331,306,338,396,390,320,355.0,369.0,-70,-6,-64
478,15,3,1,9,0,336,342,428,424,401,264,349,335,366,380,435,444,440.0,420.0,9,55,-46
293,16,3,1,9,0,303,211,267,280,321,189,271,255,230,322,292,267,280.0,294.0,-25,-30,5
299,17,3,1,9,0,250,211,244,275,284,146,275,262,250,285,292,286,289.0,288.0,-6,7,-13
129,18,3,1,9,0,124,106,151,157,167,81,107,85,111,132,133,94,114.0,120.0,-39,1,-40
531,19,3,1,9,0,488,346,464,567,506,316,529,433,489,457,606,708,657.0,590.0,102,149,-47
174,20,3,1,9,0,169,138,184,155,213,116,188,148,168,179,203,176,190.0,186.0,-27,24,-51
290,21,3,1,9,0,271,195,252,267,297,206,288,291,280,277,346,254,300.0,292.0,-92,69,-161
199,22,3,1,9,0,239,208,258,336,315,155,306,267,240,317,304,316,310.0,312.0,12,-13,25
221,1,4,2,9,0,216,166,212,210,117,96,135,131,161,142,167,201,184.0,170.0,34,25,9
399,2,4,2,9,0,256,209,270,308,173,110,159,185,191,176,253,332,292.0,254.0,79,77,2
204,3,4,2,9,0,193,128,165,176,89,72,136,148,139,117,145,167,156.0,143.0,22,28,-6
164,4,4,2,9,0,286,179,246,342,136,109,179,166,96,85,131,159,145.0,125.0,28,46,-18
667,5,4,2,9,0,712,401,438,436,351,212,361,425,290,324,427,553,490.0,435.0,126,103,23
338,6,4,2,9,0,358,250,325,348,264,151,204,182,203,195,266,313,290.0,258.0,47,71,-24
729,7,4,2,9,0,606,454,468,556,225,175,357,467,449,285,377,522,450.0,395.0,145,92,53
230,8,4,2,9,0,187,181,144,181,92,70,148,181,165,127,190,198,194.0,172.0,8,63,-55
5596,9,4,2,9,0,5211,4012,4216,4195,2391,1639,3992,3988,3668,3906,4522,4949,4736.0,4459.0,427,616,-189
630,10,4,2,9,0,444,331,432,386,248,166,443,418,434,344,461,540,500.0,448.0,79,117,-38
1400,11,4,2,9,0,1130,943,1033,1154,680,651,982,1039,1051,947,1072,1268,1170.0,1096.0,196,125,71
520,12,4,2,9,0,380,260,302,351,208,96,254,328,298,271,331,451,391.0,351.0,120,60,60
645,13,4,2,9,0,584,385,397,419,248,284,584,570,485,345,559,623,591.0,509.0,64,214,-150
854,14,4,2,9,0,673,556,567,651,338,242,578,638,439,516,644,816,730.0,659.0,172,128,44
1887,15,4,2,9,0,1296,1228,1343,1310,747,739,1438,1404,1200,1131,1522,1730,1626.0,1461.0,208,391,-183
780,16,4,2,9,0,744,726,677,787,450,226,461,459,468,446,524,665,594.0,545.0,141,78,63
891,17,4,2,9,0,619,436,474,674,394,223,436,554,554,548,663,787,725.0,666.0,124,115,9
1034,18,4,2,9,0,615,563,615,519,231,173,535,612,676,709,737,966,852.0,804.0,229,28,201
810,19,4,2,9,0,840,522,652,848,213,233,610,646,562,459,596,792,694.0,616.0,196,137,59
200,20,4,2,9,0,208,150,157,208,123,85,166,157,116,162,140,173,156.0,158.0,33,-22,55
344,21,4,2,9,0,262,219,225,317,148,105,202,242,221,226,279,358,318.0,288.0,79,53,26
303,22,4,2,9,0,334,222,288,303,90,85,233,244,241,205,236,349,292.0,263.0,113,31,82
216,1,5,3,9,0,234,168,249,477,199,177,267,169,193,170,168,208,188.0,182.0,40,-2,42
2469,2,5,3,9,0,3307,3096,3216,4503,4785,3067,2754,2281,2227,1995,2206,1981,2094.0,2061.0,-225,211,-436
467,3,5,3,9,0,502,360,520,675,504,451,680,487,440,356,384,433,408.0,391.0,49,28,21
136,4,5,3,9,0,242,199,305,514,151,92,197,124,132,112,101,80,90.0,98.0,-21,-11,-10
1242,5,5,3,9,0,1449,1007,1411,1954,1724,1537,1481,1090,1021,990,1018,1119,1068.0,1042.0,101,28,73
1266,6,5,3,9,0,1458,1238,1535,2328,2152,1881,1518,1284,1266,1165,1072,1126,1099.0,1121.0,54,-93,147
2744,7,5,3,9,0,3519,3268,3907,6576,4483,3060,2839,2545,2879,2279,2583,2917,2750.0,2593.0,334,304,30
1338,8,5,3,9,0,1749,1354,1585,2844,2093,1361,1353,1118,1259,955,1154,1235,1194.0,1115.0,81,199,-118
1720,9,5,3,9,0,1999,1555,2007,3029,1611,1579,2180,1684,1684,1682,1409,1573,1491.0,1555.0,164,-273,437
1360,10,5,3,9,0,2515,2293,2687,4443,3084,1836,2310,1540,1616,1343,1308,1943,1626.0,1531.0,635,-35,670
1651,11,5,3,9,0,1764,1493,1942,3067,2165,2419,2029,1601,1578,1375,1523,1501,1512.0,1466.0,-22,148,-170
666,12,5,3,9,0,1111,824,980,1510,1290,922,875,668,648,536,537,656,596.0,576.0,119,1,118
2753,13,5,3,9,0,3303,2808,3641,6231,3870,3403,2945,3015,3119,2522,2789,2808,2798.0,2706.0,19,267,-248
2664,14,5,3,9,0,3584,3821,4668,7650,5825,3564,3197,2704,2715,2598,2658,2563,2610.0,2606.0,-95,60,-155
1319,15,5,3,9,0,1295,1112,1294,2062,1260,1629,1592,1156,1224,1121,1218,1188,1203.0,1176.0,-30,97,-127
1018,16,5,3,9,0,1202,958,1353,2198,1919,1140,1262,895,1069,835,836,949,892.0,873.0,113,1,112
1185,17,5,3,9,0,1773,1354,1770,2693,2364,1506,1541,1174,1020,997,939,1035,987.0,990.0,96,-58,154
400,18,5,3,9,0,573,523,688,892,592,650,741,463,546,473,389,402,396.0,421.0,13,-84,97
1041,19,5,3,9,0,1135,824,1154,1710,924,939,1322,959,988,854,912,964,938.0,910.0,52,58,-6
241,20,5,3,9,0,284,201,250,357,250,248,235,212,191,173,197,218,208.0,196.0,21,24,-3
1406,21,5,3,9,0,1658,1590,1877,3217,2072,1105,1314,1222,1105,910,1051,1117,1084.0,1026.0,66,141,-75
540,22,5,3,9,0,795,518,816,982,506,518,806,657,585,602,530,544,537.0,559.0,14,-72,86
399,1,6,1,9,0,555,272,582,623,382,114,351,229,285,289,234,347,290.0,290.0,113,-55,168
493,2,6,1,9,0,543,553,546,680,484,300,452,403,419,390,633,639,636.0,554.0,6,243,-237
640,3,6,1,9,0,831,715,836,832,551,317,489,505,604,525,595,623,609.0,581.0,28,70,-42
130,4,6,1,9,0,502,362,440,598,212,102,180,142,124,93,130,133,132.0,119.0,3,37,-34
1101,5,6,1,9,0,1460,1050,1385,1850,1223,671,850,790,838,870,1020,1346,1183.0,1079.0,326,150,176
1168,6,6,1,9,0,1565,1256,1491,1666,1515,717,1018,980,1077,1165,1206,1280,1243.0,1217.0,74,41,33
2022,7,6,1,9,0,2580,2061,2146,2737,1706,842,1734,1902,2031,1983,2192,2226,2209.0,2134.0,34,209,-175
614,8,6,1,9,0,690,724,762,993,533,312,595,582,569,606,683,717,700.0,669.0,34,77,-43
5863,9,6,1,9,0,8215,6582,6734,6492,5607,2647,5713,4896,5717,5445,4899,5914,5406.0,5419.0,1015,-546,1561
734,10,6,1,9,0,913,743,853,894,799,409,719,453,603,532,611,719,665.0,621.0,108,79,29
1722,11,6,1,9,0,2410,2283,2584,2672,1728,1016,1729,1498,1701,1735,1850,1857,1854.0,1814.0,7,115,-108
905,12,6,1,9,0,1340,1065,1086,1291,1027,356,690,687,838,753,813,1041,927.0,869.0,228,60,168
2361,13,6,1,9,0,3253,2277,2327,2703,2119,1271,2126,2486,2863,2426,2914,2989,2952.0,2776.0,75,488,-413
2677,14,6,1,9,0,3446,2827,2797,3447,2952,1308,2514,2566,2841,2880,3363,3319,3341.0,3187.0,-44,483,-527
1241,15,6,1,9,0,1369,1262,1632,1972,795,459,876,905,1141,1077,1165,1379,1272.0,1207.0,214,88,126
1288,16,6,1,9,0,1938,1686,1663,2151,1566,597,1095,1029,1047,1133,1293,1344,1318.0,1257.0,51,160,-109
1482,17,6,1,9,0,2573,2247,1966,2770,1651,844,1487,1573,1636,1382,1564,1802,1683.0,1583.0,238,182,56
384,18,6,1,9,0,390,371,447,476,264,148,314,267,427,418,348,436,392.0,401.0,88,-70,158
408,19,6,1,9,0,397,317,403,513,241,211,360,293,362,342,372,462,417.0,392.0,90,30,60
579,20,6,1,9,0,888,646,803,1149,803,328,472,453,543,623,549,633,591.0,602.0,84,-74,158
553,21,6,1,9,0,687,665,655,845,620,247,468,497,551,436,566,577,572.0,526.0,11,130,-119
572,22,6,1,9,0,669,544,740,1032,399,306,506,449,585,503,512,594,553.0,536.0,82,9,73
1258,1,7,3,9,0,958,710,977,1212,1265,890,1247,1119,1184,1456,1316,1194,1255.0,1322.0,-122,-140,18
150,2,7,3,9,0,79,45,66,119,104,63,214,133,132,248,173,187,180.0,203.0,14,-75,89
187,3,7,3,9,0,54,43,56,75,86,64,154,131,164,163,146,193,170.0,167.0,47,-17,64
1463,4,7,3,9,0,1027,677,793,1627,1352,1114,1508,1132,1430,1670,1367,1416,1392.0,1484.0,49,-303,352
431,5,7,3,9,0,199,102,145,321,208,187,254,335,308,285,276,420,348.0,327.0,144,-9,153
398,6,7,3,9,0,182,145,176,251,253,175,322,340,315,352,311,384,348.0,349.0,73,-41,114
1321,7,7,3,9,0,710,494,739,1047,878,649,1303,1248,1216,1405,1283,1284,1284.0,1324.0,1,-122,123
344,8,7,3,9,0,121,83,105,184,165,123,244,320,272,242,233,292,262.0,256.0,59,-9,68
1134,9,7,3,9,0,514,463,571,819,762,448,944,1100,1025,1038,994,984,989.0,1005.0,-10,-44,34
126,10,7,3,9,0,36,87,45,96,92,54,103,134,119,86,123,99,111.0,103.0,-24,37,-61
1328,11,7,3,9,0,923,563,731,1002,974,650,1188,1289,1048,1276,1137,1253,1195.0,1222.0,116,-139,255
204,12,7,3,9,0,89,43,74,97,118,85,164,140,153,162,165,154,160.0,160.0,-11,3,-14
873,13,7,3,9,0,284,232,288,493,470,361,599,660,769,569,656,773,714.0,666.0,117,87,30
909,14,7,3,9,0,387,282,366,596,517,345,763,731,685,764,754,849,802.0,789.0,95,-10,105
1113,15,7,3,9,0,350,278,533,736,534,424,754,915,865,808,908,999,954.0,905.0,91,100,-9
270,16,7,3,9,0,115,66,94,173,151,103,240,253,187,234,272,286,279.0,264.0,14,38,-24
250,17,7,3,9,0,68,60,83,119,101,59,203,163,182,206,192,239,216.0,212.0,47,-14,61
241,18,7,3,9,0,99,106,97,170,123,106,206,303,187,204,204,249,226.0,219.0,45,0,45
413,19,7,3,9,0,184,111,151,300,181,154,357,324,363,378,413,435,424.0,409.0,22,35,-13
168,20,7,3,9,0,120,43,58,100,60,71,130,181,128,151,124,150,137.0,142.0,26,-27,53
434,21,7,3,9,0,164,136,164,313,234,179,320,305,340,358,313,390,352.0,354.0,77,-45,122
281,22,7,3,9,0,130,76,95,177,129,74,323,185,255,260,224,227,226.0,237.0,3,-36,39
357,1,8,2,9,0,605,431,543,697,325,168,288,309,527,516,379,272,326.0,389.0,-107,-137,30
109,2,8,2,9,0,80,64,106,112,40,25,38,54,68,55,75,116,96.0,82.0,41,20,21
46,3,8,2,9,0,50,48,60,75,31,18,29,46,51,51,61,78,70.0,63.0,17,10,7
68,4,8,2,9,0,107,59,86,132,40,51,59,50,54,60,151,111,131.0,107.0,-40,91,-131
371,5,8,2,9,0,379,187,278,408,216,117,192,175,229,259,209,437,323.0,302.0,228,-50,278
385,6,8,2,9,0,452,363,447,587,357,148,207,278,368,463,445,401,423.0,436.0,-44,-18,-26
287,7,8,2,9,0,524,437,477,555,320,180,373,400,374,355,402,517,460.0,425.0,115,47,68
47,8,8,2,9,0,61,59,55,64,30,23,28,38,44,60,71,103,87.0,78.0,32,11,21
438,9,8,2,9,0,284,225,342,408,121,39,166,158,211,185,222,453,338.0,287.0,231,37,194
119,10,8,2,9,0,86,66,86,129,68,34,47,50,71,60,56,125,90.0,80.0,69,-4,73
648,11,8,2,9,0,1311,1156,1271,1767,893,628,788,879,1067,1002,995,690,842.0,896.0,-305,-7,-298
198,12,8,2,9,0,205,175,224,302,169,92,161,188,202,170,233,263,248.0,222.0,30,63,-33
190,13,8,2,9,0,149,129,127,215,80,56,93,108,163,149,199,289,244.0,212.0,90,50,40
278,14,8,2,9,0,300,257,320,368,183,97,185,329,340,259,262,298,280.0,273.0,36,3,33
466,15,8,2,9,0,867,742,941,1163,445,309,478,511,775,845,706,532,619.0,694.0,-174,-139,-35
244,16,8,2,9,0,253,233,287,401,211,94,172,184,195,243,185,256,220.0,228.0,71,-58,129
221,17,8,2,9,0,213,182,259,315,201,83,173,167,198,189,202,231,216.0,207.0,29,13,16
156,18,8,2,9,0,86,70,117,145,54,20,51,78,114,140,134,168,151.0,147.0,34,-6,40
77,19,8,2,9,0,78,81,68,104,28,21,52,82,45,37,92,119,106.0,83.0,27,55,-28
91,20,8,2,9,0,77,40,57,62,28,20,37,37,33,64,92,101,96.0,86.0,9,28,-19
134,21,8,2,9,0,137,141,113,177,107,51,78,83,124,102,102,142,122.0,115.0,40,0,40
33,22,8,2,9,0,39,29,28,30,11,11,8,18,20,17,27,60,44.0,35.0,33,10,23
982,1,9,1,9,0,839,851,1537,1734,940,540,957,807,919,933,755,914,834.0,867.0,159,-178,337
345,2,9,1,9,0,375,464,639,732,400,288,346,301,327,290,401,329,365.0,340.0,-72,111,-183
382,3,9,1,9,0,426,433,493,573,322,195,323,333,363,302,240,293,266.0,278.0,53,-62,115
472,4,9,1,9,0,648,532,915,1057,659,394,601,489,595,532,503,449,476.0,495.0,-54,-29,-25
1218,5,9,1,9,0,1394,1020,1293,1876,1072,611,873,761,808,800,793,898,846.0,830.0,105,-7,112
1020,6,9,1,9,0,938,1018,1287,1597,1015,457,773,664,769,751,688,875,782.0,771.0,187,-63,250
1388,7,9,1,9,0,1497,1547,1722,2394,1077,522,1253,1236,1215,1019,955,1078,1016.0,1017.0,123,-64,187
448,8,9,1,9,0,407,489,581,742,375,248,450,310,404,335,340,378,359.0,351.0,38,5,33
1048,9,9,1,9,0,1197,1508,2163,2594,949,463,1024,892,976,1062,838,972,905.0,957.0,134,-224,358
298,10,9,1,9,0,338,373,502,713,341,210,322,222,345,302,257,262,260.0,274.0,5,-45,50
1574,11,9,1,9,0,1413,1635,2059,2647,1466,939,1519,1181,1355,1281,1072,1305,1188.0,1219.0,233,-209,442
1080,12,9,1,9,0,798,900,1083,1527,753,397,757,746,837,677,745,886,816.0,769.0,141,68,73
793,13,9,1,9,0,771,828,1012,1235,691,404,655,694,773,655,680,691,686.0,675.0,11,25,-14
1247,14,9,1,9,0,1228,1191,1470,2122,1000,589,1119,1013,903,937,951,1080,1016.0,989.0,129,14,115
1136,15,9,1,9,0,1042,1090,1626,2068,1003,537,978,796,1015,879,797,986,892.0,887.0,189,-82,271
1376,16,9,1,9,0,1135,1284,1519,1632,1025,485,1058,873,1015,949,835,965,900.0,916.0,130,-114,244
1329,17,9,1,9,0,1175,1168,1619,2178,1217,467,1068,962,1084,875,893,959,926.0,909.0,66,18,48
487,18,9,1,9,0,426,568,767,913,522,257,433,373,497,408,356,398,377.0,387.0,42,-52,94
438,19,9,1,9,0,365,407,443,594,254,172,277,329,290,263,262,428,345.0,318.0,166,-1,167
390,20,9,1,9,0,386,354,500,762,420,252,342,321,324,387,329,286,308.0,334.0,-43,-58,15
423,21,9,1,9,0,360,444,478,651,365,184,306,238,357,732,447,312,380.0,497.0,-135,-285,150
203,22,9,1,9,0,201,203,289,372,142,121,207,187,231,186,143,232,188.0,187.0,89,-43,132
1337,1,10,2,9,0,1560,1261,1546,1428,635,513,975,1070,1137,2596,1172,1207,1190.0,1658.0,35,-1424,1459
565,2,10,2,9,0,412,350,412,626,249,167,333,316,408,510,602,649,626.0,587.0,47,92,-45
685,3,10,2,9,0,434,451,516,701,285,178,320,330,439,413,440,575,508.0,476.0,135,27,108
110,4,10,2,9,0,278,174,264,913,106,74,113,101,453,335,314,124,219.0,258.0,-190,-21,-169
2175,5,10,2,9,0,2351,1555,1783,2691,1134,763,1522,1501,1649,1954,1996,2318,2157.0,2089.0,322,42,280
2098,6,10,2,9,0,2578,2110,2138,2356,1607,968,1908,2068,2171,2517,2384,2828,2606.0,2576.0,444,-133,577
4184,7,10,2,9,0,4079,3911,3787,4830,2048,1323,3138,3779,4223,3954,4263,5234,4748.0,4484.0,971,309,662
967,8,10,2,9,0,774,678,852,1073,317,283,629,610,883,1085,1017,1391,1204.0,1164.0,374,-68,442
2750,9,10,2,9,0,2219,1912,2435,2500,695,488,1495,1512,1848,2203,1964,2643,2304.0,2270.0,679,-239,918
1006,10,10,2,9,0,723,646,783,869,475,293,738,554,830,966,1021,1065,1043.0,1017.0,44,55,-11
4453,11,10,2,9,0,5089,5170,5016,5865,2657,2401,4119,4083,4704,4995,4877,5866,5372.0,5246.0,989,-118,1107
1776,12,10,2,9,0,1446,1175,1376,1737,923,549,1502,1828,1895,1662,1811,1988,1900.0,1820.0,177,149,28
1969,13,10,2,9,0,2166,1672,1926,2621,900,720,1379,2198,2809,2761,2856,3219,3038.0,2945.0,363,95,268
3047,14,10,2,9,0,2794,2644,2874,3243,1683,1042,2558,3199,3067,3400,3871,4333,4102.0,3868.0,462,471,-9
3209,15,10,2,9,0,3258,3003,3295,3490,1289,1038,1965,1876,2506,2778,3135,3712,3424.0,3208.0,577,357,220
1719,16,10,2,9,0,1779,1500,1547,1624,929,480,1234,1278,1437,1882,1699,1835,1767.0,1805.0,136,-183,319
2090,17,10,2,9,0,1793,1457,1585,1952,989,516,1513,1616,1696,1720,1686,2057,1872.0,1821.0,371,-34,405
1317,18,10,2,9,0,859,836,1130,958,546,402,859,878,1319,1184,1258,1327,1292.0,1256.0,69,74,-5
874,19,10,2,9,0,667,540,619,821,205,149,446,498,474,571,727,964,846.0,754.0,237,156,81
674,20,10,2,9,0,501,422,419,597,296,163,296,401,429,660,507,590,548.0,586.0,83,-153,236
1047,21,10,2,9,0,880,891,912,1151,413,242,475,689,883,1688,1091,1205,1148.0,1328.0,114,-597,711
382,22,10,2,9,0,298,250,347,415,118,130,301,193,254,310,279,412,346.0,334.0,133,-31,164
129,1,11,2,9,0,225,144,225,270,79,27,45,95,103,101,83,103,93.0,96.0,20,-18,38
327,2,11,2,9,0,215,192,267,384,296,172,285,192,231,213,247,282,264.0,247.0,35,34,1
244,3,11,2,9,0,257,237,359,450,248,124,211,203,178,177,181,202,192.0,187.0,21,4,17
546,4,11,2,9,0,755,684,938,1287,118,74,556,952,1106,818,968,836,902.0,874.0,-132,150,-282
1065,5,11,2,9,0,1134,707,1002,2805,1326,797,891,676,702,734,761,905,833.0,800.0,144,27,117
692,6,11,2,9,0,752,716,977,1443,903,436,535,520,582,612,532,660,596.0,601.0,128,-80,208
1744,7,11,2,9,0,2253,1752,2198,3785,1878,1009,1343,1575,1488,1335,1337,1747,1542.0,1473.0,410,2,408
518,8,11,2,9,0,635,370,1993,2925,603,248,417,464,574,426,448,540,494.0,471.0,92,22,70
1500,9,11,2,9,0,1526,1065,2044,2419,914,399,1078,1095,1082,1215,1038,1245,1142.0,1166.0,207,-177,384
629,10,11,2,9,0,452,368,493,935,666,303,492,403,512,470,474,495,484.0,480.0,21,4,17
982,11,11,2,9,0,1231,1184,1531,2308,910,648,752,1041,985,944,821,908,864.0,891.0,87,-123,210
721,12,11,2,9,0,831,701,917,1377,999,364,509,561,555,561,469,643,556.0,558.0,174,-92,266
1031,13,11,2,9,0,941,754,1144,2067,1110,641,741,953,1002,876,936,1050,993.0,954.0,114,60,54
1822,14,11,2,9,0,1491,1090,1965,3560,2272,888,1199,1423,1368,1487,1652,1740,1696.0,1626.0,88,165,-77
2001,15,11,2,9,0,1978,2287,3147,4324,1028,639,1114,1097,2340,1882,1700,2222,1961.0,1935.0,522,-182,704
1167,16,11,2,9,0,528,521,941,1534,1004,347,476,456,410,475,460,525,492.0,487.0,65,-15,80
1015,17,11,2,9,0,1102,762,1142,1719,1133,438,685,688,650,716,659,750,704.0,708.0,91,-57,148
775,18,11,2,9,0,605,468,762,1967,434,268,656,565,712,722,602,609,606.0,644.0,7,-120,127
192,19,11,2,9,0,319,239,291,520,199,149,205,202,188,167,160,157,158.0,161.0,-3,-7,4
470,20,11,2,9,0,317,253,326,532,432,291,409,310,302,286,280,366,323.0,311.0,86,-6,92
1081,21,11,2,9,0,1013,830,1010,1651,919,422,609,612,587,580,1155,818,986.0,851.0,-337,575,-912
138,22,11,2,9,0,154,114,204,257,135,104,114,128,104,132,112,136,124.0,127.0,24,-20,44
64,1,12,2,9,0,78,75,125,158,63,40,60,51,45,46,45,48,46.0,46.0,3,-1,4
384,2,12,2,9,0,409,425,375,535,421,246,288,240,252,266,378,341,360.0,328.0,-37,112,-149
292,3,12,2,9,0,321,287,448,676,363,164,250,212,180,206,169,180,174.0,185.0,11,-37,48
80,4,12,2,9,0,328,289,360,496,86,74,109,80,71,61,54,68,61.0,61.0,14,-7,21
912,5,12,2,9,0,894,870,831,1260,724,451,621,526,535,628,654,720,687.0,667.0,66,26,40
446,6,12,2,9,0,570,478,510,806,576,272,358,315,316,346,322,391,356.0,353.0,69,-24,93
1156,7,12,2,9,0,1544,1660,1778,2915,1529,762,977,1071,1025,958,930,1153,1042.0,1014.0,223,-28,251
862,8,12,2,9,0,657,689,668,1092,615,366,578,543,590,543,530,702,616.0,592.0,172,-13,185
1000,9,12,2,9,0,987,1170,1384,1437,718,363,821,836,734,867,743,867,805.0,826.0,124,-124,248
423,10,12,2,9,0,336,321,463,659,452,233,370,288,292,316,346,373,360.0,345.0,27,30,-3
488,11,12,2,9,0,619,691,743,1008,543,405,518,460,406,448,428,481,454.0,452.0,53,-20,73
422,12,12,2,9,0,576,518,577,816,634,247,323,301,331,301,285,348,316.0,311.0,63,-16,79
1304,13,12,2,9,0,1442,1308,1432,2365,1304,951,1023,1070,1210,930,1140,1221,1180.0,1097.0,81,210,-129
1233,14,12,2,9,0,1362,1148,1406,2228,1526,717,888,888,823,850,1053,1131,1092.0,1011.0,78,203,-125
625,15,12,2,9,0,656,660,874,1121,438,306,511,460,520,507,491,573,532.0,524.0,82,-16,98
478,16,12,2,9,0,594,534,655,903,635,255,364,342,325,362,407,342,374.0,370.0,-65,45,-110
640,17,12,2,9,0,852,609,763,1216,773,321,479,531,540,517,429,513,471.0,486.0,84,-88,172
311,18,12,2,9,0,280,218,239,420,249,153,274,195,252,248,212,300,256.0,253.0,88,-36,124
348,19,12,2,9,0,450,328,514,641,287,222,321,326,279,247,251,291,271.0,263.0,40,4,36
352,20,12,2,9,0,325,272,292,402,296,142,238,207,233,232,240,260,250.0,244.0,20,8,12
857,21,12,2,9,0,705,729,755,1158,815,410,484,484,492,471,470,664,567.0,535.0,194,-1,195
200,22,12,2,9,0,249,176,328,336,166,145,205,161,183,216,199,211,205.0,209.0,12,-17,29
77,1,13,1,9,0,181,158,314,461,180,102,190,125,145,92,77,83,80.0,84.0,6,-15,21
601,2,13,1,9,0,447,627,757,1396,1059,575,778,650,682,486,654,573,614.0,571.0,-81,168,-249
453,3,13,1,9,0,287,324,527,720,520,270,473,409,472,356,344,415,380.0,372.0,71,-12,83
61,4,13,1,9,0,237,199,242,487,101,86,162,127,117,78,41,43,42.0,54.0,2,-37,39
1302,5,13,1,9,0,1263,1243,1605,2433,1860,1194,1302,1156,1192,925,872,1055,964.0,951.0,183,-53,236
952,6,13,1,9,0,1069,1269,1370,2298,1440,720,878,861,934,738,651,739,695.0,709.0,88,-87,175
1725,7,13,1,9,0,1485,1686,2126,3804,2217,1109,1504,1812,1956,1321,1432,1563,1498.0,1439.0,131,111,20
623,8,13,1,9,0,496,642,748,1215,772,404,591,661,732,531,562,597,580.0,563.0,35,31,4
829,9,13,1,9,0,835,848,1467,2021,1040,446,977,1064,948,854,663,649,656.0,722.0,-14,-191,177
460,10,13,1,9,0,342,388,511,880,738,330,660,454,586,385,399,303,351.0,362.0,-96,14,-110
957,11,13,1,9,0,1116,1451,1816,2525,1540,1130,1441,1246,1265,930,913,863,888.0,902.0,-50,-17,-33
574,12,13,1,9,0,725,733,889,1320,1015,377,598,631,632,491,445,477,461.0,471.0,32,-46,78
1540,13,13,1,9,0,1437,1548,2026,3281,1882,1126,1456,2041,2368,1518,1714,1628,1671.0,1620.0,-86,196,-282
1473,14,13,1,9,0,1313,1473,1843,2975,2324,1002,1413,1518,1509,1135,1362,1395,1378.0,1297.0,33,227,-194
930,15,13,1,9,0,1089,1175,1502,2235,958,565,880,893,948,697,814,804,809.0,772.0,-10,117,-127
825,16,13,1,9,0,868,924,1339,1557,1148,463,782,723,758,663,696,627,662.0,662.0,-69,33,-102
651,17,13,1,9,0,633,772,835,1281,1235,439,733,664,655,498,506,508,507.0,504.0,2,8,-6
337,18,13,1,9,0,307,414,622,877,518,365,529,461,541,380,328,306,317.0,338.0,-22,-52,30
359,19,13,1,9,0,291,296,396,542,311,224,349,397,405,266,303,286,294.0,285.0,-17,37,-54
335,20,13,1,9,0,311,316,419,666,489,274,346,334,368,358,284,258,271.0,300.0,-26,-74,48
603,21,13,1,9,0,519,627,715,1549,1036,394,463,535,597,405,487,551,519.0,481.0,64,82,-18
585,22,13,1,9,0,442,411,616,998,401,372,684,679,736,526,592,672,632.0,597.0,80,66,14
371,1,14,1,9,0,661,472,781,1047,423,192,279,354,355,429,362,376,369.0,389.0,14,-67,81
994,2,14,1,9,0,1084,1148,1159,1879,1354,680,631,992,1295,955,1148,1036,1092.0,1046.0,-112,193,-305
925,3,14,1,9,0,725,701,941,1442,814,347,566,786,1042,724,802,839,820.0,788.0,37,78,-41
293,4,14,1,9,0,664,474,569,1295,274,176,281,280,376,386,433,291,362.0,370.0,-142,47,-189
2342,5,14,1,9,0,2289,1556,2162,4188,2540,1081,1111,1488,1668,1412,1619,1860,1740.0,1630.0,241,207,34
1685,6,14,1,9,0,1996,1889,2073,3650,2495,863,893,1218,1582,1360,1404,1555,1480.0,1440.0,151,44,107
3377,7,14,1,9,0,3461,3252,3594,6275,3467,1356,2002,3249,3444,2666,3057,2942,3000.0,2888.0,-115,391,-506
911,8,14,1,9,0,805,800,914,1576,743,357,500,790,998,720,798,855,826.0,791.0,57,78,-21
2302,9,14,1,9,0,2808,2902,3269,4342,1784,653,1364,1722,2162,2247,2038,2128,2083.0,2138.0,90,-209,299
693,10,14,1,9,0,670,621,739,1316,892,381,556,538,802,574,699,609,654.0,627.0,-90,125,-215
2743,11,14,1,9,0,3453,3560,3776,5864,3032,1760,2316,2607,3244,2604,2564,2570,2567.0,2579.0,6,-40,46
1133,12,14,1,9,0,1325,1195,1285,2160,1579,453,603,962,960,811,902,887,894.0,867.0,-15,91,-106
2466,13,14,1,9,0,2481,2298,2594,4551,2375,1231,1427,2467,3049,2213,2567,2481,2524.0,2420.0,-86,354,-440
3339,14,14,1,9,0,3571,3427,4047,8018,5309,1586,1915,2716,3025,2701,2930,3143,3036.0,2925.0,213,229,-16
2335,15,14,1,9,0,2579,2724,3014,4336,1679,826,1161,1890,2275,1899,2230,2234,2232.0,2121.0,4,331,-327
1693,16,14,1,9,0,1747,1512,1848,3179,2049,551,906,1028,1278,1264,1359,1217,1288.0,1280.0,-142,95,-237
1887,17,14,1,9,0,2187,1872,2355,3747,2461,732,1157,1395,1621,1288,1479,1482,1480.0,1416.0,3,191,-188
723,18,14,1,9,0,738,859,1140,1306,596,364,463,616,759,757,740,708,724.0,735.0,-32,-17,-15
1144,19,14,1,9,0,1218,970,1188,1784,769,415,765,1227,1203,969,1200,1102,1151.0,1090.0,-98,231,-329
836,20,14,1,9,0,770,622,761,1417,877,373,399,529,594,627,619,620,620.0,622.0,1,-8,9
918,21,14,1,9,0,727,899,841,1546,1008,303,361,648,917,661,790,773,782.0,741.0,-17,129,-146
867,22,14,1,9,0,675,517,944,1290,579,365,604,725,778,831,876,865,870.0,857.0,-11,45,-56
719,1,15,2,9,0,820,623,807,1293,851,433,764,667,727,689,522,968,745.0,726.0,446,-167,613
471,2,15,2,9,0,456,394,535,639,509,300,415,361,462,414,443,436,440.0,431.0,-7,29,-36
531,3,15,2,9,0,482,477,451,580,494,276,556,527,562,528,446,576,511.0,517.0,130,-82,212
842,4,15,2,9,0,1276,969,1288,2146,1327,923,1308,982,1002,1096,834,1075,954.0,1002.0,241,-262,503
835,5,15,2,9,0,1123,634,781,1105,856,454,680,597,621,651,776,861,818.0,763.0,85,125,-40
856,6,15,2,9,0,840,774,803,1070,953,364,644,584,685,706,708,895,802.0,770.0,187,2,185
1363,7,15,2,9,0,1315,1224,1513,1837,1329,778,1244,1284,1298,1141,1319,1334,1326.0,1265.0,15,178,-163
794,8,15,2,9,0,729,770,798,1203,945,474,746,713,727,660,639,991,815.0,763.0,352,-21,373
526,9,15,2,9,0,438,425,536,825,423,180,427,549,477,696,389,618,504.0,568.0,229,-307,536
191,10,15,2,9,0,141,135,160,243,179,71,140,141,183,151,137,141,139.0,143.0,4,-14,18
1620,11,15,2,9,0,1838,1848,1951,2643,1820,1058,1565,1288,1340,1313,1263,1676,1470.0,1417.0,413,-50,463
379,12,15,2,9,0,419,377,424,571,408,151,325,301,312,293,255,351,303.0,300.0,96,-38,134
1515,13,15,2,9,0,1377,1264,1433,1923,1604,884,1377,1523,1631,1539,1425,1590,1508.0,1518.0,165,-114,279
1016,14,15,2,9,0,1081,952,1113,1482,1178,548,1003,1062,1044,1052,1125,1238,1182.0,1138.0,113,73,40
733,15,15,2,9,0,733,722,894,1112,767,352,679,681,651,616,628,814,721.0,686.0,186,12,174
373,16,15,2,9,0,373,329,377,483,446,164,271,261,296,275,330,388,359.0,331.0,58,55,3
527,17,15,2,9,0,464,438,477,783,487,262,452,359,428,383,395,447,421.0,408.0,52,12,40
217,18,15,2,9,0,235,212,345,456,397,140,227,217,291,297,182,259,220.0,246.0,77,-115,192
217,19,15,2,9,0,261,247,251,310,270,165,356,218,179,255,221,255,238.0,244.0,34,-34,68
448,20,15,2,9,0,486,426,491,644,555,263,408,381,378,462,374,447,410.0,428.0,73,-88,161
536,21,15,2,9,0,568,617,622,758,719,361,603,579,645,499,553,624,588.0,559.0,71,54,17
96,22,15,2,9,0,159,142,152,169,104,79,149,106,141,121,123,121,122.0,122.0,-2,2,-4
55,1,16,2,9,0,41,395,67,117,63,37,86,109,100,151,123,42,82.0,105.0,-81,-28,-53
1465,2,16,2,9,0,1254,988,1142,1590,946,692,1035,755,884,765,1277,1207,1242.0,1083.0,-70,512,-582
1161,3,16,2,9,0,895,802,945,982,602,413,714,724,743,629,652,1139,896.0,807.0,487,23,464
341,4,16,2,9,0,737,477,625,985,300,271,404,282,274,292,278,289,284.0,286.0,11,-14,25
3201,5,16,2,9,0,2955,1733,2221,3340,1470,1639,3175,2405,2457,2398,2530,2754,2642.0,2561.0,224,132,92
478,6,16,2,9,0,488,424,410,575,248,260,384,279,286,452,366,371,368.0,396.0,5,-86,91
3668,7,16,2,9,0,3837,3617,3662,4024,1903,1708,2748,2376,2932,2420,2797,3096,2946.0,2771.0,299,377,-78
1434,8,16,2,9,0,1561,1243,1188,1616,679,442,672,792,892,815,1028,1189,1108.0,1011.0,161,213,-52
2157,9,16,2,9,0,2010,1906,2111,2398,1196,1075,2249,1558,2005,1936,1682,1885,1784.0,1834.0,203,-254,457
488,10,16,2,9,0,409,384,459,435,440,301,449,664,501,523,446,573,510.0,514.0,127,-77,204
810,11,16,2,9,0,840,781,777,930,527,626,655,605,586,670,623,694,658.0,662.0,71,-47,118
399,12,16,2,9,0,538,488,482,540,354,189,356,270,359,296,244,355,300.0,298.0,111,-52,163
3843,13,16,2,9,0,3910,3483,3233,4206,2068,1780,2633,2656,3148,2856,3242,3648,3445.0,3249.0,406,386,20
2094,14,16,2,9,0,2323,1931,2018,2962,1570,1050,1823,1515,1509,1506,1785,1836,1810.0,1709.0,51,279,-228
822,15,16,2,9,0,723,606,634,886,424,422,628,555,606,538,517,542,530.0,532.0,25,-21,46
533,16,16,2,9,0,725,585,544,920,483,270,442,304,376,403,430,440,435.0,424.0,10,27,-17
1450,17,16,2,9,0,1680,1444,1489,2336,1714,653,1232,835,1023,1076,1149,1284,1216.0,1170.0,135,73,62
661,18,16,2,9,0,710,690,597,622,308,292,460,424,486,428,470,413,442.0,437.0,-57,42,-99
1582,19,16,2,9,0,1871,1308,1478,1878,681,691,1319,1119,1215,1237,1419,1601,1510.0,1419.0,182,182,0
234,20,16,2,9,0,347,184,172,247,131,105,125,160,126,176,161,199,180.0,179.0,38,-15,53
777,21,16,2,9,0,695,580,634,1051,558,384,605,487,577,560,603,780,692.0,648.0,177,43,134
2187,22,16,2,9,0,1562,1308,1636,1781,730,952,1556,1254,1336,1463,1649,2283,1966.0,1798.0,634,186,448
1879,1,17,2,9,0,2397,1674,2362,3060,1909,501,2672,4039,883,4181,1421,1782,1602.0,2461.0,361,-2760,3121
1367,2,17,2,9,0,1076,1038,1033,1402,656,504,651,603,785,827,1300,1307,1304.0,1145.0,7,473,-466
749,3,17,2,9,0,541,468,630,827,268,214,376,413,543,491,575,777,676.0,614.0,202,84,118
355,4,17,2,9,0,835,516,1494,2145,217,200,2331,1550,280,361,498,297,398.0,385.0,-201,137,-338
2567,5,17,2,9,0,2707,1708,2119,2450,1355,937,1478,2078,1399,1459,1801,2351,2076.0,1870.0,550,342,208
2710,6,17,2,9,0,2863,2529,2927,3132,1460,775,1436,1362,1591,1598,1947,2510,2228.0,2018.0,563,349,214
4366,7,17,2,9,0,4409,4129,4087,5401,1885,1225,2010,2269,2615,2569,3263,3929,3596.0,3254.0,666,694,-28
1865,8,17,2,9,0,1510,1452,1547,2066,692,491,877,974,1192,1135,1670,2019,1844.0,1608.0,349,535,-186
1731,9,17,2,9,0,2192,2036,2188,2519,625,462,1475,1506,1216,1544,1515,1754,1634.0,1604.0,239,-29,268
689,10,17,2,9,0,589,568,596,616,308,176,366,289,407,451,518,551,534.0,507.0,33,67,-34
4430,11,17,2,9,0,5016,4475,5007,5643,2143,1862,2644,2631,3008,3307,4299,4173,4236.0,3926.0,-126,992,-1118
1734,12,17,2,9,0,2044,1627,1981,2357,973,442,916,895,1031,1009,1333,1810,1572.0,1384.0,477,324,153
4197,13,17,2,9,0,3951,3277,3711,5424,1723,1261,2043,2652,2981,2611,4091,4869,4480.0,3857.0,778,1480,-702
4989,14,17,2,9,0,4500,3793,4237,5119,2463,1238,2429,2562,2723,3091,4009,4961,4485.0,4020.0,952,918,34
2322,15,17,2,9,0,2777,2324,2401,2755,895,768,1359,1321,1533,1474,1767,2205,1986.0,1815.0,438,293,145
1567,16,17,2,9,0,1818,1296,1466,1985,1002,357,841,848,822,1085,1431,1415,1423.0,1310.0,-16,346,-362
2202,17,17,2,9,0,2187,1670,2078,2533,1085,531,1104,1014,1204,1328,1663,1969,1816.0,1653.0,306,335,-29
1242,18,17,2,9,0,1279,1170,1218,1549,440,400,775,721,1235,973,1141,1223,1182.0,1112.0,82,168,-86
746,19,17,2,9,0,897,700,869,1098,268,212,386,587,555,690,977,861,919.0,843.0,-116,287,-403
1122,20,17,2,9,0,1171,824,938,1120,617,359,603,607,619,800,1027,1072,1050.0,966.0,45,227,-182
1577,21,17,2,9,0,1300,1165,1199,1748,631,397,661,1831,842,1735,1691,1436,1564.0,1621.0,-255,-44,-211
458,22,17,2,9,0,404,286,466,480,162,156,276,218,323,452,354,467,410.0,424.0,113,-98,211
352,1,18,2,9,0,502,314,574,754,315,362,767,319,351,300,314,334,324.0,316.0,20,14,6
599,2,18,2,9,0,435,635,692,866,452,295,448,404,525,442,543,578,560.0,521.0,35,101,-66
679,3,18,2,9,0,427,495,612,941,427,254,591,556,550,476,504,704,604.0,561.0,200,28,172
113,4,18,2,9,0,346,199,341,546,125,89,159,100,115,114,150,110,130.0,125.0,-40,36,-76
1236,5,18,2,9,0,903,838,1187,1812,1017,704,1344,1235,1081,1056,878,1050,964.0,995.0,172,-178,350
812,6,18,2,9,0,734,813,952,1669,741,475,869,701,638,694,733,857,795.0,761.0,124,39,85
3132,7,18,2,9,0,2451,2995,3812,5496,2330,1515,2865,2841,2834,2558,2825,3266,3046.0,2883.0,441,267,174
1282,8,18,2,9,0,1052,1126,1234,2626,1165,641,1247,1425,1531,1329,1557,1538,1548.0,1475.0,-19,228,-247
614,9,18,2,9,0,529,384,525,1055,368,255,433,540,513,805,467,681,574.0,651.0,214,-338,552
107,10,18,2,9,0,255,362,355,448,365,155,240,485,249,405,222,128,175.0,252.0,-94,-183,89
1053,11,18,2,9,0,864,1310,1728,2261,1167,1028,1507,1281,827,792,892,955,924.0,880.0,63,100,-37
309,12,18,2,9,0,301,356,946,847,641,223,316,236,253,238,242,217,230.0,232.0,-25,4,-29
2904,13,18,2,9,0,2265,2586,3058,5478,1932,1551,2981,3513,3250,2524,3284,3386,3335.0,3065.0,102,760,-658
1597,14,18,2,9,0,1141,1472,1941,3092,1731,893,1695,1504,1408,1487,1714,1721,1718.0,1641.0,7,227,-220
623,15,18,2,9,0,659,638,706,1205,504,467,741,598,514,446,578,432,505.0,485.0,-146,132,-278
198,16,18,2,9,0,202,272,348,657,298,154,273,222,166,164,170,172,171.0,169.0,2,6,-4
425,17,18,2,9,0,698,568,587,1351,576,253,448,437,409,373,484,393,438.0,417.0,-91,111,-202
352,18,18,2,9,0,342,307,452,617,215,148,255,232,240,199,231,301,266.0,244.0,70,32,38
902,19,18,2,9,0,684,572,853,1026,394,408,768,721,776,679,667,892,780.0,746.0,225,-12,237
233,20,18,2,9,0,304,408,379,694,353,248,346,329,249,207,249,199,224.0,218.0,-50,42,-92
777,21,18,2,9,0,623,693,804,1400,754,418,791,600,553,553,625,614,620.0,597.0,-11,72,-83
943,22,18,2,9,0,307,324,496,710,280,266,503,464,518,466,471,859,665.0,599.0,388,5,383
237,1,19,2,9,0,150,148,312,359,339,177,321,249,248,328,254,307,280.0,296.0,53,-74,127
363,2,19,2,9,0,304,344,442,485,409,248,357,375,412,347,430,418,424.0,398.0,-12,83,-95
444,3,19,2,9,0,325,432,401,434,519,319,522,443,583,484,431,411,421.0,442.0,-20,-53,33
855,4,19,2,9,0,1150,795,1121,1802,1263,877,1267,1047,1549,1033,967,860,914.0,953.0,-107,-66,-41
1048,5,19,2,9,0,741,610,732,1083,1390,565,951,827,852,794,845,1009,927.0,883.0,164,51,113
590,6,19,2,9,0,323,440,519,629,667,315,471,534,553,570,581,499,540.0,550.0,-82,11,-93
1942,7,19,2,9,0,1391,1370,1666,1642,1861,878,1578,1694,1792,1554,1627,1927,1777.0,1703.0,300,73,227
455,8,19,2,9,0,330,480,421,414,426,317,451,395,445,395,431,409,420.0,412.0,-22,36,-58
878,9,19,2,9,0,523,704,995,1243,727,322,827,693,791,804,769,839,804.0,804.0,70,-35,105
190,10,19,2,9,0,156,159,192,214,225,119,204,139,193,190,168,192,180.0,183.0,24,-22,46
1046,11,19,2,9,0,1280,881,1099,1374,1336,868,1301,1124,1278,1241,1197,1296,1246.0,1245.0,99,-44,143
268,12,19,2,9,0,178,237,276,329,364,141,291,237,315,278,285,309,297.0,291.0,24,7,17
1750,13,19,2,9,0,1115,1052,1461,1615,1768,1165,1697,1805,2074,1714,1806,1864,1835.0,1795.0,58,92,-34
1504,14,19,2,9,0,1104,1357,1223,1443,1429,856,1325,1403,1419,1413,1478,1579,1528.0,1490.0,101,65,36
701,15,19,2,9,0,404,512,747,863,742,356,707,633,707,646,663,732,698.0,680.0,69,17,52
551,16,19,2,9,0,393,374,473,566,558,262,443,396,470,482,493,546,520.0,507.0,53,11,42
409,17,19,2,9,0,253,248,418,494,519,230,424,383,397,379,387,399,393.0,388.0,12,8,4
604,18,19,2,9,0,186,285,325,402,404,188,330,251,340,301,284,315,300.0,300.0,31,-17,48
828,19,19,2,9,0,569,738,644,1082,704,546,870,783,781,790,785,765,775.0,780.0,-20,-5,-15
329,20,19,2,9,0,262,251,282,391,433,202,335,319,317,436,335,381,358.0,384.0,46,-101,147
482,21,19,2,9,0,419,276,346,497,487,257,378,390,460,393,519,500,510.0,471.0,-19,126,-145
870,22,19,2,9,0,731,657,664,964,785,666,1198,1070,1179,970,890,1044,967.0,968.0,154,-80,234
639,1,20,1,9,0,1150,1010,1563,1504,815,447,731,532,612,632,552,602,577.0,595.0,50,-80,130
383,2,20,1,9,0,570,759,692,785,585,277,403,310,422,368,501,439,470.0,436.0,-62,133,-195
141,3,20,1,9,0,327,407,342,430,303,110,229,177,183,153,136,170,153.0,153.0,34,-17,51
272,4,20,1,9,0,925,740,925,1127,376,284,427,371,462,336,275,270,272.0,294.0,-5,-61,56
828,5,20,1,9,0,1885,1100,1320,1775,1096,562,764,657,680,772,616,717,666.0,702.0,101,-156,257
690,6,20,1,9,0,1023,1001,1064,1490,952,364,600,581,589,605,632,685,658.0,641.0,53,27,26
1047,7,20,1,9,0,1432,1303,1408,1739,940,501,805,813,957,836,892,940,916.0,889.0,48,56,-8
123,8,20,1,9,0,289,333,332,371,229,113,151,138,130,107,102,135,118.0,115.0,33,-5,38
800,9,20,1,9,0,1320,1463,1644,2216,854,451,986,862,846,947,768,780,774.0,832.0,12,-179,191
173,10,20,1,9,0,240,280,255,372,218,114,237,155,197,163,181,169,175.0,171.0,-12,18,-30
1123,11,20,1,9,0,1897,1872,2263,3132,1586,987,1345,1015,1158,1068,1086,1181,1134.0,1112.0,95,18,77
471,12,20,1,9,0,855,798,870,1144,754,284,498,430,503,444,457,461,459.0,454.0,4,13,-9
581,13,20,1,9,0,861,883,944,1218,652,442,599,687,716,543,668,679,674.0,630.0,11,125,-114
571,14,20,1,9,0,1067,1021,1121,1578,856,471,700,719,644,669,703,653,678.0,675.0,-50,34,-84
1278,15,20,1,9,0,2367,2323,2703,3371,1749,893,1369,1150,1156,1037,1172,1334,1253.0,1181.0,162,135,27
533,16,20,1,9,0,920,1033,988,1333,941,363,579,523,593,600,621,519,570.0,580.0,-102,21,-123
673,17,20,1,9,0,1056,973,1081,1561,1003,386,716,610,659,562,594,642,618.0,599.0,48,32,16
338,18,20,1,9,0,714,853,905,1102,667,370,551,387,534,372,366,372,369.0,370.0,6,-6,12
248,19,20,1,9,0,491,437,403,555,253,188,258,212,206,203,265,272,268.0,247.0,7,62,-55
248,20,20,1,9,0,477,428,496,740,452,184,293,290,264,303,274,250,262.0,276.0,-24,-29,5
205,21,20,1,9,0,433,450,479,533,395,223,292,216,328,233,285,238,262.0,252.0,-47,52,-99
179,22,20,1,9,0,359,320,352,428,213,219,281,217,259,239,210,238,224.0,229.0,28,-29,57
636,1,21,2,9,0,552,450,685,688,275,231,396,369,368,427,353,607,480.0,462.0,254,-74,328
634,2,21,2,9,0,640,687,714,1001,409,321,443,427,437,368,556,556,556.0,493.0,0,188,-188
660,3,21,2,9,0,557,650,671,789,370,239,440,455,525,460,522,607,564.0,530.0,85,62,23
549,4,21,2,9,0,1431,1045,1332,1807,402,360,619,496,497,491,482,542,512.0,505.0,60,-9,69
3069,5,21,2,9,0,2921,2017,2913,3590,1589,1106,1523,1538,1537,1666,1861,2475,2168.0,2001.0,614,195,419
1638,6,21,2,9,0,1596,1491,1717,1968,921,593,995,1124,1199,1070,1346,1713,1530.0,1376.0,367,276,91
2980,7,21,2,9,0,2615,2547,2776,3299,1329,945,1856,2083,2108,1738,2082,2655,2368.0,2158.0,573,344,229
791,8,21,2,9,0,787,813,782,1130,401,261,510,549,610,526,688,866,777.0,693.0,178,162,16
1488,9,21,2,9,0,1438,1702,2171,2397,475,354,1081,908,1044,1235,994,1368,1181.0,1199.0,374,-241,615
424,10,21,2,9,0,358,395,493,595,225,179,348,224,290,274,316,397,356.0,329.0,81,42,39
3158,11,21,2,9,0,2962,3228,3579,4302,1623,1477,2234,2129,2434,2155,2485,3088,2786.0,2576.0,603,330,273
842,12,21,2,9,0,755,781,885,1016,398,230,537,551,590,548,652,808,730.0,669.0,156,104,52
4034,13,21,2,9,0,2860,2877,2989,3954,1565,1311,2239,2725,3260,2705,3344,4173,3758.0,3407.0,829,639,190
3374,14,21,2,9,0,2493,2358,2638,3291,1489,872,1684,1948,1801,1780,2489,2996,2742.0,2422.0,507,709,-202
2753,15,21,2,9,0,1992,2163,2458,2897,961,793,1491,1417,1453,1417,1645,2472,2058.0,1845.0,827,228,599
1182,16,21,2,9,0,1142,948,1247,1304,805,357,634,667,656,762,898,966,932.0,875.0,68,136,-68
1080,17,21,2,9,0,950,757,948,1222,427,264,565,544,561,563,728,991,860.0,761.0,263,165,98
728,18,21,2,9,0,694,837,946,924,385,327,518,415,620,444,541,690,616.0,558.0,149,97,52
1162,19,21,2,9,0,1057,1007,1160,1513,414,423,828,916,847,707,895,1272,1084.0,958.0,377,188,189
559,20,21,2,9,0,365,407,493,612,296,209,288,300,336,388,329,435,382.0,384.0,106,-59,165
911,21,21,2,9,0,801,945,946,1143,404,239,410,468,587,452,654,835,744.0,647.0,181,202,-21
842,22,21,2,9,0,914,753,1190,1198,462,436,1058,713,772,690,729,1100,914.0,840.0,371,39,332
1004,1,22,4,9,0,690,633,790,925,325,455,653,555,624,740,612,758,685.0,703.0,146,-128,274
300,2,22,4,9,0,408,431,527,546,194,218,317,270,316,211,290,290,290.0,264.0,0,79,-79
334,3,22,4,9,0,355,371,359,418,168,163,287,292,335,266,288,328,308.0,294.0,40,22,18
655,4,22,4,9,0,1074,915,1162,1615,471,523,831,698,714,664,617,559,588.0,613.0,-58,-47,-11
1044,5,22,4,9,0,1155,772,961,1167,445,516,738,665,640,630,656,820,738.0,702.0,164,26,138
819,6,22,4,9,0,841,878,933,1003,374,418,658,653,606,565,618,791,704.0,658.0,173,53,120
2507,7,22,4,9,0,2308,2307,2370,2766,875,984,1739,1860,1899,1420,1615,2002,1808.0,1679.0,387,195,192
331,8,22,4,9,0,313,320,355,484,139,184,247,243,229,225,247,307,277.0,260.0,60,22,38
845,9,22,4,9,0,992,1092,1209,1464,402,402,896,629,772,826,680,829,754.0,778.0,149,-146,295
203,10,22,4,9,0,246,259,290,384,118,109,224,157,222,215,154,183,168.0,184.0,29,-61,90
2463,11,22,4,9,0,2679,2595,2801,3241,1057,1612,2234,1953,2227,1909,2048,2422,2235.0,2126.0,374,139,235
431,12,22,4,9,0,442,498,481,511,213,176,385,307,351,273,345,404,374.0,341.0,59,72,-13
1901,13,22,4,9,0,1525,1603,1929,2115,754,885,1533,1690,1813,1571,1661,1916,1788.0,1716.0,255,90,165
1356,14,22,4,9,0,1383,1309,1461,1740,591,724,1200,1228,1058,967,1158,1211,1184.0,1112.0,53,191,-138
2311,15,22,4,9,0,1991,2033,2127,2662,818,1237,1764,1676,1729,1525,1884,2258,2071.0,1889.0,374,359,15
557,16,22,4,9,0,611,603,616,685,305,279,470,356,444,412,438,504,471.0,451.0,66,26,40
525,17,22,4,9,0,645,501,559,768,256,278,497,347,424,341,409,480,444.0,410.0,71,68,3
363,18,22,4,9,0,397,473,480,608,216,257,389,262,395,326,356,356,356.0,346.0,0,30,-30
385,19,22,4,9,0,553,489,516,595,169,217,412,408,386,321,346,352,349.0,340.0,6,25,-19
163,20,22,4,9,0,189,159,216,258,69,99,133,100,129,180,126,116,121.0,141.0,-10,-54,44
460,21,22,4,9,0,425,510,487,657,185,238,361,306,395,301,417,437,427.0,385.0,20,116,-96
357,22,22,4,9,0,511,443,413,533,157,228,535,404,398,359,345,475,410.0,393.0,130,-14,144
38,1,23,1,9,0,126,104,114,215,76,41,45,61,38,52,37,39,38.0,43.0,2,-15,17
41,2,23,1,9,0,133,139,121,182,95,41,34,36,31,58,44,55,50.0,52.0,11,-14,25
79,3,23,1,9,0,121,108,174,205,99,66,95,76,72,76,74,85,80.0,78.0,11,-2,13
39,4,23,1,9,0,250,161,243,439,74,40,54,53,41,27,32,51,42.0,37.0,19,5,14
183,5,23,1,9,0,459,291,297,513,309,153,136,133,149,150,134,136,135.0,140.0,2,-16,18
395,6,23,1,9,0,655,600,692,1047,578,273,312,307,331,314,279,347,313.0,313.0,68,-35,103
690,7,23,1,9,0,1138,1097,1099,1844,902,381,538,572,675,544,536,649,592.0,576.0,113,-8,121
265,8,23,1,9,0,250,277,308,545,238,158,237,226,236,217,178,237,208.0,211.0,59,-39,98
141,9,23,1,9,0,282,277,289,373,126,71,118,103,101,96,92,121,106.0,103.0,29,-4,33
56,10,23,1,9,0,108,100,115,162,93,53,69,35,53,40,48,50,49.0,46.0,2,8,-6
207,11,23,1,9,0,370,406,397,621,300,168,197,206,183,203,185,213,199.0,200.0,28,-18,46
59,12,23,1,9,0,150,164,143,266,151,36,61,68,60,40,53,57,55.0,50.0,4,13,-9
544,13,23,1,9,0,742,699,808,1460,748,389,430,459,518,401,452,524,488.0,459.0,72,51,21
303,14,23,1,9,0,566,471,617,1100,524,174,251,240,290,254,290,316,303.0,287.0,26,36,-10
74,15,23,1,9,0,198,211,191,260,101,55,63,66,67,90,77,72,74.0,80.0,-5,-13,8
182,16,23,1,9,0,326,324,313,534,275,79,103,125,96,138,125,127,126.0,130.0,2,-13,15
166,17,23,1,9,0,347,286,335,535,308,119,163,126,142,139,138,161,150.0,146.0,23,-1,24
56,18,23,1,9,0,102,89,87,129,60,25,51,31,35,42,33,28,30.0,34.0,-5,-9,4
180,19,23,1,9,0,280,278,265,371,149,91,133,121,130,132,148,200,174.0,160.0,52,16,36
85,20,23,1,9,0,250,189,199,335,168,84,69,66,80,88,67,79,73.0,78.0,12,-21,33
110,21,23,1,9,0,167,197,186,360,209,62,83,76,106,84,83,85,84.0,84.0,2,-1,3
132,22,23,1,9,0,248,169,223,312,126,95,154,101,143,86,105,123,114.0,105.0,18,19,-1
654,1,24,2,9,0,651,489,558,362,679,494,731,600,672,772,704,727,716.0,734.0,23,-68,91
174,2,24,2,9,0,201,174,160,155,229,130,223,186,188,194,250,267,258.0,237.0,17,56,-39
92,3,24,2,9,0,97,99,82,59,106,63,136,99,113,83,99,112,106.0,98.0,13,16,-3
659,4,24,2,9,0,831,642,654,521,798,532,838,575,694,618,670,630,650.0,639.0,-40,52,-92
507,5,24,2,9,0,615,471,430,474,703,394,653,524,606,614,549,576,562.0,580.0,27,-65,92
335,6,24,2,9,0,348,248,228,187,338,203,372,311,341,346,340,353,346.0,346.0,13,-6,19
473,7,24,2,9,0,525,474,421,353,610,362,607,527,608,548,531,526,528.0,535.0,-5,-17,12
119,8,24,2,9,0,121,105,117,105,129,94,160,139,138,152,130,124,127.0,135.0,-6,-22,16
1161,9,24,2,9,0,1180,1049,976,1007,1207,847,1361,1093,1267,1219,1095,1304,1200.0,1206.0,209,-124,333
146,10,24,2,9,0,151,126,138,119,159,102,172,121,154,153,137,153,145.0,148.0,16,-16,32
1338,11,24,2,9,0,1585,1270,1186,1077,1735,1066,1713,1523,1554,1639,1493,1583,1538.0,1572.0,90,-146,236
224,12,24,2,9,0,232,164,154,152,242,146,291,216,232,253,206,215,210.0,225.0,9,-47,56
376,13,24,2,9,0,362,307,254,182,340,242,360,379,362,327,372,362,367.0,354.0,-10,45,-55
332,14,24,2,9,0,339,239,284,223,320,199,311,289,319,320,350,407,378.0,359.0,57,30,27
1190,15,24,2,9,0,1439,1239,1136,1024,1529,973,1602,1326,1507,1501,1473,1537,1505.0,1504.0,64,-28,92
338,16,24,2,9,0,407,272,273,274,370,238,369,296,339,369,331,321,326.0,340.0,-10,-38,28
299,17,24,2,9,0,285,213,205,215,305,186,346,275,278,289,275,275,275.0,280.0,0,-14,14
413,18,24,2,9,0,448,353,321,324,518,242,572,350,498,528,403,477,440.0,469.0,74,-125,199
266,19,24,2,9,0,299,229,207,174,292,205,321,225,242,252,295,316,306.0,288.0,21,43,-22
190,20,24,2,9,0,255,197,217,217,267,199,277,240,244,232,258,263,260.0,251.0,5,26,-21
210,21,24,2,9,0,283,263,205,197,285,151,281,203,248,250,270,252,261.0,257.0,-18,20,-38
92,22,24,2,9,0,71,81,63,53,93,68,133,85,82,113,113,134,124.0,120.0,21,0,21
290,1,25,1,9,0,281,281,247,225,315,160,297,263,287,314,230,299,264.0,281.0,69,-84,153
187,2,25,1,9,0,165,167,133,176,164,108,164,133,153,126,180,169,174.0,158.0,-11,54,-65
103,3,25,1,9,0,120,96,85,86,86,62,103,111,102,97,88,89,88.0,91.0,1,-9,10
289,4,25,1,9,0,429,308,324,417,323,190,356,270,290,257,234,246,240.0,246.0,12,-23,35
389,5,25,1,9,0,389,305,301,337,483,166,411,313,351,316,288,271,280.0,292.0,-17,-28,11
219,6,25,1,9,0,205,162,169,174,188,119,173,183,210,172,186,222,204.0,193.0,36,14,22
332,7,25,1,9,0,292,265,227,253,339,160,306,297,331,234,253,292,272.0,260.0,39,19,20
102,8,25,1,9,0,99,83,81,91,111,56,97,101,97,84,91,94,92.0,90.0,3,7,-4
505,9,25,1,9,0,575,462,510,512,581,314,531,409,540,562,422,478,450.0,487.0,56,-140,196
92,10,25,1,9,0,108,102,103,109,128,57,103,59,104,114,85,94,90.0,98.0,9,-29,38
797,11,25,1,9,0,757,642,661,734,807,456,741,678,793,643,655,701,678.0,666.0,46,12,34
138,12,25,1,9,0,155,115,129,138,165,79,158,126,152,118,104,127,116.0,116.0,23,-14,37
247,13,25,1,9,0,226,184,180,178,203,126,201,195,251,175,165,222,194.0,187.0,57,-10,67
215,14,25,1,9,0,187,161,189,173,186,103,191,191,194,156,186,216,201.0,186.0,30,30,0
718,15,25,1,9,0,620,587,599,595,656,382,738,625,720,647,584,732,658.0,654.0,148,-63,211
262,16,25,1,9,0,331,219,258,266,270,142,257,214,255,256,231,241,236.0,243.0,10,-25,35
213,17,25,1,9,0,179,160,168,191,210,114,205,161,191,162,167,198,182.0,176.0,31,5,26
237,18,25,1,9,0,259,202,201,205,241,127,267,183,283,239,197,201,199.0,212.0,4,-42,46
130,19,25,1,9,0,165,130,138,128,140,90,113,125,138,146,129,145,137.0,140.0,16,-17,33
144,20,25,1,9,0,109,123,106,134,131,54,117,102,136,130,124,110,117.0,121.0,-14,-6,-8
138,21,25,1,9,0,192,172,135,145,159,85,142,119,156,144,123,140,132.0,136.0,17,-21,38
81,22,25,1,9,0,74,50,53,61,68,34,78,65,79,70,61,83,72.0,71.0,22,-9,31
593,1,26,1,9,0,478,428,493,474,835,424,592,562,626,644,634,694,664.0,657.0,60,-10,70
238,2,26,1,9,0,237,204,210,215,310,178,234,223,203,223,258,250,254.0,244.0,-8,35,-43
105,3,26,1,9,0,91,72,82,74,139,87,116,104,125,105,116,128,122.0,116.0,12,11,1
751,4,26,1,9,0,853,604,747,817,1033,648,841,763,792,726,727,824,776.0,759.0,97,1,96
615,5,26,1,9,0,388,382,361,382,695,383,524,456,456,507,479,440,460.0,475.0,-39,-28,-11
255,6,26,1,9,0,228,183,176,177,354,152,225,259,222,223,254,259,256.0,245.0,5,31,-26
468,7,26,1,9,0,344,338,348,336,608,328,530,488,475,451,429,468,448.0,449.0,39,-22,61
138,8,26,1,9,0,108,84,93,100,165,96,130,118,97,142,140,152,146.0,145.0,12,-2,14
1111,9,26,1,9,0,875,627,766,825,1178,690,1101,964,1020,962,1084,1109,1096.0,1052.0,25,122,-97
148,10,26,1,9,0,124,72,100,114,160,106,163,133,138,136,134,129,132.0,133.0,-5,-2,-3
1012,11,26,1,9,0,918,791,915,1007,1591,766,1115,1026,1072,1033,982,1080,1031.0,1032.0,98,-51,149
175,12,26,1,9,0,155,101,129,108,227,115,167,214,182,168,165,197,181.0,177.0,32,-3,35
260,13,26,1,9,0,200,202,203,219,376,209,316,289,290,301,301,298,300.0,300.0,-3,0,-3
329,14,26,1,9,0,252,194,283,262,357,201,287,304,275,256,289,287,288.0,277.0,-2,33,-35
930,15,26,1,9,0,834,733,849,908,1436,623,970,967,965,954,954,1063,1008.0,990.0,109,0,109
379,16,26,1,9,0,326,230,315,356,436,202,366,316,282,393,360,384,372.0,379.0,24,-33,57
252,17,26,1,9,0,184,143,174,192,302,179,246,255,226,219,246,249,248.0,238.0,3,27,-24
361,18,26,1,9,0,266,197,227,256,500,212,338,297,357,330,288,330,309.0,316.0,42,-42,84
268,19,26,1,9,0,225,176,194,227,304,176,286,261,241,263,276,299,288.0,279.0,23,13,10
223,20,26,1,9,0,176,151,174,194,265,152,205,197,174,223,187,198,192.0,203.0,11,-36,47
226,21,26,1,9,0,228,210,194,216,307,140,222,205,251,252,248,224,236.0,241.0,-24,-4,-20
92,22,26,1,9,0,77,74,83,85,102,84,125,116,121,127,86,123,104.0,112.0,37,-41,78
210,1,27,4,9,0,190,188,201,262,80,97,160,113,154,142,142,182,162.0,155.0,40,0,40
58,2,27,4,9,0,52,76,100,59,26,35,34,50,78,51,74,46,60.0,57.0,-28,23,-51
25,3,27,4,9,0,31,42,40,37,22,17,26,37,25,21,17,27,22.0,22.0,10,-4,14
163,4,27,4,9,0,232,200,230,226,93,117,153,137,139,94,88,112,100.0,98.0,24,-6,30
277,5,27,4,9,0,216,166,240,223,57,76,90,137,164,128,144,184,164.0,152.0,40,16,24
95,6,27,4,9,0,106,110,130,121,57,59,72,81,74,76,100,108,104.0,95.0,8,24,-16
268,7,27,4,9,0,258,215,231,199,113,137,218,152,167,149,160,180,170.0,163.0,20,11,9
34,8,27,4,9,0,31,31,28,33,16,10,28,22,76,22,26,27,26.0,25.0,1,4,-3
232,9,27,4,9,0,290,309,396,384,120,115,231,223,244,188,202,225,214.0,205.0,23,14,9
53,10,27,4,9,0,35,34,41,40,20,18,18,25,33,31,30,38,34.0,33.0,8,-1,9
503,11,27,4,9,0,447,420,635,591,225,325,414,342,390,329,340,426,383.0,365.0,86,11,75
58,12,27,4,9,0,50,52,66,85,10,18,37,40,39,37,38,50,44.0,42.0,12,1,11
127,13,27,4,9,0,145,141,166,161,78,99,131,131,102,71,97,118,108.0,95.0,21,26,-5
128,14,27,4,9,0,118,117,128,163,57,77,90,88,75,84,92,121,106.0,99.0,29,8,21
575,15,27,4,9,0,415,422,523,567,168,290,344,386,300,355,415,511,463.0,427.0,96,60,36
111,16,27,4,9,0,110,92,120,142,48,54,76,88,66,69,75,103,89.0,82.0,28,6,22
92,17,27,4,9,0,96,79,112,124,41,43,61,74,75,46,72,85,78.0,68.0,13,26,-13
70,18,27,4,9,0,61,85,108,127,23,28,50,51,59,58,62,64,63.0,61.0,2,4,-2
89,19,27,4,9,0,87,77,106,83,28,38,67,45,65,40,54,75,64.0,56.0,21,14,7
56,20,27,4,9,0,47,43,77,67,17,20,19,34,34,37,30,40,35.0,36.0,10,-7,17
75,21,27,4,9,0,79,83,68,82,41,52,48,66,99,56,51,90,70.0,66.0,39,-5,44
30,22,27,4,9,0,42,40,48,45,18,18,48,30,46,28,19,30,24.0,26.0,11,-9,20
825,1,28,2,9,0,145,129,306,492,378,283,374,311,427,498,475,609,542.0,527.0,134,-23,157
259,2,28,2,9,0,83,75,142,154,140,101,145,149,178,192,272,277,274.0,247.0,5,80,-75
185,3,28,2,9,0,47,48,67,109,121,79,109,124,169,140,135,176,156.0,150.0,41,-5,46
730,4,28,2,9,0,321,175,311,576,511,299,438,522,580,543,591,697,644.0,610.0,106,48,58
1038,5,28,2,9,0,356,206,340,526,495,291,361,444,497,529,571,643,607.0,581.0,72,42,30
565,6,28,2,9,0,104,111,219,307,304,148,259,319,271,331,363,453,408.0,382.0,90,32,58
941,7,28,2,9,0,246,241,312,378,406,284,400,479,557,520,550,741,646.0,604.0,191,30,161
185,8,28,2,9,0,47,46,58,83,94,61,99,97,93,99,121,177,149.0,132.0,56,22,34
1094,9,28,2,9,0,398,282,593,912,598,355,607,642,701,764,756,899,828.0,806.0,143,-8,151
158,10,28,2,9,0,39,30,50,68,74,33,77,72,113,104,139,145,142.0,129.0,6,35,-29
1727,11,28,2,9,0,270,351,609,1028,993,652,891,910,1046,1085,1159,1451,1305.0,1232.0,292,74,218
344,12,28,2,9,0,47,59,107,208,200,69,151,150,175,152,209,258,234.0,206.0,49,57,-8
630,13,28,2,9,0,172,141,298,340,342,250,323,382,440,423,438,563,500.0,475.0,125,15,110
560,14,28,2,9,0,143,136,170,239,290,184,293,341,325,356,405,492,448.0,418.0,87,49,38
2180,15,28,2,9,0,643,498,965,1300,996,708,969,1088,1209,1284,1524,1958,1741.0,1589.0,434,240,194
473,16,28,2,9,0,116,101,212,331,334,134,250,279,305,303,339,437,388.0,360.0,98,36,62
484,17,28,2,9,0,78,92,180,310,284,146,251,271,354,267,331,429,380.0,342.0,98,64,34
353,18,28,2,9,0,69,95,138,176,229,97,153,164,270,221,253,308,280.0,261.0,55,32,23
531,19,28,2,9,0,193,157,189,261,256,190,274,317,341,370,440,648,544.0,486.0,208,70,138
256,20,28,2,9,0,51,35,76,157,115,82,120,97,175,209,162,190,176.0,187.0,28,-47,75
387,21,28,2,9,0,115,96,127,205,223,136,166,239,247,199,284,366,325.0,283.0,82,85,-3
210,22,28,2,9,0,58,56,108,145,104,92,153,138,145,157,161,240,200.0,186.0,79,4,75
449,1,29,1,9,0,494,298,341,507,266,214,347,256,335,387,323,471,397.0,394.0,148,-64,212
157,2,29,1,9,0,197,180,169,225,142,99,142,158,164,176,231,206,218.0,204.0,-25,55,-80
178,3,29,1,9,0,174,157,121,169,76,74,105,133,145,136,151,168,160.0,152.0,17,15,2
353,4,29,1,9,0,529,355,417,450,177,170,259,234,290,279,265,274,270.0,273.0,9,-14,23
596,5,29,1,9,0,641,403,433,394,242,224,324,333,361,319,358,452,405.0,376.0,94,39,55
323,6,29,1,9,0,328,172,256,310,160,139,211,231,217,227,254,298,276.0,260.0,44,27,17
597,7,29,1,9,0,582,453,469,507,305,251,332,402,428,398,413,574,494.0,462.0,161,15,146
173,8,29,1,9,0,143,117,124,97,55,43,101,86,111,100,106,169,138.0,125.0,63,6,57
788,9,29,1,9,0,867,710,821,895,435,271,630,599,641,694,710,772,741.0,725.0,62,16,46
118,10,29,1,9,0,137,85,114,124,79,66,108,95,119,99,124,137,130.0,120.0,13,25,-12
1019,11,29,1,9,0,1166,688,937,1154,552,589,835,807,903,879,877,1098,988.0,951.0,221,-2,223
227,12,29,1,9,0,193,186,189,178,106,91,145,142,176,146,152,202,177.0,167.0,50,6,44
362,13,29,1,9,0,423,324,327,378,179,188,251,302,319,290,307,411,359.0,336.0,104,17,87
348,14,29,1,9,0,420,237,276,308,156,143,260,258,238,212,252,290,271.0,251.0,38,40,-2
1388,15,29,1,9,0,1045,917,1072,1169,550,543,759,841,892,995,1035,1285,1160.0,1105.0,250,40,210
438,16,29,1,9,0,429,270,308,378,261,177,285,262,281,264,324,372,348.0,320.0,48,60,-12
310,17,29,1,9,0,359,193,226,309,145,129,251,238,285,222,261,332,296.0,272.0,71,39,32
255,18,29,1,9,0,263,253,214,293,168,110,183,202,270,233,236,280,258.0,250.0,44,3,41
233,19,29,1,9,0,242,174,177,213,86,85,121,151,164,140,139,209,174.0,163.0,70,-1,71
144,20,29,1,9,0,128,96,89,130,65,59,92,68,101,131,82,96,89.0,103.0,14,-49,63
198,21,29,1,9,0,215,165,164,174,112,81,131,150,180,137,151,189,170.0,159.0,38,14,24
90,22,29,1,9,0,140,82,95,85,44,40,74,82,95,78,104,128,116.0,103.0,24,26,-2
671,1,30,1,9,0,504,402,593,748,538,251,456,315,445,485,411,558,484.0,485.0,147,-74,221
328,2,30,1,9,0,231,316,323,344,263,166,191,198,263,290,341,252,296.0,294.0,-89,51,-140
194,3,30,1,9,0,201,207,206,200,197,109,152,165,213,178,177,172,174.0,176.0,-5,-1,-4
920,4,30,1,9,0,731,715,939,1050,755,424,693,651,781,754,805,949,877.0,836.0,144,51,93
959,5,30,1,9,0,1072,583,560,641,624,348,443,468,502,547,611,673,642.0,610.0,62,64,-2
394,6,30,1,9,0,329,282,331,409,330,200,229,256,264,317,284,317,300.0,306.0,33,-33,66
768,7,30,1,9,0,678,438,630,646,659,309,458,540,534,523,541,632,586.0,565.0,91,18,73
160,8,30,1,9,0,143,139,142,103,120,44,90,120,136,128,136,187,162.0,150.0,51,8,43
1501,9,30,1,9,0,1342,1295,1408,1829,1269,499,1006,894,1099,1203,1068,1323,1196.0,1198.0,255,-135,390
193,10,30,1,9,0,189,162,142,255,213,82,152,117,156,149,174,198,186.0,174.0,24,25,-1
1354,11,30,1,9,0,1255,1040,1108,1430,1304,649,954,933,1003,955,1112,1268,1190.0,1112.0,156,157,-1
341,12,30,1,9,0,275,218,275,247,282,85,186,198,229,203,249,256,252.0,236.0,7,46,-39
548,13,30,1,9,0,471,407,417,527,425,254,337,412,434,405,458,546,502.0,470.0,88,53,35
412,14,30,1,9,0,469,405,382,502,442,251,354,426,325,372,375,398,386.0,382.0,23,3,20
1660,15,30,1,9,0,1241,932,1214,1500,938,567,836,888,1017,1178,1317,1460,1388.0,1318.0,143,139,4
503,16,30,1,9,0,529,447,473,526,572,259,428,363,377,445,438,468,453.0,450.0,30,-7,37
470,17,30,1,9,0,476,369,391,505,374,207,342,370,431,366,451,421,436.0,413.0,-30,85,-115
348,18,30,1,9,0,282,298,320,358,335,144,206,194,282,238,262,319,290.0,273.0,57,24,33
484,19,30,1,9,0,418,357,335,454,281,156,268,293,330,277,371,482,426.0,377.0,111,94,17
267,20,30,1,9,0,259,188,209,244,199,108,153,121,186,284,146,224,185.0,218.0,78,-138,216
331,21,30,1,9,0,352,366,242,346,325,174,210,225,299,236,330,298,314.0,288.0,-32,94,-126
136,22,30,1,9,0,219,123,190,198,139,94,144,137,133,149,128,210,169.0,162.0,82,-21,103
518,1,31,2,9,0,438,357,513,576,543,384,696,487,649,633,685,664,674.0,661.0,-21,52,-73
233,2,31,2,9,0,139,117,236,257,243,199,312,234,314,249,292,267,280.0,269.0,-25,43,-68
76,3,31,2,9,0,47,37,60,80,54,43,84,76,64,93,74,68,71.0,78.0,-6,-19,13
578,4,31,2,9,0,410,328,585,816,536,311,688,527,617,587,668,640,654.0,632.0,-28,81,-109
659,5,31,2,9,0,455,290,447,593,591,337,640,478,571,603,551,645,598.0,600.0,94,-52,146
400,6,31,2,9,0,236,233,275,385,322,230,435,350,391,362,386,364,375.0,371.0,-22,24,-46
540,7,31,2,9,0,297,285,401,440,468,289,622,538,593,498,535,586,560.0,540.0,51,37,14
91,8,31,2,9,0,31,30,61,103,57,64,78,79,91,70,76,114,95.0,87.0,38,6,32
1372,9,31,2,9,0,800,773,983,1319,1274,618,1449,1061,1394,1469,1265,1360,1312.0,1365.0,95,-204,299
190,10,31,2,9,0,93,94,126,167,115,84,164,123,176,156,157,172,164.0,162.0,15,1,14
1073,11,31,2,9,0,729,862,988,1160,1203,919,1681,1193,1428,1269,1375,1458,1416.0,1367.0,83,106,-23
203,12,31,2,9,0,144,96,129,200,185,89,224,198,224,201,206,230,218.0,212.0,24,5,19
409,13,31,2,9,0,194,192,281,283,417,232,460,496,484,423,463,437,450.0,441.0,-26,40,-66
393,14,31,2,9,0,209,174,237,350,258,224,388,425,429,397,410,418,414.0,408.0,8,13,-5
1579,15,31,2,9,0,1208,929,1465,1724,1540,1004,2273,1596,1876,1650,1852,1906,1879.0,1803.0,54,202,-148
331,16,31,2,9,0,199,144,218,283,271,143,325,266,300,353,314,383,348.0,350.0,69,-39,108
397,17,31,2,9,0,209,203,255,374,375,195,380,321,402,363,372,409,390.0,381.0,37,9,28
384,18,31,2,9,0,236,214,251,346,352,161,369,304,419,307,353,366,360.0,342.0,13,46,-33
212,19,31,2,9,0,133,91,159,186,215,146,225,256,285,240,260,305,282.0,268.0,45,20,25
213,20,31,2,9,0,132,105,200,253,198,131,290,195,274,315,277,268,272.0,287.0,-9,-38,29
199,21,31,2,9,0,159,132,134,174,188,135,235,193,286,212,215,219,217.0,215.0,4,3,1
69,22,31,2,9,0,23,28,58,76,70,44,104,104,97,90,78,104,91.0,91.0,26,-12,38
261,1,32,3,9,0,426,299,501,825,333,136,253,217,192,208,169,209,189.0,195.0,40,-39,79
633,2,32,3,9,0,913,926,928,1393,1050,634,598,559,552,559,568,496,532.0,541.0,-72,9,-81
194,3,32,3,9,0,200,230,272,405,185,132,207,141,156,128,146,189,168.0,154.0,43,18,25
91,4,32,3,9,0,370,330,446,852,178,127,199,127,128,132,116,105,110.0,118.0,-11,-16,5
479,5,32,3,9,0,971,792,934,1509,1063,565,512,413,385,387,456,447,452.0,430.0,-9,69,-78
1032,6,32,3,9,0,1421,1263,1461,2601,1965,1072,936,771,749,842,897,904,900.0,881.0,7,55,-48
2146,7,32,3,9,0,2814,2975,3077,5360,2858,1598,1729,1694,1756,1539,1936,1912,1924.0,1796.0,-24,397,-421
542,8,32,3,9,0,778,791,803,1442,701,396,447,437,462,390,470,484,477.0,448.0,14,80,-66
3372,9,32,3,9,0,5098,5032,5800,8421,3465,1872,3263,2465,2754,2779,2551,2831,2691.0,2720.0,280,-228,508
1771,10,32,3,9,0,3110,3025,3479,6171,2981,1510,1845,1206,1444,1326,1376,2120,1748.0,1607.0,744,50,694
1410,11,32,3,9,0,2045,1978,2153,3757,2028,1542,1465,1325,1301,1251,1387,1382,1384.0,1340.0,-5,136,-141
463,12,32,3,9,0,806,703,736,1319,827,443,434,359,341,393,389,426,408.0,403.0,37,-4,41
1276,13,32,3,9,0,1631,1500,1789,2863,1366,1047,1021,1146,1168,1072,1294,1269,1282.0,1212.0,-25,222,-247
3080,14,32,3,9,0,4617,4700,5194,9539,6024,2842,2528,2423,2523,2603,3162,2973,3068.0,2913.0,-189,559,-748
894,15,32,3,9,0,1435,1528,1653,2646,934,580,745,680,733,621,813,822,818.0,752.0,9,192,-183
595,16,32,3,9,0,891,696,982,1629,1137,521,524,406,468,397,454,447,450.0,433.0,-7,57,-64
889,17,32,3,9,0,1544,1234,1513,2352,1658,771,808,663,615,657,743,779,761.0,726.0,36,86,-50
371,18,32,3,9,0,706,724,738,1086,453,316,456,314,359,319,319,322,320.0,320.0,3,0,3
512,19,32,3,9,0,644,644,694,1039,408,313,505,468,482,534,500,483,492.0,506.0,-17,-34,17
169,20,32,3,9,0,359,279,304,514,324,210,169,172,136,158,183,160,172.0,167.0,-23,25,-48
634,21,32,3,9,0,785,855,1045,1704,937,403,499,452,488,436,535,576,556.0,516.0,41,99,-58
559,22,32,3,9,0,839,638,832,1045,394,365,562,482,469,565,521,543,532.0,543.0,22,-44,66
770,1,33,2,9,0,2065,1032,1283,1483,389,338,505,521,647,608,619,726,672.0,651.0,107,11,96
248,2,33,2,9,0,402,396,360,567,208,160,208,214,226,198,297,263,280.0,253.0,-34,99,-133
370,3,33,2,9,0,712,648,698,789,413,215,340,311,387,355,326,370,348.0,350.0,44,-29,73
86,4,33,2,9,0,451,276,389,488,143,102,126,84,102,87,71,101,86.0,86.0,30,-16,46
831,5,33,2,9,0,1286,786,820,1117,531,374,577,521,559,581,527,664,596.0,591.0,137,-54,191
360,6,33,2,9,0,726,594,615,705,385,198,241,246,257,285,305,420,362.0,337.0,115,20,95
1251,7,33,2,9,0,1777,1435,1352,1707,803,424,738,843,928,824,912,1138,1025.0,958.0,226,88,138
260,8,33,2,9,0,391,347,352,464,131,87,174,169,231,178,188,345,266.0,237.0,157,10,147
327,9,33,2,9,0,326,342,407,475,130,117,221,195,239,246,184,249,216.0,226.0,65,-62,127
109,10,33,2,9,0,181,167,158,231,93,43,77,54,89,79,95,76,86.0,83.0,-19,16,-35
1361,11,33,2,9,0,2099,1880,1868,2181,991,782,1094,1007,1280,1090,1058,1318,1188.0,1155.0,260,-32,292
331,12,33,2,9,0,532,430,438,495,251,128,183,180,217,188,232,281,256.0,234.0,49,44,5
765,13,33,2,9,0,1153,782,978,1229,546,360,592,598,847,611,670,860,765.0,714.0,190,59,131
577,14,33,2,9,0,954,750,835,1053,508,259,492,410,471,586,659,755,707.0,667.0,96,73,23
681,15,33,2,9,0,920,884,1063,1213,348,291,556,450,632,576,610,714,662.0,633.0,104,34,70
238,16,33,2,9,0,406,336,358,440,200,80,136,138,174,236,210,228,219.0,225.0,18,-26,44
464,17,33,2,9,0,688,528,670,749,385,150,254,224,307,284,328,398,363.0,337.0,70,44,26
252,18,33,2,9,0,314,302,385,408,188,136,178,176,297,240,200,252,226.0,231.0,52,-40,92
110,19,33,2,9,0,246,156,195,210,53,54,81,84,109,71,94,144,119.0,103.0,50,23,27
118,20,33,2,9,0,240,178,181,295,131,85,113,117,117,161,107,136,122.0,135.0,29,-54,83
674,21,33,2,9,0,1109,958,1012,1286,412,280,531,610,649,548,736,763,750.0,682.0,27,188,-161
106,22,33,2,9,0,256,202,210,228,66,80,160,104,150,105,113,153,133.0,124.0,40,8,32
429,1,34,2,9,0,422,337,524,679,950,175,263,226,214,231,1376,364,870.0,657.0,-1012,1145,-2157
193,2,34,2,9,0,142,173,215,293,131,118,135,108,106,85,183,133,158.0,134.0,-50,98,-148
67,3,34,2,9,0,87,94,102,118,60,38,63,48,62,45,54,52,53.0,50.0,-2,9,-11
201,4,34,2,9,0,241,166,231,280,180,87,167,105,117,108,135,120,128.0,121.0,-15,27,-42
401,5,34,2,9,0,419,226,291,404,151,140,210,163,126,156,158,240,199.0,185.0,82,2,80
190,6,34,2,9,0,172,127,176,201,116,64,85,74,80,96,91,141,116.0,109.0,50,-5,55
411,7,34,2,9,0,405,274,383,451,230,146,276,296,237,243,266,313,290.0,274.0,47,23,24
94,8,34,2,9,0,104,75,85,95,42,23,68,34,43,37,45,67,56.0,50.0,22,8,14
132,9,34,2,9,0,140,175,225,268,104,54,144,101,111,106,100,115,108.0,107.0,15,-6,21
44,10,34,2,9,0,42,39,42,71,30,28,32,17,42,31,35,34,34.0,33.0,-1,4,-5
537,11,34,2,9,0,566,501,644,669,334,279,388,278,361,289,335,427,381.0,350.0,92,46,46
97,12,34,2,9,0,97,83,104,86,64,32,40,53,58,44,58,62,60.0,55.0,4,14,-10
288,13,34,2,9,0,186,192,206,272,140,97,162,151,190,159,151,222,186.0,177.0,71,-8,79
275,14,34,2,9,0,156,169,219,319,144,90,156,142,133,159,150,253,202.0,187.0,103,-9,112
399,15,34,2,9,0,293,289,400,452,190,120,235,179,236,184,200,265,232.0,216.0,65,16,49
99,16,34,2,9,0,71,47,81,82,146,33,61,41,44,47,128,75,102.0,83.0,-53,81,-134
167,17,34,2,9,0,158,115,135,228,105,59,115,89,71,92,97,142,120.0,110.0,45,5,40
81,18,34,2,9,0,93,107,132,139,77,43,64,62,76,55,207,71,139.0,111.0,-136,152,-288
57,19,34,2,9,0,69,52,62,81,42,40,28,19,48,46,42,41,42.0,43.0,-1,-4,3
97,20,34,2,9,0,66,46,77,87,44,31,56,52,34,81,74,75,74.0,77.0,1,-7,8
182,21,34,2,9,0,208,170,201,238,124,83,169,151,120,99,145,151,148.0,132.0,6,46,-40
45,22,34,2,9,0,45,45,56,48,22,17,60,50,40,34,50,39,44.0,41.0,-11,16,-27
295,1,35,2,9,0,130,129,206,317,238,124,175,178,198,247,172,229,200.0,216.0,57,-75,132
64,2,35,2,9,0,150,68,61,94,64,55,50,58,59,74,82,64,73.0,73.0,-18,8,-26
127,3,35,2,9,0,59,69,77,114,119,58,88,84,113,93,124,126,125.0,114.0,2,31,-29
639,4,35,2,9,0,341,411,466,954,488,303,463,422,404,405,524,536,530.0,488.0,12,119,-107
541,5,35,2,9,0,226,219,270,560,493,212,308,310,321,356,354,476,415.0,395.0,122,-2,124
275,6,35,2,9,0,226,131,164,192,238,108,126,152,161,181,221,244,232.0,215.0,23,40,-17
895,7,35,2,9,0,451,391,462,714,609,352,736,802,743,732,752,968,860.0,817.0,216,20,196
192,8,35,2,9,0,81,104,152,230,168,75,152,133,162,155,176,214,195.0,182.0,38,21,17
2543,9,35,2,9,0,783,887,1988,1893,1283,554,1157,1342,1371,1506,1365,1632,1498.0,1501.0,267,-141,408
299,10,35,2,9,0,211,167,204,333,316,132,218,179,232,209,214,240,227.0,221.0,26,5,21
884,11,35,2,9,0,409,489,602,865,785,520,701,575,790,696,727,808,768.0,744.0,81,31,50
334,12,35,2,9,0,272,168,194,280,264,100,195,178,199,185,190,228,209.0,201.0,38,5,33
540,13,35,2,9,0,279,275,250,454,387,248,489,372,444,470,561,546,554.0,526.0,-15,91,-106
373,14,35,2,9,0,184,168,191,300,319,141,195,250,224,252,313,287,300.0,284.0,-26,61,-87
794,15,35,2,9,0,355,572,795,787,577,391,567,562,623,668,663,739,701.0,690.0,76,-5,81
583,16,35,2,9,0,287,394,374,566,545,193,390,310,389,475,504,667,586.0,549.0,163,29,134
522,17,35,2,9,0,332,203,423,412,412,410,531,262,352,341,399,402,400.0,381.0,3,58,-55
643,18,35,2,9,0,331,397,363,562,555,242,485,658,692,517,589,652,620.0,586.0,63,72,-9
342,19,35,2,9,0,219,239,228,340,230,163,328,229,232,286,261,346,304.0,298.0,85,-25,110
359,20,35,2,9,0,281,158,348,846,378,203,261,239,256,499,348,265,306.0,371.0,-83,-151,68
209,21,35,2,9,0,63,62,99,126,138,68,103,103,121,139,167,222,194.0,176.0,55,28,27
705,22,35,2,9,0,91,46,89,107,57,72,88,195,88,95,117,126,122.0,113.0,9,22,-13
253,1,36,1,9,0,263,222,276,374,264,140,173,111,133,219,252,305,278.0,259.0,53,33,20
322,2,36,1,9,0,322,420,444,423,403,246,278,240,349,251,370,328,349.0,316.0,-42,119,-161
594,3,36,1,9,0,541,608,505,619,534,251,398,363,397,446,439,554,496.0,480.0,115,-7,122
716,4,36,1,9,0,1019,845,1016,1441,741,459,672,521,645,648,738,710,724.0,699.0,-28,90,-118
964,5,36,1,9,0,1080,712,743,1078,940,507,616,610,516,696,747,853,800.0,765.0,106,51,55
274,6,36,1,9,0,210,217,212,273,247,107,152,149,170,178,202,240,221.0,207.0,38,24,14
970,7,36,1,9,0,866,764,681,1011,688,350,548,657,631,628,667,792,730.0,696.0,125,39,86
337,8,36,1,9,0,283,280,288,348,274,115,219,218,272,224,246,326,286.0,265.0,80,22,58
2281,9,36,1,9,0,1686,2097,2144,2562,1849,777,1549,1067,1547,1898,1873,2104,1988.0,1958.0,231,-25,256
365,10,36,1,9,0,333,376,342,443,364,194,278,172,226,248,272,340,306.0,287.0,68,24,44
728,11,36,1,9,0,670,713,682,857,658,425,546,407,545,534,592,698,645.0,608.0,106,58,48
378,12,36,1,9,0,304,324,277,382,334,121,180,176,242,230,289,241,265.0,253.0,-48,59,-107
1052,13,36,1,9,0,829,875,790,1042,804,407,572,721,849,721,962,1094,1028.0,926.0,132,241,-109
768,14,36,1,9,0,525,514,567,656,654,303,427,422,450,484,638,714,676.0,612.0,76,154,-78
738,15,36,1,9,0,658,707,687,970,632,338,464,407,503,544,617,739,678.0,633.0,122,73,49
1452,16,36,1,9,0,1194,1234,1296,1458,1429,526,890,740,929,1121,1218,1196,1207.0,1178.0,-22,97,-119
687,17,36,1,9,0,586,532,579,879,712,262,444,376,475,496,530,587,558.0,538.0,57,34,23
385,18,36,1,9,0,331,423,388,523,387,223,336,237,399,355,340,322,331.0,339.0,-18,-15,-3
852,19,36,1,9,0,919,871,786,1105,571,424,658,595,611,583,678,909,794.0,723.0,231,95,136
473,20,36,1,9,0,452,406,568,732,616,327,364,351,290,544,368,383,376.0,432.0,15,-176,191
617,21,36,1,9,0,480,618,464,618,561,288,381,522,505,419,505,615,560.0,513.0,110,86,24
410,22,36,1,9,0,364,346,348,497,267,165,333,307,314,331,413,428,420.0,391.0,15,82,-67
89,1,37,2,9,0,135,111,242,237,68,37,61,48,42,46,60,56,58.0,54.0,-4,14,-18
117,2,37,2,9,0,170,165,182,271,140,100,100,97,72,92,101,116,108.0,103.0,15,9,6
134,3,37,2,9,0,135,144,149,195,78,54,74,78,87,84,89,105,97.0,93.0,16,5,11
42,4,37,2,9,0,163,97,128,205,34,44,59,36,32,45,41,40,40.0,42.0,-1,-4,3
297,5,37,2,9,0,355,284,276,560,275,186,178,154,123,197,155,287,221.0,213.0,132,-42,174
141,6,37,2,9,0,258,234,289,496,209,109,109,97,103,125,123,120,122.0,123.0,-3,-2,-1
255,7,37,2,9,0,455,430,397,599,241,156,188,181,193,211,187,260,224.0,219.0,73,-24,97
105,8,37,2,9,0,165,187,192,226,67,52,65,70,76,81,82,108,95.0,90.0,26,1,25
692,9,37,2,9,0,966,1096,1273,1753,510,290,467,429,504,568,492,615,554.0,558.0,123,-76,199
142,10,37,2,9,0,163,183,209,314,161,76,113,66,89,103,111,120,116.0,111.0,9,8,1
460,11,37,2,9,0,663,720,808,1176,484,399,360,358,395,364,346,423,384.0,378.0,77,-18,95
210,12,37,2,9,0,243,282,281,556,258,99,139,120,123,138,130,192,161.0,153.0,62,-8,70
243,13,37,2,9,0,311,284,290,435,164,126,133,165,184,178,191,217,204.0,195.0,26,13,13
372,14,37,2,9,0,316,283,364,562,252,130,136,161,188,248,234,365,300.0,282.0,131,-14,145
507,15,37,2,9,0,660,738,799,1102,332,255,331,293,293,451,433,549,491.0,478.0,116,-18,134
188,16,37,2,9,0,271,257,362,526,267,110,92,100,79,129,117,148,132.0,131.0,31,-12,43
236,17,37,2,9,0,292,260,313,627,286,115,133,96,119,133,162,229,196.0,175.0,67,29,38
168,18,37,2,9,0,282,315,340,500,185,128,160,130,141,134,138,134,136.0,135.0,-4,4,-8
160,19,37,2,9,0,311,260,209,299,101,86,133,111,127,127,138,164,151.0,143.0,26,11,15
112,20,37,2,9,0,165,151,159,317,179,87,70,59,80,101,84,95,90.0,93.0,11,-17,28
87,21,37,2,9,0,114,163,141,242,89,58,62,55,62,48,76,86,81.0,70.0,10,28,-18
69,22,37,2,9,0,139,103,121,126,60,44,65,66,61,78,87,93,90.0,86.0,6,9,-3
475,1,38,2,9,0,427,336,1289,571,175,135,300,320,311,280,332,341,336.0,318.0,9,52,-43
296,2,38,2,9,0,226,257,285,393,160,154,201,154,174,208,237,210,224.0,218.0,-27,29,-56
368,3,38,2,9,0,291,326,339,631,236,164,278,287,352,354,352,396,374.0,367.0,44,-2,46
374,4,38,2,9,0,797,664,656,980,232,253,315,319,299,344,411,421,416.0,392.0,10,67,-57
1263,5,38,2,9,0,1230,923,1016,1536,609,478,708,677,703,870,874,1179,1026.0,974.0,305,4,301
743,6,38,2,9,0,565,666,550,750,358,257,522,447,450,474,531,638,584.0,548.0,107,57,50
3225,7,38,2,9,0,2915,3148,3502,5481,1788,1203,1635,2012,1985,2046,2150,2770,2460.0,2322.0,620,104,516
1141,8,38,2,9,0,792,899,919,1474,502,371,567,626,775,870,822,1077,950.0,923.0,255,-48,303
11327,9,38,2,9,0,11167,12710,12394,15317,5306,3718,8079,6812,7957,8612,8119,10514,9316.0,9082.0,2395,-493,2888
2448,10,38,2,9,0,1639,1709,1789,2693,1195,777,1366,1087,1463,1613,1736,2291,2014.0,1880.0,555,123,432
2698,11,38,2,9,0,2274,2226,2622,3296,1247,1529,2148,2087,2259,2343,2472,2603,2538.0,2473.0,131,129,2
1563,12,38,2,9,0,1083,1277,1265,1764,857,484,797,835,979,1050,1189,1342,1266.0,1194.0,153,139,14
2337,13,38,2,9,0,1988,2221,2449,3796,1214,995,1259,1697,1832,1815,2279,2449,2364.0,2181.0,170,464,-294
2311,14,38,2,9,0,1783,1739,1951,3130,1278,848,1290,1492,1391,1525,1910,2272,2091.0,1902.0,362,385,-23
1932,15,38,2,9,0,1709,2001,2019,2088,700,801,1246,1369,1509,1644,1767,1896,1832.0,1769.0,129,123,6
1206,16,38,2,9,0,1071,1120,1425,1562,736,376,772,827,842,1061,1101,1051,1076.0,1071.0,-50,40,-90
2160,17,38,2,9,0,1721,1444,1769,3168,1244,677,1105,1093,1503,1476,1786,1858,1822.0,1707.0,72,310,-238
1544,18,38,2,9,0,1477,1846,1591,1981,769,598,1058,945,1316,1163,1316,1476,1396.0,1318.0,160,153,7
2147,19,38,2,9,0,3035,2443,2622,3705,1059,1132,1642,1541,1606,1822,1931,2151,2041.0,1968.0,220,109,111
467,20,38,2,9,0,624,494,548,828,333,235,331,330,400,708,364,385,374.0,486.0,21,-344,365
425,21,38,2,9,0,462,457,402,722,289,175,287,284,326,299,382,387,384.0,356.0,5,83,-78
927,22,38,2,9,0,651,605,913,1064,350,347,604,509,589,621,701,1075,888.0,799.0,374,80,294
288,1,39,1,9,0,330,234,241,272,250,161,224,213,175,131,62,223,142.0,139.0,161,-69,230
480,2,39,1,9,0,288,285,282,383,494,162,297,298,329,209,81,389,235.0,226.0,308,-128,436
393,3,39,1,9,0,397,353,331,374,412,213,364,399,353,232,84,339,212.0,218.0,255,-148,403
411,4,39,1,9,0,651,432,527,798,336,255,324,347,230,135,126,317,222.0,193.0,191,-9,200
522,5,39,1,9,0,560,353,364,502,560,198,280,354,296,108,64,382,223.0,185.0,318,-44,362
488,6,39,1,9,0,464,369,339,449,378,228,339,365,359,86,125,393,259.0,201.0,268,39,229
1192,7,39,1,9,0,1347,1014,1020,1083,1132,648,948,1214,1085,369,273,1000,636.0,547.0,727,-96,823
551,8,39,1,9,0,462,394,347,454,373,276,370,403,345,137,148,396,272.0,227.0,248,11,237
2956,9,39,1,9,0,3040,2810,2842,3119,2859,1337,2735,2621,2524,1566,594,2431,1512.0,1530.0,1837,-972,2809
336,10,39,1,9,0,346,287,279,316,376,154,306,255,297,140,103,277,190.0,173.0,174,-37,211
926,11,39,1,9,0,1153,908,905,1057,1012,579,905,787,820,405,226,838,532.0,490.0,612,-179,791
402,12,39,1,9,0,407,325,334,414,397,195,355,439,342,151,95,317,206.0,188.0,222,-56,278
911,13,39,1,9,0,837,696,646,778,797,602,842,1066,971,374,253,922,588.0,516.0,669,-121,790
1295,14,39,1,9,0,1165,786,979,1154,954,596,986,1159,919,330,428,1111,770.0,623.0,683,98,585
847,15,39,1,9,0,767,611,709,819,752,388,650,682,669,277,191,789,490.0,419.0,598,-86,684
1385,16,39,1,9,0,1463,1111,1292,1497,1405,549,1164,1131,1057,674,316,1053,684.0,681.0,737,-358,1095
712,17,39,1,9,0,776,563,649,953,623,341,556,689,570,218,194,551,372.0,321.0,357,-24,381
591,18,39,1,9,0,641,586,610,611,627,347,556,479,612,226,137,543,340.0,302.0,406,-89,495
853,19,39,1,9,0,816,696,727,851,758,485,709,730,631,387,271,733,502.0,464.0,462,-116,578
285,20,39,1,9,0,222,152,145,208,248,87,111,125,128,35,39,154,96.0,76.0,115,4,111
434,21,39,1,9,0,429,415,400,482,463,229,331,386,360,198,125,357,241.0,227.0,232,-73,305
630,22,39,1,9,0,621,450,630,549,617,346,607,485,461,268,130,519,324.0,306.0,389,-138,527
227,1,40,1,9,0,287,238,345,456,114,153,205,172,211,259,235,234,234.0,243.0,-1,-24,23
420,2,40,1,9,0,327,285,338,442,406,203,364,347,383,359,548,448,498.0,452.0,-100,189,-289
305,3,40,1,9,0,246,282,331,382,195,193,311,298,379,324,426,353,390.0,368.0,-73,102,-175
150,4,40,1,9,0,303,262,356,580,121,115,186,128,156,127,143,113,128.0,128.0,-30,16,-46
494,5,40,1,9,0,636,487,569,804,459,234,390,378,467,472,512,561,536.0,515.0,49,40,9
523,6,40,1,9,0,439,428,489,503,403,244,376,434,485,530,589,548,568.0,556.0,-41,59,-100
895,7,40,1,9,0,815,855,912,1164,554,505,703,953,906,900,978,952,965.0,943.0,-26,78,-104
333,8,40,1,9,0,310,284,316,428,223,193,301,299,310,314,437,371,404.0,374.0,-66,123,-189
2906,9,40,1,9,0,2478,2450,3345,3730,1930,1262,2615,2284,2880,3003,3073,3157,3115.0,3078.0,84,70,14
386,10,40,1,9,0,290,313,377,417,266,187,309,304,370,332,440,396,418.0,389.0,-44,108,-152
1127,11,40,1,9,0,1193,1114,1454,1527,877,754,1069,1130,1243,1239,1359,1276,1318.0,1291.0,-83,120,-203
346,12,40,1,9,0,340,317,350,507,305,161,323,377,500,498,505,477,491.0,493.0,-28,7,-35
738,13,40,1,9,0,590,551,574,797,453,434,572,723,877,842,1076,876,976.0,931.0,-200,234,-434
822,14,40,1,9,0,687,548,872,1036,630,391,702,797,764,826,1251,974,1112.0,1017.0,-277,425,-702
1013,15,40,1,9,0,800,942,1151,1258,739,529,861,969,1092,1188,1336,1191,1264.0,1238.0,-145,148,-293
844,16,40,1,9,0,1065,918,1189,1511,963,454,719,775,822,1002,1247,1129,1188.0,1126.0,-118,245,-363
466,17,40,1,9,0,456,452,506,737,420,189,443,430,470,484,597,615,606.0,565.0,18,113,-95
521,18,40,1,9,0,556,643,734,779,473,353,640,561,659,677,791,724,758.0,731.0,-67,114,-181
508,19,40,1,9,0,437,390,480,602,285,241,431,475,512,466,627,589,608.0,561.0,-38,161,-199
180,20,40,1,9,0,203,186,200,305,185,95,179,155,153,233,211,194,202.0,213.0,-17,-22,5
274,21,40,1,9,0,293,309,345,496,293,157,234,292,346,246,352,406,379.0,335.0,54,106,-52
359,22,40,1,9,0,347,306,404,422,214,206,322,309,385,388,444,380,412.0,404.0,-64,56,-120
183,1,41,3,9,0,248,166,277,348,224,140,212,313,130,176,126,150,138.0,151.0,24,-50,74
13,2,41,3,9,0,22,12,22,33,19,19,18,22,20,12,9,9,9.0,10.0,0,-3,3
19,3,41,3,9,0,20,16,19,22,21,19,29,36,17,19,26,22,24.0,22.0,-4,7,-11
314,4,41,3,9,0,433,353,372,511,424,244,378,320,244,260,250,268,259.0,259.0,18,-10,28
22,5,41,3,9,0,53,34,42,64,69,42,47,33,29,34,13,37,25.0,28.0,24,-21,45
37,6,41,3,9,0,65,52,74,75,83,59,59,57,45,62,31,45,38.0,46.0,14,-31,45
242,7,41,3,9,0,349,309,286,341,430,189,295,303,192,237,256,222,239.0,238.0,-34,19,-53
109,8,41,3,9,0,76,58,62,78,105,64,83,78,62,75,85,83,84.0,81.0,-2,10,-12
906,9,41,3,9,0,959,887,972,1235,1009,443,848,749,579,865,757,844,800.0,822.0,87,-108,195
17,10,41,3,9,0,23,23,13,26,34,17,20,12,20,22,16,21,18.0,20.0,5,-6,11
353,11,41,3,9,0,352,323,380,481,397,258,351,301,241,305,301,319,310.0,308.0,18,-4,22
29,12,41,3,9,0,44,29,35,37,61,16,26,40,25,30,32,20,26.0,27.0,-12,2,-14
258,13,41,3,9,0,229,234,231,316,308,172,236,271,218,215,233,230,232.0,226.0,-3,18,-21
153,14,41,3,9,0,192,150,188,209,242,134,155,146,105,140,155,161,158.0,152.0,6,15,-9
365,15,41,3,9,0,252,293,323,375,353,222,270,371,311,449,354,283,318.0,362.0,-71,-95,24
48,16,41,3,9,0,58,26,64,62,54,47,52,51,39,64,44,59,52.0,56.0,15,-20,35
28,17,41,3,9,0,47,25,31,44,54,26,27,28,26,30,22,38,30.0,30.0,16,-8,24
54,18,41,3,9,0,42,57,83,105,92,41,56,43,37,75,57,57,57.0,63.0,0,-18,18
128,19,41,3,9,0,181,127,153,187,158,103,124,129,115,148,126,163,144.0,146.0,37,-22,59
16,20,41,3,9,0,19,17,12,27,22,12,27,12,19,15,18,21,20.0,18.0,3,3,0
22,21,41,3,9,0,19,25,29,46,61,16,38,37,27,23,27,20,24.0,23.0,-7,4,-11
58,22,41,3,9,0,77,62,61,65,66,41,61,62,37,56,42,70,56.0,56.0,28,-14,42
284,1,42,1,9,0,237,260,331,369,161,142,190,140,165,214,189,313,251.0,239.0,124,-25,149
387,2,42,1,9,0,388,519,521,651,386,202,309,233,292,232,382,379,380.0,331.0,-3,150,-153
208,3,42,1,9,0,181,185,190,234,146,90,139,127,131,111,141,187,164.0,146.0,46,30,16
167,4,42,1,9,0,313,223,301,382,210,141,181,149,153,130,100,130,115.0,120.0,30,-30,60
773,5,42,1,9,0,645,492,617,839,509,240,360,342,344,334,430,617,524.0,460.0,187,96,91
368,6,42,1,9,0,508,453,504,690,387,163,254,266,293,273,348,415,382.0,345.0,67,75,-8
877,7,42,1,9,0,825,774,709,964,444,303,464,570,555,507,649,847,748.0,668.0,198,142,56
373,8,42,1,9,0,278,277,302,443,175,132,238,204,221,191,257,331,294.0,260.0,74,66,8
3858,9,42,1,9,0,3967,4449,4901,5547,3229,1517,2906,3040,2996,3064,2940,3296,3118.0,3100.0,356,-124,480
423,10,42,1,9,0,362,434,458,665,381,181,321,247,278,230,271,353,312.0,285.0,82,41,41
861,11,42,1,9,0,875,888,974,1139,690,508,722,614,698,656,855,923,889.0,811.0,68,199,-131
387,12,42,1,9,0,440,408,499,625,381,184,276,300,321,252,286,354,320.0,297.0,68,34,34
756,13,42,1,9,0,591,602,602,830,407,320,433,514,507,400,601,794,698.0,598.0,193,201,-8
641,14,42,1,9,0,666,620,614,920,507,247,499,530,473,405,626,853,740.0,628.0,227,221,6
1091,15,42,1,9,0,1148,998,1169,1424,732,558,806,842,817,859,969,1255,1112.0,1028.0,286,110,176
908,16,42,1,9,0,987,818,1066,1347,698,270,511,498,504,540,672,774,723.0,662.0,102,132,-30
628,17,42,1,9,0,752,630,700,988,570,203,418,421,498,401,577,729,653.0,569.0,152,176,-24
815,18,42,1,9,0,676,754,796,1043,605,368,580,595,656,635,615,765,690.0,672.0,150,-20,170
567,19,42,1,9,0,553,433,460,600,253,193,341,357,363,293,369,581,475.0,414.0,212,76,136
253,20,42,1,9,0,243,227,222,229,139,105,116,140,127,159,132,163,148.0,151.0,31,-27,58
297,21,42,1,9,0,191,253,229,293,140,96,140,126,155,135,199,252,226.0,195.0,53,64,-11
264,22,42,1,9,0,256,198,199,322,111,123,264,218,232,182,233,390,312.0,268.0,157,51,106
374,1,43,2,9,0,455,354,457,516,264,193,369,368,312,223,311,325,318.0,286.0,14,88,-74
116,2,43,2,9,0,168,236,233,253,206,111,144,116,120,119,120,92,106.0,110.0,-28,1,-29
180,3,43,2,9,0,180,212,200,238,219,114,172,145,184,185,176,175,176.0,179.0,-1,-9,8
493,4,43,2,9,0,733,603,754,1094,601,390,482,397,375,385,359,390,374.0,378.0,31,-26,57
472,5,43,2,9,0,498,363,489,543,391,237,325,296,251,270,231,353,292.0,285.0,122,-39,161
316,6,43,2,9,0,472,444,568,578,495,153,185,233,254,279,190,233,212.0,234.0,43,-89,132
888,7,43,2,9,0,1001,1018,1094,1221,1031,476,846,727,791,753,709,746,728.0,736.0,37,-44,81
458,8,43,2,9,0,381,370,395,605,316,221,369,335,297,249,379,331,355.0,320.0,-48,130,-178
2790,9,43,2,9,0,2762,3019,3563,3747,2666,1125,2377,2460,2143,2250,2148,2251,2200.0,2216.0,103,-102,205
136,10,43,2,9,0,134,146,194,174,193,92,119,101,114,104,103,130,116.0,112.0,27,-1,28
980,11,43,2,9,0,1155,1292,1491,1524,1070,552,1008,901,895,803,803,813,808.0,806.0,10,0,10
207,12,43,2,9,0,280,258,340,409,346,81,166,179,201,165,187,208,198.0,187.0,21,22,-1
941,13,43,2,9,0,812,975,971,1119,789,422,734,762,790,652,806,800,803.0,753.0,-6,154,-160
510,14,43,2,9,0,592,609,805,866,692,326,488,531,450,448,469,417,443.0,445.0,-52,21,-73
1522,15,43,2,9,0,1259,1371,1516,1515,1138,549,969,1010,1108,1385,1507,1239,1373.0,1377.0,-268,122,-390
521,16,43,2,9,0,707,729,779,906,749,253,446,434,381,436,412,489,450.0,446.0,77,-24,101
459,17,43,2,9,0,626,645,767,839,710,238,437,402,430,431,398,373,386.0,401.0,-25,-33,8
360,18,43,2,9,0,434,571,612,638,509,288,542,508,519,527,327,322,324.0,392.0,-5,-200,195
950,19,43,2,9,0,1256,1020,1269,1395,898,506,962,872,971,851,914,875,894.0,880.0,-39,63,-102
141,20,43,2,9,0,183,170,200,213,159,106,164,130,104,160,133,125,129.0,139.0,-8,-27,19
195,21,43,2,9,0,251,273,309,371,227,159,225,195,179,129,173,160,166.0,154.0,-13,44,-57
375,22,43,2,9,0,536,422,639,783,366,217,537,358,448,306,533,522,528.0,454.0,-11,227,-238
288,1,44,1,9,0,263,186,304,291,260,125,252,169,218,208,195,239,217.0,214.0,44,-13,57
53,2,44,1,9,0,45,62,97,95,78,48,59,48,61,43,79,64,72.0,62.0,-15,36,-51
72,3,44,1,9,0,53,57,54,64,35,18,51,53,69,55,61,64,62.0,60.0,3,6,-3
578,4,44,1,9,0,542,458,551,739,435,233,445,341,391,396,426,482,454.0,435.0,56,30,26
444,5,44,1,9,0,406,218,246,296,270,133,178,212,190,231,208,233,220.0,224.0,25,-23,48
150,6,44,1,9,0,108,119,125,125,156,59,89,69,81,70,72,75,74.0,72.0,3,2,1
344,7,44,1,9,0,259,209,228,356,218,112,223,197,226,179,193,249,221.0,207.0,56,14,42
57,8,44,1,9,0,29,27,53,51,47,21,35,29,43,35,45,44,44.0,41.0,-1,10,-11
444,9,44,1,9,0,319,341,442,572,437,152,310,246,338,497,305,362,334.0,388.0,57,-192,249
68,10,44,1,9,0,48,35,38,46,44,34,25,32,38,35,50,44,47.0,43.0,-6,15,-21
290,11,44,1,9,0,235,218,248,301,251,138,200,177,214,189,187,223,205.0,200.0,36,-2,38
97,12,44,1,9,0,74,57,75,92,84,32,51,53,76,51,70,67,68.0,63.0,-3,19,-22
213,13,44,1,9,0,81,95,123,131,106,79,112,113,144,111,129,162,146.0,134.0,33,18,15
164,14,44,1,9,0,136,137,144,187,131,57,111,155,108,118,135,163,149.0,139.0,28,17,11
142,15,44,1,9,0,127,129,149,230,149,78,139,107,108,142,110,130,120.0,127.0,20,-32,52
162,16,44,1,9,0,128,132,148,184,148,61,111,94,101,110,110,157,134.0,126.0,47,0,47
209,17,44,1,9,0,125,121,157,211,135,74,132,109,108,118,96,135,116.0,116.0,39,-22,61
112,18,44,1,9,0,63,93,111,124,108,57,77,71,97,95,75,85,80.0,85.0,10,-20,30
173,19,44,1,9,0,93,93,126,129,69,51,75,76,107,67,96,152,124.0,105.0,56,29,27
157,20,44,1,9,0,113,105,132,160,125,77,112,97,87,149,112,142,127.0,134.0,30,-37,67
202,21,44,1,9,0,118,176,150,182,148,77,137,111,172,117,112,144,128.0,124.0,32,-5,37
75,22,44,1,9,0,64,44,71,77,53,34,68,53,50,51,50,100,75.0,67.0,50,-1,51
93,1,45,1,9,0,195,186,244,388,154,85,126,92,105,104,90,95,92.0,96.0,5,-14,19
68,2,45,1,9,0,199,190,214,267,194,91,60,53,77,69,54,60,57.0,61.0,6,-15,21
64,3,45,1,9,0,117,180,167,259,127,62,61,62,68,40,53,87,70.0,60.0,34,13,21
13,4,45,1,9,0,195,143,181,370,71,41,51,25,21,23,21,16,18.0,20.0,-5,-2,-3
138,5,45,1,9,0,451,335,432,691,448,194,129,110,118,105,113,152,132.0,123.0,39,8,31
284,6,45,1,9,0,665,719,699,1253,712,250,227,217,259,222,209,229,219.0,220.0,20,-13,33
412,7,45,1,9,0,799,850,792,1449,549,320,297,347,332,246,290,297,294.0,278.0,7,44,-37
80,8,45,1,9,0,176,226,231,426,153,81,103,83,114,108,86,92,89.0,95.0,6,-22,28
470,9,45,1,9,0,810,953,1204,1628,496,168,342,246,344,349,247,271,259.0,289.0,24,-102,126
41,10,45,1,9,0,96,119,135,240,121,56,54,26,39,23,31,45,38.0,33.0,14,8,6
446,11,45,1,9,0,928,1050,1083,1908,768,543,404,402,487,371,340,347,344.0,353.0,7,-31,38
222,12,45,1,9,0,368,358,434,733,453,153,150,168,191,126,131,163,147.0,140.0,32,5,27
274,13,45,1,9,0,576,665,667,1158,476,272,257,300,350,276,304,321,312.0,300.0,17,28,-11
401,14,45,1,9,0,823,894,1006,1883,910,372,312,380,366,295,321,290,306.0,302.0,-31,26,-57
487,15,45,1,9,0,968,1022,1202,2202,744,430,386,337,361,407,360,410,385.0,392.0,50,-47,97
165,16,45,1,9,0,278,353,409,749,443,143,138,130,145,146,117,118,118.0,127.0,1,-29,30
189,17,45,1,9,0,352,322,439,744,378,131,137,149,138,134,113,150,132.0,132.0,37,-21,58
140,18,45,1,9,0,242,345,391,594,265,149,173,130,137,127,100,127,114.0,118.0,27,-27,54
55,19,45,1,9,0,151,176,186,256,75,62,80,75,84,47,39,66,52.0,51.0,27,-8,35
36,20,45,1,9,0,101,86,92,172,124,38,29,23,20,27,17,21,19.0,22.0,4,-10,14
80,21,45,1,9,0,155,205,212,325,144,79,70,64,97,57,67,82,74.0,69.0,15,10,5
43,22,45,1,9,0,116,107,126,152,43,36,52,38,43,41,34,44,39.0,40.0,10,-7,17
136,1,46,1,9,0,94,69,88,96,65,19,37,175,5,12,7,8,8.0,9.0,1,-5,6
46,2,46,1,9,0,192,214,209,182,216,75,82,86,83,57,67,66,66.0,63.0,-1,10,-11
34,3,46,1,9,0,174,176,130,141,132,46,66,45,69,41,38,46,42.0,42.0,8,-3,11
60,4,46,1,9,0,259,158,186,277,124,81,65,48,29,26,33,15,24.0,25.0,-18,7,-25
63,5,46,1,9,0,374,267,205,292,350,117,93,78,81,64,97,44,70.0,68.0,-53,33,-86
88,6,46,1,9,0,407,332,341,384,513,121,108,92,90,118,107,99,103.0,108.0,-8,-11,3
346,7,46,1,9,0,669,572,480,596,555,214,153,209,203,175,145,127,136.0,149.0,-18,-30,12
3,8,46,1,9,0,82,89,70,67,66,26,12,22,19,12,23,3,13.0,13.0,-20,11,-31
17,9,46,1,9,0,99,91,101,84,62,19,63,37,30,29,26,25,26.0,27.0,-1,-3,2
11,10,46,1,9,0,57,42,39,50,45,14,26,20,6,2,8,5,6.0,5.0,-3,6,-9
151,11,46,1,9,0,534,502,474,569,538,214,216,188,191,134,129,86,108.0,116.0,-43,-5,-38
58,12,46,1,9,0,423,281,274,309,360,94,101,91,90,79,82,62,72.0,74.0,-20,3,-23
180,13,46,1,9,0,378,372,326,383,353,154,150,162,149,131,144,91,118.0,122.0,-53,13,-66
93,14,46,1,9,0,505,471,372,457,538,139,100,129,104,87,70,63,66.0,73.0,-7,-17,10
167,15,46,1,9,0,525,437,429,453,388,129,152,151,108,106,91,89,90.0,95.0,-2,-15,13
89,16,46,1,9,0,470,379,317,421,474,120,139,119,158,186,109,65,87.0,120.0,-44,-77,33
163,17,46,1,9,0,455,353,348,428,459,95,148,114,114,115,100,92,96.0,102.0,-8,-15,7
29,18,46,1,9,0,150,148,127,159,136,38,44,37,55,51,15,28,22.0,31.0,13,-36,49
51,19,46,1,9,0,239,216,174,238,151,59,93,137,105,53,60,48,54.0,54.0,-12,7,-19
14,20,46,1,9,0,119,108,151,126,110,41,27,16,19,16,22,15,18.0,18.0,-7,6,-13
60,21,46,1,9,0,219,279,210,288,180,80,67,82,94,70,81,86,84.0,79.0,5,11,-6
17,22,46,1,9,0,126,121,118,156,75,46,57,45,34,22,28,31,30.0,27.0,3,6,-3
379,1,47,2,9,0,330,188,341,384,208,78,136,169,219,267,195,272,234.0,245.0,77,-72,149
142,2,47,2,9,0,177,216,186,206,142,56,68,79,116,111,106,126,116.0,114.0,20,-5,25
69,3,47,2,9,0,103,121,125,115,74,44,45,52,72,39,48,70,59.0,52.0,22,9,13
170,4,47,2,9,0,646,461,553,771,253,139,206,162,160,198,159,181,170.0,179.0,22,-39,61
768,5,47,2,9,0,770,548,657,933,673,263,243,304,396,459,464,505,484.0,476.0,41,5,36
780,6,47,2,9,0,849,800,764,993,964,338,340,389,526,609,640,679,660.0,643.0,39,31,8
912,7,47,2,9,0,1068,979,957,1332,1011,383,430,537,623,546,597,690,644.0,611.0,93,51,42
151,8,47,2,9,0,200,213,203,275,128,67,102,111,136,137,121,130,126.0,129.0,9,-16,25
1150,9,47,2,9,0,1341,1182,1660,1546,767,278,638,579,734,773,669,732,700.0,725.0,63,-104,167
150,10,47,2,9,0,192,181,188,276,186,86,105,86,125,135,129,121,125.0,128.0,-8,-6,-2
1956,11,47,2,9,0,2054,2015,2022,2642,2094,991,984,1074,1356,1448,1465,1619,1542.0,1511.0,154,17,137
614,12,47,2,9,0,481,368,453,691,614,157,211,274,326,317,295,445,370.0,352.0,150,-22,172
507,13,47,2,9,0,728,665,667,773,530,290,330,342,436,385,393,514,454.0,431.0,121,8,113
1439,14,47,2,9,0,1676,1390,1577,2409,1865,640,650,891,1055,1267,1138,1176,1157.0,1194.0,38,-129,167
1624,15,47,2,9,0,1572,1696,1832,2222,1022,501,663,715,913,1088,1232,1489,1360.0,1270.0,257,144,113
526,16,47,2,9,0,525,475,492,661,605,178,211,256,312,333,394,414,404.0,380.0,20,61,-41
540,17,47,2,9,0,561,481,547,698,488,170,228,287,352,372,388,447,418.0,402.0,59,16,43
408,18,47,2,9,0,427,469,556,601,361,197,246,246,307,332,263,303,283.0,299.0,40,-69,109
182,19,47,2,9,0,335,246,211,328,161,100,120,120,168,137,149,154,152.0,147.0,5,12,-7
352,20,47,2,9,0,445,330,373,430,326,140,158,145,189,295,272,251,262.0,273.0,-21,-23,2
259,21,47,2,9,0,350,449,347,562,349,119,145,167,210,170,185,229,207.0,195.0,44,15,29
77,22,47,2,9,0,133,82,97,100,69,37,53,48,62,47,72,53,62.0,57.0,-19,25,-44
11,1,48,2,9,0,10,4,41,46,32,19,54,17,10,12,11,6,8.0,10.0,-5,-1,-4
120,2,48,2,9,0,159,126,119,169,142,104,91,53,62,66,54,100,77.0,73.0,46,-12,58
172,3,48,2,9,0,327,297,353,430,278,168,258,163,176,174,153,161,157.0,163.0,8,-21,29
21,4,48,2,9,0,96,46,78,112,52,38,30,13,7,12,11,3,7.0,9.0,-8,-1,-7
211,5,48,2,9,0,723,408,517,641,617,336,250,134,145,143,161,174,168.0,159.0,13,18,-5
153,6,48,2,9,0,211,71,198,190,278,146,119,59,72,88,63,82,72.0,78.0,19,-25,44
554,7,48,2,9,0,1782,1445,1562,2281,1763,885,746,509,752,650,656,635,646.0,647.0,-21,6,-27
321,8,48,2,9,0,842,579,768,886,691,295,401,285,317,252,283,337,310.0,291.0,54,31,23
160,9,48,2,9,0,821,619,710,1008,472,229,471,212,177,139,130,131,130.0,133.0,1,-9,10
148,10,48,2,9,0,191,132,192,308,251,110,119,55,137,102,134,127,130.0,121.0,-7,32,-39
124,11,48,2,9,0,195,95,307,309,370,299,211,106,111,126,119,95,107.0,113.0,-24,-7,-17
96,12,48,2,9,0,145,60,177,182,224,84,107,42,42,52,41,45,43.0,46.0,4,-11,15
807,13,48,2,9,0,1949,1092,1644,1840,1468,940,941,733,782,635,713,852,782.0,733.0,139,78,61
399,14,48,2,9,0,546,306,774,911,1101,433,362,211,283,281,280,284,282.0,282.0,4,-1,5
277,15,48,2,9,0,149,42,380,352,327,197,195,168,241,204,240,223,232.0,222.0,-17,36,-53
51,16,48,2,9,0,100,46,116,125,211,58,65,32,39,46,41,44,42.0,44.0,3,-5,8
92,17,48,2,9,0,140,74,141,165,230,105,87,42,50,62,55,47,51.0,55.0,-8,-7,-1
86,18,48,2,9,0,159,110,281,215,204,105,130,66,70,71,48,58,53.0,59.0,10,-23,33
317,19,48,2,9,0,654,384,528,619,375,317,409,425,215,168,173,244,208.0,195.0,71,5,66
25,20,48,2,9,0,119,62,80,104,116,61,54,25,34,33,27,26,26.0,29.0,-1,-6,5
127,21,48,2,9,0,168,145,214,250,261,108,136,75,123,125,148,123,136.0,132.0,-25,23,-48
219,22,48,2,9,0,302,291,350,342,207,144,192,137,117,137,97,118,108.0,117.0,21,-40,61
381,1,49,1,9,0,371,283,435,596,174,80,151,177,200,272,204,286,245.0,254.0,82,-68,150
242,2,49,1,9,0,477,514,538,699,444,236,185,176,241,235,239,233,236.0,236.0,-6,4,-10
226,3,49,1,9,0,337,354,323,485,221,94,125,138,233,182,202,244,223.0,209.0,42,20,22
285,4,49,1,9,0,877,636,879,1517,309,174,289,242,251,279,287,271,279.0,279.0,-16,8,-24
612,5,49,1,9,0,1020,712,770,1305,743,339,285,287,359,363,364,444,404.0,390.0,80,1,79
847,6,49,1,9,0,1066,894,964,1597,855,344,344,422,524,660,677,843,760.0,727.0,166,17,149
972,7,49,1,9,0,1278,1160,1107,1740,687,383,327,543,829,670,841,808,824.0,773.0,-33,171,-204
232,8,49,1,9,0,280,282,301,514,192,100,117,126,207,172,186,212,199.0,190.0,26,14,12
704,9,49,1,9,0,1382,1240,1586,1899,542,186,403,360,460,604,483,479,481.0,522.0,-4,-121,117
114,10,49,1,9,0,277,266,309,514,260,96,110,81,120,111,123,118,120.0,117.0,-5,12,-17
1073,11,49,1,9,0,1406,1396,1446,2279,939,574,593,645,899,941,918,876,897.0,912.0,-42,-23,-19
577,12,49,1,9,0,638,519,571,900,502,180,199,229,302,289,342,439,390.0,357.0,97,53,44
870,13,49,1,9,0,1066,990,1108,1749,708,414,412,600,843,768,843,1013,928.0,875.0,170,75,95
1173,14,49,1,9,0,1525,1493,1622,2735,1331,509,557,792,1003,1139,1208,1046,1127.0,1131.0,-162,69,-231
1568,15,49,1,9,0,1804,1911,2130,3255,1119,581,616,676,899,1179,1212,1449,1330.0,1280.0,237,33,204
541,16,49,1,9,0,678,560,634,1014,597,202,210,256,309,467,354,417,386.0,413.0,63,-113,176
495,17,49,1,9,0,712,546,606,978,498,212,209,272,280,287,311,368,340.0,322.0,57,24,33
287,18,49,1,9,0,406,499,552,782,311,141,184,131,214,223,160,193,176.0,192.0,33,-63,96
202,19,49,1,9,0,315,299,258,424,127,80,97,131,161,165,176,170,173.0,170.0,-6,11,-17
170,20,49,1,9,0,336,267,309,532,260,104,78,93,126,161,148,159,154.0,156.0,11,-13,24
295,21,49,1,9,0,373,472,366,620,315,130,154,179,263,204,263,363,313.0,277.0,100,59,41
90,22,49,1,9,0,206,170,232,274,80,52,66,71,97,87,91,116,104.0,98.0,25,4,21
202,1,50,4,9,0,257,239,345,396,369,177,174,163,140,140,130,154,142.0,141.0,24,-10,34
215,2,50,4,9,0,358,406,373,334,203,134,207,159,159,199,202,227,214.0,209.0,25,3,22
40,3,50,4,9,0,123,116,59,90,51,29,42,27,40,31,39,40,40.0,37.0,1,8,-7
55,4,50,4,9,0,203,168,222,242,93,60,87,42,47,47,40,41,40.0,43.0,1,-7,8
499,5,50,4,9,0,731,758,778,781,288,239,321,272,333,406,352,417,384.0,392.0,65,-54,119
293,6,50,4,9,0,630,644,607,661,309,266,301,237,309,289,297,345,321.0,310.0,48,8,40
535,7,50,4,9,0,772,807,782,994,540,419,572,464,433,395,383,432,408.0,403.0,49,-12,61
82,8,50,4,9,0,240,200,132,201,88,44,87,60,67,72,87,105,96.0,88.0,18,15,3
499,9,50,4,9,0,619,721,938,1135,331,231,477,411,394,418,380,461,420.0,420.0,81,-38,119
149,10,50,4,9,0,268,247,370,403,140,92,140,131,131,161,121,124,122.0,135.0,3,-40,43
768,11,50,4,9,0,1020,1227,1286,1781,805,710,885,641,740,693,656,701,678.0,683.0,45,-37,82
261,12,50,4,9,0,391,438,444,431,157,97,173,170,210,195,175,219,197.0,196.0,44,-20,64
455,13,50,4,9,0,729,766,589,806,391,375,484,404,455,438,404,455,430.0,432.0,51,-34,85
510,14,50,4,9,0,777,834,729,896,363,334,528,418,445,554,381,446,414.0,460.0,65,-173,238
505,15,50,4,9,0,573,616,797,1044,341,386,475,363,466,458,443,473,458.0,458.0,30,-15,45
192,16,50,4,9,0,375,452,413,461,270,123,194,119,150,177,181,200,190.0,186.0,19,4,15
251,17,50,4,9,0,394,414,458,478,157,99,182,167,188,184,200,195,198.0,193.0,-5,16,-21
227,18,50,4,9,0,339,397,455,593,250,154,266,219,283,228,214,225,220.0,222.0,11,-14,25
64,19,50,4,9,0,144,114,136,149,45,36,75,66,76,84,71,67,69.0,74.0,-4,-13,9
161,20,50,4,9,0,422,402,422,475,136,124,148,136,160,225,137,123,130.0,162.0,-14,-88,74
187,21,50,4,9,0,446,595,355,464,194,145,188,141,176,186,164,204,184.0,185.0,40,-22,62
37,22,50,4,9,0,237,176,82,87,40,47,82,54,34,48,39,38,38.0,42.0,-1,-9,8
425,1,51,2,9,0,420,355,228,579,371,131,288,266,225,283,286,352,319.0,307.0,66,3,63
285,2,51,2,9,0,200,244,165,338,215,134,179,192,167,169,217,170,194.0,185.0,-47,48,-95
50,3,51,2,9,0,40,41,43,48,41,28,59,37,53,61,54,60,57.0,58.0,6,-7,13
106,4,51,2,9,0,304,268,372,383,131,61,110,108,70,103,89,94,92.0,95.0,5,-14,19
730,5,51,2,9,0,632,431,484,820,550,286,428,433,456,497,476,571,524.0,515.0,95,-21,116
654,6,51,2,9,0,521,495,362,758,508,322,432,425,545,563,499,558,528.0,540.0,59,-64,123
508,7,51,2,9,0,410,423,383,729,410,227,320,381,388,394,345,413,379.0,384.0,68,-49,117
65,8,51,2,9,0,78,61,91,136,74,57,53,62,47,59,62,56,59.0,59.0,-6,3,-9
1539,9,51,2,9,0,1298,1305,1034,2232,1023,444,1072,1007,969,1190,954,1225,1090.0,1123.0,271,-236,507
264,10,51,2,9,0,237,215,191,328,208,107,160,131,178,209,223,211,217.0,214.0,-12,14,-26
1384,11,51,2,9,0,1190,1239,807,1846,1142,747,1023,870,969,1040,1045,1132,1088.0,1072.0,87,5,82
361,12,51,2,9,0,306,226,131,436,290,111,237,235,226,237,243,304,274.0,261.0,61,6,55
469,13,51,2,9,0,360,308,272,475,287,194,265,298,335,339,355,444,400.0,379.0,89,16,73
706,14,51,2,9,0,554,543,420,747,459,249,457,513,513,571,508,547,528.0,542.0,39,-63,102
1060,15,51,2,9,0,824,856,695,1454,752,503,780,679,725,759,836,1202,1019.0,932.0,366,77,289
481,16,51,2,9,0,304,278,190,481,312,158,246,258,251,428,347,390,368.0,388.0,43,-81,124
467,17,51,2,9,0,329,289,235,425,324,139,263,238,293,308,308,344,326.0,320.0,36,0,36
547,18,51,2,9,0,469,472,415,699,508,260,395,323,426,506,406,485,446.0,466.0,79,-100,179
125,19,51,2,9,0,154,125,64,125,66,52,82,116,125,102,110,143,126.0,118.0,33,8,25
380,20,51,2,9,0,389,322,256,548,310,185,288,287,285,378,280,285,282.0,314.0,5,-98,103
227,21,51,2,9,0,188,226,181,259,170,96,124,121,134,165,167,184,176.0,172.0,17,2,15
53,22,51,2,9,0,84,67,65,115,61,52,76,85,53,52,53,68,60.0,58.0,15,1,14
310,1,52,1,9,0,336,292,421,473,415,199,338,303,272,297,230,306,268.0,278.0,76,-67,143
296,2,52,1,9,0,316,363,485,535,500,259,353,295,304,293,320,299,310.0,304.0,-21,27,-48
191,3,52,1,9,0,224,233,229,234,273,129,208,180,191,167,194,197,196.0,186.0,3,27,-24
397,4,52,1,9,0,442,429,500,681,534,295,402,398,365,374,341,360,350.0,358.0,19,-33,52
610,5,52,1,9,0,659,704,743,849,933,442,540,493,508,553,476,460,468.0,496.0,-16,-77,61
206,6,52,1,9,0,314,271,334,368,404,198,210,162,176,206,197,185,191.0,196.0,-12,-9,-3
642,7,52,1,9,0,771,679,776,936,911,376,595,546,558,596,483,522,502.0,534.0,39,-113,152
141,8,52,1,9,0,135,142,208,244,213,113,141,101,103,104,107,143,125.0,118.0,36,3,33
1188,9,52,1,9,0,1408,1392,1836,2078,1526,521,1068,875,905,1067,825,969,897.0,954.0,144,-242,386
167,10,52,1,9,0,207,208,246,317,323,145,236,156,189,166,140,172,156.0,159.0,32,-26,58
549,11,52,1,9,0,611,660,847,820,821,461,589,458,423,545,436,500,468.0,494.0,64,-109,173
170,12,52,1,9,0,215,187,249,262,297,113,164,151,133,139,150,149,150.0,146.0,-1,11,-12
519,13,52,1,9,0,576,625,746,750,758,431,483,470,474,415,495,501,498.0,470.0,6,80,-74
437,14,52,1,9,0,596,604,752,820,826,447,615,567,493,543,423,493,458.0,486.0,70,-120,190
340,15,52,1,9,0,387,524,623,684,550,252,401,254,311,325,307,322,314.0,318.0,15,-18,33
295,16,52,1,9,0,346,310,385,425,481,197,299,246,238,274,238,273,256.0,262.0,35,-36,71
378,17,52,1,9,0,424,364,460,493,505,239,383,321,315,341,325,336,330.0,334.0,11,-16,27
151,18,52,1,9,0,223,268,329,338,400,163,217,128,161,123,141,139,140.0,134.0,-2,18,-20
251,19,52,1,9,0,364,303,369,450,249,117,274,320,298,258,236,274,255.0,256.0,38,-22,60
331,20,52,1,9,0,406,400,540,575,576,284,403,314,306,439,296,285,290.0,340.0,-11,-143,132
236,21,52,1,9,0,293,365,346,404,376,178,272,285,266,201,203,229,216.0,211.0,26,2,24
258,22,52,1,9,0,331,302,341,410,324,206,341,242,239,273,292,251,272.0,272.0,-41,19,-60
249,1,53,2,9,0,628,446,636,846,241,179,180,191,192,253,247,261,254.0,254.0,14,-6,20
200,2,53,2,9,0,278,304,365,493,290,145,117,124,158,128,183,166,174.0,159.0,-17,55,-72
137,3,53,2,9,0,222,206,310,562,284,123,119,71,119,101,97,110,104.0,103.0,13,-4,17
65,4,53,2,9,0,498,257,444,824,105,71,55,60,50,59,51,57,54.0,56.0,6,-8,14
641,5,53,2,9,0,1042,762,1080,1730,983,504,400,394,380,436,516,607,562.0,520.0,91,80,11
1036,6,53,2,9,0,1078,1023,1260,2243,1186,528,593,566,477,521,594,770,682.0,628.0,176,73,103
994,7,53,2,9,0,1622,1536,1637,2998,1261,553,503,551,645,651,724,836,780.0,737.0,112,73,39
273,8,53,2,9,0,308,299,372,645,313,178,140,164,178,173,195,230,212.0,199.0,35,22,13
844,9,53,2,9,0,1369,1274,1967,3191,905,337,855,959,831,614,794,1007,900.0,805.0,213,180,33
332,10,53,2,9,0,232,252,337,697,471,179,227,188,213,224,204,252,228.0,227.0,48,-20,68
976,11,53,2,9,0,2163,1918,2283,3836,1631,972,777,763,993,802,889,897,893.0,863.0,8,87,-79
417,12,53,2,9,0,542,547,676,1270,658,229,229,221,283,227,273,344,308.0,281.0,71,46,25
625,13,53,2,9,0,987,969,1064,2232,950,551,442,578,697,555,544,666,605.0,588.0,122,-11,133
1393,14,53,2,9,0,1548,1431,1720,3243,1894,828,807,1011,1085,1013,1189,1300,1244.0,1167.0,111,176,-65
573,15,53,2,9,0,1067,1140,1205,1850,574,328,328,361,426,423,467,565,516.0,485.0,98,44,54
310,16,53,2,9,0,576,710,866,1354,755,244,256,243,222,247,223,230,226.0,233.0,7,-24,31
628,17,53,2,9,0,844,687,982,1756,938,322,403,371,448,412,466,511,488.0,463.0,45,54,-9
522,18,53,2,9,0,645,645,746,1041,462,182,250,215,304,238,233,338,286.0,270.0,105,-5,110
146,19,53,2,9,0,415,275,422,561,181,92,144,178,144,111,123,123,123.0,119.0,0,12,-12
306,20,53,2,9,0,722,571,643,1136,557,231,195,203,189,260,190,212,201.0,221.0,22,-70,92
525,21,53,2,9,0,652,682,805,1567,639,298,275,310,369,282,381,491,436.0,385.0,110,99,11
80,22,53,2,9,0,164,109,207,305,102,62,72,62,93,71,101,93,97.0,88.0,-8,30,-38
33,1,54,1,9,0,112,64,139,159,95,31,32,33,18,19,21,31,26.0,24.0,10,2,8
70,2,54,1,9,0,88,129,116,195,181,91,58,50,67,48,56,60,58.0,55.0,4,8,-4
142,3,54,1,9,0,178,215,227,336,327,113,110,91,126,86,83,105,94.0,91.0,22,-3,25
32,4,54,1,9,0,124,113,153,246,99,35,29,28,28,17,19,21,20.0,19.0,2,2,0
107,5,54,1,9,0,260,194,267,387,398,155,108,95,80,69,76,114,95.0,86.0,38,7,31
137,6,54,1,9,0,277,262,301,471,484,121,103,101,118,103,101,112,106.0,105.0,11,-2,13
372,7,54,1,9,0,670,629,591,961,723,263,300,312,311,242,273,332,302.0,282.0,59,31,28
92,8,54,1,9,0,92,114,133,167,149,66,59,57,51,58,45,92,68.0,65.0,47,-13,60
44,9,54,1,9,0,111,142,134,176,97,19,44,38,31,35,30,38,34.0,34.0,8,-5,13
12,10,54,1,9,0,27,44,52,62,66,20,31,15,25,9,23,18,20.0,17.0,-5,14,-19
87,11,54,1,9,0,222,289,312,450,333,168,137,94,101,95,97,80,88.0,91.0,-17,2,-19
106,12,54,1,9,0,158,141,164,252,264,69,58,63,82,66,58,86,72.0,70.0,28,-8,36
184,13,54,1,9,0,268,281,338,473,362,182,165,226,205,142,157,221,189.0,173.0,64,15,49
292,14,54,1,9,0,436,457,535,679,669,213,223,212,206,190,239,237,238.0,222.0,-2,49,-51
54,15,54,1,9,0,152,167,161,255,131,59,54,69,64,57,47,53,50.0,52.0,6,-10,16
134,16,54,1,9,0,231,258,278,385,450,105,110,104,89,90,81,127,104.0,99.0,46,-9,55
415,17,54,1,9,0,453,378,533,776,857,222,262,247,257,219,243,308,276.0,257.0,65,24,41
14,18,54,1,9,0,50,51,83,65,41,21,20,20,33,19,21,25,23.0,22.0,4,2,2
62,19,54,1,9,0,152,128,129,166,109,50,66,72,45,46,43,59,51.0,49.0,16,-3,19
87,20,54,1,9,0,157,175,189,306,256,58,77,65,70,84,67,84,76.0,78.0,17,-17,34
237,21,54,1,9,0,329,421,381,634,493,193,190,176,193,161,204,222,213.0,196.0,18,43,-25
76,22,54,1,9,0,141,126,204,277,131,70,96,70,62,54,66,59,62.0,60.0,-7,12,-19
108,1,55,1,9,0,188,167,211,361,138,71,95,74,75,111,81,104,92.0,99.0,23,-30,53
361,2,55,1,9,0,486,521,434,743,406,299,256,259,276,323,373,379,376.0,358.0,6,50,-44
378,3,55,1,9,0,374,366,390,683,304,135,211,181,248,260,314,339,326.0,304.0,25,54,-29
129,4,55,1,9,0,458,302,357,675,173,56,121,79,138,89,102,103,102.0,98.0,1,13,-12
1106,5,55,1,9,0,1530,1137,1318,2057,1186,681,782,644,814,979,1044,1182,1113.0,1068.0,138,65,73
361,6,55,1,9,0,479,476,493,865,574,194,213,248,307,345,317,346,332.0,336.0,29,-28,57
720,7,55,1,9,0,922,870,894,1538,723,282,412,473,536,614,680,774,727.0,689.0,94,66,28
685,8,55,1,9,0,470,495,510,974,417,214,254,346,509,560,656,816,736.0,677.0,160,96,64
575,9,55,1,9,0,730,702,768,1105,569,259,493,354,430,585,484,578,531.0,549.0,94,-101,195
225,10,55,1,9,0,217,208,212,406,260,101,165,105,174,218,194,217,206.0,210.0,23,-24,47
567,11,55,1,9,0,765,828,786,1332,698,402,409,494,495,557,550,609,580.0,572.0,59,-7,66
291,12,55,1,9,0,350,363,356,774,420,110,193,205,216,298,283,295,289.0,292.0,12,-15,27
1153,13,55,1,9,0,936,974,964,2069,891,397,516,929,990,983,1137,1295,1216.0,1138.0,158,154,4
847,14,55,1,9,0,924,913,934,1916,1026,330,387,521,645,908,946,966,956.0,940.0,20,38,-18
405,15,55,1,9,0,604,663,556,982,370,195,281,311,304,395,371,467,419.0,411.0,96,-24,120
277,16,55,1,9,0,385,300,389,721,401,105,159,186,195,272,290,243,266.0,268.0,-47,18,-65
552,17,55,1,9,0,722,567,687,1290,631,205,298,333,363,464,424,425,424.0,438.0,1,-40,41
154,18,55,1,9,0,217,240,253,385,180,95,138,114,150,154,163,198,180.0,172.0,35,9,26
198,19,55,1,9,0,209,211,226,330,135,104,181,144,138,167,145,200,172.0,171.0,55,-22,77
617,20,55,1,9,0,909,844,751,1420,661,420,464,477,481,631,557,639,598.0,609.0,82,-74,156
661,21,55,1,9,0,574,623,639,1234,604,184,336,402,415,468,687,690,688.0,615.0,3,219,-216
146,22,55,1,9,0,126,126,150,236,76,111,111,78,108,134,127,165,146.0,142.0,38,-7,45
461,1,56,1,9,0,500,412,620,805,357,95,198,187,218,252,286,379,332.0,306.0,93,34,59
741,2,56,1,9,0,851,856,921,1249,829,418,522,444,470,542,766,801,784.0,703.0,35,224,-189
789,3,56,1,9,0,500,528,675,925,601,288,415,322,461,499,595,688,642.0,594.0,93,96,-3
338,4,56,1,9,0,672,532,779,1421,437,212,313,278,276,253,302,320,311.0,292.0,18,49,-31
1788,5,56,1,9,0,2178,1620,1861,2915,2183,903,1084,938,1042,1247,1538,1846,1692.0,1544.0,308,291,17
755,6,56,1,9,0,798,757,934,1307,1141,304,330,322,356,545,585,712,648.0,614.0,127,40,87
1170,7,56,1,9,0,1160,1214,1192,1610,1006,389,569,611,624,776,1014,1189,1102.0,993.0,175,238,-63
652,8,56,1,9,0,505,511,601,970,406,198,368,305,370,503,552,733,642.0,596.0,181,49,132
1490,9,56,1,9,0,1576,1507,1902,2685,1203,341,825,879,785,1142,1134,1550,1342.0,1275.0,416,-8,424
369,10,56,1,9,0,347,352,440,665,433,149,235,168,197,226,296,330,313.0,284.0,34,70,-36
1770,11,56,1,9,0,1646,1598,1955,2752,1481,650,861,854,961,1280,1420,1671,1546.0,1457.0,251,140,111
407,12,56,1,9,0,510,475,511,802,624,159,229,268,266,354,440,475,458.0,423.0,35,86,-51
1432,13,56,1,9,0,1009,905,1021,1551,970,478,608,767,810,890,1254,1423,1338.0,1189.0,169,364,-195
1724,14,56,1,9,0,1342,1399,1530,2696,1928,502,672,701,850,1415,1787,1789,1788.0,1664.0,2,372,-370
1797,15,56,1,9,0,1320,1351,1499,2124,704,292,530,641,696,932,1254,1486,1370.0,1224.0,232,322,-90
609,16,56,1,9,0,653,620,794,1252,837,201,313,330,347,462,609,643,626.0,571.0,34,147,-113
1138,17,56,1,9,0,1383,1339,1478,2360,1657,503,671,579,591,827,934,1043,988.0,935.0,109,107,2
543,18,56,1,9,0,414,399,601,698,428,129,211,219,281,359,378,470,424.0,402.0,92,19,73
316,19,56,1,9,0,331,306,361,459,235,125,226,187,250,248,334,351,342.0,311.0,17,86,-69
1572,20,56,1,9,0,1671,1487,1581,2727,1846,758,896,740,908,1151,1313,1405,1359.0,1290.0,92,162,-70
991,21,56,1,9,0,764,827,896,1319,905,333,426,445,444,565,798,975,886.0,779.0,177,233,-56
281,22,56,1,9,0,219,256,312,397,173,117,199,155,143,190,253,271,262.0,238.0,18,63,-45
27,1,57,3,9,0,28,27,30,34,19,29,28,25,38,29,32,29,30.0,30.0,-3,3,-6
817,2,57,3,9,0,1639,1736,1547,1939,1680,1190,1187,815,815,786,875,755,815.0,805.0,-120,89,-209
70,3,57,3,9,0,107,93,105,108,54,78,117,71,70,60,56,65,60.0,60.0,9,-4,13
80,4,57,3,9,0,282,198,305,504,106,118,157,120,110,104,70,81,76.0,85.0,11,-34,45
523,5,57,3,9,0,717,655,773,955,603,645,678,519,472,474,468,514,491.0,485.0,46,-6,52
226,6,57,3,9,0,197,214,225,272,216,223,191,165,153,149,145,130,138.0,141.0,-15,-4,-11
348,7,57,3,9,0,622,551,636,1105,629,541,513,451,400,375,388,431,410.0,398.0,43,13,30
99,8,57,3,9,0,137,118,161,233,166,115,127,118,117,113,93,103,98.0,103.0,10,-20,30
464,9,57,3,9,0,644,624,713,866,346,505,757,513,503,519,390,440,415.0,450.0,50,-129,179
40,10,57,3,9,0,93,63,75,97,92,50,85,53,57,36,20,17,18.0,24.0,-3,-16,13
537,11,57,3,9,0,766,763,871,1150,610,843,857,623,558,495,522,542,532.0,520.0,20,27,-7
109,12,57,3,9,0,134,92,117,148,132,89,105,90,70,62,87,69,78.0,73.0,-18,25,-43
477,13,57,3,9,0,561,554,769,983,537,616,685,621,541,500,570,609,590.0,560.0,39,70,-31
950,14,57,3,9,0,703,746,952,1314,922,778,753,612,592,519,715,609,662.0,614.0,-106,196,-302
303,15,57,3,9,0,451,456,466,653,312,498,511,368,351,319,353,307,330.0,326.0,-46,34,-80
383,16,57,3,9,0,582,592,590,903,514,438,482,408,403,314,306,325,316.0,315.0,19,-8,27
258,17,57,3,9,0,366,327,426,575,405,314,375,353,267,377,276,257,266.0,303.0,-19,-101,82
94,18,57,3,9,0,156,179,175,195,85,140,157,133,146,133,94,101,98.0,109.0,7,-39,46
165,19,57,3,9,0,216,260,281,370,158,187,236,191,184,170,200,162,181.0,177.0,-38,30,-68
469,20,57,3,9,0,643,645,706,955,636,643,771,438,521,498,470,463,466.0,477.0,-7,-28,21
154,21,57,3,9,0,227,209,280,324,195,155,198,180,157,132,131,161,146.0,141.0,30,-1,31
38,22,57,3,9,0,70,59,76,90,35,48,67,46,41,40,28,43,36.0,37.0,15,-12,27
101,1,58,2,9,0,218,159,193,281,60,52,74,61,69,81,59,68,64.0,69.0,9,-22,31
128,2,58,2,9,0,241,224,227,356,181,119,130,103,154,125,106,113,110.0,115.0,7,-19,26
82,3,58,2,9,0,86,129,183,244,117,67,81,65,79,55,51,79,65.0,62.0,28,-4,32
133,4,58,2,9,0,472,326,417,805,105,52,132,97,103,144,172,170,171.0,162.0,-2,28,-30
583,5,58,2,9,0,1133,824,910,1456,816,454,505,463,516,491,453,624,538.0,523.0,171,-38,209
129,6,58,2,9,0,310,267,287,463,251,96,133,88,118,91,110,111,110.0,104.0,1,19,-18
347,7,58,2,9,0,797,679,738,1182,600,283,311,395,408,271,332,415,374.0,339.0,83,61,22
152,8,58,2,9,0,226,243,264,497,192,96,135,117,169,144,132,175,154.0,150.0,43,-12,55
297,9,58,2,9,0,596,574,615,869,297,127,271,262,258,278,238,265,252.0,260.0,27,-40,67
124,10,58,2,9,0,167,205,233,425,254,71,136,107,135,145,104,103,104.0,117.0,-1,-41,40
382,11,58,2,9,0,761,731,749,1017,461,270,342,363,373,289,260,265,262.0,271.0,5,-29,34
104,12,58,2,9,0,229,198,198,315,211,60,84,84,68,64,78,105,92.0,82.0,27,14,13
477,13,58,2,9,0,771,682,755,1430,754,390,398,481,498,419,459,630,544.0,503.0,171,40,131
415,14,58,2,9,0,851,876,865,1601,892,268,371,333,363,396,440,436,438.0,424.0,-4,44,-48
258,15,58,2,9,0,1437,406,420,845,174,81,170,192,246,204,243,235,239.0,227.0,-8,39,-47
57,16,58,2,9,0,110,128,133,246,134,39,47,55,60,48,51,63,57.0,54.0,12,3,9
244,17,58,2,9,0,439,335,447,756,439,130,231,191,211,178,177,209,193.0,188.0,32,-1,33
94,18,58,2,9,0,142,175,166,247,102,51,67,60,67,91,79,101,90.0,90.0,22,-12,34
18,19,58,2,9,0,68,54,102,113,47,21,29,27,30,22,21,21,21.0,21.0,0,-1,1
438,20,58,2,9,0,764,548,596,1578,630,283,298,337,395,444,428,519,474.0,464.0,91,-16,107
325,21,58,2,9,0,455,455,558,938,498,189,261,260,236,226,286,349,318.0,287.0,63,60,3
12,22,58,2,9,0,17,16,45,45,7,10,21,11,20,18,12,17,14.0,16.0,5,-6,11
404,1,59,2,9,0,1049,393,448,746,228,125,223,190,233,237,1154,290,722.0,560.0,-864,917,-1781
75,2,59,2,9,0,410,266,224,235,105,67,68,72,70,100,79,62,70.0,80.0,-17,-21,4
111,3,59,2,9,0,263,289,273,340,208,63,95,64,75,89,75,89,82.0,84.0,14,-14,28
51,4,59,2,9,0,2528,156,179,362,72,29,64,61,50,56,417,666,542.0,380.0,249,361,-112
368,5,59,2,9,0,1666,730,631,1027,542,251,246,265,230,226,834,315,574.0,458.0,-519,608,-1127
583,6,59,2,9,0,961,755,678,1434,792,244,232,308,344,363,315,452,384.0,377.0,137,-48,185
630,7,59,2,9,0,2646,1380,1053,1685,823,326,341,453,371,362,372,520,446.0,418.0,148,10,138
187,8,59,2,9,0,660,386,479,604,321,126,162,162,182,154,558,292,425.0,335.0,-266,404,-670
478,9,59,2,9,0,1623,936,1038,1493,451,130,374,366,407,481,329,409,369.0,406.0,80,-152,232
204,10,59,2,9,0,360,349,312,543,250,76,136,99,136,130,103,145,124.0,126.0,42,-27,69
1015,11,59,2,9,0,2388,1650,1467,2828,1205,656,751,787,807,758,1395,929,1162.0,1027.0,-466,637,-1103
418,12,59,2,9,0,752,626,577,1241,549,138,232,271,262,250,268,377,322.0,298.0,109,18,91
411,13,59,2,9,0,1606,840,561,1020,602,249,293,362,351,329,285,374,330.0,329.0,89,-44,133
1189,14,59,2,9,0,1669,959,1021,1584,992,320,512,660,557,721,719,991,855.0,810.0,272,-2,274
499,15,59,2,9,0,1203,828,859,1272,386,193,342,341,375,377,337,402,370.0,372.0,65,-40,105
371,16,59,2,9,0,769,691,751,1208,523,161,272,326,270,280,775,316,546.0,457.0,-459,495,-954
457,17,59,2,9,0,847,522,619,891,508,132,232,212,222,268,261,329,295.0,286.0,68,-7,75
131,18,59,2,9,0,304,268,291,431,173,74,106,104,121,115,77,91,84.0,94.0,14,-38,52
79,19,59,2,9,0,291,139,186,225,91,51,75,101,66,42,52,68,60.0,54.0,16,10,6
63,20,59,2,9,0,310,182,148,242,128,33,53,51,65,76,57,46,52.0,60.0,-11,-19,8
271,21,59,2,9,0,661,278,275,432,182,64,143,136,155,142,754,199,476.0,365.0,-555,612,-1167
21,22,59,2,9,0,137,83,61,140,53,29,33,28,48,27,21,28,24.0,25.0,7,-6,13
92,1,60,1,9,0,161,113,162,163,142,84,128,99,108,102,143,141,142.0,129.0,-2,41,-43
95,2,60,1,9,0,111,95,152,131,146,84,119,80,84,87,136,120,128.0,114.0,-16,49,-65
69,3,60,1,9,0,81,97,81,90,83,41,62,87,86,67,58,68,63.0,64.0,10,-9,19
55,4,60,1,9,0,131,79,100,123,88,65,74,70,62,63,53,50,52.0,55.0,-3,-10,7
301,5,60,1,9,0,447,284,279,330,341,184,223,201,224,188,192,262,227.0,214.0,70,4,66
138,6,60,1,9,0,182,170,183,198,254,107,149,150,152,146,136,174,155.0,152.0,38,-10,48
179,7,60,1,9,0,198,152,160,191,159,74,162,163,162,117,116,158,137.0,130.0,42,-1,43
32,8,60,1,9,0,34,32,31,28,41,25,46,41,28,30,28,32,30.0,30.0,4,-2,6
480,9,60,1,9,0,593,541,658,638,568,264,527,387,410,437,440,502,471.0,460.0,62,3,59
143,10,60,1,9,0,208,163,172,213,297,121,197,152,163,152,143,162,152.0,152.0,19,-9,28
342,11,60,1,9,0,402,385,402,439,430,213,408,324,345,284,373,290,332.0,316.0,-83,89,-172
75,12,60,1,9,0,94,87,76,120,103,50,101,76,71,82,82,105,94.0,90.0,23,0,23
121,13,60,1,9,0,92,82,85,95,109,50,116,95,137,104,134,131,132.0,123.0,-3,30,-33
132,14,60,1,9,0,153,141,134,164,130,78,142,114,90,124,140,149,144.0,138.0,9,16,-7
287,15,60,1,9,0,308,339,364,397,466,185,307,317,322,277,351,327,339.0,318.0,-24,74,-98
164,16,60,1,9,0,232,184,244,236,270,129,200,183,140,190,186,222,204.0,199.0,36,-4,40
282,17,60,1,9,0,395,308,355,445,519,215,330,301,296,262,319,373,346.0,318.0,54,57,-3
100,18,60,1,9,0,93,87,125,99,145,57,96,88,101,91,78,106,92.0,92.0,28,-13,41
123,19,60,1,9,0,194,115,126,155,89,59,109,102,100,85,79,140,110.0,101.0,61,-6,67
117,20,60,1,9,0,203,173,179,214,160,89,140,134,104,264,151,136,144.0,184.0,-15,-113,98
207,21,60,1,9,0,256,263,252,263,274,154,228,212,258,163,256,338,297.0,252.0,82,93,-11
62,22,60,1,9,0,68,54,66,57,65,35,91,67,47,50,39,70,54.0,53.0,31,-11,42
270,1,1,1,10,0,228,369,374,305,193,309,264,241,251,240,298,308,303.0,282.0,10,58,-48
298,2,1,1,10,0,310,402,456,434,194,302,243,321,230,362,323,306,314.0,330.0,-17,-39,22
134,3,1,1,10,0,178,204,219,180,128,201,176,192,155,199,170,176,173.0,182.0,6,-29,35
226,4,1,1,10,0,371,460,563,468,432,472,340,407,314,302,310,293,302.0,302.0,-17,8,-25
303,5,1,1,10,0,350,453,570,500,253,378,337,331,336,304,330,449,390.0,361.0,119,26,93
153,6,1,1,10,0,136,179,226,198,76,132,155,144,166,155,166,192,179.0,171.0,26,11,15
371,7,1,1,10,0,394,483,601,468,290,412,484,450,432,449,413,563,488.0,475.0,150,-36,186
166,8,1,1,10,0,233,215,260,248,146,249,182,251,173,213,197,239,218.0,216.0,42,-16,58
2740,9,1,1,10,0,2711,3532,3800,2692,1680,2958,2368,2754,2696,2582,2782,2822,2802.0,2729.0,40,200,-160
304,10,1,1,10,0,349,472,505,425,248,383,277,377,293,309,331,402,366.0,347.0,71,22,49
664,11,1,1,10,0,764,871,1010,800,486,817,617,720,689,718,682,759,720.0,720.0,77,-36,113
152,12,1,1,10,0,166,204,262,236,78,191,154,186,149,156,168,164,166.0,163.0,-4,12,-16
288,13,1,1,10,0,228,291,305,260,190,297,311,328,293,325,352,363,358.0,347.0,11,27,-16
274,14,1,1,10,0,351,521,505,405,250,355,393,307,297,380,309,344,326.0,344.0,35,-71,106
620,15,1,1,10,0,702,660,865,633,409,621,561,562,591,624,669,649,659.0,647.0,-20,45,-65
246,16,1,1,10,0,447,480,474,497,228,445,423,403,455,424,361,409,385.0,398.0,48,-63,111
238,17,1,1,10,0,327,364,474,347,174,297,304,284,259,316,280,304,292.0,300.0,24,-36,60
299,18,1,1,10,0,368,331,404,292,181,307,209,324,299,311,316,288,302.0,305.0,-28,5,-33
592,19,1,1,10,0,769,941,997,650,566,775,692,738,626,805,715,744,730.0,755.0,29,-90,119
88,20,1,1,10,0,120,155,199,115,72,126,107,119,138,135,104,119,112.0,119.0,15,-31,46
289,21,1,1,10,0,324,393,440,305,219,295,292,328,285,305,307,293,300.0,302.0,-14,2,-16
234,22,1,1,10,0,310,458,461,292,234,401,305,324,284,313,335,248,292.0,299.0,-87,22,-109
423,1,2,2,10,0,271,639,518,268,263,442,321,383,408,481,506,615,560.0,534.0,109,25,84
430,2,2,2,10,0,334,609,519,292,264,403,325,415,354,487,506,484,495.0,492.0,-22,19,-41
348,3,2,2,10,0,216,370,337,175,149,316,260,258,252,263,332,312,322.0,302.0,-20,69,-89
261,4,2,2,10,0,231,675,811,368,359,470,369,376,352,396,326,421,374.0,381.0,95,-70,165
668,5,2,2,10,0,469,1053,1125,657,560,806,700,679,724,721,901,1021,961.0,881.0,120,180,-60
468,6,2,2,10,0,253,574,507,301,225,317,315,350,352,460,517,524,520.0,500.0,7,57,-50
1251,7,2,2,10,0,876,1567,1574,775,729,1060,1229,1119,1113,1342,1502,1693,1598.0,1512.0,191,160,31
477,8,2,2,10,0,320,590,571,290,239,407,358,384,335,452,519,543,531.0,505.0,24,67,-43
10502,9,2,2,10,0,6925,13598,11515,5136,4688,10371,8733,8990,9100,9110,10367,11177,10772.0,10218.0,810,1257,-447
949,10,2,2,10,0,642,1386,1258,750,559,1074,832,939,901,1075,1222,1237,1230.0,1178.0,15,147,-132
2160,11,2,2,10,0,1763,3112,2877,1445,1635,2184,1828,1916,1948,2090,2406,2465,2436.0,2320.0,59,316,-257
470,12,2,2,10,0,356,595,741,435,311,545,463,483,513,576,577,634,606.0,596.0,57,1,56
1018,13,2,2,10,0,520,1137,974,498,486,847,1025,993,829,1052,1183,1231,1207.0,1155.0,48,131,-83
861,14,2,2,10,0,565,1273,1234,645,486,968,944,932,1043,1153,1163,1133,1148.0,1150.0,-30,10,-40
1801,15,2,2,10,0,1293,2709,2467,1135,1205,1969,1744,1919,1847,2165,2419,2373,2396.0,2319.0,-46,254,-300
795,16,2,2,10,0,742,1001,1050,703,508,734,619,699,876,984,989,1033,1011.0,1002.0,44,5,39
750,17,2,2,10,0,582,1112,1192,689,445,769,687,748,707,821,1006,917,962.0,915.0,-89,185,-274
1443,18,2,2,10,0,817,2205,1578,856,899,1607,1181,1494,1511,1522,1699,1828,1764.0,1683.0,129,177,-48
1842,19,2,2,10,0,1064,2892,2161,1110,1306,1905,1837,1784,1845,2218,2361,2147,2254.0,2242.0,-214,143,-357
226,20,2,2,10,0,173,470,398,244,215,285,259,240,371,328,317,303,310.0,316.0,-14,-11,-3
505,21,2,2,10,0,375,582,607,340,260,369,435,466,394,526,525,529,527.0,527.0,4,-1,5
782,22,2,2,10,0,480,1076,1018,447,521,1186,639,827,849,957,1229,987,1108.0,1058.0,-242,272,-514
105,1,3,1,10,0,112,163,167,157,101,187,162,155,200,158,195,163,179.0,172.0,-32,37,-69
296,2,3,1,10,0,218,354,350,290,213,293,226,236,265,410,329,332,330.0,357.0,3,-81,84
183,3,3,1,10,0,155,184,233,279,174,228,241,255,251,306,251,232,242.0,263.0,-19,-55,36
404,4,3,1,10,0,457,611,677,549,387,627,524,389,503,552,475,412,444.0,480.0,-63,-77,14
264,5,3,1,10,0,300,411,434,516,235,377,355,370,404,481,373,432,402.0,429.0,59,-108,167
116,6,3,1,10,0,129,128,138,176,83,127,116,129,142,151,124,165,144.0,147.0,41,-27,68
322,7,3,1,10,0,327,415,400,420,235,353,334,323,407,400,410,471,440.0,427.0,61,10,51
125,8,3,1,10,0,111,141,197,179,103,189,173,157,177,211,167,160,164.0,179.0,-7,-44,37
1468,9,3,1,10,0,1421,1989,1829,1713,1159,1738,1536,1581,1833,1828,1593,1985,1789.0,1802.0,392,-235,627
158,10,3,1,10,0,165,181,173,211,121,197,149,174,163,216,133,185,159.0,178.0,52,-83,135
350,11,3,1,10,0,333,437,427,470,296,446,386,375,444,454,461,476,468.0,464.0,15,7,8
120,12,3,1,10,0,90,107,109,126,55,113,112,112,126,130,154,177,166.0,154.0,23,24,-1
300,13,3,1,10,0,274,302,328,389,251,371,364,437,425,531,444,375,410.0,450.0,-69,-87,18
301,14,3,1,10,0,262,352,337,377,202,331,306,338,396,390,320,382,351.0,364.0,62,-70,132
383,15,3,1,10,0,342,428,424,401,264,349,335,366,380,435,444,478,461.0,452.0,34,9,25
194,16,3,1,10,0,211,267,280,321,189,271,255,230,322,292,267,293,280.0,284.0,26,-25,51
216,17,3,1,10,0,211,244,275,284,146,275,262,250,285,292,286,299,292.0,292.0,13,-6,19
102,18,3,1,10,0,106,151,157,167,81,107,85,111,132,133,94,129,112.0,119.0,35,-39,74
506,19,3,1,10,0,346,464,567,506,316,529,433,489,457,606,708,531,620.0,615.0,-177,102,-279
114,20,3,1,10,0,138,184,155,213,116,188,148,168,179,203,176,174,175.0,184.0,-2,-27,25
201,21,3,1,10,0,195,252,267,297,206,288,291,280,277,346,254,290,272.0,297.0,36,-92,128
191,22,3,1,10,0,208,258,336,315,155,306,267,240,317,304,316,199,258.0,273.0,-117,12,-129
204,1,4,2,10,0,166,212,210,117,96,135,131,161,142,167,201,221,211.0,196.0,20,34,-14
317,2,4,2,10,0,209,270,308,173,110,159,185,191,176,253,332,399,366.0,328.0,67,79,-12
226,3,4,2,10,0,128,165,176,89,72,136,148,139,117,145,167,204,186.0,172.0,37,22,15
150,4,4,2,10,0,179,246,342,136,109,179,166,96,85,131,159,164,162.0,151.0,5,28,-23
370,5,4,2,10,0,401,438,436,351,212,361,425,290,324,427,553,667,610.0,549.0,114,126,-12
363,6,4,2,10,0,250,325,348,264,151,204,182,203,195,266,313,338,326.0,306.0,25,47,-22
587,7,4,2,10,0,454,468,556,225,175,357,467,449,285,377,522,729,626.0,543.0,207,145,62
208,8,4,2,10,0,181,144,181,92,70,148,181,165,127,190,198,230,214.0,206.0,32,8,24
4889,9,4,2,10,0,4012,4216,4195,2391,1639,3992,3988,3668,3906,4522,4949,5596,5272.0,5022.0,647,427,220
553,10,4,2,10,0,331,432,386,248,166,443,418,434,344,461,540,630,585.0,544.0,90,79,11
1213,11,4,2,10,0,943,1033,1154,680,651,982,1039,1051,947,1072,1268,1400,1334.0,1247.0,132,196,-64
466,12,4,2,10,0,260,302,351,208,96,254,328,298,271,331,451,520,486.0,434.0,69,120,-51
615,13,4,2,10,0,385,397,419,248,284,584,570,485,345,559,623,645,634.0,609.0,22,64,-42
726,14,4,2,10,0,556,567,651,338,242,578,638,439,516,644,816,854,835.0,771.0,38,172,-134
1466,15,4,2,10,0,1228,1343,1310,747,739,1438,1404,1200,1131,1522,1730,1887,1808.0,1713.0,157,208,-51
873,16,4,2,10,0,726,677,787,450,226,461,459,468,446,524,665,780,722.0,656.0,115,141,-26
679,17,4,2,10,0,436,474,674,394,223,436,554,554,548,663,787,891,839.0,780.0,104,124,-20
837,18,4,2,10,0,563,615,519,231,173,535,612,676,709,737,966,1034,1000.0,912.0,68,229,-161
690,19,4,2,10,0,522,652,848,213,233,610,646,562,459,596,792,810,801.0,733.0,18,196,-178
168,20,4,2,10,0,150,157,208,123,85,166,157,116,162,140,173,200,186.0,171.0,27,33,-6
333,21,4,2,10,0,219,225,317,148,105,202,242,221,226,279,358,344,351.0,327.0,-14,79,-93
327,22,4,2,10,0,222,288,303,90,85,233,244,241,205,236,349,303,326.0,296.0,-46,113,-159
192,1,5,3,10,0,168,249,477,199,177,267,169,193,170,168,208,216,212.0,197.0,8,40,-32
3585,2,5,3,10,0,3096,3216,4503,4785,3067,2754,2281,2227,1995,2206,1981,2469,2225.0,2219.0,488,-225,713
506,3,5,3,10,0,360,520,675,504,451,680,487,440,356,384,433,467,450.0,428.0,34,49,-15
106,4,5,3,10,0,199,305,514,151,92,197,124,132,112,101,80,136,108.0,106.0,56,-21,77
1321,5,5,3,10,0,1007,1411,1954,1724,1537,1481,1090,1021,990,1018,1119,1242,1180.0,1126.0,123,101,22
1339,6,5,3,10,0,1238,1535,2328,2152,1881,1518,1284,1266,1165,1072,1126,1266,1196.0,1155.0,140,54,86
3229,7,5,3,10,0,3268,3907,6576,4483,3060,2839,2545,2879,2279,2583,2917,2744,2830.0,2748.0,-173,334,-507
1662,8,5,3,10,0,1354,1585,2844,2093,1361,1353,1118,1259,955,1154,1235,1338,1286.0,1242.0,103,81,22
1696,9,5,3,10,0,1555,2007,3029,1611,1579,2180,1684,1684,1682,1409,1573,1720,1646.0,1567.0,147,164,-17
1586,10,5,3,10,0,2293,2687,4443,3084,1836,2310,1540,1616,1343,1308,1943,1360,1652.0,1537.0,-583,635,-1218
1865,11,5,3,10,0,1493,1942,3067,2165,2419,2029,1601,1578,1375,1523,1501,1651,1576.0,1558.0,150,-22,172
811,12,5,3,10,0,824,980,1510,1290,922,875,668,648,536,537,656,666,661.0,620.0,10,119,-109
3344,13,5,3,10,0,2808,3641,6231,3870,3403,2945,3015,3119,2522,2789,2808,2753,2780.0,2783.0,-55,19,-74
3259,14,5,3,10,0,3821,4668,7650,5825,3564,3197,2704,2715,2598,2658,2563,2664,2614.0,2628.0,101,-95,196
1309,15,5,3,10,0,1112,1294,2062,1260,1629,1592,1156,1224,1121,1218,1188,1319,1254.0,1242.0,131,-30,161
1151,16,5,3,10,0,958,1353,2198,1919,1140,1262,895,1069,835,836,949,1018,984.0,934.0,69,113,-44
1214,17,5,3,10,0,1354,1770,2693,2364,1506,1541,1174,1020,997,939,1035,1185,1110.0,1053.0,150,96,54
437,18,5,3,10,0,523,688,892,592,650,741,463,546,473,389,402,400,401.0,397.0,-2,13,-15
839,19,5,3,10,0,824,1154,1710,924,939,1322,959,988,854,912,964,1041,1002.0,972.0,77,52,25
244,20,5,3,10,0,201,250,357,250,248,235,212,191,173,197,218,241,230.0,219.0,23,21,2
1562,21,5,3,10,0,1590,1877,3217,2072,1105,1314,1222,1105,910,1051,1117,1406,1262.0,1191.0,289,66,223
569,22,5,3,10,0,518,816,982,506,518,806,657,585,602,530,544,540,542.0,538.0,-4,14,-18
276,1,6,1,10,0,272,582,623,382,114,351,229,285,289,234,347,399,373.0,327.0,52,113,-61
556,2,6,1,10,0,553,546,680,484,300,452,403,419,390,633,639,493,566.0,588.0,-146,6,-152
628,3,6,1,10,0,715,836,832,551,317,489,505,604,525,595,623,640,632.0,619.0,17,28,-11
95,4,6,1,10,0,362,440,598,212,102,180,142,124,93,130,133,130,132.0,131.0,-3,3,-6
933,5,6,1,10,0,1050,1385,1850,1223,671,850,790,838,870,1020,1346,1101,1224.0,1156.0,-245,326,-571
1138,6,6,1,10,0,1256,1491,1666,1515,717,1018,980,1077,1165,1206,1280,1168,1224.0,1218.0,-112,74,-186
2178,7,6,1,10,0,2061,2146,2737,1706,842,1734,1902,2031,1983,2192,2226,2022,2124.0,2147.0,-204,34,-238
692,8,6,1,10,0,724,762,993,533,312,595,582,569,606,683,717,614,666.0,671.0,-103,34,-137
5896,9,6,1,10,0,6582,6734,6492,5607,2647,5713,4896,5717,5445,4899,5914,5863,5888.0,5559.0,-51,1015,-1066
660,10,6,1,10,0,743,853,894,799,409,719,453,603,532,611,719,734,726.0,688.0,15,108,-93
1874,11,6,1,10,0,2283,2584,2672,1728,1016,1729,1498,1701,1735,1850,1857,1722,1790.0,1810.0,-135,7,-142
884,12,6,1,10,0,1065,1086,1291,1027,356,690,687,838,753,813,1041,905,973.0,920.0,-136,228,-364
2420,13,6,1,10,0,2277,2327,2703,2119,1271,2126,2486,2863,2426,2914,2989,2361,2675.0,2755.0,-628,75,-703
2531,14,6,1,10,0,2827,2797,3447,2952,1308,2514,2566,2841,2880,3363,3319,2677,2998.0,3120.0,-642,-44,-598
1255,15,6,1,10,0,1262,1632,1972,795,459,876,905,1141,1077,1165,1379,1241,1310.0,1262.0,-138,214,-352
1247,16,6,1,10,0,1686,1663,2151,1566,597,1095,1029,1047,1133,1293,1344,1288,1316.0,1308.0,-56,51,-107
1432,17,6,1,10,0,2247,1966,2770,1651,844,1487,1573,1636,1382,1564,1802,1482,1642.0,1616.0,-320,238,-558
415,18,6,1,10,0,371,447,476,264,148,314,267,427,418,348,436,384,410.0,389.0,-52,88,-140
449,19,6,1,10,0,317,403,513,241,211,360,293,362,342,372,462,408,435.0,414.0,-54,90,-144
475,20,6,1,10,0,646,803,1149,803,328,472,453,543,623,549,633,579,606.0,587.0,-54,84,-138
626,21,6,1,10,0,665,655,845,620,247,468,497,551,436,566,577,553,565.0,565.0,-24,11,-35
502,22,6,1,10,0,544,740,1032,399,306,506,449,585,503,512,594,572,583.0,559.0,-22,82,-104
958,1,7,3,10,0,710,977,1212,1265,890,1247,1119,1184,1456,1316,1194,1258,1226.0,1256.0,64,-122,186
190,2,7,3,10,0,45,66,119,104,63,214,133,132,248,173,187,150,168.0,170.0,-37,14,-51
137,3,7,3,10,0,43,56,75,86,64,154,131,164,163,146,193,187,190.0,175.0,-6,47,-53
1056,4,7,3,10,0,677,793,1627,1352,1114,1508,1132,1430,1670,1367,1416,1463,1440.0,1415.0,47,49,-2
254,5,7,3,10,0,102,145,321,208,187,254,335,308,285,276,420,431,426.0,376.0,11,144,-133
291,6,7,3,10,0,145,176,251,253,175,322,340,315,352,311,384,398,391.0,364.0,14,73,-59
1189,7,7,3,10,0,494,739,1047,878,649,1303,1248,1216,1405,1283,1284,1321,1302.0,1296.0,37,1,36
209,8,7,3,10,0,83,105,184,165,123,244,320,272,242,233,292,344,318.0,290.0,52,59,-7
946,9,7,3,10,0,463,571,819,762,448,944,1100,1025,1038,994,984,1134,1059.0,1037.0,150,-10,160
97,10,7,3,10,0,87,45,96,92,54,103,134,119,86,123,99,126,112.0,116.0,27,-24,51
1121,11,7,3,10,0,563,731,1002,974,650,1188,1289,1048,1276,1137,1253,1328,1290.0,1239.0,75,116,-41
178,12,7,3,10,0,43,74,97,118,85,164,140,153,162,165,154,204,179.0,174.0,50,-11,61
579,13,7,3,10,0,232,288,493,470,361,599,660,769,569,656,773,873,823.0,767.0,100,117,-17
743,14,7,3,10,0,282,366,596,517,345,763,731,685,764,754,849,909,879.0,837.0,60,95,-35
743,15,7,3,10,0,278,533,736,534,424,754,915,865,808,908,999,1113,1056.0,1007.0,114,91,23
205,16,7,3,10,0,66,94,173,151,103,240,253,187,234,272,286,270,278.0,276.0,-16,14,-30
170,17,7,3,10,0,60,83,119,101,59,203,163,182,206,192,239,250,244.0,227.0,11,47,-36
181,18,7,3,10,0,106,97,170,123,106,206,303,187,204,204,249,241,245.0,231.0,-8,45,-53
296,19,7,3,10,0,111,151,300,181,154,357,324,363,378,413,435,413,424.0,420.0,-22,22,-44
111,20,7,3,10,0,43,58,100,60,71,130,181,128,151,124,150,168,159.0,147.0,18,26,-8
291,21,7,3,10,0,136,164,313,234,179,320,305,340,358,313,390,434,412.0,379.0,44,77,-33
192,22,7,3,10,0,76,95,177,129,74,323,185,255,260,224,227,281,254.0,244.0,54,3,51
325,1,8,2,10,0,431,543,697,325,168,288,309,527,516,379,272,357,314.0,336.0,85,-107,192
89,2,8,2,10,0,64,106,112,40,25,38,54,68,55,75,116,109,112.0,100.0,-7,41,-48
46,3,8,2,10,0,48,60,75,31,18,29,46,51,51,61,78,46,62.0,62.0,-32,17,-49
85,4,8,2,10,0,59,86,132,40,51,59,50,54,60,151,111,68,90.0,110.0,-43,-40,-3
295,5,8,2,10,0,187,278,408,216,117,192,175,229,259,209,437,371,404.0,339.0,-66,228,-294
356,6,8,2,10,0,363,447,587,357,148,207,278,368,463,445,401,385,393.0,410.0,-16,-44,28
263,7,8,2,10,0,437,477,555,320,180,373,400,374,355,402,517,287,402.0,402.0,-230,115,-345
63,8,8,2,10,0,59,55,64,30,23,28,38,44,60,71,103,47,75.0,74.0,-56,32,-88
420,9,8,2,10,0,225,342,408,121,39,166,158,211,185,222,453,438,446.0,371.0,-15,231,-246
131,10,8,2,10,0,66,86,129,68,34,47,50,71,60,56,125,119,122.0,100.0,-6,69,-75
797,11,8,2,10,0,1156,1271,1767,893,628,788,879,1067,1002,995,690,648,669.0,778.0,-42,-305,263
189,12,8,2,10,0,175,224,302,169,92,161,188,202,170,233,263,198,230.0,231.0,-65,30,-95
211,13,8,2,10,0,129,127,215,80,56,93,108,163,149,199,289,190,240.0,226.0,-99,90,-189
272,14,8,2,10,0,257,320,368,183,97,185,329,340,259,262,298,278,288.0,279.0,-20,36,-56
593,15,8,2,10,0,742,941,1163,445,309,478,511,775,845,706,532,466,499.0,568.0,-66,-174,108
251,16,8,2,10,0,233,287,401,211,94,172,184,195,243,185,256,244,250.0,228.0,-12,71,-83
183,17,8,2,10,0,182,259,315,201,83,173,167,198,189,202,231,221,226.0,218.0,-10,29,-39
185,18,8,2,10,0,70,117,145,54,20,51,78,114,140,134,168,156,162.0,153.0,-12,34,-46
81,19,8,2,10,0,81,68,104,28,21,52,82,45,37,92,119,77,98.0,96.0,-42,27,-69
99,20,8,2,10,0,40,57,62,28,20,37,37,33,64,92,101,91,96.0,95.0,-10,9,-19
146,21,8,2,10,0,141,113,177,107,51,78,83,124,102,102,142,134,138.0,126.0,-8,40,-48
21,22,8,2,10,0,29,28,30,11,11,8,18,20,17,27,60,33,46.0,40.0,-27,33,-60
870,1,9,1,10,0,851,1537,1734,940,540,957,807,919,933,755,914,982,948.0,884.0,68,159,-91
355,2,9,1,10,0,464,639,732,400,288,346,301,327,290,401,329,345,337.0,358.0,16,-72,88
398,3,9,1,10,0,433,493,573,322,195,323,333,363,302,240,293,382,338.0,305.0,89,53,36
373,4,9,1,10,0,532,915,1057,659,394,601,489,595,532,503,449,472,460.0,475.0,23,-54,77
888,5,9,1,10,0,1020,1293,1876,1072,611,873,761,808,800,793,898,1218,1058.0,970.0,320,105,215
977,6,9,1,10,0,1018,1287,1597,1015,457,773,664,769,751,688,875,1020,948.0,861.0,145,187,-42
1080,7,9,1,10,0,1547,1722,2394,1077,522,1253,1236,1215,1019,955,1078,1388,1233.0,1140.0,310,123,187
532,8,9,1,10,0,489,581,742,375,248,450,310,404,335,340,378,448,413.0,389.0,70,38,32
1071,9,9,1,10,0,1508,2163,2594,949,463,1024,892,976,1062,838,972,1048,1010.0,953.0,76,134,-58
338,10,9,1,10,0,373,502,713,341,210,322,222,345,302,257,262,298,280.0,272.0,36,5,31
1407,11,9,1,10,0,1635,2059,2647,1466,939,1519,1181,1355,1281,1072,1305,1574,1440.0,1317.0,269,233,36
1037,12,9,1,10,0,900,1083,1527,753,397,757,746,837,677,745,886,1080,983.0,904.0,194,141,53
740,13,9,1,10,0,828,1012,1235,691,404,655,694,773,655,680,691,793,742.0,721.0,102,11,91
1099,14,9,1,10,0,1191,1470,2122,1000,589,1119,1013,903,937,951,1080,1247,1164.0,1093.0,167,129,38
1153,15,9,1,10,0,1090,1626,2068,1003,537,978,796,1015,879,797,986,1136,1061.0,973.0,150,189,-39
1214,16,9,1,10,0,1284,1519,1632,1025,485,1058,873,1015,949,835,965,1376,1170.0,1059.0,411,130,281
1057,17,9,1,10,0,1168,1619,2178,1217,467,1068,962,1084,875,893,959,1329,1144.0,1060.0,370,66,304
518,18,9,1,10,0,568,767,913,522,257,433,373,497,408,356,398,487,442.0,414.0,89,42,47
320,19,9,1,10,0,407,443,594,254,172,277,329,290,263,262,428,438,433.0,376.0,10,166,-156
312,20,9,1,10,0,354,500,762,420,252,342,321,324,387,329,286,390,338.0,335.0,104,-43,147
398,21,9,1,10,0,444,478,651,365,184,306,238,357,732,447,312,423,368.0,394.0,111,-135,246
179,22,9,1,10,0,203,289,372,142,121,207,187,231,186,143,232,203,218.0,193.0,-29,89,-118
691,1,10,2,10,0,1261,1546,1428,635,513,975,1070,1137,2596,1172,1207,1337,1272.0,1239.0,130,35,95
362,2,10,2,10,0,350,412,626,249,167,333,316,408,510,602,649,565,607.0,605.0,-84,47,-131
372,3,10,2,10,0,451,516,701,285,178,320,330,439,413,440,575,685,630.0,567.0,110,135,-25
37,4,10,2,10,0,174,264,913,106,74,113,101,453,335,314,124,110,117.0,183.0,-14,-190,176
1415,5,10,2,10,0,1555,1783,2691,1134,763,1522,1501,1649,1954,1996,2318,2175,2246.0,2163.0,-143,322,-465
1480,6,10,2,10,0,2110,2138,2356,1607,968,1908,2068,2171,2517,2384,2828,2098,2463.0,2437.0,-730,444,-1174
2802,7,10,2,10,0,3911,3787,4830,2048,1323,3138,3779,4223,3954,4263,5234,4184,4709.0,4560.0,-1050,971,-2021
750,8,10,2,10,0,678,852,1073,317,283,629,610,883,1085,1017,1391,967,1179.0,1125.0,-424,374,-798
2176,9,10,2,10,0,1912,2435,2500,695,488,1495,1512,1848,2203,1964,2643,2750,2696.0,2452.0,107,679,-572
598,10,10,2,10,0,646,783,869,475,293,738,554,830,966,1021,1065,1006,1036.0,1031.0,-59,44,-103
3479,11,10,2,10,0,5170,5016,5865,2657,2401,4119,4083,4704,4995,4877,5866,4453,5160.0,5065.0,-1413,989,-2402
1261,12,10,2,10,0,1175,1376,1737,923,549,1502,1828,1895,1662,1811,1988,1776,1882.0,1858.0,-212,177,-389
1711,13,10,2,10,0,1672,1926,2621,900,720,1379,2198,2809,2761,2856,3219,1969,2594.0,2681.0,-1250,363,-1613
2328,14,10,2,10,0,2644,2874,3243,1683,1042,2558,3199,3067,3400,3871,4333,3047,3690.0,3750.0,-1286,462,-1748
2554,15,10,2,10,0,3003,3295,3490,1289,1038,1965,1876,2506,2778,3135,3712,3209,3460.0,3352.0,-503,577,-1080
1162,16,10,2,10,0,1500,1547,1624,929,480,1234,1278,1437,1882,1699,1835,1719,1777.0,1751.0,-116,136,-252
1239,17,10,2,10,0,1457,1585,1952,989,516,1513,1616,1696,1720,1686,2057,2090,2074.0,1944.0,33,371,-338
1081,18,10,2,10,0,836,1130,958,546,402,859,878,1319,1184,1258,1327,1317,1322.0,1301.0,-10,69,-79
497,19,10,2,10,0,540,619,821,205,149,446,498,474,571,727,964,874,919.0,855.0,-90,237,-327
413,20,10,2,10,0,422,419,597,296,163,296,401,429,660,507,590,674,632.0,590.0,84,83,1
626,21,10,2,10,0,891,912,1151,413,242,475,689,883,1688,1091,1205,1047,1126.0,1114.0,-158,114,-272
247,22,10,2,10,0,250,347,415,118,130,301,193,254,310,279,412,382,397.0,358.0,-30,133,-163
99,1,11,2,10,0,144,225,270,79,27,45,95,103,101,83,103,129,116.0,105.0,26,20,6
422,2,11,2,10,0,192,267,384,296,172,285,192,231,213,247,282,327,304.0,285.0,45,35,10
274,3,11,2,10,0,237,359,450,248,124,211,203,178,177,181,202,244,223.0,209.0,42,21,21
268,4,11,2,10,0,684,938,1287,118,74,556,952,1106,818,968,836,546,691.0,783.0,-290,-132,-158
1092,5,11,2,10,0,707,1002,2805,1326,797,891,676,702,734,761,905,1065,985.0,910.0,160,144,16
828,6,11,2,10,0,716,977,1443,903,436,535,520,582,612,532,660,692,676.0,628.0,32,128,-96
1960,7,11,2,10,0,1752,2198,3785,1878,1009,1343,1575,1488,1335,1337,1747,1744,1746.0,1609.0,-3,410,-413
746,8,11,2,10,0,370,1993,2925,603,248,417,464,574,426,448,540,518,529.0,502.0,-22,92,-114
1591,9,11,2,10,0,1065,2044,2419,914,399,1078,1095,1082,1215,1038,1245,1500,1372.0,1261.0,255,207,48
719,10,11,2,10,0,368,493,935,666,303,492,403,512,470,474,495,629,562.0,533.0,134,21,113
1078,11,11,2,10,0,1184,1531,2308,910,648,752,1041,985,944,821,908,982,945.0,904.0,74,87,-13
910,12,11,2,10,0,701,917,1377,999,364,509,561,555,561,469,643,721,682.0,611.0,78,174,-96
1362,13,11,2,10,0,754,1144,2067,1110,641,741,953,1002,876,936,1050,1031,1040.0,1006.0,-19,114,-133
2212,14,11,2,10,0,1090,1965,3560,2272,888,1199,1423,1368,1487,1652,1740,1822,1781.0,1738.0,82,88,-6
2752,15,11,2,10,0,2287,3147,4324,1028,639,1114,1097,2340,1882,1700,2222,2001,2112.0,1974.0,-221,522,-743
723,16,11,2,10,0,521,941,1534,1004,347,476,456,410,475,460,525,1167,846.0,717.0,642,65,577
980,17,11,2,10,0,762,1142,1719,1133,438,685,688,650,716,659,750,1015,882.0,808.0,265,91,174
965,18,11,2,10,0,468,762,1967,434,268,656,565,712,722,602,609,775,692.0,662.0,166,7,159
253,19,11,2,10,0,239,291,520,199,149,205,202,188,167,160,157,192,174.0,170.0,35,-3,38
485,20,11,2,10,0,253,326,532,432,291,409,310,302,286,280,366,470,418.0,372.0,104,86,18
1331,21,11,2,10,0,830,1010,1651,919,422,609,612,587,580,1155,818,1081,950.0,1018.0,263,-337,600
80,22,11,2,10,0,114,204,257,135,104,114,128,104,132,112,136,138,137.0,129.0,2,24,-22
47,1,12,2,10,0,75,125,158,63,40,60,51,45,46,45,48,64,56.0,52.0,16,3,13
421,2,12,2,10,0,425,375,535,421,246,288,240,252,266,378,341,384,362.0,368.0,43,-37,80
330,3,12,2,10,0,287,448,676,363,164,250,212,180,206,169,180,292,236.0,214.0,112,11,101
56,4,12,2,10,0,289,360,496,86,74,109,80,71,61,54,68,80,74.0,67.0,12,14,-2
881,5,12,2,10,0,870,831,1260,724,451,621,526,535,628,654,720,912,816.0,762.0,192,66,126
556,6,12,2,10,0,478,510,806,576,272,358,315,316,346,322,391,446,418.0,386.0,55,69,-14
1444,7,12,2,10,0,1660,1778,2915,1529,762,977,1071,1025,958,930,1153,1156,1154.0,1080.0,3,223,-220
804,8,12,2,10,0,689,668,1092,615,366,578,543,590,543,530,702,862,782.0,698.0,160,172,-12
961,9,12,2,10,0,1170,1384,1437,718,363,821,836,734,867,743,867,1000,934.0,870.0,133,124,9
428,10,12,2,10,0,321,463,659,452,233,370,288,292,316,346,373,423,398.0,381.0,50,27,23
651,11,12,2,10,0,691,743,1008,543,405,518,460,406,448,428,481,488,484.0,466.0,7,53,-46
444,12,12,2,10,0,518,577,816,634,247,323,301,331,301,285,348,422,385.0,352.0,74,63,11
1511,13,12,2,10,0,1308,1432,2365,1304,951,1023,1070,1210,930,1140,1221,1304,1262.0,1222.0,83,81,2
1386,14,12,2,10,0,1148,1406,2228,1526,717,888,888,823,850,1053,1131,1233,1182.0,1139.0,102,78,24
628,15,12,2,10,0,660,874,1121,438,306,511,460,520,507,491,573,625,599.0,563.0,52,82,-30
502,16,12,2,10,0,534,655,903,635,255,364,342,325,362,407,342,478,410.0,409.0,136,-65,201
693,17,12,2,10,0,609,763,1216,773,321,479,531,540,517,429,513,640,576.0,527.0,127,84,43
264,18,12,2,10,0,218,239,420,249,153,274,195,252,248,212,300,311,306.0,274.0,11,88,-77
358,19,12,2,10,0,328,514,641,287,222,321,326,279,247,251,291,348,320.0,297.0,57,40,17
335,20,12,2,10,0,272,292,402,296,142,238,207,233,232,240,260,352,306.0,284.0,92,20,72
802,21,12,2,10,0,729,755,1158,815,410,484,484,492,471,470,664,857,760.0,664.0,193,194,-1
279,22,12,2,10,0,176,328,336,166,145,205,161,183,216,199,211,200,206.0,203.0,-11,12,-23
70,1,13,1,10,0,158,314,461,180,102,190,125,145,92,77,83,77,80.0,79.0,-6,6,-12
737,2,13,1,10,0,627,757,1396,1059,575,778,650,682,486,654,573,601,587.0,609.0,28,-81,109
477,3,13,1,10,0,324,527,720,520,270,473,409,472,356,344,415,453,434.0,404.0,38,71,-33
36,4,13,1,10,0,199,242,487,101,86,162,127,117,78,41,43,61,52.0,48.0,18,2,16
1043,5,13,1,10,0,1243,1605,2433,1860,1194,1302,1156,1192,925,872,1055,1302,1178.0,1076.0,247,183,64
974,6,13,1,10,0,1269,1370,2298,1440,720,878,861,934,738,651,739,952,846.0,781.0,213,88,125
1648,7,13,1,10,0,1686,2126,3804,2217,1109,1504,1812,1956,1321,1432,1563,1725,1644.0,1573.0,162,131,31
673,8,13,1,10,0,642,748,1215,772,404,591,661,732,531,562,597,623,610.0,594.0,26,35,-9
797,9,13,1,10,0,848,1467,2021,1040,446,977,1064,948,854,663,649,829,739.0,714.0,180,-14,194
395,10,13,1,10,0,388,511,880,738,330,660,454,586,385,399,303,460,382.0,387.0,157,-96,253
1065,11,13,1,10,0,1451,1816,2525,1540,1130,1441,1246,1265,930,913,863,957,910.0,911.0,94,-50,144
678,12,13,1,10,0,733,889,1320,1015,377,598,631,632,491,445,477,574,526.0,499.0,97,32,65
1628,13,13,1,10,0,1548,2026,3281,1882,1126,1456,2041,2368,1518,1714,1628,1540,1584.0,1627.0,-88,-86,-2
1530,14,13,1,10,0,1473,1843,2975,2324,1002,1413,1518,1509,1135,1362,1395,1473,1434.0,1410.0,78,33,45
965,15,13,1,10,0,1175,1502,2235,958,565,880,893,948,697,814,804,930,867.0,849.0,126,-10,136
791,16,13,1,10,0,924,1339,1557,1148,463,782,723,758,663,696,627,825,726.0,716.0,198,-69,267
664,17,13,1,10,0,772,835,1281,1235,439,733,664,655,498,506,508,651,580.0,555.0,143,2,141
330,18,13,1,10,0,414,622,877,518,365,529,461,541,380,328,306,337,322.0,324.0,31,-22,53
298,19,13,1,10,0,296,396,542,311,224,349,397,405,266,303,286,359,322.0,316.0,73,-17,90
284,20,13,1,10,0,316,419,666,489,274,346,334,368,358,284,258,335,296.0,292.0,77,-26,103
672,21,13,1,10,0,627,715,1549,1036,394,463,535,597,405,487,551,603,577.0,547.0,52,64,-12
481,22,13,1,10,0,411,616,998,401,372,684,679,736,526,592,672,585,628.0,616.0,-87,80,-167
244,1,14,1,10,0,472,781,1047,423,192,279,354,355,429,362,376,371,374.0,370.0,-5,14,-19
1360,2,14,1,10,0,1148,1159,1879,1354,680,631,992,1295,955,1148,1036,994,1015.0,1059.0,-42,-112,70
923,3,14,1,10,0,701,941,1442,814,347,566,786,1042,724,802,839,925,882.0,855.0,86,37,49
235,4,14,1,10,0,474,569,1295,274,176,281,280,376,386,433,291,293,292.0,339.0,2,-142,144
1859,5,14,1,10,0,1556,2162,4188,2540,1081,1111,1488,1668,1412,1619,1860,2342,2101.0,1940.0,482,241,241
1690,6,14,1,10,0,1889,2073,3650,2495,863,893,1218,1582,1360,1404,1555,1685,1620.0,1548.0,130,151,-21
3085,7,14,1,10,0,3252,3594,6275,3467,1356,2002,3249,3444,2666,3057,2942,3377,3160.0,3125.0,435,-115,550
936,8,14,1,10,0,800,914,1576,743,357,500,790,998,720,798,855,911,883.0,855.0,56,57,-1
2021,9,14,1,10,0,2902,3269,4342,1784,653,1364,1722,2162,2247,2038,2128,2302,2215.0,2156.0,174,90,84
620,10,14,1,10,0,621,739,1316,892,381,556,538,802,574,699,609,693,651.0,667.0,84,-90,174
2663,11,14,1,10,0,3560,3776,5864,3032,1760,2316,2607,3244,2604,2564,2570,2743,2656.0,2626.0,173,6,167
1043,12,14,1,10,0,1195,1285,2160,1579,453,603,962,960,811,902,887,1133,1010.0,974.0,246,-15,261
2211,13,14,1,10,0,2298,2594,4551,2375,1231,1427,2467,3049,2213,2567,2481,2466,2474.0,2505.0,-15,-86,71
3184,14,14,1,10,0,3427,4047,8018,5309,1586,1915,2716,3025,2701,2930,3143,3339,3241.0,3137.0,196,213,-17
2198,15,14,1,10,0,2724,3014,4336,1679,826,1161,1890,2275,1899,2230,2234,2335,2284.0,2266.0,101,4,97
1417,16,14,1,10,0,1512,1848,3179,2049,551,906,1028,1278,1264,1359,1217,1693,1455.0,1423.0,476,-142,618
1640,17,14,1,10,0,1872,2355,3747,2461,732,1157,1395,1621,1288,1479,1482,1887,1684.0,1616.0,405,3,402
786,18,14,1,10,0,859,1140,1306,596,364,463,616,759,757,740,708,723,716.0,724.0,15,-32,47
952,19,14,1,10,0,970,1188,1784,769,415,765,1227,1203,969,1200,1102,1144,1123.0,1149.0,42,-98,140
742,20,14,1,10,0,622,761,1417,877,373,399,529,594,627,619,620,836,728.0,692.0,216,1,215
1016,21,14,1,10,0,899,841,1546,1008,303,361,648,917,661,790,773,918,846.0,827.0,145,-17,162
758,22,14,1,10,0,517,944,1290,579,365,604,725,778,831,876,865,867,866.0,869.0,2,-11,13
517,1,15,2,10,0,623,807,1293,851,433,764,667,727,689,522,968,719,844.0,736.0,-249,446,-695
370,2,15,2,10,0,394,535,639,509,300,415,361,462,414,443,436,471,454.0,450.0,35,-7,42
533,3,15,2,10,0,477,451,580,494,276,556,527,562,528,446,576,531,554.0,518.0,-45,130,-175
705,4,15,2,10,0,969,1288,2146,1327,923,1308,982,1002,1096,834,1075,842,958.0,917.0,-233,241,-474
604,5,15,2,10,0,634,781,1105,856,454,680,597,621,651,776,861,835,848.0,824.0,-26,85,-111
786,6,15,2,10,0,774,803,1070,953,364,644,584,685,706,708,895,856,876.0,820.0,-39,187,-226
1113,7,15,2,10,0,1224,1513,1837,1329,778,1244,1284,1298,1141,1319,1334,1363,1348.0,1339.0,29,15,14
659,8,15,2,10,0,770,798,1203,945,474,746,713,727,660,639,991,794,892.0,808.0,-197,352,-549
381,9,15,2,10,0,425,536,825,423,180,427,549,477,696,389,618,526,572.0,511.0,-92,229,-321
116,10,15,2,10,0,135,160,243,179,71,140,141,183,151,137,141,191,166.0,156.0,50,4,46
1295,11,15,2,10,0,1848,1951,2643,1820,1058,1565,1288,1340,1313,1263,1676,1620,1648.0,1520.0,-56,413,-469
320,12,15,2,10,0,377,424,571,408,151,325,301,312,293,255,351,379,365.0,328.0,28,96,-68
1285,13,15,2,10,0,1264,1433,1923,1604,884,1377,1523,1631,1539,1425,1590,1515,1552.0,1510.0,-75,165,-240
988,14,15,2,10,0,952,1113,1482,1178,548,1003,1062,1044,1052,1125,1238,1016,1127.0,1126.0,-222,113,-335
614,15,15,2,10,0,722,894,1112,767,352,679,681,651,616,628,814,733,774.0,725.0,-81,186,-267
300,16,15,2,10,0,329,377,483,446,164,271,261,296,275,330,388,373,380.0,364.0,-15,58,-73
425,17,15,2,10,0,438,477,783,487,262,452,359,428,383,395,447,527,487.0,456.0,80,52,28
256,18,15,2,10,0,212,345,456,397,140,227,217,291,297,182,259,217,238.0,219.0,-42,77,-119
176,19,15,2,10,0,247,251,310,270,165,356,218,179,255,221,255,217,236.0,231.0,-38,34,-72
311,20,15,2,10,0,426,491,644,555,263,408,381,378,462,374,447,448,448.0,423.0,1,73,-72
522,21,15,2,10,0,617,622,758,719,361,603,579,645,499,553,624,536,580.0,571.0,-88,71,-159
100,22,15,2,10,0,142,152,169,104,79,149,106,141,121,123,121,96,108.0,113.0,-25,-2,-23
43,1,16,2,10,0,395,67,117,63,37,86,109,100,151,123,42,55,48.0,73.0,13,-81,94
1333,2,16,2,10,0,988,1142,1590,946,692,1035,755,884,765,1277,1207,1465,1336.0,1316.0,258,-70,328
1060,3,16,2,10,0,802,945,982,602,413,714,724,743,629,652,1139,1161,1150.0,984.0,22,487,-465
277,4,16,2,10,0,477,625,985,300,271,404,282,274,292,278,289,341,315.0,303.0,52,11,41
2401,5,16,2,10,0,1733,2221,3340,1470,1639,3175,2405,2457,2398,2530,2754,3201,2978.0,2828.0,447,224,223
493,6,16,2,10,0,424,410,575,248,260,384,279,286,452,366,371,478,424.0,405.0,107,5,102
3505,7,16,2,10,0,3617,3662,4024,1903,1708,2748,2376,2932,2420,2797,3096,3668,3382.0,3187.0,572,299,273
1465,8,16,2,10,0,1243,1188,1616,679,442,672,792,892,815,1028,1189,1434,1312.0,1217.0,245,161,84
2044,9,16,2,10,0,1906,2111,2398,1196,1075,2249,1558,2005,1936,1682,1885,2157,2021.0,1908.0,272,203,69
369,10,16,2,10,0,384,459,435,440,301,449,664,501,523,446,573,488,530.0,502.0,-85,127,-212
917,11,16,2,10,0,781,777,930,527,626,655,605,586,670,623,694,810,752.0,709.0,116,71,45
425,12,16,2,10,0,488,482,540,354,189,356,270,359,296,244,355,399,377.0,333.0,44,111,-67
3840,13,16,2,10,0,3483,3233,4206,2068,1780,2633,2656,3148,2856,3242,3648,3843,3746.0,3578.0,195,406,-211
2086,14,16,2,10,0,1931,2018,2962,1570,1050,1823,1515,1509,1506,1785,1836,2094,1965.0,1905.0,258,51,207
660,15,16,2,10,0,606,634,886,424,422,628,555,606,538,517,542,822,682.0,627.0,280,25,255
573,16,16,2,10,0,585,544,920,483,270,442,304,376,403,430,440,533,486.0,468.0,93,10,83
1174,17,16,2,10,0,1444,1489,2336,1714,653,1232,835,1023,1076,1149,1284,1450,1367.0,1294.0,166,135,31
640,18,16,2,10,0,690,597,622,308,292,460,424,486,428,470,413,661,537.0,515.0,248,-57,305
1557,19,16,2,10,0,1308,1478,1878,681,691,1319,1119,1215,1237,1419,1601,1582,1592.0,1534.0,-19,182,-201
262,20,16,2,10,0,184,172,247,131,105,125,160,126,176,161,199,234,216.0,198.0,35,38,-3
886,21,16,2,10,0,580,634,1051,558,384,605,487,577,560,603,780,777,778.0,720.0,-3,177,-180
1730,22,16,2,10,0,1308,1636,1781,730,952,1556,1254,1336,1463,1649,2283,2187,2235.0,2040.0,-96,634,-730
887,1,17,2,10,0,1674,2362,3060,1909,501,2672,4039,883,4181,1421,1782,1879,1830.0,1694.0,97,361,-264
1252,2,17,2,10,0,1038,1033,1402,656,504,651,603,785,827,1300,1307,1367,1337.0,1325.0,60,7,53
772,3,17,2,10,0,468,630,827,268,214,376,413,543,491,575,777,749,763.0,700.0,-28,202,-230
265,4,17,2,10,0,516,1494,2145,217,200,2331,1550,280,361,498,297,355,326.0,383.0,58,-201,259
2053,5,17,2,10,0,1708,2119,2450,1355,937,1478,2078,1399,1459,1801,2351,2567,2459.0,2240.0,216,550,-334
2516,6,17,2,10,0,2529,2927,3132,1460,775,1436,1362,1591,1598,1947,2510,2710,2610.0,2389.0,200,563,-363
4122,7,17,2,10,0,4129,4087,5401,1885,1225,2010,2269,2615,2569,3263,3929,4366,4148.0,3853.0,437,666,-229
1828,8,17,2,10,0,1452,1547,2066,692,491,877,974,1192,1135,1670,2019,1865,1942.0,1851.0,-154,349,-503
1687,9,17,2,10,0,2036,2188,2519,625,462,1475,1506,1216,1544,1515,1754,1731,1742.0,1667.0,-23,239,-262
586,10,17,2,10,0,568,596,616,308,176,366,289,407,451,518,551,689,620.0,586.0,138,33,105
4745,11,17,2,10,0,4475,5007,5643,2143,1862,2644,2631,3008,3307,4299,4173,4430,4302.0,4301.0,257,-126,383
1615,12,17,2,10,0,1627,1981,2357,973,442,916,895,1031,1009,1333,1810,1734,1772.0,1626.0,-76,477,-553
4377,13,17,2,10,0,3277,3711,5424,1723,1261,2043,2652,2981,2611,4091,4869,4197,4533.0,4386.0,-672,778,-1450
4481,14,17,2,10,0,3793,4237,5119,2463,1238,2429,2562,2723,3091,4009,4961,4989,4975.0,4653.0,28,952,-924
2259,15,17,2,10,0,2324,2401,2755,895,768,1359,1321,1533,1474,1767,2205,2322,2264.0,2098.0,117,438,-321
1474,16,17,2,10,0,1296,1466,1985,1002,357,841,848,822,1085,1431,1415,1567,1491.0,1471.0,152,-16,168
1856,17,17,2,10,0,1670,2078,2533,1085,531,1104,1014,1204,1328,1663,1969,2202,2086.0,1945.0,233,306,-73
1298,18,17,2,10,0,1170,1218,1549,440,400,775,721,1235,973,1141,1223,1242,1232.0,1202.0,19,82,-63
692,19,17,2,10,0,700,869,1098,268,212,386,587,555,690,977,861,746,804.0,861.0,-115,-116,1
870,20,17,2,10,0,824,938,1120,617,359,603,607,619,800,1027,1072,1122,1097.0,1074.0,50,45,5
1777,21,17,2,10,0,1165,1199,1748,631,397,661,1831,842,1735,1691,1436,1577,1506.0,1568.0,141,-255,396
427,22,17,2,10,0,286,466,480,162,156,276,218,323,452,354,467,458,462.0,426.0,-9,113,-122
238,1,18,2,10,0,314,574,754,315,362,767,319,351,300,314,334,352,343.0,333.0,18,20,-2
835,2,18,2,10,0,635,692,866,452,295,448,404,525,442,543,578,599,588.0,573.0,21,35,-14
805,3,18,2,10,0,495,612,941,427,254,591,556,550,476,504,704,679,692.0,629.0,-25,200,-225
75,4,18,2,10,0,199,341,546,125,89,159,100,115,114,150,110,113,112.0,124.0,3,-40,43
1013,5,18,2,10,0,838,1187,1812,1017,704,1344,1235,1081,1056,878,1050,1236,1143.0,1055.0,186,172,14
1004,6,18,2,10,0,813,952,1669,741,475,869,701,638,694,733,857,812,834.0,801.0,-45,124,-169
3700,7,18,2,10,0,2995,3812,5496,2330,1515,2865,2841,2834,2558,2825,3266,3132,3199.0,3074.0,-134,441,-575
1762,8,18,2,10,0,1126,1234,2626,1165,641,1247,1425,1531,1329,1557,1538,1282,1410.0,1459.0,-256,-19,-237
408,9,18,2,10,0,384,525,1055,368,255,433,540,513,805,467,681,614,648.0,587.0,-67,214,-281
185,10,18,2,10,0,362,355,448,365,155,240,485,249,405,222,128,107,118.0,152.0,-21,-94,73
993,11,18,2,10,0,1310,1728,2261,1167,1028,1507,1281,827,792,892,955,1053,1004.0,967.0,98,63,35
282,12,18,2,10,0,356,946,847,641,223,316,236,253,238,242,217,309,263.0,256.0,92,-25,117
3615,13,18,2,10,0,2586,3058,5478,1932,1551,2981,3513,3250,2524,3284,3386,2904,3145.0,3191.0,-482,102,-584
1924,14,18,2,10,0,1472,1941,3092,1731,893,1695,1504,1408,1487,1714,1721,1597,1659.0,1677.0,-124,7,-131
523,15,18,2,10,0,638,706,1205,504,467,741,598,514,446,578,432,623,528.0,544.0,191,-146,337
208,16,18,2,10,0,272,348,657,298,154,273,222,166,164,170,172,198,185.0,180.0,26,2,24
410,17,18,2,10,0,568,587,1351,576,253,448,437,409,373,484,393,425,409.0,434.0,32,-91,123
251,18,18,2,10,0,307,452,617,215,148,255,232,240,199,231,301,352,326.0,295.0,51,70,-19
982,19,18,2,10,0,572,853,1026,394,408,768,721,776,679,667,892,902,897.0,820.0,10,225,-215
246,20,18,2,10,0,408,379,694,353,248,346,329,249,207,249,199,233,216.0,227.0,34,-50,84
930,21,18,2,10,0,693,804,1400,754,418,791,600,553,553,625,614,777,696.0,672.0,163,-11,174
658,22,18,2,10,0,324,496,710,280,266,503,464,518,466,471,859,943,901.0,758.0,84,388,-304
241,1,19,2,10,0,148,312,359,339,177,321,249,248,328,254,307,237,272.0,266.0,-70,53,-123
355,2,19,2,10,0,344,442,485,409,248,357,375,412,347,430,418,363,390.0,404.0,-55,-12,-43
497,3,19,2,10,0,432,401,434,519,319,522,443,583,484,431,411,444,428.0,429.0,33,-20,53
791,4,19,2,10,0,795,1121,1802,1263,877,1267,1047,1549,1033,967,860,855,858.0,894.0,-5,-107,102
823,5,19,2,10,0,610,732,1083,1390,565,951,827,852,794,845,1009,1048,1028.0,967.0,39,164,-125
552,6,19,2,10,0,440,519,629,667,315,471,534,553,570,581,499,590,544.0,557.0,91,-82,173
1727,7,19,2,10,0,1370,1666,1642,1861,878,1578,1694,1792,1554,1627,1927,1942,1934.0,1832.0,15,300,-285
463,8,19,2,10,0,480,421,414,426,317,451,395,445,395,431,409,455,432.0,432.0,46,-22,68
889,9,19,2,10,0,704,995,1243,727,322,827,693,791,804,769,839,878,858.0,829.0,39,70,-31
217,10,19,2,10,0,159,192,214,225,119,204,139,193,190,168,192,190,191.0,183.0,-2,24,-26
1162,11,19,2,10,0,881,1099,1374,1336,868,1301,1124,1278,1241,1197,1296,1046,1171.0,1180.0,-250,99,-349
301,12,19,2,10,0,237,276,329,364,141,291,237,315,278,285,309,268,288.0,287.0,-41,24,-65
1625,13,19,2,10,0,1052,1461,1615,1768,1165,1697,1805,2074,1714,1806,1864,1750,1807.0,1807.0,-114,58,-172
1582,14,19,2,10,0,1357,1223,1443,1429,856,1325,1403,1419,1413,1478,1579,1504,1542.0,1520.0,-75,101,-176
734,15,19,2,10,0,512,747,863,742,356,707,633,707,646,663,732,701,716.0,699.0,-31,69,-100
501,16,19,2,10,0,374,473,566,558,262,443,396,470,482,493,546,551,548.0,530.0,5,53,-48
410,17,19,2,10,0,248,418,494,519,230,424,383,397,379,387,399,409,404.0,398.0,10,12,-2
431,18,19,2,10,0,285,325,402,404,188,330,251,340,301,284,315,604,460.0,401.0,289,31,258
793,19,19,2,10,0,738,644,1082,704,546,870,783,781,790,785,765,828,796.0,793.0,63,-20,83
373,20,19,2,10,0,251,282,391,433,202,335,319,317,436,335,381,329,355.0,348.0,-52,46,-98
768,21,19,2,10,0,276,346,497,487,257,378,390,460,393,519,500,482,491.0,500.0,-18,-19,1
813,22,19,2,10,0,657,664,964,785,666,1198,1070,1179,970,890,1044,870,957.0,935.0,-174,154,-328
404,1,20,1,10,0,1010,1563,1504,815,447,731,532,612,632,552,602,639,620.0,598.0,37,50,-13
371,2,20,1,10,0,759,692,785,585,277,403,310,422,368,501,439,383,411.0,441.0,-56,-62,6
127,3,20,1,10,0,407,342,430,303,110,229,177,183,153,136,170,141,156.0,149.0,-29,34,-63
206,4,20,1,10,0,740,925,1127,376,284,427,371,462,336,275,270,272,271.0,272.0,2,-5,7
542,5,20,1,10,0,1100,1320,1775,1096,562,764,657,680,772,616,717,828,772.0,720.0,111,101,10
608,6,20,1,10,0,1001,1064,1490,952,364,600,581,589,605,632,685,690,688.0,669.0,5,53,-48
835,7,20,1,10,0,1303,1408,1739,940,501,805,813,957,836,892,940,1047,994.0,960.0,107,48,59
108,8,20,1,10,0,333,332,371,229,113,151,138,130,107,102,135,123,129.0,120.0,-12,33,-45
819,9,20,1,10,0,1463,1644,2216,854,451,986,862,846,947,768,780,800,790.0,783.0,20,12,8
175,10,20,1,10,0,280,255,372,218,114,237,155,197,163,181,169,173,171.0,174.0,4,-12,16
952,11,20,1,10,0,1872,2263,3132,1586,987,1345,1015,1158,1068,1086,1181,1123,1152.0,1130.0,-58,95,-153
423,12,20,1,10,0,798,870,1144,754,284,498,430,503,444,457,461,471,466.0,463.0,10,4,6
499,13,20,1,10,0,883,944,1218,652,442,599,687,716,543,668,679,581,630.0,643.0,-98,11,-109
445,14,20,1,10,0,1021,1121,1578,856,471,700,719,644,669,703,653,571,612.0,642.0,-82,-50,-32
1146,15,20,1,10,0,2323,2703,3371,1749,893,1369,1150,1156,1037,1172,1334,1278,1306.0,1261.0,-56,162,-218
456,16,20,1,10,0,1033,988,1333,941,363,579,523,593,600,621,519,533,526.0,558.0,14,-102,116
494,17,20,1,10,0,973,1081,1561,1003,386,716,610,659,562,594,642,673,658.0,636.0,31,48,-17
360,18,20,1,10,0,853,905,1102,667,370,551,387,534,372,366,372,338,355.0,359.0,-34,6,-40
226,19,20,1,10,0,437,403,555,253,188,258,212,206,203,265,272,248,260.0,262.0,-24,7,-31
200,20,20,1,10,0,428,496,740,452,184,293,290,264,303,274,250,248,249.0,257.0,-2,-24,22
191,21,20,1,10,0,450,479,533,395,223,292,216,328,233,285,238,205,222.0,243.0,-33,-47,14
150,22,20,1,10,0,320,352,428,213,219,281,217,259,239,210,238,179,208.0,209.0,-59,28,-87
687,1,21,2,10,0,450,685,688,275,231,396,369,368,427,353,607,636,622.0,532.0,29,254,-225
776,2,21,2,10,0,687,714,1001,409,321,443,427,437,368,556,556,634,595.0,582.0,78,0,78
829,3,21,2,10,0,650,671,789,370,239,440,455,525,460,522,607,660,634.0,596.0,53,85,-32
493,4,21,2,10,0,1045,1332,1807,402,360,619,496,497,491,482,542,549,546.0,524.0,7,60,-53
2341,5,21,2,10,0,2017,2913,3590,1589,1106,1523,1538,1537,1666,1861,2475,3069,2772.0,2468.0,594,614,-20
1809,6,21,2,10,0,1491,1717,1968,921,593,995,1124,1199,1070,1346,1713,1638,1676.0,1566.0,-75,367,-442
2964,7,21,2,10,0,2547,2776,3299,1329,945,1856,2083,2108,1738,2082,2655,2980,2818.0,2572.0,325,573,-248
915,8,21,2,10,0,813,782,1130,401,261,510,549,610,526,688,866,791,828.0,782.0,-75,178,-253
1712,9,21,2,10,0,1702,2171,2397,475,354,1081,908,1044,1235,994,1368,1488,1428.0,1283.0,120,374,-254
502,10,21,2,10,0,395,493,595,225,179,348,224,290,274,316,397,424,410.0,379.0,27,81,-54
3744,11,21,2,10,0,3228,3579,4302,1623,1477,2234,2129,2434,2155,2485,3088,3158,3123.0,2910.0,70,603,-533
1004,12,21,2,10,0,781,885,1016,398,230,537,551,590,548,652,808,842,825.0,767.0,34,156,-122
4164,13,21,2,10,0,2877,2989,3954,1565,1311,2239,2725,3260,2705,3344,4173,4034,4104.0,3850.0,-139,829,-968
3430,14,21,2,10,0,2358,2638,3291,1489,872,1684,1948,1801,1780,2489,2996,3374,3185.0,2953.0,378,507,-129
3040,15,21,2,10,0,2163,2458,2897,961,793,1491,1417,1453,1417,1645,2472,2753,2612.0,2290.0,281,827,-546
1166,16,21,2,10,0,948,1247,1304,805,357,634,667,656,762,898,966,1182,1074.0,1015.0,216,68,148
998,17,21,2,10,0,757,948,1222,427,264,565,544,561,563,728,991,1080,1036.0,933.0,89,263,-174
859,18,21,2,10,0,837,946,924,385,327,518,415,620,444,541,690,728,709.0,653.0,38,149,-111
1131,19,21,2,10,0,1007,1160,1513,414,423,828,916,847,707,895,1272,1162,1217.0,1110.0,-110,377,-487
585,20,21,2,10,0,407,493,612,296,209,288,300,336,388,329,435,559,497.0,441.0,124,106,18
1108,21,21,2,10,0,945,946,1143,404,239,410,468,587,452,654,835,911,873.0,800.0,76,181,-105
859,22,21,2,10,0,753,1190,1198,462,436,1058,713,772,690,729,1100,842,971.0,890.0,-258,371,-629
810,1,22,4,10,0,633,790,925,325,455,653,555,624,740,612,758,1004,881.0,791.0,246,146,100
338,2,22,4,10,0,431,527,546,194,218,317,270,316,211,290,290,300,295.0,293.0,10,0,10
323,3,22,4,10,0,371,359,418,168,163,287,292,335,266,288,328,334,331.0,317.0,6,40,-34
482,4,22,4,10,0,915,1162,1615,471,523,831,698,714,664,617,559,655,607.0,610.0,96,-58,154
665,5,22,4,10,0,772,961,1167,445,516,738,665,640,630,656,820,1044,932.0,840.0,224,164,60
792,6,22,4,10,0,878,933,1003,374,418,658,653,606,565,618,791,819,805.0,743.0,28,173,-145
2148,7,22,4,10,0,2307,2370,2766,875,984,1739,1860,1899,1420,1615,2002,2507,2254.0,2041.0,505,387,118
274,8,22,4,10,0,320,355,484,139,184,247,243,229,225,247,307,331,319.0,295.0,24,60,-36
876,9,22,4,10,0,1092,1209,1464,402,402,896,629,772,826,680,829,845,837.0,785.0,16,149,-133
224,10,22,4,10,0,259,290,384,118,109,224,157,222,215,154,183,203,193.0,180.0,20,29,-9
2396,11,22,4,10,0,2595,2801,3241,1057,1612,2234,1953,2227,1909,2048,2422,2463,2442.0,2311.0,41,374,-333
370,12,22,4,10,0,498,481,511,213,176,385,307,351,273,345,404,431,418.0,393.0,27,59,-32
1771,13,22,4,10,0,1603,1929,2115,754,885,1533,1690,1813,1571,1661,1916,1901,1908.0,1826.0,-15,255,-270
1347,14,22,4,10,0,1309,1461,1740,591,724,1200,1228,1058,967,1158,1211,1356,1284.0,1242.0,145,53,92
2171,15,22,4,10,0,2033,2127,2662,818,1237,1764,1676,1729,1525,1884,2258,2311,2284.0,2151.0,53,374,-321
493,16,22,4,10,0,603,616,685,305,279,470,356,444,412,438,504,557,530.0,500.0,53,66,-13
413,17,22,4,10,0,501,559,768,256,278,497,347,424,341,409,480,525,502.0,471.0,45,71,-26
428,18,22,4,10,0,473,480,608,216,257,389,262,395,326,356,356,363,360.0,358.0,7,0,7
344,19,22,4,10,0,489,516,595,169,217,412,408,386,321,346,352,385,368.0,361.0,33,6,27
123,20,22,4,10,0,159,216,258,69,99,133,100,129,180,126,116,163,140.0,135.0,47,-10,57
507,21,22,4,10,0,510,487,657,185,238,361,306,395,301,417,437,460,448.0,438.0,23,20,3
314,22,22,4,10,0,443,413,533,157,228,535,404,398,359,345,475,357,416.0,392.0,-118,130,-248
27,1,23,1,10,0,104,114,215,76,41,45,61,38,52,37,39,38,38.0,38.0,-1,2,-3
52,2,23,1,10,0,139,121,182,95,41,34,36,31,58,44,55,41,48.0,47.0,-14,11,-25
66,3,23,1,10,0,108,174,205,99,66,95,76,72,76,74,85,79,82.0,79.0,-6,11,-17
40,4,23,1,10,0,161,243,439,74,40,54,53,41,27,32,51,39,45.0,41.0,-12,19,-31
129,5,23,1,10,0,291,297,513,309,153,136,133,149,150,134,136,183,160.0,151.0,47,2,45
358,6,23,1,10,0,600,692,1047,578,273,312,307,331,314,279,347,395,371.0,340.0,48,68,-20
646,7,23,1,10,0,1097,1099,1844,902,381,538,572,675,544,536,649,690,670.0,625.0,41,113,-72
271,8,23,1,10,0,277,308,545,238,158,237,226,236,217,178,237,265,251.0,227.0,28,59,-31
114,9,23,1,10,0,277,289,373,126,71,118,103,101,96,92,121,141,131.0,118.0,20,29,-9
61,10,23,1,10,0,100,115,162,93,53,69,35,53,40,48,50,56,53.0,51.0,6,2,4
225,11,23,1,10,0,406,397,621,300,168,197,206,183,203,185,213,207,210.0,202.0,-6,28,-34
62,12,23,1,10,0,164,143,266,151,36,61,68,60,40,53,57,59,58.0,56.0,2,4,-2
517,13,23,1,10,0,699,808,1460,748,389,430,459,518,401,452,524,544,534.0,507.0,20,72,-52
354,14,23,1,10,0,471,617,1100,524,174,251,240,290,254,290,316,303,310.0,303.0,-13,26,-39
78,15,23,1,10,0,211,191,260,101,55,63,66,67,90,77,72,74,73.0,74.0,2,-5,7
178,16,23,1,10,0,324,313,534,275,79,103,125,96,138,125,127,182,154.0,145.0,55,2,53
159,17,23,1,10,0,286,335,535,308,119,163,126,142,139,138,161,166,164.0,155.0,5,23,-18
34,18,23,1,10,0,89,87,129,60,25,51,31,35,42,33,28,56,42.0,39.0,28,-5,33
119,19,23,1,10,0,278,265,371,149,91,133,121,130,132,148,200,180,190.0,176.0,-20,52,-72
68,20,23,1,10,0,189,199,335,168,84,69,66,80,88,67,79,85,82.0,77.0,6,12,-6
130,21,23,1,10,0,197,186,360,209,62,83,76,106,84,83,85,110,98.0,93.0,25,2,23
70,22,23,1,10,0,169,223,312,126,95,154,101,143,86,105,123,132,128.0,120.0,9,18,-9
627,1,24,2,10,0,489,558,362,679,494,731,600,672,772,704,727,654,690.0,695.0,-73,23,-96
213,2,24,2,10,0,174,160,155,229,130,223,186,188,194,250,267,174,220.0,230.0,-93,17,-110
79,3,24,2,10,0,99,82,59,106,63,136,99,113,83,99,112,92,102.0,101.0,-20,13,-33
544,4,24,2,10,0,642,654,521,798,532,838,575,694,618,670,630,659,644.0,653.0,29,-40,69
629,5,24,2,10,0,471,430,474,703,394,653,524,606,614,549,576,507,542.0,544.0,-69,27,-96
325,6,24,2,10,0,248,228,187,338,203,372,311,341,346,340,353,335,344.0,343.0,-18,13,-31
504,7,24,2,10,0,474,421,353,610,362,607,527,608,548,531,526,473,500.0,510.0,-53,-5,-48
114,8,24,2,10,0,105,117,105,129,94,160,139,138,152,130,124,119,122.0,124.0,-5,-6,1
1178,9,24,2,10,0,1049,976,1007,1207,847,1361,1093,1267,1219,1095,1304,1161,1232.0,1187.0,-143,209,-352
149,10,24,2,10,0,126,138,119,159,102,172,121,154,153,137,153,146,150.0,145.0,-7,16,-23
1428,11,24,2,10,0,1270,1186,1077,1735,1066,1713,1523,1554,1639,1493,1583,1338,1460.0,1471.0,-245,90,-335
199,12,24,2,10,0,164,154,152,242,146,291,216,232,253,206,215,224,220.0,215.0,9,9,0
325,13,24,2,10,0,307,254,182,340,242,360,379,362,327,372,362,376,369.0,370.0,14,-10,24
310,14,24,2,10,0,239,284,223,320,199,311,289,319,320,350,407,332,370.0,363.0,-75,57,-132
1401,15,24,2,10,0,1239,1136,1024,1529,973,1602,1326,1507,1501,1473,1537,1190,1364.0,1400.0,-347,64,-411
311,16,24,2,10,0,272,273,274,370,238,369,296,339,369,331,321,338,330.0,330.0,17,-10,27
270,17,24,2,10,0,213,205,215,305,186,346,275,278,289,275,275,299,287.0,283.0,24,0,24
401,18,24,2,10,0,353,321,324,518,242,572,350,498,528,403,477,413,445.0,431.0,-64,74,-138
226,19,24,2,10,0,229,207,174,292,205,321,225,242,252,295,316,266,291.0,292.0,-50,21,-71
261,20,24,2,10,0,197,217,217,267,199,277,240,244,232,258,263,190,226.0,237.0,-73,5,-78
232,21,24,2,10,0,263,205,197,285,151,281,203,248,250,270,252,210,231.0,244.0,-42,-18,-24
79,22,24,2,10,0,81,63,53,93,68,133,85,82,113,113,134,92,113.0,113.0,-42,21,-63
307,1,25,1,10,0,281,247,225,315,160,297,263,287,314,230,299,290,294.0,273.0,-9,69,-78
139,2,25,1,10,0,167,133,176,164,108,164,133,153,126,180,169,187,178.0,179.0,18,-11,29
85,3,25,1,10,0,96,85,86,86,62,103,111,102,97,88,89,103,96.0,93.0,14,1,13
227,4,25,1,10,0,308,324,417,323,190,356,270,290,257,234,246,289,268.0,256.0,43,12,31
298,5,25,1,10,0,305,301,337,483,166,411,313,351,316,288,271,389,330.0,316.0,118,-17,135
180,6,25,1,10,0,162,169,174,188,119,173,183,210,172,186,222,219,220.0,209.0,-3,36,-39
281,7,25,1,10,0,265,227,253,339,160,306,297,331,234,253,292,332,312.0,292.0,40,39,1
75,8,25,1,10,0,83,81,91,111,56,97,101,97,84,91,94,102,98.0,96.0,8,3,5
502,9,25,1,10,0,462,510,512,581,314,531,409,540,562,422,478,505,492.0,468.0,27,56,-29
94,10,25,1,10,0,102,103,109,128,57,103,59,104,114,85,94,92,93.0,90.0,-2,9,-11
673,11,25,1,10,0,642,661,734,807,456,741,678,793,643,655,701,797,749.0,718.0,96,46,50
158,12,25,1,10,0,115,129,138,165,79,158,126,152,118,104,127,138,132.0,123.0,11,23,-12
198,13,25,1,10,0,184,180,178,203,126,201,195,251,175,165,222,247,234.0,211.0,25,57,-32
183,14,25,1,10,0,161,189,173,186,103,191,191,194,156,186,216,215,216.0,206.0,-1,30,-31
681,15,25,1,10,0,587,599,595,656,382,738,625,720,647,584,732,718,725.0,678.0,-14,148,-162
216,16,25,1,10,0,219,258,266,270,142,257,214,255,256,231,241,262,252.0,245.0,21,10,11
168,17,25,1,10,0,160,168,191,210,114,205,161,191,162,167,198,213,206.0,193.0,15,31,-16
226,18,25,1,10,0,202,201,205,241,127,267,183,283,239,197,201,237,219.0,212.0,36,4,32
114,19,25,1,10,0,130,138,128,140,90,113,125,138,146,129,145,130,138.0,135.0,-15,16,-31
134,20,25,1,10,0,123,106,134,131,54,117,102,136,130,124,110,144,127.0,126.0,34,-14,48
149,21,25,1,10,0,172,135,145,159,85,142,119,156,144,123,140,138,139.0,134.0,-2,17,-19
56,22,25,1,10,0,50,53,61,68,34,78,65,79,70,61,83,81,82.0,75.0,-2,22,-24
524,1,26,1,10,0,428,493,474,835,424,592,562,626,644,634,694,593,644.0,640.0,-101,60,-161
175,2,26,1,10,0,204,210,215,310,178,234,223,203,223,258,250,238,244.0,249.0,-12,-8,-4
107,3,26,1,10,0,72,82,74,139,87,116,104,125,105,116,128,105,116.0,116.0,-23,12,-35
607,4,26,1,10,0,604,747,817,1033,648,841,763,792,726,727,824,751,788.0,767.0,-73,97,-170
366,5,26,1,10,0,382,361,382,695,383,524,456,456,507,479,440,615,528.0,511.0,175,-39,214
231,6,26,1,10,0,183,176,177,354,152,225,259,222,223,254,259,255,257.0,256.0,-4,5,-9
361,7,26,1,10,0,338,348,336,608,328,530,488,475,451,429,468,468,468.0,455.0,0,39,-39
125,8,26,1,10,0,84,93,100,165,96,130,118,97,142,140,152,138,145.0,143.0,-14,12,-26
990,9,26,1,10,0,627,766,825,1178,690,1101,964,1020,962,1084,1109,1111,1110.0,1101.0,2,25,-23
137,10,26,1,10,0,72,100,114,160,106,163,133,138,136,134,129,148,138.0,137.0,19,-5,24
891,11,26,1,10,0,791,915,1007,1591,766,1115,1026,1072,1033,982,1080,1012,1046.0,1025.0,-68,98,-166
164,12,26,1,10,0,101,129,108,227,115,167,214,182,168,165,197,175,186.0,179.0,-22,32,-54
239,13,26,1,10,0,202,203,219,376,209,316,289,290,301,301,298,260,279.0,286.0,-38,-3,-35
268,14,26,1,10,0,194,283,262,357,201,287,304,275,256,289,287,329,308.0,302.0,42,-2,44
896,15,26,1,10,0,733,849,908,1436,623,970,967,965,954,954,1063,930,996.0,982.0,-133,109,-242
336,16,26,1,10,0,230,315,356,436,202,366,316,282,393,360,384,379,382.0,374.0,-5,24,-29
213,17,26,1,10,0,143,174,192,302,179,246,255,226,219,246,249,252,250.0,249.0,3,3,0
323,18,26,1,10,0,197,227,256,500,212,338,297,357,330,288,330,361,346.0,326.0,31,42,-11
233,19,26,1,10,0,176,194,227,304,176,286,261,241,263,276,299,268,284.0,281.0,-31,23,-54
169,20,26,1,10,0,151,174,194,265,152,205,197,174,223,187,198,223,210.0,203.0,25,11,14
202,21,26,1,10,0,210,194,216,307,140,222,205,251,252,248,224,226,225.0,233.0,2,-24,26
77,22,26,1,10,0,74,83,85,102,84,125,116,121,127,86,123,92,108.0,100.0,-31,37,-68
219,1,27,4,10,0,188,201,262,80,97,160,113,154,142,142,182,210,196.0,178.0,28,40,-12
61,2,27,4,10,0,76,100,59,26,35,34,50,78,51,74,46,58,52.0,59.0,12,-28,40
23,3,27,4,10,0,42,40,37,22,17,26,37,25,21,17,27,25,26.0,23.0,-2,10,-12
169,4,27,4,10,0,200,230,226,93,117,153,137,139,94,88,112,163,138.0,121.0,51,24,27
125,5,27,4,10,0,166,240,223,57,76,90,137,164,128,144,184,277,230.0,202.0,93,40,53
113,6,27,4,10,0,110,130,121,57,59,72,81,74,76,100,108,95,102.0,101.0,-13,8,-21
232,7,27,4,10,0,215,231,199,113,137,218,152,167,149,160,180,268,224.0,203.0,88,20,68
36,8,27,4,10,0,31,28,33,16,10,28,22,76,22,26,27,34,30.0,29.0,7,1,6
206,9,27,4,10,0,309,396,384,120,115,231,223,244,188,202,225,232,228.0,220.0,7,23,-16
32,10,27,4,10,0,34,41,40,20,18,18,25,33,31,30,38,53,46.0,40.0,15,8,7
487,11,27,4,10,0,420,635,591,225,325,414,342,390,329,340,426,503,464.0,423.0,77,86,-9
43,12,27,4,10,0,52,66,85,10,18,37,40,39,37,38,50,58,54.0,49.0,8,12,-4
156,13,27,4,10,0,141,166,161,78,99,131,131,102,71,97,118,127,122.0,114.0,9,21,-12
128,14,27,4,10,0,117,128,163,57,77,90,88,75,84,92,121,128,124.0,114.0,7,29,-22
426,15,27,4,10,0,422,523,567,168,290,344,386,300,355,415,511,575,543.0,500.0,64,96,-32
77,16,27,4,10,0,92,120,142,48,54,76,88,66,69,75,103,111,107.0,96.0,8,28,-20
69,17,27,4,10,0,79,112,124,41,43,61,74,75,46,72,85,92,88.0,83.0,7,13,-6
54,18,27,4,10,0,85,108,127,23,28,50,51,59,58,62,64,70,67.0,65.0,6,2,4
57,19,27,4,10,0,77,106,83,28,38,67,45,65,40,54,75,89,82.0,73.0,14,21,-7
32,20,27,4,10,0,43,77,67,17,20,19,34,34,37,30,40,56,48.0,42.0,16,10,6
83,21,27,4,10,0,83,68,82,41,52,48,66,99,56,51,90,75,82.0,72.0,-15,39,-54
25,22,27,4,10,0,40,48,45,18,18,48,30,46,28,19,30,30,30.0,26.0,0,11,-11
487,1,28,2,10,0,129,306,492,378,283,374,311,427,498,475,609,825,717.0,636.0,216,134,82
213,2,28,2,10,0,75,142,154,140,101,145,149,178,192,272,277,259,268.0,269.0,-18,5,-23
176,3,28,2,10,0,48,67,109,121,79,109,124,169,140,135,176,185,180.0,165.0,9,41,-32
557,4,28,2,10,0,175,311,576,511,299,438,522,580,543,591,697,730,714.0,673.0,33,106,-73
541,5,28,2,10,0,206,340,526,495,291,361,444,497,529,571,643,1038,840.0,751.0,395,72,323
402,6,28,2,10,0,111,219,307,304,148,259,319,271,331,363,453,565,509.0,460.0,112,90,22
568,7,28,2,10,0,241,312,378,406,284,400,479,557,520,550,741,941,841.0,744.0,200,191,9
168,8,28,2,10,0,46,58,83,94,61,99,97,93,99,121,177,185,181.0,161.0,8,56,-48
934,9,28,2,10,0,282,593,912,598,355,607,642,701,764,756,899,1094,996.0,916.0,195,143,52
129,10,28,2,10,0,30,50,68,74,33,77,72,113,104,139,145,158,152.0,147.0,13,6,7
1253,11,28,2,10,0,351,609,1028,993,652,891,910,1046,1085,1159,1451,1727,1589.0,1446.0,276,292,-16
206,12,28,2,10,0,59,107,208,200,69,151,150,175,152,209,258,344,301.0,270.0,86,49,37
455,13,28,2,10,0,141,298,340,342,250,323,382,440,423,438,563,630,596.0,544.0,67,125,-58
422,14,28,2,10,0,136,170,239,290,184,293,341,325,356,405,492,560,526.0,486.0,68,87,-19
1479,15,28,2,10,0,498,965,1300,996,708,969,1088,1209,1284,1524,1958,2180,2069.0,1887.0,222,434,-212
371,16,28,2,10,0,101,212,331,334,134,250,279,305,303,339,437,473,455.0,416.0,36,98,-62
339,17,28,2,10,0,92,180,310,284,146,251,271,354,267,331,429,484,456.0,415.0,55,98,-43
274,18,28,2,10,0,95,138,176,229,97,153,164,270,221,253,308,353,330.0,305.0,45,55,-10
397,19,28,2,10,0,157,189,261,256,190,274,317,341,370,440,648,531,590.0,540.0,-117,208,-325
142,20,28,2,10,0,35,76,157,115,82,120,97,175,209,162,190,256,223.0,203.0,66,28,38
357,21,28,2,10,0,96,127,205,223,136,166,239,247,199,284,366,387,376.0,346.0,21,82,-61
129,22,28,2,10,0,56,108,145,104,92,153,138,145,157,161,240,210,225.0,204.0,-30,79,-109
434,1,29,1,10,0,298,341,507,266,214,347,256,335,387,323,471,449,460.0,414.0,-22,148,-170
158,2,29,1,10,0,180,169,225,142,99,142,158,164,176,231,206,157,182.0,198.0,-49,-25,-24
179,3,29,1,10,0,157,121,169,76,74,105,133,145,136,151,168,178,173.0,166.0,10,17,-7
267,4,29,1,10,0,355,417,450,177,170,259,234,290,279,265,274,353,314.0,297.0,79,9,70
393,5,29,1,10,0,403,433,394,242,224,324,333,361,319,358,452,596,524.0,469.0,144,94,50
290,6,29,1,10,0,172,256,310,160,139,211,231,217,227,254,298,323,310.0,292.0,25,44,-19
509,7,29,1,10,0,453,469,507,305,251,332,402,428,398,413,574,597,586.0,528.0,23,161,-138
150,8,29,1,10,0,117,124,97,55,43,101,86,111,100,106,169,173,171.0,149.0,4,63,-59
776,9,29,1,10,0,710,821,895,435,271,630,599,641,694,710,772,788,780.0,757.0,16,62,-46
143,10,29,1,10,0,85,114,124,79,66,108,95,119,99,124,137,118,128.0,126.0,-19,13,-32
1157,11,29,1,10,0,688,937,1154,552,589,835,807,903,879,877,1098,1019,1058.0,998.0,-79,221,-300
235,12,29,1,10,0,186,189,178,106,91,145,142,176,146,152,202,227,214.0,194.0,25,50,-25
402,13,29,1,10,0,324,327,378,179,188,251,302,319,290,307,411,362,386.0,360.0,-49,104,-153
286,14,29,1,10,0,237,276,308,156,143,260,258,238,212,252,290,348,319.0,297.0,58,38,20
1216,15,29,1,10,0,917,1072,1169,550,543,759,841,892,995,1035,1285,1388,1336.0,1236.0,103,250,-147
443,16,29,1,10,0,270,308,378,261,177,285,262,281,264,324,372,438,405.0,378.0,66,48,18
299,17,29,1,10,0,193,226,309,145,129,251,238,285,222,261,332,310,321.0,301.0,-22,71,-93
305,18,29,1,10,0,253,214,293,168,110,183,202,270,233,236,280,255,268.0,257.0,-25,44,-69
143,19,29,1,10,0,174,177,213,86,85,121,151,164,140,139,209,233,221.0,194.0,24,70,-46
114,20,29,1,10,0,96,89,130,65,59,92,68,101,131,82,96,144,120.0,107.0,48,14,34
226,21,29,1,10,0,165,164,174,112,81,131,150,180,137,151,189,198,194.0,179.0,9,38,-29
82,22,29,1,10,0,82,95,85,44,40,74,82,95,78,104,128,90,109.0,107.0,-38,24,-62
391,1,30,1,10,0,402,593,748,538,251,456,315,445,485,411,558,671,614.0,547.0,113,147,-34
261,2,30,1,10,0,316,323,344,263,166,191,198,263,290,341,252,328,290.0,307.0,76,-89,165
149,3,30,1,10,0,207,206,200,197,109,152,165,213,178,177,172,194,183.0,181.0,22,-5,27
743,4,30,1,10,0,715,939,1050,755,424,693,651,781,754,805,949,920,934.0,891.0,-29,144,-173
435,5,30,1,10,0,583,560,641,624,348,443,468,502,547,611,673,959,816.0,748.0,286,62,224
291,6,30,1,10,0,282,331,409,330,200,229,256,264,317,284,317,394,356.0,332.0,77,33,44
491,7,30,1,10,0,438,630,646,659,309,458,540,534,523,541,632,768,700.0,647.0,136,91,45
129,8,30,1,10,0,139,142,103,120,44,90,120,136,128,136,187,160,174.0,161.0,-27,51,-78
1221,9,30,1,10,0,1295,1408,1829,1269,499,1006,894,1099,1203,1068,1323,1501,1412.0,1297.0,178,255,-77
169,10,30,1,10,0,162,142,255,213,82,152,117,156,149,174,198,193,196.0,188.0,-5,24,-29
983,11,30,1,10,0,1040,1108,1430,1304,649,954,933,1003,955,1112,1268,1354,1311.0,1245.0,86,156,-70
219,12,30,1,10,0,218,275,247,282,85,186,198,229,203,249,256,341,298.0,282.0,85,7,78
398,13,30,1,10,0,407,417,527,425,254,337,412,434,405,458,546,548,547.0,517.0,2,88,-86
339,14,30,1,10,0,405,382,502,442,251,354,426,325,372,375,398,412,405.0,395.0,14,23,-9
1157,15,30,1,10,0,932,1214,1500,938,567,836,888,1017,1178,1317,1460,1660,1560.0,1479.0,200,143,57
382,16,30,1,10,0,447,473,526,572,259,428,363,377,445,438,468,503,486.0,470.0,35,30,5
359,17,30,1,10,0,369,391,505,374,207,342,370,431,366,451,421,470,446.0,447.0,49,-30,79
276,18,30,1,10,0,298,320,358,335,144,206,194,282,238,262,319,348,334.0,310.0,29,57,-28
306,19,30,1,10,0,357,335,454,281,156,268,293,330,277,371,482,484,483.0,446.0,2,111,-109
164,20,30,1,10,0,188,209,244,199,108,153,121,186,284,146,224,267,246.0,212.0,43,78,-35
274,21,30,1,10,0,366,242,346,325,174,210,225,299,236,330,298,331,314.0,320.0,33,-32,65
95,22,30,1,10,0,123,190,198,139,94,144,137,133,149,128,210,136,173.0,158.0,-74,82,-156
503,1,31,2,10,0,357,513,576,543,384,696,487,649,633,685,664,518,591.0,622.0,-146,-21,-125
166,2,31,2,10,0,117,236,257,243,199,312,234,314,249,292,267,233,250.0,264.0,-34,-25,-9
58,3,31,2,10,0,37,60,80,54,43,84,76,64,93,74,68,76,72.0,73.0,8,-6,14
411,4,31,2,10,0,328,585,816,536,311,688,527,617,587,668,640,578,609.0,629.0,-62,-28,-34
365,5,31,2,10,0,290,447,593,591,337,640,478,571,603,551,645,659,652.0,618.0,14,94,-80
336,6,31,2,10,0,233,275,385,322,230,435,350,391,362,386,364,400,382.0,383.0,36,-22,58
332,7,31,2,10,0,285,401,440,468,289,622,538,593,498,535,586,540,563.0,554.0,-46,51,-97
72,8,31,2,10,0,30,61,103,57,64,78,79,91,70,76,114,91,102.0,94.0,-23,38,-61
1116,9,31,2,10,0,773,983,1319,1274,618,1449,1061,1394,1469,1265,1360,1372,1366.0,1332.0,12,95,-83
125,10,31,2,10,0,94,126,167,115,84,164,123,176,156,157,172,190,181.0,173.0,18,15,3
894,11,31,2,10,0,862,988,1160,1203,919,1681,1193,1428,1269,1375,1458,1073,1266.0,1302.0,-385,83,-468
138,12,31,2,10,0,96,129,200,185,89,224,198,224,201,206,230,203,216.0,213.0,-27,24,-51
277,13,31,2,10,0,192,281,283,417,232,460,496,484,423,463,437,409,423.0,436.0,-28,-26,-2
275,14,31,2,10,0,174,237,350,258,224,388,425,429,397,410,418,393,406.0,407.0,-25,8,-33
1310,15,31,2,10,0,929,1465,1724,1540,1004,2273,1596,1876,1650,1852,1906,1579,1742.0,1779.0,-327,54,-381
242,16,31,2,10,0,144,218,283,271,143,325,266,300,353,314,383,331,357.0,343.0,-52,69,-121
243,17,31,2,10,0,203,255,374,375,195,380,321,402,363,372,409,397,403.0,393.0,-12,37,-49
305,18,31,2,10,0,214,251,346,352,161,369,304,419,307,353,366,384,375.0,368.0,18,13,5
189,19,31,2,10,0,91,159,186,215,146,225,256,285,240,260,305,212,258.0,259.0,-93,45,-138
164,20,31,2,10,0,105,200,253,198,131,290,195,274,315,277,268,213,240.0,253.0,-55,-9,-46
188,21,31,2,10,0,132,134,174,188,135,235,193,286,212,215,219,199,209.0,211.0,-20,4,-24
44,22,31,2,10,0,28,58,76,70,44,104,104,97,90,78,104,69,86.0,84.0,-35,26,-61
157,1,32,3,10,0,299,501,825,333,136,253,217,192,208,169,209,261,235.0,213.0,52,40,12
817,2,32,3,10,0,926,928,1393,1050,634,598,559,552,559,568,496,633,564.0,566.0,137,-72,209
188,3,32,3,10,0,230,272,405,185,132,207,141,156,128,146,189,194,192.0,176.0,5,43,-38
84,4,32,3,10,0,330,446,852,178,127,199,127,128,132,116,105,91,98.0,104.0,-14,-11,-3
394,5,32,3,10,0,792,934,1509,1063,565,512,413,385,387,456,447,479,463.0,461.0,32,-9,41
1004,6,32,3,10,0,1263,1461,2601,1965,1072,936,771,749,842,897,904,1032,968.0,944.0,128,7,121
2072,7,32,3,10,0,2975,3077,5360,2858,1598,1729,1694,1756,1539,1936,1912,2146,2029.0,1998.0,234,-24,258
537,8,32,3,10,0,791,803,1442,701,396,447,437,462,390,470,484,542,513.0,499.0,58,14,44
3213,9,32,3,10,0,5032,5800,8421,3465,1872,3263,2465,2754,2779,2551,2831,3372,3102.0,2918.0,541,280,261
1953,10,32,3,10,0,3025,3479,6171,2981,1510,1845,1206,1444,1326,1376,2120,1771,1946.0,1756.0,-349,744,-1093
1551,11,32,3,10,0,1978,2153,3757,2028,1542,1465,1325,1301,1251,1387,1382,1410,1396.0,1393.0,28,-5,33
502,12,32,3,10,0,703,736,1319,827,443,434,359,341,393,389,426,463,444.0,426.0,37,37,0
1339,13,32,3,10,0,1500,1789,2863,1366,1047,1021,1146,1168,1072,1294,1269,1276,1272.0,1280.0,7,-25,32
3382,14,32,3,10,0,4700,5194,9539,6024,2842,2528,2423,2523,2603,3162,2973,3080,3026.0,3072.0,107,-189,296
995,15,32,3,10,0,1528,1653,2646,934,580,745,680,733,621,813,822,894,858.0,843.0,72,9,63
540,16,32,3,10,0,696,982,1629,1137,521,524,406,468,397,454,447,595,521.0,499.0,148,-7,155
856,17,32,3,10,0,1234,1513,2352,1658,771,808,663,615,657,743,779,889,834.0,804.0,110,36,74
355,18,32,3,10,0,724,738,1086,453,316,456,314,359,319,319,322,371,346.0,337.0,49,3,46
500,19,32,3,10,0,644,694,1039,408,313,505,468,482,534,500,483,512,498.0,498.0,29,-17,46
141,20,32,3,10,0,279,304,514,324,210,169,172,136,158,183,160,169,164.0,171.0,9,-23,32
679,21,32,3,10,0,855,1045,1704,937,403,499,452,488,436,535,576,634,605.0,582.0,58,41,17
428,22,32,3,10,0,638,832,1045,394,365,562,482,469,565,521,543,559,551.0,541.0,16,22,-6
537,1,33,2,10,0,1032,1283,1483,389,338,505,521,647,608,619,726,770,748.0,705.0,44,107,-63
248,2,33,2,10,0,396,360,567,208,160,208,214,226,198,297,263,248,256.0,269.0,-15,-34,19
413,3,33,2,10,0,648,698,789,413,215,340,311,387,355,326,370,370,370.0,355.0,0,44,-44
53,4,33,2,10,0,276,389,488,143,102,126,84,102,87,71,101,86,94.0,86.0,-15,30,-45
558,5,33,2,10,0,786,820,1117,531,374,577,521,559,581,527,664,831,748.0,674.0,167,137,30
450,6,33,2,10,0,594,615,705,385,198,241,246,257,285,305,420,360,390.0,362.0,-60,115,-175
1154,7,33,2,10,0,1435,1352,1707,803,424,738,843,928,824,912,1138,1251,1194.0,1100.0,113,226,-113
267,8,33,2,10,0,347,352,464,131,87,174,169,231,178,188,345,260,302.0,264.0,-85,157,-242
211,9,33,2,10,0,342,407,475,130,117,221,195,239,246,184,249,327,288.0,253.0,78,65,13
105,10,33,2,10,0,167,158,231,93,43,77,54,89,79,95,76,109,92.0,93.0,33,-19,52
1434,11,33,2,10,0,1880,1868,2181,991,782,1094,1007,1280,1090,1058,1318,1361,1340.0,1246.0,43,260,-217
328,12,33,2,10,0,430,438,495,251,128,183,180,217,188,232,281,331,306.0,281.0,50,49,1
645,13,33,2,10,0,782,978,1229,546,360,592,598,847,611,670,860,765,812.0,765.0,-95,190,-285
697,14,33,2,10,0,750,835,1053,508,259,492,410,471,586,659,755,577,666.0,664.0,-178,96,-274
755,15,33,2,10,0,884,1063,1213,348,291,556,450,632,576,610,714,681,698.0,668.0,-33,104,-137
222,16,33,2,10,0,336,358,440,200,80,136,138,174,236,210,228,238,233.0,225.0,10,18,-8
369,17,33,2,10,0,528,670,749,385,150,254,224,307,284,328,398,464,431.0,397.0,66,70,-4
280,18,33,2,10,0,302,385,408,188,136,178,176,297,240,200,252,252,252.0,235.0,0,52,-52
80,19,33,2,10,0,156,195,210,53,54,81,84,109,71,94,144,110,127.0,116.0,-34,50,-84
97,20,33,2,10,0,178,181,295,131,85,113,117,117,161,107,136,118,127.0,120.0,-18,29,-47
958,21,33,2,10,0,958,1012,1286,412,280,531,610,649,548,736,763,674,718.0,724.0,-89,27,-116
123,22,33,2,10,0,202,210,228,66,80,160,104,150,105,113,153,106,130.0,124.0,-47,40,-87
271,1,34,2,10,0,337,524,679,950,175,263,226,214,231,1376,364,429,396.0,723.0,65,-1012,1077
170,2,34,2,10,0,173,215,293,131,118,135,108,106,85,183,133,193,163.0,170.0,60,-50,110
84,3,34,2,10,0,94,102,118,60,38,63,48,62,45,54,52,67,60.0,58.0,15,-2,17
105,4,34,2,10,0,166,231,280,180,87,167,105,117,108,135,120,201,160.0,152.0,81,-15,96
151,5,34,2,10,0,226,291,404,151,140,210,163,126,156,158,240,401,320.0,266.0,161,82,79
131,6,34,2,10,0,127,176,201,116,64,85,74,80,96,91,141,190,166.0,141.0,49,50,-1
311,7,34,2,10,0,274,383,451,230,146,276,296,237,243,266,313,411,362.0,330.0,98,47,51
54,8,34,2,10,0,75,85,95,42,23,68,34,43,37,45,67,94,80.0,69.0,27,22,5
132,9,34,2,10,0,175,225,268,104,54,144,101,111,106,100,115,132,124.0,116.0,17,15,2
32,10,34,2,10,0,39,42,71,30,28,32,17,42,31,35,34,44,39.0,38.0,10,-1,11
405,11,34,2,10,0,501,644,669,334,279,388,278,361,289,335,427,537,482.0,433.0,110,92,18
53,12,34,2,10,0,83,104,86,64,32,40,53,58,44,58,62,97,80.0,72.0,35,4,31
202,13,34,2,10,0,192,206,272,140,97,162,151,190,159,151,222,288,255.0,220.0,66,71,-5
177,14,34,2,10,0,169,219,319,144,90,156,142,133,159,150,253,275,264.0,226.0,22,103,-81
223,15,34,2,10,0,289,400,452,190,120,235,179,236,184,200,265,399,332.0,288.0,134,65,69
64,16,34,2,10,0,47,81,82,146,33,61,41,44,47,128,75,99,87.0,101.0,24,-53,77
127,17,34,2,10,0,115,135,228,105,59,115,89,71,92,97,142,167,154.0,135.0,25,45,-20
95,18,34,2,10,0,107,132,139,77,43,64,62,76,55,207,71,81,76.0,120.0,10,-136,146
41,19,34,2,10,0,52,62,81,42,40,28,19,48,46,42,41,57,49.0,47.0,16,-1,17
76,20,34,2,10,0,46,77,87,44,31,56,52,34,81,74,75,97,86.0,82.0,22,1,21
131,21,34,2,10,0,170,201,238,124,83,169,151,120,99,145,151,182,166.0,159.0,31,6,25
36,22,34,2,10,0,45,56,48,22,17,60,50,40,34,50,39,45,42.0,45.0,6,-11,17
178,1,35,2,10,0,129,206,317,238,124,175,178,198,247,172,229,295,262.0,232.0,66,57,9
71,2,35,2,10,0,68,61,94,64,55,50,58,59,74,82,64,64,64.0,70.0,0,-18,18
119,3,35,2,10,0,69,77,114,119,58,88,84,113,93,124,126,127,126.0,126.0,1,2,-1
464,4,35,2,10,0,411,466,954,488,303,463,422,404,405,524,536,639,588.0,566.0,103,12,91
437,5,35,2,10,0,219,270,560,493,212,308,310,321,356,354,476,541,508.0,457.0,65,122,-57
225,6,35,2,10,0,131,164,192,238,108,126,152,161,181,221,244,275,260.0,247.0,31,23,8
828,7,35,2,10,0,391,462,714,609,352,736,802,743,732,752,968,895,932.0,872.0,-73,216,-289
218,8,35,2,10,0,104,152,230,168,75,152,133,162,155,176,214,192,203.0,194.0,-22,38,-60
2393,9,35,2,10,0,887,1988,1893,1283,554,1157,1342,1371,1506,1365,1632,2543,2088.0,1847.0,911,267,644
302,10,35,2,10,0,167,204,333,316,132,218,179,232,209,214,240,299,270.0,251.0,59,26,33
890,11,35,2,10,0,489,602,865,785,520,701,575,790,696,727,808,884,846.0,806.0,76,81,-5
263,12,35,2,10,0,168,194,280,264,100,195,178,199,185,190,228,334,281.0,251.0,106,38,68
446,13,35,2,10,0,275,250,454,387,248,489,372,444,470,561,546,540,543.0,549.0,-6,-15,9
278,14,35,2,10,0,168,191,300,319,141,195,250,224,252,313,287,373,330.0,324.0,86,-26,112
766,15,35,2,10,0,572,795,787,577,391,567,562,623,668,663,739,794,766.0,732.0,55,76,-21
520,16,35,2,10,0,394,374,566,545,193,390,310,389,475,504,667,583,625.0,585.0,-84,163,-247
391,17,35,2,10,0,203,423,412,412,410,531,262,352,341,399,402,522,462.0,441.0,120,3,117
659,18,35,2,10,0,397,363,562,555,242,485,658,692,517,589,652,643,648.0,628.0,-9,63,-72
250,19,35,2,10,0,239,228,340,230,163,328,229,232,286,261,346,342,344.0,316.0,-4,85,-89
273,20,35,2,10,0,158,348,846,378,203,261,239,256,499,348,265,359,312.0,324.0,94,-83,177
183,21,35,2,10,0,62,99,126,138,68,103,103,121,139,167,222,209,216.0,199.0,-13,55,-68
86,22,35,2,10,0,46,89,107,57,72,88,195,88,95,117,126,705,416.0,316.0,579,9,570
189,1,36,1,10,0,222,276,374,264,140,173,111,133,219,252,305,253,279.0,270.0,-52,53,-105
342,2,36,1,10,0,420,444,423,403,246,278,240,349,251,370,328,322,325.0,340.0,-6,-42,36
520,3,36,1,10,0,608,505,619,534,251,398,363,397,446,439,554,594,574.0,529.0,40,115,-75
555,4,36,1,10,0,845,1016,1441,741,459,672,521,645,648,738,710,716,713.0,721.0,6,-28,34
787,5,36,1,10,0,712,743,1078,940,507,616,610,516,696,747,853,964,908.0,855.0,111,106,5
256,6,36,1,10,0,217,212,273,247,107,152,149,170,178,202,240,274,257.0,239.0,34,38,-4
906,7,36,1,10,0,764,681,1011,688,350,548,657,631,628,667,792,970,881.0,810.0,178,125,53
407,8,36,1,10,0,280,288,348,274,115,219,218,272,224,246,326,337,332.0,303.0,11,80,-69
2270,9,36,1,10,0,2097,2144,2562,1849,777,1549,1067,1547,1898,1873,2104,2281,2192.0,2086.0,177,231,-54
351,10,36,1,10,0,376,342,443,364,194,278,172,226,248,272,340,365,352.0,326.0,25,68,-43
718,11,36,1,10,0,713,682,857,658,425,546,407,545,534,592,698,728,713.0,673.0,30,106,-76
316,12,36,1,10,0,324,277,382,334,121,180,176,242,230,289,241,378,310.0,303.0,137,-48,185
1033,13,36,1,10,0,875,790,1042,804,407,572,721,849,721,962,1094,1052,1073.0,1036.0,-42,132,-174
669,14,36,1,10,0,514,567,656,654,303,427,422,450,484,638,714,768,741.0,707.0,54,76,-22
663,15,36,1,10,0,707,687,970,632,338,464,407,503,544,617,739,738,738.0,698.0,-1,122,-123
1245,16,36,1,10,0,1234,1296,1458,1429,526,890,740,929,1121,1218,1196,1452,1324.0,1289.0,256,-22,278
558,17,36,1,10,0,532,579,879,712,262,444,376,475,496,530,587,687,637.0,601.0,100,57,43
473,18,36,1,10,0,423,388,523,387,223,336,237,399,355,340,322,385,354.0,349.0,63,-18,81
761,19,36,1,10,0,871,786,1105,571,424,658,595,611,583,678,909,852,880.0,813.0,-57,231,-288
447,20,36,1,10,0,406,568,732,616,327,364,351,290,544,368,383,473,428.0,408.0,90,15,75
643,21,36,1,10,0,618,464,618,561,288,381,522,505,419,505,615,617,616.0,579.0,2,110,-108
378,22,36,1,10,0,346,348,497,267,165,333,307,314,331,413,428,410,419.0,417.0,-18,15,-33
75,1,37,2,10,0,111,242,237,68,37,61,48,42,46,60,56,89,72.0,68.0,33,-4,37
159,2,37,2,10,0,165,182,271,140,100,100,97,72,92,101,116,117,116.0,111.0,1,15,-14
146,3,37,2,10,0,144,149,195,78,54,74,78,87,84,89,105,134,120.0,109.0,29,16,13
48,4,37,2,10,0,97,128,205,34,44,59,36,32,45,41,40,42,41.0,41.0,2,-1,3
268,5,37,2,10,0,284,276,560,275,186,178,154,123,197,155,287,297,292.0,246.0,10,132,-122
192,6,37,2,10,0,234,289,496,209,109,109,97,103,125,123,120,141,130.0,128.0,21,-3,24
349,7,37,2,10,0,430,397,599,241,156,188,181,193,211,187,260,255,258.0,234.0,-5,73,-78
132,8,37,2,10,0,187,192,226,67,52,65,70,76,81,82,108,105,106.0,98.0,-3,26,-29
978,9,37,2,10,0,1096,1273,1753,510,290,467,429,504,568,492,615,692,654.0,600.0,77,123,-46
206,10,37,2,10,0,183,209,314,161,76,113,66,89,103,111,120,142,131.0,124.0,22,9,13
571,11,37,2,10,0,720,808,1176,484,399,360,358,395,364,346,423,460,442.0,410.0,37,77,-40
317,12,37,2,10,0,282,281,556,258,99,139,120,123,138,130,192,210,201.0,177.0,18,62,-44
293,13,37,2,10,0,284,290,435,164,126,133,165,184,178,191,217,243,230.0,217.0,26,26,0
457,14,37,2,10,0,283,364,562,252,130,136,161,188,248,234,365,372,368.0,324.0,7,131,-124
551,15,37,2,10,0,738,799,1102,332,255,331,293,293,451,433,549,507,528.0,496.0,-42,116,-158
203,16,37,2,10,0,257,362,526,267,110,92,100,79,129,117,148,188,168.0,151.0,40,31,9
300,17,37,2,10,0,260,313,627,286,115,133,96,119,133,162,229,236,232.0,209.0,7,67,-60
231,18,37,2,10,0,315,340,500,185,128,160,130,141,134,138,134,168,151.0,147.0,34,-4,38
216,19,37,2,10,0,260,209,299,101,86,133,111,127,127,138,164,160,162.0,154.0,-4,26,-30
155,20,37,2,10,0,151,159,317,179,87,70,59,80,101,84,95,112,104.0,97.0,17,11,6
115,21,37,2,10,0,163,141,242,89,58,62,55,62,48,76,86,87,86.0,83.0,1,10,-9
84,22,37,2,10,0,103,121,126,60,44,65,66,61,78,87,93,69,81.0,83.0,-24,6,-30
288,1,38,2,10,0,336,1289,571,175,135,300,320,311,280,332,341,475,408.0,383.0,134,9,125
354,2,38,2,10,0,257,285,393,160,154,201,154,174,208,237,210,296,253.0,248.0,86,-27,113
451,3,38,2,10,0,326,339,631,236,164,278,287,352,354,352,396,368,382.0,372.0,-28,44,-72
323,4,38,2,10,0,664,656,980,232,253,315,319,299,344,411,421,374,398.0,402.0,-47,10,-57
1119,5,38,2,10,0,923,1016,1536,609,478,708,677,703,870,874,1179,1263,1221.0,1105.0,84,305,-221
737,6,38,2,10,0,666,550,750,358,257,522,447,450,474,531,638,743,690.0,637.0,105,107,-2
3176,7,38,2,10,0,3148,3502,5481,1788,1203,1635,2012,1985,2046,2150,2770,3225,2998.0,2715.0,455,620,-165
1396,8,38,2,10,0,899,919,1474,502,371,567,626,775,870,822,1077,1141,1109.0,1013.0,64,255,-191
10929,9,38,2,10,0,12710,12394,15317,5306,3718,8079,6812,7957,8612,8119,10514,11327,10920.0,9987.0,813,2395,-1582
2230,10,38,2,10,0,1709,1789,2693,1195,777,1366,1087,1463,1613,1736,2291,2448,2370.0,2158.0,157,555,-398
2915,11,38,2,10,0,2226,2622,3296,1247,1529,2148,2087,2259,2343,2472,2603,2698,2650.0,2591.0,95,131,-36
1467,12,38,2,10,0,1277,1265,1764,857,484,797,835,979,1050,1189,1342,1563,1452.0,1365.0,221,153,68
2523,13,38,2,10,0,2221,2449,3796,1214,995,1259,1697,1832,1815,2279,2449,2337,2393.0,2355.0,-112,170,-282
2004,14,38,2,10,0,1739,1951,3130,1278,848,1290,1492,1391,1525,1910,2272,2311,2292.0,2164.0,39,362,-323
1907,15,38,2,10,0,2001,2019,2088,700,801,1246,1369,1509,1644,1767,1896,1932,1914.0,1865.0,36,129,-93
1327,16,38,2,10,0,1120,1425,1562,736,376,772,827,842,1061,1101,1051,1206,1128.0,1119.0,155,-50,205
1767,17,38,2,10,0,1444,1769,3168,1244,677,1105,1093,1503,1476,1786,1858,2160,2009.0,1935.0,302,72,230
1688,18,38,2,10,0,1846,1591,1981,769,598,1058,945,1316,1163,1316,1476,1544,1510.0,1445.0,68,160,-92
2045,19,38,2,10,0,2443,2622,3705,1059,1132,1642,1541,1606,1822,1931,2151,2147,2149.0,2076.0,-4,220,-224
671,20,38,2,10,0,494,548,828,333,235,331,330,400,708,364,385,467,426.0,405.0,82,21,61
432,21,38,2,10,0,457,402,722,289,175,287,284,326,299,382,387,425,406.0,398.0,38,5,33
822,22,38,2,10,0,605,913,1064,350,347,604,509,589,621,701,1075,927,1001.0,901.0,-148,374,-522
334,1,39,1,10,0,234,241,272,250,161,224,213,175,131,62,223,288,256.0,191.0,65,161,-96
466,2,39,1,10,0,285,282,383,494,162,297,298,329,209,81,389,480,434.0,317.0,91,308,-217
355,3,39,1,10,0,353,331,374,412,213,364,399,353,232,84,339,393,366.0,272.0,54,255,-201
461,4,39,1,10,0,432,527,798,336,255,324,347,230,135,126,317,411,364.0,285.0,94,191,-97
529,5,39,1,10,0,353,364,502,560,198,280,354,296,108,64,382,522,452.0,323.0,140,318,-178
570,6,39,1,10,0,369,339,449,378,228,339,365,359,86,125,393,488,440.0,335.0,95,268,-173
1241,7,39,1,10,0,1014,1020,1083,1132,648,948,1214,1085,369,273,1000,1192,1096.0,822.0,192,727,-535
467,8,39,1,10,0,394,347,454,373,276,370,403,345,137,148,396,551,474.0,365.0,155,248,-93
3252,9,39,1,10,0,2810,2842,3119,2859,1337,2735,2621,2524,1566,594,2431,2956,2694.0,1994.0,525,1837,-1312
389,10,39,1,10,0,287,279,316,376,154,306,255,297,140,103,277,336,306.0,239.0,59,174,-115
1064,11,39,1,10,0,908,905,1057,1012,579,905,787,820,405,226,838,926,882.0,663.0,88,612,-524
446,12,39,1,10,0,325,334,414,397,195,355,439,342,151,95,317,402,360.0,271.0,85,222,-137
1078,13,39,1,10,0,696,646,778,797,602,842,1066,971,374,253,922,911,916.0,695.0,-11,669,-680
1278,14,39,1,10,0,786,979,1154,954,596,986,1159,919,330,428,1111,1295,1203.0,945.0,184,683,-499
1023,15,39,1,10,0,611,709,819,752,388,650,682,669,277,191,789,847,818.0,609.0,58,598,-540
1304,16,39,1,10,0,1111,1292,1497,1405,549,1164,1131,1057,674,316,1053,1385,1219.0,918.0,332,737,-405
695,17,39,1,10,0,563,649,953,623,341,556,689,570,218,194,551,712,632.0,486.0,161,357,-196
622,18,39,1,10,0,586,610,611,627,347,556,479,612,226,137,543,591,567.0,424.0,48,406,-358
891,19,39,1,10,0,696,727,851,758,485,709,730,631,387,271,733,853,793.0,619.0,120,462,-342
243,20,39,1,10,0,152,145,208,248,87,111,125,128,35,39,154,285,220.0,159.0,131,115,16
525,21,39,1,10,0,415,400,482,463,229,331,386,360,198,125,357,434,396.0,305.0,77,232,-155
543,22,39,1,10,0,450,630,549,617,346,607,485,461,268,130,519,630,574.0,426.0,111,389,-278
143,1,40,1,10,0,238,345,456,114,153,205,172,211,259,235,234,227,230.0,232.0,-7,-1,-6
225,2,40,1,10,0,285,338,442,406,203,364,347,383,359,548,448,420,434.0,472.0,-28,-100,72
214,3,40,1,10,0,282,331,382,195,193,311,298,379,324,426,353,305,329.0,361.0,-48,-73,25
121,4,40,1,10,0,262,356,580,121,115,186,128,156,127,143,113,150,132.0,135.0,37,-30,67
291,5,40,1,10,0,487,569,804,459,234,390,378,467,472,512,561,494,528.0,522.0,-67,49,-116
287,6,40,1,10,0,428,489,503,403,244,376,434,485,530,589,548,523,536.0,553.0,-25,-41,16
531,7,40,1,10,0,855,912,1164,554,505,703,953,906,900,978,952,895,924.0,942.0,-57,-26,-31
194,8,40,1,10,0,284,316,428,223,193,301,299,310,314,437,371,333,352.0,380.0,-38,-66,28
1622,9,40,1,10,0,2450,3345,3730,1930,1262,2615,2284,2880,3003,3073,3157,2906,3032.0,3045.0,-251,84,-335
211,10,40,1,10,0,313,377,417,266,187,309,304,370,332,440,396,386,391.0,407.0,-10,-44,34
677,11,40,1,10,0,1114,1454,1527,877,754,1069,1130,1243,1239,1359,1276,1127,1202.0,1254.0,-149,-83,-66
244,12,40,1,10,0,317,350,507,305,161,323,377,500,498,505,477,346,412.0,443.0,-131,-28,-103
454,13,40,1,10,0,551,574,797,453,434,572,723,877,842,1076,876,738,807.0,897.0,-138,-200,62
486,14,40,1,10,0,548,872,1036,630,391,702,797,764,826,1251,974,822,898.0,1016.0,-152,-277,125
688,15,40,1,10,0,942,1151,1258,739,529,861,969,1092,1188,1336,1191,1013,1102.0,1180.0,-178,-145,-33
697,16,40,1,10,0,918,1189,1511,963,454,719,775,822,1002,1247,1129,844,986.0,1073.0,-285,-118,-167
266,17,40,1,10,0,452,506,737,420,189,443,430,470,484,597,615,466,540.0,559.0,-149,18,-167
382,18,40,1,10,0,643,734,779,473,353,640,561,659,677,791,724,521,622.0,679.0,-203,-67,-136
353,19,40,1,10,0,390,480,602,285,241,431,475,512,466,627,589,508,548.0,575.0,-81,-38,-43
134,20,40,1,10,0,186,200,305,185,95,179,155,153,233,211,194,180,187.0,195.0,-14,-17,3
153,21,40,1,10,0,309,345,496,293,157,234,292,346,246,352,406,274,340.0,344.0,-132,54,-186
210,22,40,1,10,0,306,404,422,214,206,322,309,385,388,444,380,359,370.0,394.0,-21,-64,43
117,1,41,3,10,0,166,277,348,224,140,212,313,130,176,126,150,183,166.0,153.0,33,24,9
11,2,41,3,10,0,12,22,33,19,19,18,22,20,12,9,9,13,11.0,10.0,4,0,4
25,3,41,3,10,0,16,19,22,21,19,29,36,17,19,26,22,19,20.0,22.0,-3,-4,1
181,4,41,3,10,0,353,372,511,424,244,378,320,244,260,250,268,314,291.0,277.0,46,18,28
23,5,41,3,10,0,34,42,64,69,42,47,33,29,34,13,37,22,30.0,24.0,-15,24,-39
42,6,41,3,10,0,52,74,75,83,59,59,57,45,62,31,45,37,41.0,38.0,-8,14,-22
190,7,41,3,10,0,309,286,341,430,189,295,303,192,237,256,222,242,232.0,240.0,20,-34,54
96,8,41,3,10,0,58,62,78,105,64,83,78,62,75,85,83,109,96.0,92.0,26,-2,28
781,9,41,3,10,0,887,972,1235,1009,443,848,749,579,865,757,844,906,875.0,836.0,62,87,-25
17,10,41,3,10,0,23,13,26,34,17,20,12,20,22,16,21,17,19.0,18.0,-4,5,-9
284,11,41,3,10,0,323,380,481,397,258,351,301,241,305,301,319,353,336.0,324.0,34,18,16
23,12,41,3,10,0,29,35,37,61,16,26,40,25,30,32,20,29,24.0,27.0,9,-12,21
218,13,41,3,10,0,234,231,316,308,172,236,271,218,215,233,230,258,244.0,240.0,28,-3,31
126,14,41,3,10,0,150,188,209,242,134,155,146,105,140,155,161,153,157.0,156.0,-8,6,-14
291,15,41,3,10,0,293,323,375,353,222,270,371,311,449,354,283,365,324.0,334.0,82,-71,153
34,16,41,3,10,0,26,64,62,54,47,52,51,39,64,44,59,48,54.0,50.0,-11,15,-26
29,17,41,3,10,0,25,31,44,54,26,27,28,26,30,22,38,28,33.0,29.0,-10,16,-26
58,18,41,3,10,0,57,83,105,92,41,56,43,37,75,57,57,54,56.0,56.0,-3,0,-3
97,19,41,3,10,0,127,153,187,158,103,124,129,115,148,126,163,128,146.0,139.0,-35,37,-72
10,20,41,3,10,0,17,12,27,22,12,27,12,19,15,18,21,16,18.0,18.0,-5,3,-8
12,21,41,3,10,0,25,29,46,61,16,38,37,27,23,27,20,22,21.0,23.0,2,-7,9
32,22,41,3,10,0,62,61,65,66,41,61,62,37,56,42,70,58,64.0,57.0,-12,28,-40
306,1,42,1,10,0,260,331,369,161,142,190,140,165,214,189,313,284,298.0,262.0,-29,124,-153
509,2,42,1,10,0,519,521,651,386,202,309,233,292,232,382,379,387,383.0,383.0,8,-3,11
204,3,42,1,10,0,185,190,234,146,90,139,127,131,111,141,187,208,198.0,179.0,21,46,-25
151,4,42,1,10,0,223,301,382,210,141,181,149,153,130,100,130,167,148.0,132.0,37,30,7
547,5,42,1,10,0,492,617,839,509,240,360,342,344,334,430,617,773,695.0,607.0,156,187,-31
351,6,42,1,10,0,453,504,690,387,163,254,266,293,273,348,415,368,392.0,377.0,-47,67,-114
968,7,42,1,10,0,774,709,964,444,303,464,570,555,507,649,847,877,862.0,791.0,30,198,-168
351,8,42,1,10,0,277,302,443,175,132,238,204,221,191,257,331,373,352.0,320.0,42,74,-32
4197,9,42,1,10,0,4449,4901,5547,3229,1517,2906,3040,2996,3064,2940,3296,3858,3577.0,3365.0,562,356,206
346,10,42,1,10,0,434,458,665,381,181,321,247,278,230,271,353,423,388.0,349.0,70,82,-12
961,11,42,1,10,0,888,974,1139,690,508,722,614,698,656,855,923,861,892.0,880.0,-62,68,-130
280,12,42,1,10,0,408,499,625,381,184,276,300,321,252,286,354,387,370.0,342.0,33,68,-35
775,13,42,1,10,0,602,602,830,407,320,433,514,507,400,601,794,756,775.0,717.0,-38,193,-231
609,14,42,1,10,0,620,614,920,507,247,499,530,473,405,626,853,641,747.0,707.0,-212,227,-439
1244,15,42,1,10,0,998,1169,1424,732,558,806,842,817,859,969,1255,1091,1173.0,1105.0,-164,286,-450
619,16,42,1,10,0,818,1066,1347,698,270,511,498,504,540,672,774,908,841.0,785.0,134,102,32
544,17,42,1,10,0,630,700,988,570,203,418,421,498,401,577,729,628,678.0,645.0,-101,152,-253
822,18,42,1,10,0,754,796,1043,605,368,580,595,656,635,615,765,815,790.0,732.0,50,150,-100
618,19,42,1,10,0,433,460,600,253,193,341,357,363,293,369,581,567,574.0,506.0,-14,212,-226
237,20,42,1,10,0,227,222,229,139,105,116,140,127,159,132,163,253,208.0,183.0,90,31,59
330,21,42,1,10,0,253,229,293,140,96,140,126,155,135,199,252,297,274.0,249.0,45,53,-8
192,22,42,1,10,0,198,199,322,111,123,264,218,232,182,233,390,264,327.0,296.0,-126,157,-283
342,1,43,2,10,0,354,457,516,264,193,369,368,312,223,311,325,374,350.0,337.0,49,14,35
114,2,43,2,10,0,236,233,253,206,111,144,116,120,119,120,92,116,104.0,109.0,24,-28,52
177,3,43,2,10,0,212,200,238,219,114,172,145,184,185,176,175,180,178.0,177.0,5,-1,6
438,4,43,2,10,0,603,754,1094,601,390,482,397,375,385,359,390,493,442.0,414.0,103,31,72
247,5,43,2,10,0,363,489,543,391,237,325,296,251,270,231,353,472,412.0,352.0,119,122,-3
289,6,43,2,10,0,444,568,578,495,153,185,233,254,279,190,233,316,274.0,246.0,83,43,40
910,7,43,2,10,0,1018,1094,1221,1031,476,846,727,791,753,709,746,888,817.0,781.0,142,37,105
381,8,43,2,10,0,370,395,605,316,221,369,335,297,249,379,331,458,394.0,389.0,127,-48,175
2698,9,43,2,10,0,3019,3563,3747,2666,1125,2377,2460,2143,2250,2148,2251,2790,2520.0,2396.0,539,103,436
127,10,43,2,10,0,146,194,174,193,92,119,101,114,104,103,130,136,133.0,123.0,6,27,-21
1039,11,43,2,10,0,1292,1491,1524,1070,552,1008,901,895,803,803,813,980,896.0,865.0,167,10,157
235,12,43,2,10,0,258,340,409,346,81,166,179,201,165,187,208,207,208.0,201.0,-1,21,-22
861,13,43,2,10,0,975,971,1119,789,422,734,762,790,652,806,800,941,870.0,849.0,141,-6,147
471,14,43,2,10,0,609,805,866,692,326,488,531,450,448,469,417,510,464.0,465.0,93,-52,145
1512,15,43,2,10,0,1371,1516,1515,1138,549,969,1010,1108,1385,1507,1239,1522,1380.0,1423.0,283,-268,551
449,16,43,2,10,0,729,779,906,749,253,446,434,381,436,412,489,521,505.0,474.0,32,77,-45
387,17,43,2,10,0,645,767,839,710,238,437,402,430,431,398,373,459,416.0,410.0,86,-25,111
452,18,43,2,10,0,571,612,638,509,288,542,508,519,527,327,322,360,341.0,336.0,38,-5,43
831,19,43,2,10,0,1020,1269,1395,898,506,962,872,971,851,914,875,950,912.0,913.0,75,-39,114
144,20,43,2,10,0,170,200,213,159,106,164,130,104,160,133,125,141,133.0,133.0,16,-8,24
208,21,43,2,10,0,273,309,371,227,159,225,195,179,129,173,160,195,178.0,176.0,35,-13,48
424,22,43,2,10,0,422,639,783,366,217,537,358,448,306,533,522,375,448.0,477.0,-147,-11,-136
307,1,44,1,10,0,186,304,291,260,125,252,169,218,208,195,239,288,264.0,241.0,49,44,5
60,2,44,1,10,0,62,97,95,78,48,59,48,61,43,79,64,53,58.0,65.0,-11,-15,4
82,3,44,1,10,0,57,54,64,35,18,51,53,69,55,61,64,72,68.0,66.0,8,3,5
448,4,44,1,10,0,458,551,739,435,233,445,341,391,396,426,482,578,530.0,495.0,96,56,40
241,5,44,1,10,0,218,246,296,270,133,178,212,190,231,208,233,444,338.0,295.0,211,25,186
124,6,44,1,10,0,119,125,125,156,59,89,69,81,70,72,75,150,112.0,99.0,75,3,72
254,7,44,1,10,0,209,228,356,218,112,223,197,226,179,193,249,344,296.0,262.0,95,56,39
33,8,44,1,10,0,27,53,51,47,21,35,29,43,35,45,44,57,50.0,49.0,13,-1,14
473,9,44,1,10,0,341,442,572,437,152,310,246,338,497,305,362,444,403.0,370.0,82,57,25
69,10,44,1,10,0,35,38,46,44,34,25,32,38,35,50,44,68,56.0,54.0,24,-6,30
301,11,44,1,10,0,218,248,301,251,138,200,177,214,189,187,223,290,256.0,233.0,67,36,31
77,12,44,1,10,0,57,75,92,84,32,51,53,76,51,70,67,97,82.0,78.0,30,-3,33
174,13,44,1,10,0,95,123,131,106,79,112,113,144,111,129,162,213,188.0,168.0,51,33,18
158,14,44,1,10,0,137,144,187,131,57,111,155,108,118,135,163,164,164.0,154.0,1,28,-27
139,15,44,1,10,0,129,149,230,149,78,139,107,108,142,110,130,142,136.0,127.0,12,20,-8
143,16,44,1,10,0,132,148,184,148,61,111,94,101,110,110,157,162,160.0,143.0,5,47,-42
137,17,44,1,10,0,121,157,211,135,74,132,109,108,118,96,135,209,172.0,147.0,74,39,35
118,18,44,1,10,0,93,111,124,108,57,77,71,97,95,75,85,112,98.0,91.0,27,10,17
146,19,44,1,10,0,93,126,129,69,51,75,76,107,67,96,152,173,162.0,140.0,21,56,-35
158,20,44,1,10,0,105,132,160,125,77,112,97,87,149,112,142,157,150.0,137.0,15,30,-15
224,21,44,1,10,0,176,150,182,148,77,137,111,172,117,112,144,202,173.0,153.0,58,32,26
78,22,44,1,10,0,44,71,77,53,34,68,53,50,51,50,100,75,88.0,75.0,-25,50,-75
83,1,45,1,10,0,186,244,388,154,85,126,92,105,104,90,95,93,94.0,93.0,-2,5,-7
102,2,45,1,10,0,190,214,267,194,91,60,53,77,69,54,60,68,64.0,61.0,8,6,2
46,3,45,1,10,0,180,167,259,127,62,61,62,68,40,53,87,64,76.0,68.0,-23,34,-57
11,4,45,1,10,0,143,181,370,71,41,51,25,21,23,21,16,13,14.0,17.0,-3,-5,2
140,5,45,1,10,0,335,432,691,448,194,129,110,118,105,113,152,138,145.0,134.0,-14,39,-53
331,6,45,1,10,0,719,699,1253,712,250,227,217,259,222,209,229,284,256.0,241.0,55,20,35
443,7,45,1,10,0,850,792,1449,549,320,297,347,332,246,290,297,412,354.0,333.0,115,7,108
88,8,45,1,10,0,226,231,426,153,81,103,83,114,108,86,92,80,86.0,86.0,-12,6,-18
547,9,45,1,10,0,953,1204,1628,496,168,342,246,344,349,247,271,470,370.0,329.0,199,24,175
46,10,45,1,10,0,119,135,240,121,56,54,26,39,23,31,45,41,43.0,39.0,-4,14,-18
468,11,45,1,10,0,1050,1083,1908,768,543,404,402,487,371,340,347,446,396.0,378.0,99,7,92
258,12,45,1,10,0,358,434,733,453,153,150,168,191,126,131,163,222,192.0,172.0,59,32,27
306,13,45,1,10,0,665,667,1158,476,272,257,300,350,276,304,321,274,298.0,300.0,-47,17,-64
454,14,45,1,10,0,894,1006,1883,910,372,312,380,366,295,321,290,401,346.0,337.0,111,-31,142
673,15,45,1,10,0,1022,1202,2202,744,430,386,337,361,407,360,410,487,448.0,419.0,77,50,27
198,16,45,1,10,0,353,409,749,443,143,138,130,145,146,117,118,165,142.0,133.0,47,1,46
192,17,45,1,10,0,322,439,744,378,131,137,149,138,134,113,150,189,170.0,151.0,39,37,2
178,18,45,1,10,0,345,391,594,265,149,173,130,137,127,100,127,140,134.0,122.0,13,27,-14
56,19,45,1,10,0,176,186,256,75,62,80,75,84,47,39,66,55,60.0,53.0,-11,27,-38
14,20,45,1,10,0,86,92,172,124,38,29,23,20,27,17,21,36,28.0,25.0,15,4,11
101,21,45,1,10,0,205,212,325,144,79,70,64,97,57,67,82,80,81.0,76.0,-2,15,-17
32,22,45,1,10,0,107,126,152,43,36,52,38,43,41,34,44,43,44.0,40.0,-1,10,-11
3,1,46,1,10,0,69,88,96,65,19,37,175,5,12,7,8,136,72.0,50.0,128,1,127
65,2,46,1,10,0,214,209,182,216,75,82,86,83,57,67,66,46,56.0,60.0,-20,-1,-19
32,3,46,1,10,0,176,130,141,132,46,66,45,69,41,38,46,34,40.0,39.0,-12,8,-20
11,4,46,1,10,0,158,186,277,124,81,65,48,29,26,33,15,60,38.0,36.0,45,-18,63
63,5,46,1,10,0,267,205,292,350,117,93,78,81,64,97,44,63,54.0,68.0,19,-53,72
111,6,46,1,10,0,332,341,384,513,121,108,92,90,118,107,99,88,94.0,98.0,-11,-8,-3
326,7,46,1,10,0,572,480,596,555,214,153,209,203,175,145,127,346,236.0,206.0,219,-18,237
7,8,46,1,10,0,89,70,67,66,26,12,22,19,12,23,3,3,3.0,10.0,0,-20,20
16,9,46,1,10,0,91,101,84,62,19,63,37,30,29,26,25,17,21.0,23.0,-8,-1,-7
8,10,46,1,10,0,42,39,50,45,14,26,20,6,2,8,5,11,8.0,8.0,6,-3,9
201,11,46,1,10,0,502,474,569,538,214,216,188,191,134,129,86,151,118.0,122.0,65,-43,108
77,12,46,1,10,0,281,274,309,360,94,101,91,90,79,82,62,58,60.0,67.0,-4,-20,16
201,13,46,1,10,0,372,326,383,353,154,150,162,149,131,144,91,180,136.0,138.0,89,-53,142
117,14,46,1,10,0,471,372,457,538,139,100,129,104,87,70,63,93,78.0,75.0,30,-7,37
264,15,46,1,10,0,437,429,453,388,129,152,151,108,106,91,89,167,128.0,116.0,78,-2,80
106,16,46,1,10,0,379,317,421,474,120,139,119,158,186,109,65,89,77.0,88.0,24,-44,68
156,17,46,1,10,0,353,348,428,459,95,148,114,114,115,100,92,163,128.0,118.0,71,-8,79
27,18,46,1,10,0,148,127,159,136,38,44,37,55,51,15,28,29,28.0,24.0,1,13,-12
55,19,46,1,10,0,216,174,238,151,59,93,137,105,53,60,48,51,50.0,53.0,3,-12,15
6,20,46,1,10,0,108,151,126,110,41,27,16,19,16,22,15,14,14.0,17.0,-1,-7,6
43,21,46,1,10,0,279,210,288,180,80,67,82,94,70,81,86,60,73.0,76.0,-26,5,-31
28,22,46,1,10,0,121,118,156,75,46,57,45,34,22,28,31,17,24.0,25.0,-14,3,-17
301,1,47,2,10,0,188,341,384,208,78,136,169,219,267,195,272,379,326.0,282.0,107,77,30
139,2,47,2,10,0,216,186,206,142,56,68,79,116,111,106,126,142,134.0,125.0,16,20,-4
60,3,47,2,10,0,121,125,115,74,44,45,52,72,39,48,70,69,70.0,62.0,-1,22,-23
152,4,47,2,10,0,461,553,771,253,139,206,162,160,198,159,181,170,176.0,170.0,-11,22,-33
629,5,47,2,10,0,548,657,933,673,263,243,304,396,459,464,505,768,636.0,579.0,263,41,222
759,6,47,2,10,0,800,764,993,964,338,340,389,526,609,640,679,780,730.0,700.0,101,39,62
884,7,47,2,10,0,979,957,1332,1011,383,430,537,623,546,597,690,912,801.0,733.0,222,93,129
145,8,47,2,10,0,213,203,275,128,67,102,111,136,137,121,130,151,140.0,134.0,21,9,12
1234,9,47,2,10,0,1182,1660,1546,767,278,638,579,734,773,669,732,1150,941.0,850.0,418,63,355
190,10,47,2,10,0,181,188,276,186,86,105,86,125,135,129,121,150,136.0,133.0,29,-8,37
2009,11,47,2,10,0,2015,2022,2642,2094,991,984,1074,1356,1448,1465,1619,1956,1788.0,1680.0,337,154,183
519,12,47,2,10,0,368,453,691,614,157,211,274,326,317,295,445,614,530.0,451.0,169,150,19
523,13,47,2,10,0,665,667,773,530,290,330,342,436,385,393,514,507,510.0,471.0,-7,121,-128
1566,14,47,2,10,0,1390,1577,2409,1865,640,650,891,1055,1267,1138,1176,1439,1308.0,1251.0,263,38,225
1714,15,47,2,10,0,1696,1832,2222,1022,501,663,715,913,1088,1232,1489,1624,1556.0,1448.0,135,257,-122
562,16,47,2,10,0,475,492,661,605,178,211,256,312,333,394,414,526,470.0,445.0,112,20,92
497,17,47,2,10,0,481,547,698,488,170,228,287,352,372,388,447,540,494.0,458.0,93,59,34
504,18,47,2,10,0,469,556,601,361,197,246,246,307,332,263,303,408,356.0,325.0,105,40,65
162,19,47,2,10,0,246,211,328,161,100,120,120,168,137,149,154,182,168.0,162.0,28,5,23
358,20,47,2,10,0,330,373,430,326,140,158,145,189,295,272,251,352,302.0,292.0,101,-21,122
243,21,47,2,10,0,449,347,562,349,119,145,167,210,170,185,229,259,244.0,224.0,30,44,-14
99,22,47,2,10,0,82,97,100,69,37,53,48,62,47,72,53,77,65.0,67.0,24,-19,43
22,1,48,2,10,0,4,41,46,32,19,54,17,10,12,11,6,11,8.0,9.0,5,-5,10
234,2,48,2,10,0,126,119,169,142,104,91,53,62,66,54,100,120,110.0,91.0,20,46,-26
446,3,48,2,10,0,297,353,430,278,168,258,163,176,174,153,161,172,166.0,162.0,11,8,3
34,4,48,2,10,0,46,78,112,52,38,30,13,7,12,11,3,21,12.0,12.0,18,-8,26
648,5,48,2,10,0,408,517,641,617,336,250,134,145,143,161,174,211,192.0,182.0,37,13,24
349,6,48,2,10,0,71,198,190,278,146,119,59,72,88,63,82,153,118.0,99.0,71,19,52
1575,7,48,2,10,0,1445,1562,2281,1763,885,746,509,752,650,656,635,554,594.0,615.0,-81,-21,-60
1057,8,48,2,10,0,579,768,886,691,295,401,285,317,252,283,337,321,329.0,314.0,-16,54,-70
443,9,48,2,10,0,619,710,1008,472,229,471,212,177,139,130,131,160,146.0,140.0,29,1,28
260,10,48,2,10,0,132,192,308,251,110,119,55,137,102,134,127,148,138.0,136.0,21,-7,28
351,11,48,2,10,0,95,307,309,370,299,211,106,111,126,119,95,124,110.0,113.0,29,-24,53
201,12,48,2,10,0,60,177,182,224,84,107,42,42,52,41,45,96,70.0,61.0,51,4,47
2258,13,48,2,10,0,1092,1644,1840,1468,940,941,733,782,635,713,852,807,830.0,791.0,-45,139,-184
1114,14,48,2,10,0,306,774,911,1101,433,362,211,283,281,280,284,399,342.0,321.0,115,4,111
513,15,48,2,10,0,42,380,352,327,197,195,168,241,204,240,223,277,250.0,247.0,54,-17,71
166,16,48,2,10,0,46,116,125,211,58,65,32,39,46,41,44,51,48.0,45.0,7,3,4
309,17,48,2,10,0,74,141,165,230,105,87,42,50,62,55,47,92,70.0,65.0,45,-8,53
260,18,48,2,10,0,110,281,215,204,105,130,66,70,71,48,58,86,72.0,64.0,28,10,18
715,19,48,2,10,0,384,528,619,375,317,409,425,215,168,173,244,317,280.0,245.0,73,71,2
81,20,48,2,10,0,62,80,104,116,61,54,25,34,33,27,26,25,26.0,26.0,-1,-1,0
394,21,48,2,10,0,145,214,250,261,108,136,75,123,125,148,123,127,125.0,133.0,4,-25,29
569,22,48,2,10,0,291,350,342,207,144,192,137,117,137,97,118,219,168.0,145.0,101,21,80
357,1,49,1,10,0,283,435,596,174,80,151,177,200,272,204,286,381,334.0,290.0,95,82,13
311,2,49,1,10,0,514,538,699,444,236,185,176,241,235,239,233,242,238.0,238.0,9,-6,15
285,3,49,1,10,0,354,323,485,221,94,125,138,233,182,202,244,226,235.0,224.0,-18,42,-60
203,4,49,1,10,0,636,879,1517,309,174,289,242,251,279,287,271,285,278.0,281.0,14,-16,30
527,5,49,1,10,0,712,770,1305,743,339,285,287,359,363,364,444,612,528.0,473.0,168,80,88
868,6,49,1,10,0,894,964,1597,855,344,344,422,524,660,677,843,847,845.0,789.0,4,166,-162
862,7,49,1,10,0,1160,1107,1740,687,383,327,543,829,670,841,808,972,890.0,874.0,164,-33,197
248,8,49,1,10,0,282,301,514,192,100,117,126,207,172,186,212,232,222.0,210.0,20,26,-6
825,9,49,1,10,0,1240,1586,1899,542,186,403,360,460,604,483,479,704,592.0,555.0,225,-4,229
164,10,49,1,10,0,266,309,514,260,96,110,81,120,111,123,118,114,116.0,118.0,-4,-5,1
1193,11,49,1,10,0,1396,1446,2279,939,574,593,645,899,941,918,876,1073,974.0,956.0,197,-42,239
631,12,49,1,10,0,519,571,900,502,180,199,229,302,289,342,439,577,508.0,453.0,138,97,41
860,13,49,1,10,0,990,1108,1749,708,414,412,600,843,768,843,1013,870,942.0,909.0,-143,170,-313
1225,14,49,1,10,0,1493,1622,2735,1331,509,557,792,1003,1139,1208,1046,1173,1110.0,1142.0,127,-162,289
1840,15,49,1,10,0,1911,2130,3255,1119,581,616,676,899,1179,1212,1449,1568,1508.0,1410.0,119,237,-118
558,16,49,1,10,0,560,634,1014,597,202,210,256,309,467,354,417,541,479.0,437.0,124,63,61
434,17,49,1,10,0,546,606,978,498,212,209,272,280,287,311,368,495,432.0,391.0,127,57,70
353,18,49,1,10,0,499,552,782,311,141,184,131,214,223,160,193,287,240.0,213.0,94,33,61
187,19,49,1,10,0,299,258,424,127,80,97,131,161,165,176,170,202,186.0,183.0,32,-6,38
178,20,49,1,10,0,267,309,532,260,104,78,93,126,161,148,159,170,164.0,159.0,11,11,0
450,21,49,1,10,0,472,366,620,315,130,154,179,263,204,263,363,295,329.0,307.0,-68,100,-168
100,22,49,1,10,0,170,232,274,80,52,66,71,97,87,91,116,90,103.0,99.0,-26,25,-51
176,1,50,4,10,0,239,345,396,369,177,174,163,140,140,130,154,202,178.0,162.0,48,24,24
226,2,50,4,10,0,406,373,334,203,134,207,159,159,199,202,227,215,221.0,215.0,-12,25,-37
103,3,50,4,10,0,116,59,90,51,29,42,27,40,31,39,40,40,40.0,40.0,0,1,-1
59,4,50,4,10,0,168,222,242,93,60,87,42,47,47,40,41,55,48.0,45.0,14,1,13
361,5,50,4,10,0,758,778,781,288,239,321,272,333,406,352,417,499,458.0,423.0,82,65,17
432,6,50,4,10,0,644,607,661,309,266,301,237,309,289,297,345,293,319.0,312.0,-52,48,-100
703,7,50,4,10,0,807,782,994,540,419,572,464,433,395,383,432,535,484.0,450.0,103,49,54
107,8,50,4,10,0,200,132,201,88,44,87,60,67,72,87,105,82,94.0,91.0,-23,18,-41
508,9,50,4,10,0,721,938,1135,331,231,477,411,394,418,380,461,499,480.0,447.0,38,81,-43
158,10,50,4,10,0,247,370,403,140,92,140,131,131,161,121,124,149,136.0,131.0,25,3,22
937,11,50,4,10,0,1227,1286,1781,805,710,885,641,740,693,656,701,768,734.0,708.0,67,45,22
224,12,50,4,10,0,438,444,431,157,97,173,170,210,195,175,219,261,240.0,218.0,42,44,-2
703,13,50,4,10,0,766,589,806,391,375,484,404,455,438,404,455,455,455.0,438.0,0,51,-51
591,14,50,4,10,0,834,729,896,363,334,528,418,445,554,381,446,510,478.0,446.0,64,65,-1
595,15,50,4,10,0,616,797,1044,341,386,475,363,466,458,443,473,505,489.0,474.0,32,30,2
242,16,50,4,10,0,452,413,461,270,123,194,119,150,177,181,200,192,196.0,191.0,-8,19,-27
207,17,50,4,10,0,414,458,478,157,99,182,167,188,184,200,195,251,223.0,215.0,56,-5,61
321,18,50,4,10,0,397,455,593,250,154,266,219,283,228,214,225,227,226.0,222.0,2,11,-9
113,19,50,4,10,0,114,136,149,45,36,75,66,76,84,71,67,64,66.0,67.0,-3,-4,1
136,20,50,4,10,0,402,422,475,136,124,148,136,160,225,137,123,161,142.0,140.0,38,-14,52
239,21,50,4,10,0,595,355,464,194,145,188,141,176,186,164,204,187,196.0,185.0,-17,40,-57
82,22,50,4,10,0,176,82,87,40,47,82,54,34,48,39,38,37,38.0,38.0,-1,-1,0
361,1,51,2,10,0,355,228,579,371,131,288,266,225,283,286,352,425,388.0,354.0,73,66,7
214,2,51,2,10,0,244,165,338,215,134,179,192,167,169,217,170,285,228.0,224.0,115,-47,162
57,3,51,2,10,0,41,43,48,41,28,59,37,53,61,54,60,50,55.0,55.0,-10,6,-16
75,4,51,2,10,0,268,372,383,131,61,110,108,70,103,89,94,106,100.0,96.0,12,5,7
570,5,51,2,10,0,431,484,820,550,286,428,433,456,497,476,571,730,650.0,592.0,159,95,64
651,6,51,2,10,0,495,362,758,508,322,432,425,545,563,499,558,654,606.0,570.0,96,59,37
427,7,51,2,10,0,423,383,729,410,227,320,381,388,394,345,413,508,460.0,422.0,95,68,27
82,8,51,2,10,0,61,91,136,74,57,53,62,47,59,62,56,65,60.0,61.0,9,-6,15
1459,9,51,2,10,0,1305,1034,2232,1023,444,1072,1007,969,1190,954,1225,1539,1382.0,1239.0,314,271,43
238,10,51,2,10,0,215,191,328,208,107,160,131,178,209,223,211,264,238.0,233.0,53,-12,65
1302,11,51,2,10,0,1239,807,1846,1142,747,1023,870,969,1040,1045,1132,1384,1258.0,1187.0,252,87,165
365,12,51,2,10,0,226,131,436,290,111,237,235,226,237,243,304,361,332.0,303.0,57,61,-4
418,13,51,2,10,0,308,272,475,287,194,265,298,335,339,355,444,469,456.0,423.0,25,89,-64
610,14,51,2,10,0,543,420,747,459,249,457,513,513,571,508,547,706,626.0,587.0,159,39,120
1245,15,51,2,10,0,856,695,1454,752,503,780,679,725,759,836,1202,1060,1131.0,1033.0,-142,366,-508
444,16,51,2,10,0,278,190,481,312,158,246,258,251,428,347,390,481,436.0,406.0,91,43,48
351,17,51,2,10,0,289,235,425,324,139,263,238,293,308,308,344,467,406.0,373.0,123,36,87
533,18,51,2,10,0,472,415,699,508,260,395,323,426,506,406,485,547,516.0,479.0,62,79,-17
94,19,51,2,10,0,125,64,125,66,52,82,116,125,102,110,143,125,134.0,126.0,-18,33,-51
307,20,51,2,10,0,322,256,548,310,185,288,287,285,378,280,285,380,332.0,315.0,95,5,90
205,21,51,2,10,0,226,181,259,170,96,124,121,134,165,167,184,227,206.0,193.0,43,17,26
58,22,51,2,10,0,67,65,115,61,52,76,85,53,52,53,68,53,60.0,58.0,-15,15,-30
217,1,52,1,10,0,292,421,473,415,199,338,303,272,297,230,306,310,308.0,282.0,4,76,-72
284,2,52,1,10,0,363,485,535,500,259,353,295,304,293,320,299,296,298.0,305.0,-3,-21,18
163,3,52,1,10,0,233,229,234,273,129,208,180,191,167,194,197,191,194.0,194.0,-6,3,-9
323,4,52,1,10,0,429,500,681,534,295,402,398,365,374,341,360,397,378.0,366.0,37,19,18
426,5,52,1,10,0,704,743,849,933,442,540,493,508,553,476,460,610,535.0,515.0,150,-16,166
181,6,52,1,10,0,271,334,368,404,198,210,162,176,206,197,185,206,196.0,196.0,21,-12,33
489,7,52,1,10,0,679,776,936,911,376,595,546,558,596,483,522,642,582.0,549.0,120,39,81
135,8,52,1,10,0,142,208,244,213,113,141,101,103,104,107,143,141,142.0,130.0,-2,36,-38
973,9,52,1,10,0,1392,1836,2078,1526,521,1068,875,905,1067,825,969,1188,1078.0,994.0,219,144,75
131,10,52,1,10,0,208,246,317,323,145,236,156,189,166,140,172,167,170.0,160.0,-5,32,-37
440,11,52,1,10,0,660,847,820,821,461,589,458,423,545,436,500,549,524.0,495.0,49,64,-15
140,12,52,1,10,0,187,249,262,297,113,164,151,133,139,150,149,170,160.0,156.0,21,-1,22
421,13,52,1,10,0,625,746,750,758,431,483,470,474,415,495,501,519,510.0,505.0,18,6,12
366,14,52,1,10,0,604,752,820,826,447,615,567,493,543,423,493,437,465.0,451.0,-56,70,-126
344,15,52,1,10,0,524,623,684,550,252,401,254,311,325,307,322,340,331.0,323.0,18,15,3
246,16,52,1,10,0,310,385,425,481,197,299,246,238,274,238,273,295,284.0,269.0,22,35,-13
286,17,52,1,10,0,364,460,493,505,239,383,321,315,341,325,336,378,357.0,346.0,42,11,31
131,18,52,1,10,0,268,329,338,400,163,217,128,161,123,141,139,151,145.0,144.0,12,-2,14
198,19,52,1,10,0,303,369,450,249,117,274,320,298,258,236,274,251,262.0,254.0,-23,38,-61
263,20,52,1,10,0,400,540,575,576,284,403,314,306,439,296,285,331,308.0,304.0,46,-11,57
216,21,52,1,10,0,365,346,404,376,178,272,285,266,201,203,229,236,232.0,223.0,7,26,-19
237,22,52,1,10,0,302,341,410,324,206,341,242,239,273,292,251,258,254.0,267.0,7,-41,48
228,1,53,2,10,0,446,636,846,241,179,180,191,192,253,247,261,249,255.0,252.0,-12,14,-26
277,2,53,2,10,0,304,365,493,290,145,117,124,158,128,183,166,200,183.0,183.0,34,-17,51
180,3,53,2,10,0,206,310,562,284,123,119,71,119,101,97,110,137,124.0,115.0,27,13,14
85,4,53,2,10,0,257,444,824,105,71,55,60,50,59,51,57,65,61.0,58.0,8,6,2
550,5,53,2,10,0,762,1080,1730,983,504,400,394,380,436,516,607,641,624.0,588.0,34,91,-57
1137,6,53,2,10,0,1023,1260,2243,1186,528,593,566,477,521,594,770,1036,903.0,800.0,266,176,90
1041,7,53,2,10,0,1536,1637,2998,1261,553,503,551,645,651,724,836,994,915.0,851.0,158,112,46
274,8,53,2,10,0,299,372,645,313,178,140,164,178,173,195,230,273,252.0,233.0,43,35,8
769,9,53,2,10,0,1274,1967,3191,905,337,855,959,831,614,794,1007,844,926.0,882.0,-163,213,-376
309,10,53,2,10,0,252,337,697,471,179,227,188,213,224,204,252,332,292.0,263.0,80,48,32
1122,11,53,2,10,0,1918,2283,3836,1631,972,777,763,993,802,889,897,976,936.0,921.0,79,8,71
442,12,53,2,10,0,547,676,1270,658,229,229,221,283,227,273,344,417,380.0,345.0,73,71,2
757,13,53,2,10,0,969,1064,2232,950,551,442,578,697,555,544,666,625,646.0,612.0,-41,122,-163
1655,14,53,2,10,0,1431,1720,3243,1894,828,807,1011,1085,1013,1189,1300,1393,1346.0,1294.0,93,111,-18
676,15,53,2,10,0,1140,1205,1850,574,328,328,361,426,423,467,565,573,569.0,535.0,8,98,-90
348,16,53,2,10,0,710,866,1354,755,244,256,243,222,247,223,230,310,270.0,254.0,80,7,73
666,17,53,2,10,0,687,982,1756,938,322,403,371,448,412,466,511,628,570.0,535.0,117,45,72
511,18,53,2,10,0,645,746,1041,462,182,250,215,304,238,233,338,522,430.0,364.0,184,105,79
152,19,53,2,10,0,275,422,561,181,92,144,178,144,111,123,123,146,134.0,131.0,23,0,23
281,20,53,2,10,0,571,643,1136,557,231,195,203,189,260,190,212,306,259.0,236.0,94,22,72
649,21,53,2,10,0,682,805,1567,639,298,275,310,369,282,381,491,525,508.0,466.0,34,110,-76
111,22,53,2,10,0,109,207,305,102,62,72,62,93,71,101,93,80,86.0,91.0,-13,-8,-5
32,1,54,1,10,0,64,139,159,95,31,32,33,18,19,21,31,33,32.0,28.0,2,10,-8
109,2,54,1,10,0,129,116,195,181,91,58,50,67,48,56,60,70,65.0,62.0,10,4,6
150,3,54,1,10,0,215,227,336,327,113,110,91,126,86,83,105,142,124.0,110.0,37,22,15
18,4,54,1,10,0,113,153,246,99,35,29,28,28,17,19,21,32,26.0,24.0,11,2,9
93,5,54,1,10,0,194,267,387,398,155,108,95,80,69,76,114,107,110.0,99.0,-7,38,-45
149,6,54,1,10,0,262,301,471,484,121,103,101,118,103,101,112,137,124.0,117.0,25,11,14
387,7,54,1,10,0,629,591,961,723,263,300,312,311,242,273,332,372,352.0,326.0,40,59,-19
77,8,54,1,10,0,114,133,167,149,66,59,57,51,58,45,92,92,92.0,76.0,0,47,-47
35,9,54,1,10,0,142,134,176,97,19,44,38,31,35,30,38,44,41.0,37.0,6,8,-2
17,10,54,1,10,0,44,52,62,66,20,31,15,25,9,23,18,12,15.0,18.0,-6,-5,-1
93,11,54,1,10,0,289,312,450,333,168,137,94,101,95,97,80,87,84.0,88.0,7,-17,24
109,12,54,1,10,0,141,164,252,264,69,58,63,82,66,58,86,106,96.0,83.0,20,28,-8
175,13,54,1,10,0,281,338,473,362,182,165,226,205,142,157,221,184,202.0,187.0,-37,64,-101
323,14,54,1,10,0,457,535,679,669,213,223,212,206,190,239,237,292,264.0,256.0,55,-2,57
59,15,54,1,10,0,167,161,255,131,59,54,69,64,57,47,53,54,54.0,51.0,1,6,-5
149,16,54,1,10,0,258,278,385,450,105,110,104,89,90,81,127,134,130.0,114.0,7,46,-39
419,17,54,1,10,0,378,533,776,857,222,262,247,257,219,243,308,415,362.0,322.0,107,65,42
25,18,54,1,10,0,51,83,65,41,21,20,20,33,19,21,25,14,20.0,20.0,-11,4,-15
69,19,54,1,10,0,128,129,166,109,50,66,72,45,46,43,59,62,60.0,55.0,3,16,-13
77,20,54,1,10,0,175,189,306,256,58,77,65,70,84,67,84,87,86.0,79.0,3,17,-14
320,21,54,1,10,0,421,381,634,493,193,190,176,193,161,204,222,237,230.0,221.0,15,18,-3
95,22,54,1,10,0,126,204,277,131,70,96,70,62,54,66,59,76,68.0,67.0,17,-7,24
82,1,55,1,10,0,167,211,361,138,71,95,74,75,111,81,104,108,106.0,98.0,4,23,-19
567,2,55,1,10,0,521,434,743,406,299,256,259,276,323,373,379,361,370.0,371.0,-18,6,-24
412,3,55,1,10,0,366,390,683,304,135,211,181,248,260,314,339,378,358.0,344.0,39,25,14
115,4,55,1,10,0,302,357,675,173,56,121,79,138,89,102,103,129,116.0,111.0,26,1,25
1202,5,55,1,10,0,1137,1318,2057,1186,681,782,644,814,979,1044,1182,1106,1144.0,1111.0,-76,138,-214
391,6,55,1,10,0,476,493,865,574,194,213,248,307,345,317,346,361,354.0,341.0,15,29,-14
826,7,55,1,10,0,870,894,1538,723,282,412,473,536,614,680,774,720,747.0,725.0,-54,94,-148
1059,8,55,1,10,0,495,510,974,417,214,254,346,509,560,656,816,685,750.0,719.0,-131,160,-291
619,9,55,1,10,0,702,768,1105,569,259,493,354,430,585,484,578,575,576.0,546.0,-3,94,-97
224,10,55,1,10,0,208,212,406,260,101,165,105,174,218,194,217,225,221.0,212.0,8,23,-15
672,11,55,1,10,0,828,786,1332,698,402,409,494,495,557,550,609,567,588.0,575.0,-42,59,-101
351,12,55,1,10,0,363,356,774,420,110,193,205,216,298,283,295,291,293.0,290.0,-4,12,-16
1509,13,55,1,10,0,974,964,2069,891,397,516,929,990,983,1137,1295,1153,1224.0,1195.0,-142,158,-300
1114,14,55,1,10,0,913,934,1916,1026,330,387,521,645,908,946,966,847,906.0,920.0,-119,20,-139
469,15,55,1,10,0,663,556,982,370,195,281,311,304,395,371,467,405,436.0,414.0,-62,96,-158
326,16,55,1,10,0,300,389,721,401,105,159,186,195,272,290,243,277,260.0,270.0,34,-47,81
559,17,55,1,10,0,567,687,1290,631,205,298,333,363,464,424,425,552,488.0,467.0,127,1,126
199,18,55,1,10,0,240,253,385,180,95,138,114,150,154,163,198,154,176.0,172.0,-44,35,-79
175,19,55,1,10,0,211,226,330,135,104,181,144,138,167,145,200,198,199.0,181.0,-2,55,-57
667,20,55,1,10,0,844,751,1420,661,420,464,477,481,631,557,639,617,628.0,604.0,-22,82,-104
909,21,55,1,10,0,623,639,1234,604,184,336,402,415,468,687,690,661,676.0,679.0,-29,3,-32
158,22,55,1,10,0,126,150,236,76,111,111,78,108,134,127,165,146,156.0,146.0,-19,38,-57
354,1,56,1,10,0,412,620,805,357,95,198,187,218,252,286,379,461,420.0,375.0,82,93,-11
996,2,56,1,10,0,856,921,1249,829,418,522,444,470,542,766,801,741,771.0,769.0,-60,35,-95
875,3,56,1,10,0,528,675,925,601,288,415,322,461,499,595,688,789,738.0,691.0,101,93,8
287,4,56,1,10,0,532,779,1421,437,212,313,278,276,253,302,320,338,329.0,320.0,18,18,0
1737,5,56,1,10,0,1620,1861,2915,2183,903,1084,938,1042,1247,1538,1846,1788,1817.0,1724.0,-58,308,-366
739,6,56,1,10,0,757,934,1307,1141,304,330,322,356,545,585,712,755,734.0,684.0,43,127,-84
1211,7,56,1,10,0,1214,1192,1610,1006,389,569,611,624,776,1014,1189,1170,1180.0,1124.0,-19,175,-194
718,8,56,1,10,0,511,601,970,406,198,368,305,370,503,552,733,652,692.0,646.0,-81,181,-262
1748,9,56,1,10,0,1507,1902,2685,1203,341,825,879,785,1142,1134,1550,1490,1520.0,1391.0,-60,416,-476
365,10,56,1,10,0,352,440,665,433,149,235,168,197,226,296,330,369,350.0,332.0,39,34,5
1868,11,56,1,10,0,1598,1955,2752,1481,650,861,854,961,1280,1420,1671,1770,1720.0,1620.0,99,251,-152
474,12,56,1,10,0,475,511,802,624,159,229,268,266,354,440,475,407,441.0,441.0,-68,35,-103
1560,13,56,1,10,0,905,1021,1551,970,478,608,767,810,890,1254,1423,1432,1428.0,1370.0,9,169,-160
2048,14,56,1,10,0,1399,1530,2696,1928,502,672,701,850,1415,1787,1789,1724,1756.0,1767.0,-65,2,-67
1857,15,56,1,10,0,1351,1499,2124,704,292,530,641,696,932,1254,1486,1797,1642.0,1512.0,311,232,79
716,16,56,1,10,0,620,794,1252,837,201,313,330,347,462,609,643,609,626.0,620.0,-34,34,-68
1066,17,56,1,10,0,1339,1478,2360,1657,503,671,579,591,827,934,1043,1138,1090.0,1038.0,95,109,-14
521,18,56,1,10,0,399,601,698,428,129,211,219,281,359,378,470,543,506.0,464.0,73,92,-19
290,19,56,1,10,0,306,361,459,235,125,226,187,250,248,334,351,316,334.0,334.0,-35,17,-52
1555,20,56,1,10,0,1487,1581,2727,1846,758,896,740,908,1151,1313,1405,1572,1488.0,1430.0,167,92,75
1110,21,56,1,10,0,827,896,1319,905,333,426,445,444,565,798,975,991,983.0,921.0,16,177,-161
258,22,56,1,10,0,256,312,397,173,117,199,155,143,190,253,271,281,276.0,268.0,10,18,-8
26,1,57,3,10,0,27,30,34,19,29,28,25,38,29,32,29,27,28.0,29.0,-2,-3,1
1016,2,57,3,10,0,1736,1547,1939,1680,1190,1187,815,815,786,875,755,817,786.0,816.0,62,-120,182
61,3,57,3,10,0,93,105,108,54,78,117,71,70,60,56,65,70,68.0,64.0,5,9,-4
59,4,57,3,10,0,198,305,504,106,118,157,120,110,104,70,81,80,80.0,77.0,-1,11,-12
495,5,57,3,10,0,655,773,955,603,645,678,519,472,474,468,514,523,518.0,502.0,9,46,-37
119,6,57,3,10,0,214,225,272,216,223,191,165,153,149,145,130,226,178.0,167.0,96,-15,111
319,7,57,3,10,0,551,636,1105,629,541,513,451,400,375,388,431,348,390.0,389.0,-83,43,-126
118,8,57,3,10,0,118,161,233,166,115,127,118,117,113,93,103,99,101.0,98.0,-4,10,-14
326,9,57,3,10,0,624,713,866,346,505,757,513,503,519,390,440,464,452.0,431.0,24,50,-26
26,10,57,3,10,0,63,75,97,92,50,85,53,57,36,20,17,40,28.0,26.0,23,-3,26
383,11,57,3,10,0,763,871,1150,610,843,857,623,558,495,522,542,537,540.0,534.0,-5,20,-25
55,12,57,3,10,0,92,117,148,132,89,105,90,70,62,87,69,109,89.0,88.0,40,-18,58
446,13,57,3,10,0,554,769,983,537,616,685,621,541,500,570,609,477,543.0,552.0,-132,39,-171
530,14,57,3,10,0,746,952,1314,922,778,753,612,592,519,715,609,950,780.0,758.0,341,-106,447
303,15,57,3,10,0,456,466,653,312,498,511,368,351,319,353,307,303,305.0,321.0,-4,-46,42
287,16,57,3,10,0,592,590,903,514,438,482,408,403,314,306,325,383,354.0,338.0,58,19,39
207,17,57,3,10,0,327,426,575,405,314,375,353,267,377,276,257,258,258.0,264.0,1,-19,20
103,18,57,3,10,0,179,175,195,85,140,157,133,146,133,94,101,94,98.0,96.0,-7,7,-14
162,19,57,3,10,0,260,281,370,158,187,236,191,184,170,200,162,165,164.0,176.0,3,-38,41
462,20,57,3,10,0,645,706,955,636,643,771,438,521,498,470,463,469,466.0,467.0,6,-7,13
118,21,57,3,10,0,209,280,324,195,155,198,180,157,132,131,161,154,158.0,149.0,-7,30,-37
20,22,57,3,10,0,59,76,90,35,48,67,46,41,40,28,43,38,40.0,36.0,-5,15,-20
59,1,58,2,10,0,159,193,281,60,52,74,61,69,81,59,68,101,84.0,76.0,33,9,24
230,2,58,2,10,0,224,227,356,181,119,130,103,154,125,106,113,128,120.0,116.0,15,7,8
89,3,58,2,10,0,129,183,244,117,67,81,65,79,55,51,79,82,80.0,71.0,3,28,-25
91,4,58,2,10,0,326,417,805,105,52,132,97,103,144,172,170,133,152.0,158.0,-37,-2,-35
533,5,58,2,10,0,824,910,1456,816,454,505,463,516,491,453,624,583,604.0,553.0,-41,171,-212
108,6,58,2,10,0,267,287,463,251,96,133,88,118,91,110,111,129,120.0,117.0,18,1,17
344,7,58,2,10,0,679,738,1182,600,283,311,395,408,271,332,415,347,381.0,365.0,-68,83,-151
197,8,58,2,10,0,243,264,497,192,96,135,117,169,144,132,175,152,164.0,153.0,-23,43,-66
267,9,58,2,10,0,574,615,869,297,127,271,262,258,278,238,265,297,281.0,267.0,32,27,5
139,10,58,2,10,0,205,233,425,254,71,136,107,135,145,104,103,124,114.0,110.0,21,-1,22
334,11,58,2,10,0,731,749,1017,461,270,342,363,373,289,260,265,382,324.0,302.0,117,5,112
111,12,58,2,10,0,198,198,315,211,60,84,84,68,64,78,105,104,104.0,96.0,-1,27,-28
524,13,58,2,10,0,682,755,1430,754,390,398,481,498,419,459,630,477,554.0,522.0,-153,171,-324
417,14,58,2,10,0,876,865,1601,892,268,371,333,363,396,440,436,415,426.0,430.0,-21,-4,-17
263,15,58,2,10,0,406,420,845,174,81,170,192,246,204,243,235,258,246.0,245.0,23,-8,31
69,16,58,2,10,0,128,133,246,134,39,47,55,60,48,51,63,57,60.0,57.0,-6,12,-18
199,17,58,2,10,0,335,447,756,439,130,231,191,211,178,177,209,244,226.0,210.0,35,32,3
80,18,58,2,10,0,175,166,247,102,51,67,60,67,91,79,101,94,98.0,91.0,-7,22,-29
20,19,58,2,10,0,54,102,113,47,21,29,27,30,22,21,21,18,20.0,20.0,-3,0,-3
436,20,58,2,10,0,548,596,1578,630,283,298,337,395,444,428,519,438,478.0,462.0,-81,91,-172
354,21,58,2,10,0,455,558,938,498,189,261,260,236,226,286,349,325,337.0,320.0,-24,63,-87
8,22,58,2,10,0,16,45,45,7,10,21,11,20,18,12,17,12,14.0,14.0,-5,5,-10
302,1,59,2,10,0,393,448,746,228,125,223,190,233,237,1154,290,404,347.0,616.0,114,-864,978
86,2,59,2,10,0,266,224,235,105,67,68,72,70,100,79,62,75,68.0,72.0,13,-17,30
84,3,59,2,10,0,289,273,340,208,63,95,64,75,89,75,89,111,100.0,92.0,22,14,8
34,4,59,2,10,0,156,179,362,72,29,64,61,50,56,417,666,51,358.0,378.0,-615,249,-864
297,5,59,2,10,0,730,631,1027,542,251,246,265,230,226,834,315,368,342.0,506.0,53,-519,572
523,6,59,2,10,0,755,678,1434,792,244,232,308,344,363,315,452,583,518.0,450.0,131,137,-6
555,7,59,2,10,0,1380,1053,1685,823,326,341,453,371,362,372,520,630,575.0,507.0,110,148,-38
206,8,59,2,10,0,386,479,604,321,126,162,162,182,154,558,292,187,240.0,346.0,-105,-266,161
509,9,59,2,10,0,936,1038,1493,451,130,374,366,407,481,329,409,478,444.0,405.0,69,80,-11
198,10,59,2,10,0,349,312,543,250,76,136,99,136,130,103,145,204,174.0,151.0,59,42,17
1091,11,59,2,10,0,1650,1467,2828,1205,656,751,787,807,758,1395,929,1015,972.0,1113.0,86,-466,552
451,12,59,2,10,0,626,577,1241,549,138,232,271,262,250,268,377,418,398.0,354.0,41,109,-68
366,13,59,2,10,0,840,561,1020,602,249,293,362,351,329,285,374,411,392.0,357.0,37,89,-52
1206,14,59,2,10,0,959,1021,1584,992,320,512,660,557,721,719,991,1189,1090.0,966.0,198,272,-74
496,15,59,2,10,0,828,859,1272,386,193,342,341,375,377,337,402,499,450.0,413.0,97,65,32
390,16,59,2,10,0,691,751,1208,523,161,272,326,270,280,775,316,371,344.0,487.0,55,-459,514
434,17,59,2,10,0,522,619,891,508,132,232,212,222,268,261,329,457,393.0,349.0,128,68,60
145,18,59,2,10,0,268,291,431,173,74,106,104,121,115,77,91,131,111.0,100.0,40,14,26
54,19,59,2,10,0,139,186,225,91,51,75,101,66,42,52,68,79,74.0,66.0,11,16,-5
70,20,59,2,10,0,182,148,242,128,33,53,51,65,76,57,46,63,54.0,55.0,17,-11,28
274,21,59,2,10,0,278,275,432,182,64,143,136,155,142,754,199,271,235.0,408.0,72,-555,627
14,22,59,2,10,0,83,61,140,53,29,33,28,48,27,21,28,21,24.0,23.0,-7,7,-14
87,1,60,1,10,0,113,162,163,142,84,128,99,108,102,143,141,92,116.0,125.0,-49,-2,-47
78,2,60,1,10,0,95,152,131,146,84,119,80,84,87,136,120,95,108.0,117.0,-25,-16,-9
69,3,60,1,10,0,97,81,90,83,41,62,87,86,67,58,68,69,68.0,65.0,1,10,-9
67,4,60,1,10,0,79,100,123,88,65,74,70,62,63,53,50,55,52.0,53.0,5,-3,8
197,5,60,1,10,0,284,279,330,341,184,223,201,224,188,192,262,301,282.0,252.0,39,70,-31
155,6,60,1,10,0,170,183,198,254,107,149,150,152,146,136,174,138,156.0,149.0,-36,38,-74
155,7,60,1,10,0,152,160,191,159,74,162,163,162,117,116,158,179,168.0,151.0,21,42,-21
26,8,60,1,10,0,32,31,28,41,25,46,41,28,30,28,32,32,32.0,31.0,0,4,-4
480,9,60,1,10,0,541,658,638,568,264,527,387,410,437,440,502,480,491.0,474.0,-22,62,-84
132,10,60,1,10,0,163,172,213,297,121,197,152,163,152,143,162,143,152.0,149.0,-19,19,-38
314,11,60,1,10,0,385,402,439,430,213,408,324,345,284,373,290,342,316.0,335.0,52,-83,135
85,12,60,1,10,0,87,76,120,103,50,101,76,71,82,82,105,75,90.0,87.0,-30,23,-53
110,13,60,1,10,0,82,85,95,109,50,116,95,137,104,134,131,121,126.0,129.0,-10,-3,-7
125,14,60,1,10,0,141,134,164,130,78,142,114,90,124,140,149,132,140.0,140.0,-17,9,-26
278,15,60,1,10,0,339,364,397,466,185,307,317,322,277,351,327,287,307.0,322.0,-40,-24,-16
183,16,60,1,10,0,184,244,236,270,129,200,183,140,190,186,222,164,193.0,191.0,-58,36,-94
230,17,60,1,10,0,308,355,445,519,215,330,301,296,262,319,373,282,328.0,325.0,-91,54,-145
89,18,60,1,10,0,87,125,99,145,57,96,88,101,91,78,106,100,103.0,95.0,-6,28,-34
99,19,60,1,10,0,115,126,155,89,59,109,102,100,85,79,140,123,132.0,114.0,-17,61,-78
92,20,60,1,10,0,173,179,214,160,89,140,134,104,264,151,136,117,126.0,135.0,-19,-15,-4
301,21,60,1,10,0,263,252,263,274,154,228,212,258,163,256,338,207,272.0,267.0,-131,82,-213
56,22,60,1,10,0,54,66,57,65,35,91,67,47,50,39,70,62,66.0,57.0,-8,31,-39
286,1,1,1,11,0,369,374,305,193,309,264,241,251,240,298,308,270,289.0,292.0,-38,10,-48
333,2,1,1,11,0,402,456,434,194,302,243,321,230,362,323,306,298,302.0,309.0,-8,-17,9
180,3,1,1,11,0,204,219,180,128,201,176,192,155,199,170,176,134,155.0,160.0,-42,6,-48
297,4,1,1,11,0,460,563,468,432,472,340,407,314,302,310,293,226,260.0,276.0,-67,-17,-50
332,5,1,1,11,0,453,570,500,253,378,337,331,336,304,330,449,303,376.0,361.0,-146,119,-265
158,6,1,1,11,0,179,226,198,76,132,155,144,166,155,166,192,153,172.0,170.0,-39,26,-65
467,7,1,1,11,0,483,601,468,290,412,484,450,432,449,413,563,371,467.0,449.0,-192,150,-342
188,8,1,1,11,0,215,260,248,146,249,182,251,173,213,197,239,166,202.0,201.0,-73,42,-115
2953,9,1,1,11,0,3532,3800,2692,1680,2958,2368,2754,2696,2582,2782,2822,2740,2781.0,2781.0,-82,40,-122
307,10,1,1,11,0,472,505,425,248,383,277,377,293,309,331,402,304,353.0,346.0,-98,71,-169
694,11,1,1,11,0,871,1010,800,486,817,617,720,689,718,682,759,664,712.0,702.0,-95,77,-172
189,12,1,1,11,0,204,262,236,78,191,154,186,149,156,168,164,152,158.0,161.0,-12,-4,-8
305,13,1,1,11,0,291,305,260,190,297,311,328,293,325,352,363,288,326.0,334.0,-75,11,-86
282,14,1,1,11,0,521,505,405,250,355,393,307,297,380,309,344,274,309.0,309.0,-70,35,-105
676,15,1,1,11,0,660,865,633,409,621,561,562,591,624,669,649,620,634.0,646.0,-29,-20,-9
307,16,1,1,11,0,480,474,497,228,445,423,403,455,424,361,409,246,328.0,339.0,-163,48,-211
308,17,1,1,11,0,364,474,347,174,297,304,284,259,316,280,304,238,271.0,274.0,-66,24,-90
291,18,1,1,11,0,331,404,292,181,307,209,324,299,311,316,288,299,294.0,301.0,11,-28,39
725,19,1,1,11,0,941,997,650,566,775,692,738,626,805,715,744,592,668.0,684.0,-152,29,-181
116,20,1,1,11,0,155,199,115,72,126,107,119,138,135,104,119,88,104.0,104.0,-31,15,-46
342,21,1,1,11,0,393,440,305,219,295,292,328,285,305,307,293,289,291.0,296.0,-4,-14,10
302,22,1,1,11,0,458,461,292,234,401,305,324,284,313,335,248,234,241.0,272.0,-14,-87,73
528,1,2,2,11,0,639,518,268,263,442,321,383,408,481,506,615,423,519.0,515.0,-192,109,-301
474,2,2,2,11,0,609,519,292,264,403,325,415,354,487,506,484,430,457.0,473.0,-54,-22,-32
334,3,2,2,11,0,370,337,175,149,316,260,258,252,263,332,312,348,330.0,331.0,36,-20,56
344,4,2,2,11,0,675,811,368,359,470,369,376,352,396,326,421,261,341.0,336.0,-160,95,-255
951,5,2,2,11,0,1053,1125,657,560,806,700,679,724,721,901,1021,668,844.0,863.0,-353,120,-473
556,6,2,2,11,0,574,507,301,225,317,315,350,352,460,517,524,468,496.0,503.0,-56,7,-63
1337,7,2,2,11,0,1567,1574,775,729,1060,1229,1119,1113,1342,1502,1693,1251,1472.0,1482.0,-442,191,-633
486,8,2,2,11,0,590,571,290,239,407,358,384,335,452,519,543,477,510.0,513.0,-66,24,-90
10371,9,2,2,11,0,13598,11515,5136,4688,10371,8733,8990,9100,9110,10367,11177,10502,10840.0,10682.0,-675,810,-1485
1026,10,2,2,11,0,1386,1258,750,559,1074,832,939,901,1075,1222,1237,949,1093.0,1136.0,-288,15,-303
2416,11,2,2,11,0,3112,2877,1445,1635,2184,1828,1916,1948,2090,2406,2465,2160,2312.0,2344.0,-305,59,-364
499,12,2,2,11,0,595,741,435,311,545,463,483,513,576,577,634,470,552.0,560.0,-164,57,-221
1146,13,2,2,11,0,1137,974,498,486,847,1025,993,829,1052,1183,1231,1018,1124.0,1144.0,-213,48,-261
1082,14,2,2,11,0,1273,1234,645,486,968,944,932,1043,1153,1163,1133,861,997.0,1052.0,-272,-30,-242
2107,15,2,2,11,0,2709,2467,1135,1205,1969,1744,1919,1847,2165,2419,2373,1801,2087.0,2198.0,-572,-46,-526
944,16,2,2,11,0,1001,1050,703,508,734,619,699,876,984,989,1033,795,914.0,939.0,-238,44,-282
869,17,2,2,11,0,1112,1192,689,445,769,687,748,707,821,1006,917,750,834.0,891.0,-167,-89,-78
1626,18,2,2,11,0,2205,1578,856,899,1607,1181,1494,1511,1522,1699,1828,1443,1636.0,1657.0,-385,129,-514
2177,19,2,2,11,0,2892,2161,1110,1306,1905,1837,1784,1845,2218,2361,2147,1842,1994.0,2117.0,-305,-214,-91
315,20,2,2,11,0,470,398,244,215,285,259,240,371,328,317,303,226,264.0,282.0,-77,-14,-63
572,21,2,2,11,0,582,607,340,260,369,435,466,394,526,525,529,505,517.0,520.0,-24,4,-28
1050,22,2,2,11,0,1076,1018,447,521,1186,639,827,849,957,1229,987,782,884.0,999.0,-205,-242,37
146,1,3,1,11,0,163,167,157,101,187,162,155,200,158,195,163,105,134.0,154.0,-58,-32,-26
336,2,3,1,11,0,354,350,290,213,293,226,236,265,410,329,332,296,314.0,319.0,-36,3,-39
204,3,3,1,11,0,184,233,279,174,228,241,255,251,306,251,232,183,208.0,222.0,-49,-19,-30
331,4,3,1,11,0,611,677,549,387,627,524,389,503,552,475,412,404,408.0,430.0,-8,-63,55
442,5,3,1,11,0,411,434,516,235,377,355,370,404,481,373,432,264,348.0,356.0,-168,59,-227
140,6,3,1,11,0,128,138,176,83,127,116,129,142,151,124,165,116,140.0,135.0,-49,41,-90
400,7,3,1,11,0,415,400,420,235,353,334,323,407,400,410,471,322,396.0,401.0,-149,61,-210
164,8,3,1,11,0,141,197,179,103,189,173,157,177,211,167,160,125,142.0,151.0,-35,-7,-28
1849,9,3,1,11,0,1989,1829,1713,1159,1738,1536,1581,1833,1828,1593,1985,1468,1726.0,1682.0,-517,392,-909
222,10,3,1,11,0,181,173,211,121,197,149,174,163,216,133,185,158,172.0,159.0,-27,52,-79
444,11,3,1,11,0,437,427,470,296,446,386,375,444,454,461,476,350,413.0,429.0,-126,15,-141
135,12,3,1,11,0,107,109,126,55,113,112,112,126,130,154,177,120,148.0,150.0,-57,23,-80
363,13,3,1,11,0,302,328,389,251,371,364,437,425,531,444,375,300,338.0,373.0,-75,-69,-6
333,14,3,1,11,0,352,337,377,202,331,306,338,396,390,320,382,301,342.0,334.0,-81,62,-143
410,15,3,1,11,0,428,424,401,264,349,335,366,380,435,444,478,383,430.0,435.0,-95,34,-129
219,16,3,1,11,0,267,280,321,189,271,255,230,322,292,267,293,194,244.0,251.0,-99,26,-125
222,17,3,1,11,0,244,275,284,146,275,262,250,285,292,286,299,216,258.0,267.0,-83,13,-96
123,18,3,1,11,0,151,157,167,81,107,85,111,132,133,94,129,102,116.0,108.0,-27,35,-62
552,19,3,1,11,0,464,567,506,316,529,433,489,457,606,708,531,506,518.0,582.0,-25,-177,152
143,20,3,1,11,0,184,155,213,116,188,148,168,179,203,176,174,114,144.0,155.0,-60,-2,-58
173,21,3,1,11,0,252,267,297,206,288,291,280,277,346,254,290,201,246.0,248.0,-89,36,-125
233,22,3,1,11,0,258,336,315,155,306,267,240,317,304,316,199,191,195.0,235.0,-8,-117,109
244,1,4,2,11,0,212,210,117,96,135,131,161,142,167,201,221,204,212.0,209.0,-17,20,-37
430,2,4,2,11,0,270,308,173,110,159,185,191,176,253,332,399,317,358.0,349.0,-82,67,-149
182,3,4,2,11,0,165,176,89,72,136,148,139,117,145,167,204,226,215.0,199.0,22,37,-15
176,4,4,2,11,0,246,342,136,109,179,166,96,85,131,159,164,150,157.0,158.0,-14,5,-19
470,5,4,2,11,0,438,436,351,212,361,425,290,324,427,553,667,370,518.0,530.0,-297,114,-411
329,6,4,2,11,0,325,348,264,151,204,182,203,195,266,313,338,363,350.0,338.0,25,25,0
608,7,4,2,11,0,468,556,225,175,357,467,449,285,377,522,729,587,658.0,613.0,-142,207,-349
227,8,4,2,11,0,144,181,92,70,148,181,165,127,190,198,230,208,219.0,212.0,-22,32,-54
5245,9,4,2,11,0,4216,4195,2391,1639,3992,3988,3668,3906,4522,4949,5596,4889,5242.0,5145.0,-707,647,-1354
544,10,4,2,11,0,432,386,248,166,443,418,434,344,461,540,630,553,592.0,574.0,-77,90,-167
1183,11,4,2,11,0,1033,1154,680,651,982,1039,1051,947,1072,1268,1400,1213,1306.0,1294.0,-187,132,-319
388,12,4,2,11,0,302,351,208,96,254,328,298,271,331,451,520,466,493.0,479.0,-54,69,-123
535,13,4,2,11,0,397,419,248,284,584,570,485,345,559,623,645,615,630.0,628.0,-30,22,-52
725,14,4,2,11,0,567,651,338,242,578,638,439,516,644,816,854,726,790.0,799.0,-128,38,-166
1612,15,4,2,11,0,1343,1310,747,739,1438,1404,1200,1131,1522,1730,1887,1466,1676.0,1694.0,-421,157,-578
715,16,4,2,11,0,677,787,450,226,461,459,468,446,524,665,780,873,826.0,773.0,93,115,-22
645,17,4,2,11,0,474,674,394,223,436,554,554,548,663,787,891,679,785.0,786.0,-212,104,-316
825,18,4,2,11,0,615,519,231,173,535,612,676,709,737,966,1034,837,936.0,946.0,-197,68,-265
865,19,4,2,11,0,652,848,213,233,610,646,562,459,596,792,810,690,750.0,764.0,-120,18,-138
168,20,4,2,11,0,157,208,123,85,166,157,116,162,140,173,200,168,184.0,180.0,-32,27,-59
331,21,4,2,11,0,225,317,148,105,202,242,221,226,279,358,344,333,338.0,345.0,-11,-14,3
519,22,4,2,11,0,288,303,90,85,233,244,241,205,236,349,303,327,315.0,326.0,24,-46,70
208,1,5,3,11,0,249,477,199,177,267,169,193,170,168,208,216,192,204.0,205.0,-24,8,-32
3111,2,5,3,11,0,3216,4503,4785,3067,2754,2281,2227,1995,2206,1981,2469,3585,3027.0,2678.0,1116,488,628
620,3,5,3,11,0,520,675,504,451,680,487,440,356,384,433,467,506,486.0,469.0,39,34,5
116,4,5,3,11,0,305,514,151,92,197,124,132,112,101,80,136,106,121.0,107.0,-30,56,-86
1366,5,5,3,11,0,1411,1954,1724,1537,1481,1090,1021,990,1018,1119,1242,1321,1282.0,1227.0,79,123,-44
1314,6,5,3,11,0,1535,2328,2152,1881,1518,1284,1266,1165,1072,1126,1266,1339,1302.0,1244.0,73,140,-67
2974,7,5,3,11,0,3907,6576,4483,3060,2839,2545,2879,2279,2583,2917,2744,3229,2986.0,2963.0,485,-173,658
1670,8,5,3,11,0,1585,2844,2093,1361,1353,1118,1259,955,1154,1235,1338,1662,1500.0,1412.0,324,103,221
1650,9,5,3,11,0,2007,3029,1611,1579,2180,1684,1684,1682,1409,1573,1720,1696,1708.0,1663.0,-24,147,-171
1801,10,5,3,11,0,2687,4443,3084,1836,2310,1540,1616,1343,1308,1943,1360,1586,1473.0,1630.0,226,-583,809
1898,11,5,3,11,0,1942,3067,2165,2419,2029,1601,1578,1375,1523,1501,1651,1865,1758.0,1672.0,214,150,64
761,12,5,3,11,0,980,1510,1290,922,875,668,648,536,537,656,666,811,738.0,711.0,145,10,135
3669,13,5,3,11,0,3641,6231,3870,3403,2945,3015,3119,2522,2789,2808,2753,3344,3048.0,2968.0,591,-55,646
3278,14,5,3,11,0,4668,7650,5825,3564,3197,2704,2715,2598,2658,2563,2664,3259,2962.0,2829.0,595,101,494
1393,15,5,3,11,0,1294,2062,1260,1629,1592,1156,1224,1121,1218,1188,1319,1309,1314.0,1272.0,-10,131,-141
1055,16,5,3,11,0,1353,2198,1919,1140,1262,895,1069,835,836,949,1018,1151,1084.0,1039.0,133,69,64
1290,17,5,3,11,0,1770,2693,2364,1506,1541,1174,1020,997,939,1035,1185,1214,1200.0,1145.0,29,150,-121
440,18,5,3,11,0,688,892,592,650,741,463,546,473,389,402,400,437,418.0,413.0,37,-2,39
1156,19,5,3,11,0,1154,1710,924,939,1322,959,988,854,912,964,1041,839,940.0,948.0,-202,77,-279
273,20,5,3,11,0,250,357,250,248,235,212,191,173,197,218,241,244,242.0,234.0,3,23,-20
1664,21,5,3,11,0,1877,3217,2072,1105,1314,1222,1105,910,1051,1117,1406,1562,1484.0,1362.0,156,289,-133
743,22,5,3,11,0,816,982,506,518,806,657,585,602,530,544,540,569,554.0,551.0,29,-4,33
363,1,6,1,11,0,582,623,382,114,351,229,285,289,234,347,399,276,338.0,341.0,-123,52,-175
594,2,6,1,11,0,546,680,484,300,452,403,419,390,633,639,493,556,524.0,563.0,63,-146,209
626,3,6,1,11,0,836,832,551,317,489,505,604,525,595,623,640,628,634.0,630.0,-12,17,-29
126,4,6,1,11,0,440,598,212,102,180,142,124,93,130,133,130,95,112.0,119.0,-35,-3,-32
1042,5,6,1,11,0,1385,1850,1223,671,850,790,838,870,1020,1346,1101,933,1017.0,1127.0,-168,-245,77
990,6,6,1,11,0,1491,1666,1515,717,1018,980,1077,1165,1206,1280,1168,1138,1153.0,1195.0,-30,-112,82
2008,7,6,1,11,0,2146,2737,1706,842,1734,1902,2031,1983,2192,2226,2022,2178,2100.0,2142.0,156,-204,360
659,8,6,1,11,0,762,993,533,312,595,582,569,606,683,717,614,692,653.0,674.0,78,-103,181
5979,9,6,1,11,0,6734,6492,5607,2647,5713,4896,5717,5445,4899,5914,5863,5896,5880.0,5891.0,33,-51,84
643,10,6,1,11,0,853,894,799,409,719,453,603,532,611,719,734,660,697.0,704.0,-74,15,-89
1842,11,6,1,11,0,2584,2672,1728,1016,1729,1498,1701,1735,1850,1857,1722,1874,1798.0,1818.0,152,-135,287
830,12,6,1,11,0,1086,1291,1027,356,690,687,838,753,813,1041,905,884,894.0,943.0,-21,-136,115
2498,13,6,1,11,0,2327,2703,2119,1271,2126,2486,2863,2426,2914,2989,2361,2420,2390.0,2590.0,59,-628,687
2633,14,6,1,11,0,2797,3447,2952,1308,2514,2566,2841,2880,3363,3319,2677,2531,2604.0,2842.0,-146,-642,496
1301,15,6,1,11,0,1632,1972,795,459,876,905,1141,1077,1165,1379,1241,1255,1248.0,1292.0,14,-138,152
1304,16,6,1,11,0,1663,2151,1566,597,1095,1029,1047,1133,1293,1344,1288,1247,1268.0,1293.0,-41,-56,15
1538,17,6,1,11,0,1966,2770,1651,844,1487,1573,1636,1382,1564,1802,1482,1432,1457.0,1572.0,-50,-320,270
479,18,6,1,11,0,447,476,264,148,314,267,427,418,348,436,384,415,400.0,412.0,31,-52,83
502,19,6,1,11,0,403,513,241,211,360,293,362,342,372,462,408,449,428.0,440.0,41,-54,95
575,20,6,1,11,0,803,1149,803,328,472,453,543,623,549,633,579,475,527.0,562.0,-104,-54,-50
533,21,6,1,11,0,655,845,620,247,468,497,551,436,566,577,553,626,590.0,585.0,73,-24,97
654,22,6,1,11,0,740,1032,399,306,506,449,585,503,512,594,572,502,537.0,556.0,-70,-22,-48
1329,1,7,3,11,0,977,1212,1265,890,1247,1119,1184,1456,1316,1194,1258,958,1108.0,1137.0,-300,64,-364
144,2,7,3,11,0,66,119,104,63,214,133,132,248,173,187,150,190,170.0,176.0,40,-37,77
144,3,7,3,11,0,56,75,86,64,154,131,164,163,146,193,187,137,162.0,172.0,-50,-6,-44
1425,4,7,3,11,0,793,1627,1352,1114,1508,1132,1430,1670,1367,1416,1463,1056,1260.0,1312.0,-407,47,-454
309,5,7,3,11,0,145,321,208,187,254,335,308,285,276,420,431,254,342.0,368.0,-177,11,-188
357,6,7,3,11,0,176,251,253,175,322,340,315,352,311,384,398,291,344.0,358.0,-107,14,-121
1365,7,7,3,11,0,739,1047,878,649,1303,1248,1216,1405,1283,1284,1321,1189,1255.0,1265.0,-132,37,-169
376,8,7,3,11,0,105,184,165,123,244,320,272,242,233,292,344,209,276.0,282.0,-135,52,-187
1148,9,7,3,11,0,571,819,762,448,944,1100,1025,1038,994,984,1134,946,1040.0,1021.0,-188,150,-338
133,10,7,3,11,0,45,96,92,54,103,134,119,86,123,99,126,97,112.0,107.0,-29,27,-56
1341,11,7,3,11,0,731,1002,974,650,1188,1289,1048,1276,1137,1253,1328,1121,1224.0,1234.0,-207,75,-282
201,12,7,3,11,0,74,97,118,85,164,140,153,162,165,154,204,178,191.0,179.0,-26,50,-76
821,13,7,3,11,0,288,493,470,361,599,660,769,569,656,773,873,579,726.0,742.0,-294,100,-394
742,14,7,3,11,0,366,596,517,345,763,731,685,764,754,849,909,743,826.0,834.0,-166,60,-226
1029,15,7,3,11,0,533,736,534,424,754,915,865,808,908,999,1113,743,928.0,952.0,-370,114,-484
266,16,7,3,11,0,94,173,151,103,240,253,187,234,272,286,270,205,238.0,254.0,-65,-16,-49
213,17,7,3,11,0,83,119,101,59,203,163,182,206,192,239,250,170,210.0,220.0,-80,11,-91
243,18,7,3,11,0,97,170,123,106,206,303,187,204,204,249,241,181,211.0,224.0,-60,-8,-52
399,19,7,3,11,0,151,300,181,154,357,324,363,378,413,435,413,296,354.0,381.0,-117,-22,-95
139,20,7,3,11,0,58,100,60,71,130,181,128,151,124,150,168,111,140.0,143.0,-57,18,-75
339,21,7,3,11,0,164,313,234,179,320,305,340,358,313,390,434,291,362.0,372.0,-143,44,-187
276,22,7,3,11,0,95,177,129,74,323,185,255,260,224,227,281,192,236.0,233.0,-89,54,-143
514,1,8,2,11,0,543,697,325,168,288,309,527,516,379,272,357,325,341.0,318.0,-32,85,-117
134,2,8,2,11,0,106,112,40,25,38,54,68,55,75,116,109,89,99.0,105.0,-20,-7,-13
54,3,8,2,11,0,60,75,31,18,29,46,51,51,61,78,46,46,46.0,57.0,0,-32,32
105,4,8,2,11,0,86,132,40,51,59,50,54,60,151,111,68,85,76.0,88.0,17,-43,60
259,5,8,2,11,0,278,408,216,117,192,175,229,259,209,437,371,295,333.0,368.0,-76,-66,-10
460,6,8,2,11,0,447,587,357,148,207,278,368,463,445,401,385,356,370.0,381.0,-29,-16,-13
333,7,8,2,11,0,477,555,320,180,373,400,374,355,402,517,287,263,275.0,356.0,-24,-230,206
79,8,8,2,11,0,55,64,30,23,28,38,44,60,71,103,47,63,55.0,71.0,16,-56,72
538,9,8,2,11,0,342,408,121,39,166,158,211,185,222,453,438,420,429.0,437.0,-18,-15,-3
111,10,8,2,11,0,86,129,68,34,47,50,71,60,56,125,119,131,125.0,125.0,12,-6,18
1072,11,8,2,11,0,1271,1767,893,628,788,879,1067,1002,995,690,648,797,722.0,712.0,149,-42,191
283,12,8,2,11,0,224,302,169,92,161,188,202,170,233,263,198,189,194.0,217.0,-9,-65,56
214,13,8,2,11,0,127,215,80,56,93,108,163,149,199,289,190,211,200.0,230.0,21,-99,120
313,14,8,2,11,0,320,368,183,97,185,329,340,259,262,298,278,272,275.0,283.0,-6,-20,14
691,15,8,2,11,0,941,1163,445,309,478,511,775,845,706,532,466,593,530.0,530.0,127,-66,193
275,16,8,2,11,0,287,401,211,94,172,184,195,243,185,256,244,251,248.0,250.0,7,-12,19
298,17,8,2,11,0,259,315,201,83,173,167,198,189,202,231,221,183,202.0,212.0,-38,-10,-28
156,18,8,2,11,0,117,145,54,20,51,78,114,140,134,168,156,185,170.0,170.0,29,-12,41
81,19,8,2,11,0,68,104,28,21,52,82,45,37,92,119,77,81,79.0,92.0,4,-42,46
133,20,8,2,11,0,57,62,28,20,37,37,33,64,92,101,91,99,95.0,97.0,8,-10,18
140,21,8,2,11,0,113,177,107,51,78,83,124,102,102,142,134,146,140.0,141.0,12,-8,20
34,22,8,2,11,0,28,30,11,11,8,18,20,17,27,60,33,21,27.0,38.0,-12,-27,15
1135,1,9,1,11,0,1537,1734,940,540,957,807,919,933,755,914,982,870,926.0,922.0,-112,68,-180
366,2,9,1,11,0,639,732,400,288,346,301,327,290,401,329,345,355,350.0,343.0,10,16,-6
354,3,9,1,11,0,493,573,322,195,323,333,363,302,240,293,382,398,390.0,358.0,16,89,-73
574,4,9,1,11,0,915,1057,659,394,601,489,595,532,503,449,472,373,422.0,431.0,-99,23,-122
1018,5,9,1,11,0,1293,1876,1072,611,873,761,808,800,793,898,1218,888,1053.0,1001.0,-330,320,-650
994,6,9,1,11,0,1287,1597,1015,457,773,664,769,751,688,875,1020,977,998.0,957.0,-43,145,-188
1407,7,9,1,11,0,1722,2394,1077,522,1253,1236,1215,1019,955,1078,1388,1080,1234.0,1182.0,-308,310,-618
597,8,9,1,11,0,581,742,375,248,450,310,404,335,340,378,448,532,490.0,453.0,84,70,14
1472,9,9,1,11,0,2163,2594,949,463,1024,892,976,1062,838,972,1048,1071,1060.0,1030.0,23,76,-53
411,10,9,1,11,0,502,713,341,210,322,222,345,302,257,262,298,338,318.0,299.0,40,36,4
1600,11,9,1,11,0,2059,2647,1466,939,1519,1181,1355,1281,1072,1305,1574,1407,1490.0,1429.0,-167,269,-436
1127,12,9,1,11,0,1083,1527,753,397,757,746,837,677,745,886,1080,1037,1058.0,1001.0,-43,194,-237
923,13,9,1,11,0,1012,1235,691,404,655,694,773,655,680,691,793,740,766.0,741.0,-53,102,-155
1363,14,9,1,11,0,1470,2122,1000,589,1119,1013,903,937,951,1080,1247,1099,1173.0,1142.0,-148,167,-315
1265,15,9,1,11,0,1626,2068,1003,537,978,796,1015,879,797,986,1136,1153,1144.0,1092.0,17,150,-133
1261,16,9,1,11,0,1519,1632,1025,485,1058,873,1015,949,835,965,1376,1214,1295.0,1185.0,-162,411,-573
1310,17,9,1,11,0,1619,2178,1217,467,1068,962,1084,875,893,959,1329,1057,1193.0,1115.0,-272,370,-642
526,18,9,1,11,0,767,913,522,257,433,373,497,408,356,398,487,518,502.0,468.0,31,89,-58
413,19,9,1,11,0,443,594,254,172,277,329,290,263,262,428,438,320,379.0,395.0,-118,10,-128
436,20,9,1,11,0,500,762,420,252,342,321,324,387,329,286,390,312,351.0,329.0,-78,104,-182
433,21,9,1,11,0,478,651,365,184,306,238,357,732,447,312,423,398,410.0,378.0,-25,111,-136
234,22,9,1,11,0,289,372,142,121,207,187,231,186,143,232,203,179,191.0,205.0,-24,-29,5
798,1,10,2,11,0,1546,1428,635,513,975,1070,1137,2596,1172,1207,1337,691,1014.0,1078.0,-646,130,-776
313,2,10,2,11,0,412,626,249,167,333,316,408,510,602,649,565,362,464.0,525.0,-203,-84,-119
350,3,10,2,11,0,516,701,285,178,320,330,439,413,440,575,685,372,528.0,544.0,-313,110,-423
81,4,10,2,11,0,264,913,106,74,113,101,453,335,314,124,110,37,74.0,90.0,-73,-14,-59
1425,5,10,2,11,0,1783,2691,1134,763,1522,1501,1649,1954,1996,2318,2175,1415,1795.0,1969.0,-760,-143,-617
1747,6,10,2,11,0,2138,2356,1607,968,1908,2068,2171,2517,2384,2828,2098,1480,1789.0,2135.0,-618,-730,112
2819,7,10,2,11,0,3787,4830,2048,1323,3138,3779,4223,3954,4263,5234,4184,2802,3493.0,4073.0,-1382,-1050,-332
729,8,10,2,11,0,852,1073,317,283,629,610,883,1085,1017,1391,967,750,858.0,1036.0,-217,-424,207
1693,9,10,2,11,0,2435,2500,695,488,1495,1512,1848,2203,1964,2643,2750,2176,2463.0,2523.0,-574,107,-681
719,10,10,2,11,0,783,869,475,293,738,554,830,966,1021,1065,1006,598,802.0,890.0,-408,-59,-349
3686,11,10,2,11,0,5016,5865,2657,2401,4119,4083,4704,4995,4877,5866,4453,3479,3966.0,4599.0,-974,-1413,439
1656,12,10,2,11,0,1376,1737,923,549,1502,1828,1895,1662,1811,1988,1776,1261,1518.0,1675.0,-515,-212,-303
1899,13,10,2,11,0,1926,2621,900,720,1379,2198,2809,2761,2856,3219,1969,1711,1840.0,2300.0,-258,-1250,992
3052,14,10,2,11,0,2874,3243,1683,1042,2558,3199,3067,3400,3871,4333,3047,2328,2688.0,3236.0,-719,-1286,567
2117,15,10,2,11,0,3295,3490,1289,1038,1965,1876,2506,2778,3135,3712,3209,2554,2882.0,3158.0,-655,-503,-152
1291,16,10,2,11,0,1547,1624,929,480,1234,1278,1437,1882,1699,1835,1719,1162,1440.0,1572.0,-557,-116,-441
1356,17,10,2,11,0,1585,1952,989,516,1513,1616,1696,1720,1686,2057,2090,1239,1664.0,1795.0,-851,33,-884
840,18,10,2,11,0,1130,958,546,402,859,878,1319,1184,1258,1327,1317,1081,1199.0,1242.0,-236,-10,-226
533,19,10,2,11,0,619,821,205,149,446,498,474,571,727,964,874,497,686.0,778.0,-377,-90,-287
337,20,10,2,11,0,419,597,296,163,296,401,429,660,507,590,674,413,544.0,559.0,-261,84,-345
569,21,10,2,11,0,912,1151,413,242,475,689,883,1688,1091,1205,1047,626,836.0,959.0,-421,-158,-263
186,22,10,2,11,0,347,415,118,130,301,193,254,310,279,412,382,247,314.0,347.0,-135,-30,-105
145,1,11,2,11,0,225,270,79,27,45,95,103,101,83,103,129,99,114.0,110.0,-30,26,-56
431,2,11,2,11,0,267,384,296,172,285,192,231,213,247,282,327,422,374.0,344.0,95,45,50
322,3,11,2,11,0,359,450,248,124,211,203,178,177,181,202,244,274,259.0,240.0,30,42,-12
322,4,11,2,11,0,938,1287,118,74,556,952,1106,818,968,836,546,268,407.0,550.0,-278,-290,12
1163,5,11,2,11,0,1002,2805,1326,797,891,676,702,734,761,905,1065,1092,1078.0,1021.0,27,160,-133
845,6,11,2,11,0,977,1443,903,436,535,520,582,612,532,660,692,828,760.0,727.0,136,32,104
1965,7,11,2,11,0,2198,3785,1878,1009,1343,1575,1488,1335,1337,1747,1744,1960,1852.0,1817.0,216,-3,219
814,8,11,2,11,0,1993,2925,603,248,417,464,574,426,448,540,518,746,632.0,601.0,228,-22,250
1867,9,11,2,11,0,2044,2419,914,399,1078,1095,1082,1215,1038,1245,1500,1591,1546.0,1445.0,91,255,-164
806,10,11,2,11,0,493,935,666,303,492,403,512,470,474,495,629,719,674.0,614.0,90,134,-44
1100,11,11,2,11,0,1531,2308,910,648,752,1041,985,944,821,908,982,1078,1030.0,989.0,96,74,22
952,12,11,2,11,0,917,1377,999,364,509,561,555,561,469,643,721,910,816.0,758.0,189,78,111
1448,13,11,2,11,0,1144,2067,1110,641,741,953,1002,876,936,1050,1031,1362,1196.0,1148.0,331,-19,350
2155,14,11,2,11,0,1965,3560,2272,888,1199,1423,1368,1487,1652,1740,1822,2212,2017.0,1925.0,390,82,308
4073,15,11,2,11,0,3147,4324,1028,639,1114,1097,2340,1882,1700,2222,2001,2752,2376.0,2325.0,751,-221,972
753,16,11,2,11,0,941,1534,1004,347,476,456,410,475,460,525,1167,723,945.0,805.0,-444,642,-1086
1001,17,11,2,11,0,1142,1719,1133,438,685,688,650,716,659,750,1015,980,998.0,915.0,-35,265,-300
976,18,11,2,11,0,762,1967,434,268,656,565,712,722,602,609,775,965,870.0,783.0,190,166,24
319,19,11,2,11,0,291,520,199,149,205,202,188,167,160,157,192,253,222.0,201.0,61,35,26
545,20,11,2,11,0,326,532,432,291,409,310,302,286,280,366,470,485,478.0,440.0,15,104,-89
1915,21,11,2,11,0,1010,1651,919,422,609,612,587,580,1155,818,1081,1331,1206.0,1077.0,250,263,-13
126,22,11,2,11,0,204,257,135,104,114,128,104,132,112,136,138,80,109.0,118.0,-58,2,-60
74,1,12,2,11,0,125,158,63,40,60,51,45,46,45,48,64,47,56.0,53.0,-17,16,-33
469,2,12,2,11,0,375,535,421,246,288,240,252,266,378,341,384,421,402.0,382.0,37,43,-6
410,3,12,2,11,0,448,676,363,164,250,212,180,206,169,180,292,330,311.0,267.0,38,112,-74
77,4,12,2,11,0,360,496,86,74,109,80,71,61,54,68,80,56,68.0,68.0,-24,12,-36
794,5,12,2,11,0,831,1260,724,451,621,526,535,628,654,720,912,881,896.0,838.0,-31,192,-223
617,6,12,2,11,0,510,806,576,272,358,315,316,346,322,391,446,556,501.0,464.0,110,55,55
1428,7,12,2,11,0,1778,2915,1529,762,977,1071,1025,958,930,1153,1156,1444,1300.0,1251.0,288,3,285
954,8,12,2,11,0,668,1092,615,366,578,543,590,543,530,702,862,804,833.0,789.0,-58,160,-218
1391,9,12,2,11,0,1384,1437,718,363,821,836,734,867,743,867,1000,961,980.0,943.0,-39,133,-172
645,10,12,2,11,0,463,659,452,233,370,288,292,316,346,373,423,428,426.0,408.0,5,50,-45
828,11,12,2,11,0,743,1008,543,405,518,460,406,448,428,481,488,651,570.0,540.0,163,7,156
545,12,12,2,11,0,577,816,634,247,323,301,331,301,285,348,422,444,433.0,405.0,22,74,-52
1557,13,12,2,11,0,1432,2365,1304,951,1023,1070,1210,930,1140,1221,1304,1511,1408.0,1345.0,207,83,124
1268,14,12,2,11,0,1406,2228,1526,717,888,888,823,850,1053,1131,1233,1386,1310.0,1250.0,153,102,51
936,15,12,2,11,0,874,1121,438,306,511,460,520,507,491,573,625,628,626.0,609.0,3,52,-49
562,16,12,2,11,0,655,903,635,255,364,342,325,362,407,342,478,502,490.0,441.0,24,136,-112
667,17,12,2,11,0,763,1216,773,321,479,531,540,517,429,513,640,693,666.0,615.0,53,127,-74
381,18,12,2,11,0,239,420,249,153,274,195,252,248,212,300,311,264,288.0,292.0,-47,11,-58
578,19,12,2,11,0,514,641,287,222,321,326,279,247,251,291,348,358,353.0,332.0,10,57,-47
350,20,12,2,11,0,292,402,296,142,238,207,233,232,240,260,352,335,344.0,316.0,-17,92,-109
911,21,12,2,11,0,755,1158,815,410,484,484,492,471,470,664,857,802,830.0,774.0,-55,193,-248
399,22,12,2,11,0,328,336,166,145,205,161,183,216,199,211,200,279,240.0,230.0,79,-11,90
89,1,13,1,11,0,314,461,180,102,190,125,145,92,77,83,77,70,74.0,77.0,-7,-6,-1
746,2,13,1,11,0,757,1396,1059,575,778,650,682,486,654,573,601,737,669.0,637.0,136,28,108
480,3,13,1,11,0,527,720,520,270,473,409,472,356,344,415,453,477,465.0,448.0,24,38,-14
66,4,13,1,11,0,242,487,101,86,162,127,117,78,41,43,61,36,48.0,47.0,-25,18,-43
1171,5,13,1,11,0,1605,2433,1860,1194,1302,1156,1192,925,872,1055,1302,1043,1172.0,1133.0,-259,247,-506
954,6,13,1,11,0,1370,2298,1440,720,878,861,934,738,651,739,952,974,963.0,888.0,22,213,-191
1598,7,13,1,11,0,2126,3804,2217,1109,1504,1812,1956,1321,1432,1563,1725,1648,1686.0,1645.0,-77,162,-239
692,8,13,1,11,0,748,1215,772,404,591,661,732,531,562,597,623,673,648.0,631.0,50,26,24
933,9,13,1,11,0,1467,2021,1040,446,977,1064,948,854,663,649,829,797,813.0,758.0,-32,180,-212
496,10,13,1,11,0,511,880,738,330,660,454,586,385,399,303,460,395,428.0,386.0,-65,157,-222
1077,11,13,1,11,0,1816,2525,1540,1130,1441,1246,1265,930,913,863,957,1065,1011.0,962.0,108,94,14
645,12,13,1,11,0,889,1320,1015,377,598,631,632,491,445,477,574,678,626.0,576.0,104,97,7
1737,13,13,1,11,0,2026,3281,1882,1126,1456,2041,2368,1518,1714,1628,1540,1628,1584.0,1599.0,88,-88,176
1501,14,13,1,11,0,1843,2975,2324,1002,1413,1518,1509,1135,1362,1395,1473,1530,1502.0,1466.0,57,78,-21
959,15,13,1,11,0,1502,2235,958,565,880,893,948,697,814,804,930,965,948.0,900.0,35,126,-91
880,16,13,1,11,0,1339,1557,1148,463,782,723,758,663,696,627,825,791,808.0,748.0,-34,198,-232
797,17,13,1,11,0,835,1281,1235,439,733,664,655,498,506,508,651,664,658.0,608.0,13,143,-130
453,18,13,1,11,0,622,877,518,365,529,461,541,380,328,306,337,330,334.0,324.0,-7,31,-38
341,19,13,1,11,0,396,542,311,224,349,397,405,266,303,286,359,298,328.0,314.0,-61,73,-134
301,20,13,1,11,0,419,666,489,274,346,334,368,358,284,258,335,284,310.0,292.0,-51,77,-128
616,21,13,1,11,0,715,1549,1036,394,463,535,597,405,487,551,603,672,638.0,609.0,69,52,17
632,22,13,1,11,0,616,998,401,372,684,679,736,526,592,672,585,481,533.0,579.0,-104,-87,-17
388,1,14,1,11,0,781,1047,423,192,279,354,355,429,362,376,371,244,308.0,330.0,-127,-5,-122
1355,2,14,1,11,0,1159,1879,1354,680,631,992,1295,955,1148,1036,994,1360,1177.0,1130.0,366,-42,408
1180,3,14,1,11,0,941,1442,814,347,566,786,1042,724,802,839,925,923,924.0,896.0,-2,86,-88
405,4,14,1,11,0,569,1295,274,176,281,280,376,386,433,291,293,235,264.0,273.0,-58,2,-60
2496,5,14,1,11,0,2162,4188,2540,1081,1111,1488,1668,1412,1619,1860,2342,1859,2100.0,2020.0,-483,482,-965
1970,6,14,1,11,0,2073,3650,2495,863,893,1218,1582,1360,1404,1555,1685,1690,1688.0,1643.0,5,130,-125
3780,7,14,1,11,0,3594,6275,3467,1356,2002,3249,3444,2666,3057,2942,3377,3085,3231.0,3135.0,-292,435,-727
1098,8,14,1,11,0,914,1576,743,357,500,790,998,720,798,855,911,936,924.0,901.0,25,56,-31
3107,9,14,1,11,0,3269,4342,1784,653,1364,1722,2162,2247,2038,2128,2302,2021,2162.0,2150.0,-281,174,-455
871,10,14,1,11,0,739,1316,892,381,556,538,802,574,699,609,693,620,656.0,641.0,-73,84,-157
3457,11,14,1,11,0,3776,5864,3032,1760,2316,2607,3244,2604,2564,2570,2743,2663,2703.0,2659.0,-80,173,-253
1296,12,14,1,11,0,1285,2160,1579,453,603,962,960,811,902,887,1133,1043,1088.0,1021.0,-90,246,-336
2880,13,14,1,11,0,2594,4551,2375,1231,1427,2467,3049,2213,2567,2481,2466,2211,2338.0,2386.0,-255,-15,-240
4188,14,14,1,11,0,4047,8018,5309,1586,1915,2716,3025,2701,2930,3143,3339,3184,3262.0,3222.0,-155,196,-351
3021,15,14,1,11,0,3014,4336,1679,826,1161,1890,2275,1899,2230,2234,2335,2198,2266.0,2256.0,-137,101,-238
1849,16,14,1,11,0,1848,3179,2049,551,906,1028,1278,1264,1359,1217,1693,1417,1555.0,1442.0,-276,476,-752
2246,17,14,1,11,0,2355,3747,2461,732,1157,1395,1621,1288,1479,1482,1887,1640,1764.0,1670.0,-247,405,-652
928,18,14,1,11,0,1140,1306,596,364,463,616,759,757,740,708,723,786,754.0,739.0,63,15,48
1415,19,14,1,11,0,1188,1784,769,415,765,1227,1203,969,1200,1102,1144,952,1048.0,1066.0,-192,42,-234
844,20,14,1,11,0,761,1417,877,373,399,529,594,627,619,620,836,742,789.0,733.0,-94,216,-310
1193,21,14,1,11,0,841,1546,1008,303,361,648,917,661,790,773,918,1016,967.0,902.0,98,145,-47
1022,22,14,1,11,0,944,1290,579,365,604,725,778,831,876,865,867,758,812.0,830.0,-109,2,-111
661,1,15,2,11,0,807,1293,851,433,764,667,727,689,522,968,719,517,618.0,735.0,-202,-249,47
430,2,15,2,11,0,535,639,509,300,415,361,462,414,443,436,471,370,420.0,426.0,-101,35,-136
499,3,15,2,11,0,451,580,494,276,556,527,562,528,446,576,531,533,532.0,547.0,2,-45,47
996,4,15,2,11,0,1288,2146,1327,923,1308,982,1002,1096,834,1075,842,705,774.0,874.0,-137,-233,96
738,5,15,2,11,0,781,1105,856,454,680,597,621,651,776,861,835,604,720.0,767.0,-231,-26,-205
924,6,15,2,11,0,803,1070,953,364,644,584,685,706,708,895,856,786,821.0,846.0,-70,-39,-31
1322,7,15,2,11,0,1513,1837,1329,778,1244,1284,1298,1141,1319,1334,1363,1113,1238.0,1270.0,-250,29,-279
777,8,15,2,11,0,798,1203,945,474,746,713,727,660,639,991,794,659,726.0,815.0,-135,-197,62
555,9,15,2,11,0,536,825,423,180,427,549,477,696,389,618,526,381,454.0,508.0,-145,-92,-53
136,10,15,2,11,0,160,243,179,71,140,141,183,151,137,141,191,116,154.0,149.0,-75,50,-125
1548,11,15,2,11,0,1951,2643,1820,1058,1565,1288,1340,1313,1263,1676,1620,1295,1458.0,1530.0,-325,-56,-269
372,12,15,2,11,0,424,571,408,151,325,301,312,293,255,351,379,320,350.0,350.0,-59,28,-87
1653,13,15,2,11,0,1433,1923,1604,884,1377,1523,1631,1539,1425,1590,1515,1285,1400.0,1463.0,-230,-75,-155
1131,14,15,2,11,0,1113,1482,1178,548,1003,1062,1044,1052,1125,1238,1016,988,1002.0,1081.0,-28,-222,194
823,15,15,2,11,0,894,1112,767,352,679,681,651,616,628,814,733,614,674.0,720.0,-119,-81,-38
273,16,15,2,11,0,377,483,446,164,271,261,296,275,330,388,373,300,336.0,354.0,-73,-15,-58
461,17,15,2,11,0,477,783,487,262,452,359,428,383,395,447,527,425,476.0,466.0,-102,80,-182
253,18,15,2,11,0,345,456,397,140,227,217,291,297,182,259,217,256,236.0,244.0,39,-42,81
183,19,15,2,11,0,251,310,270,165,356,218,179,255,221,255,217,176,196.0,216.0,-41,-38,-3
353,20,15,2,11,0,491,644,555,263,408,381,378,462,374,447,448,311,380.0,402.0,-137,1,-138
551,21,15,2,11,0,622,758,719,361,603,579,645,499,553,624,536,522,529.0,561.0,-14,-88,74
74,22,15,2,11,0,152,169,104,79,149,106,141,121,123,121,96,100,98.0,106.0,4,-25,29
69,1,16,2,11,0,67,117,63,37,86,109,100,151,123,42,55,43,49.0,47.0,-12,13,-25
1653,2,16,2,11,0,1142,1590,946,692,1035,755,884,765,1277,1207,1465,1333,1399.0,1335.0,-132,258,-390
1217,3,16,2,11,0,945,982,602,413,714,724,743,629,652,1139,1161,1060,1110.0,1120.0,-101,22,-123
438,4,16,2,11,0,625,985,300,271,404,282,274,292,278,289,341,277,309.0,302.0,-64,52,-116
2911,5,16,2,11,0,2221,3340,1470,1639,3175,2405,2457,2398,2530,2754,3201,2401,2801.0,2785.0,-800,447,-1247
479,6,16,2,11,0,410,575,248,260,384,279,286,452,366,371,478,493,486.0,447.0,15,107,-92
3426,7,16,2,11,0,3662,4024,1903,1708,2748,2376,2932,2420,2797,3096,3668,3505,3586.0,3423.0,-163,572,-735
1372,8,16,2,11,0,1188,1616,679,442,672,792,892,815,1028,1189,1434,1465,1450.0,1363.0,31,245,-214
2682,9,16,2,11,0,2111,2398,1196,1075,2249,1558,2005,1936,1682,1885,2157,2044,2100.0,2029.0,-113,272,-385
373,10,16,2,11,0,459,435,440,301,449,664,501,523,446,573,488,369,428.0,477.0,-119,-85,-34
910,11,16,2,11,0,777,930,527,626,655,605,586,670,623,694,810,917,864.0,807.0,107,116,-9
430,12,16,2,11,0,482,540,354,189,356,270,359,296,244,355,399,425,412.0,393.0,26,44,-18
3797,13,16,2,11,0,3233,4206,2068,1780,2633,2656,3148,2856,3242,3648,3843,3840,3842.0,3777.0,-3,195,-198
2076,14,16,2,11,0,2018,2962,1570,1050,1823,1515,1509,1506,1785,1836,2094,2086,2090.0,2005.0,-8,258,-266
837,15,16,2,11,0,634,886,424,422,628,555,606,538,517,542,822,660,741.0,675.0,-162,280,-442
565,16,16,2,11,0,544,920,483,270,442,304,376,403,430,440,533,573,553.0,515.0,40,93,-53
1327,17,16,2,11,0,1489,2336,1714,653,1232,835,1023,1076,1149,1284,1450,1174,1312.0,1303.0,-276,166,-442
624,18,16,2,11,0,597,622,308,292,460,424,486,428,470,413,661,640,650.0,571.0,-21,248,-269
1850,19,16,2,11,0,1478,1878,681,691,1319,1119,1215,1237,1419,1601,1582,1557,1570.0,1580.0,-25,-19,-6
286,20,16,2,11,0,172,247,131,105,125,160,126,176,161,199,234,262,248.0,232.0,28,35,-7
963,21,16,2,11,0,634,1051,558,384,605,487,577,560,603,780,777,886,832.0,814.0,109,-3,112
2069,22,16,2,11,0,1636,1781,730,952,1556,1254,1336,1463,1649,2283,2187,1730,1958.0,2067.0,-457,-96,-361
1453,1,17,2,11,0,2362,3060,1909,501,2672,4039,883,4181,1421,1782,1879,887,1383.0,1516.0,-992,97,-1089
1286,2,17,2,11,0,1033,1402,656,504,651,603,785,827,1300,1307,1367,1252,1310.0,1309.0,-115,60,-175
819,3,17,2,11,0,630,827,268,214,376,413,543,491,575,777,749,772,760.0,766.0,23,-28,51
923,4,17,2,11,0,1494,2145,217,200,2331,1550,280,361,498,297,355,265,310.0,306.0,-90,58,-148
2483,5,17,2,11,0,2119,2450,1355,937,1478,2078,1399,1459,1801,2351,2567,2053,2310.0,2324.0,-514,216,-730
2761,6,17,2,11,0,2927,3132,1460,775,1436,1362,1591,1598,1947,2510,2710,2516,2613.0,2579.0,-194,200,-394
4579,7,17,2,11,0,4087,5401,1885,1225,2010,2269,2615,2569,3263,3929,4366,4122,4244.0,4139.0,-244,437,-681
1763,8,17,2,11,0,1547,2066,692,491,877,974,1192,1135,1670,2019,1865,1828,1846.0,1904.0,-37,-154,117
1766,9,17,2,11,0,2188,2519,625,462,1475,1506,1216,1544,1515,1754,1731,1687,1709.0,1724.0,-44,-23,-21
649,10,17,2,11,0,596,616,308,176,366,289,407,451,518,551,689,586,638.0,609.0,-103,138,-241
5223,11,17,2,11,0,5007,5643,2143,1862,2644,2631,3008,3307,4299,4173,4430,4745,4588.0,4449.0,315,257,58
1930,12,17,2,11,0,1981,2357,973,442,916,895,1031,1009,1333,1810,1734,1615,1674.0,1720.0,-119,-76,-43
4580,13,17,2,11,0,3711,5424,1723,1261,2043,2652,2981,2611,4091,4869,4197,4377,4287.0,4481.0,180,-672,852
4887,14,17,2,11,0,4237,5119,2463,1238,2429,2562,2723,3091,4009,4961,4989,4481,4735.0,4810.0,-508,28,-536
2546,15,17,2,11,0,2401,2755,895,768,1359,1321,1533,1474,1767,2205,2322,2259,2290.0,2262.0,-63,117,-180
1785,16,17,2,11,0,1466,1985,1002,357,841,848,822,1085,1431,1415,1567,1474,1520.0,1485.0,-93,152,-245
2467,17,17,2,11,0,2078,2533,1085,531,1104,1014,1204,1328,1663,1969,2202,1856,2029.0,2009.0,-346,233,-579
1293,18,17,2,11,0,1218,1549,440,400,775,721,1235,973,1141,1223,1242,1298,1270.0,1254.0,56,19,37
979,19,17,2,11,0,869,1098,268,212,386,587,555,690,977,861,746,692,719.0,766.0,-54,-115,61
978,20,17,2,11,0,938,1120,617,359,603,607,619,800,1027,1072,1122,870,996.0,1021.0,-252,50,-302
1588,21,17,2,11,0,1199,1748,631,397,661,1831,842,1735,1691,1436,1577,1777,1677.0,1597.0,200,141,59
445,22,17,2,11,0,466,480,162,156,276,218,323,452,354,467,458,427,442.0,451.0,-31,-9,-22
335,1,18,2,11,0,574,754,315,362,767,319,351,300,314,334,352,238,295.0,308.0,-114,18,-132
753,2,18,2,11,0,692,866,452,295,448,404,525,442,543,578,599,835,717.0,671.0,236,21,215
969,3,18,2,11,0,612,941,427,254,591,556,550,476,504,704,679,805,742.0,729.0,126,-25,151
167,4,18,2,11,0,341,546,125,89,159,100,115,114,150,110,113,75,94.0,99.0,-38,3,-41
1386,5,18,2,11,0,1187,1812,1017,704,1344,1235,1081,1056,878,1050,1236,1013,1124.0,1100.0,-223,186,-409
1382,6,18,2,11,0,952,1669,741,475,869,701,638,694,733,857,812,1004,908.0,891.0,192,-45,237
4698,7,18,2,11,0,3812,5496,2330,1515,2865,2841,2834,2558,2825,3266,3132,3700,3416.0,3366.0,568,-134,702
2132,8,18,2,11,0,1234,2626,1165,641,1247,1425,1531,1329,1557,1538,1282,1762,1522.0,1527.0,480,-256,736
685,9,18,2,11,0,525,1055,368,255,433,540,513,805,467,681,614,408,511.0,568.0,-206,-67,-139
206,10,18,2,11,0,355,448,365,155,240,485,249,405,222,128,107,185,146.0,140.0,78,-21,99
1433,11,18,2,11,0,1728,2261,1167,1028,1507,1281,827,792,892,955,1053,993,1023.0,1000.0,-60,98,-158
453,12,18,2,11,0,946,847,641,223,316,236,253,238,242,217,309,282,296.0,269.0,-27,92,-119
5099,13,18,2,11,0,3058,5478,1932,1551,2981,3513,3250,2524,3284,3386,2904,3615,3260.0,3302.0,711,-482,1193
2619,14,18,2,11,0,1941,3092,1731,893,1695,1504,1408,1487,1714,1721,1597,1924,1760.0,1747.0,327,-124,451
753,15,18,2,11,0,706,1205,504,467,741,598,514,446,578,432,623,523,573.0,526.0,-100,191,-291
244,16,18,2,11,0,348,657,298,154,273,222,166,164,170,172,198,208,203.0,193.0,10,26,-16
464,17,18,2,11,0,587,1351,576,253,448,437,409,373,484,393,425,410,418.0,409.0,-15,32,-47
383,18,18,2,11,0,452,617,215,148,255,232,240,199,231,301,352,251,302.0,301.0,-101,51,-152
1252,19,18,2,11,0,853,1026,394,408,768,721,776,679,667,892,902,982,942.0,925.0,80,10,70
277,20,18,2,11,0,379,694,353,248,346,329,249,207,249,199,233,246,240.0,226.0,13,34,-21
1142,21,18,2,11,0,804,1400,754,418,791,600,553,553,625,614,777,930,854.0,774.0,153,163,-10
999,22,18,2,11,0,496,710,280,266,503,464,518,466,471,859,943,658,800.0,820.0,-285,84,-369
314,1,19,2,11,0,312,359,339,177,321,249,248,328,254,307,237,241,239.0,262.0,4,-70,74
506,2,19,2,11,0,442,485,409,248,357,375,412,347,430,418,363,355,359.0,379.0,-8,-55,47
501,3,19,2,11,0,401,434,519,319,522,443,583,484,431,411,444,497,470.0,451.0,53,33,20
996,4,19,2,11,0,1121,1802,1263,877,1267,1047,1549,1033,967,860,855,791,823.0,835.0,-64,-5,-59
948,5,19,2,11,0,732,1083,1390,565,951,827,852,794,845,1009,1048,823,936.0,960.0,-225,39,-264
657,6,19,2,11,0,519,629,667,315,471,534,553,570,581,499,590,552,571.0,547.0,-38,91,-129
2049,7,19,2,11,0,1666,1642,1861,878,1578,1694,1792,1554,1627,1927,1942,1727,1834.0,1865.0,-215,15,-230
508,8,19,2,11,0,421,414,426,317,451,395,445,395,431,409,455,463,459.0,442.0,8,46,-38
996,9,19,2,11,0,995,1243,727,322,827,693,791,804,769,839,878,889,884.0,869.0,11,39,-28
221,10,19,2,11,0,192,214,225,119,204,139,193,190,168,192,190,217,204.0,200.0,27,-2,29
1396,11,19,2,11,0,1099,1374,1336,868,1301,1124,1278,1241,1197,1296,1046,1162,1104.0,1168.0,116,-250,366
381,12,19,2,11,0,276,329,364,141,291,237,315,278,285,309,268,301,284.0,293.0,33,-41,74
1780,13,19,2,11,0,1461,1615,1768,1165,1697,1805,2074,1714,1806,1864,1750,1625,1688.0,1746.0,-125,-114,-11
1735,14,19,2,11,0,1223,1443,1429,856,1325,1403,1419,1413,1478,1579,1504,1582,1543.0,1555.0,78,-75,153
955,15,19,2,11,0,747,863,742,356,707,633,707,646,663,732,701,734,718.0,722.0,33,-31,64
557,16,19,2,11,0,473,566,558,262,443,396,470,482,493,546,551,501,526.0,533.0,-50,5,-55
492,17,19,2,11,0,418,494,519,230,424,383,397,379,387,399,409,410,410.0,406.0,1,10,-9
529,18,19,2,11,0,325,402,404,188,330,251,340,301,284,315,604,431,518.0,450.0,-173,289,-462
792,19,19,2,11,0,644,1082,704,546,870,783,781,790,785,765,828,793,810.0,795.0,-35,63,-98
351,20,19,2,11,0,282,391,433,202,335,319,317,436,335,381,329,373,351.0,361.0,44,-52,96
590,21,19,2,11,0,346,497,487,257,378,390,460,393,519,500,482,768,625.0,583.0,286,-18,304
1027,22,19,2,11,0,664,964,785,666,1198,1070,1179,970,890,1044,870,813,842.0,909.0,-57,-174,117
495,1,20,1,11,0,1563,1504,815,447,731,532,612,632,552,602,639,404,522.0,548.0,-235,37,-272
382,2,20,1,11,0,692,785,585,277,403,310,422,368,501,439,383,371,377.0,398.0,-12,-56,44
115,3,20,1,11,0,342,430,303,110,229,177,183,153,136,170,141,127,134.0,146.0,-14,-29,15
198,4,20,1,11,0,925,1127,376,284,427,371,462,336,275,270,272,206,239.0,249.0,-66,2,-68
499,5,20,1,11,0,1320,1775,1096,562,764,657,680,772,616,717,828,542,685.0,696.0,-286,111,-397
574,6,20,1,11,0,1064,1490,952,364,600,581,589,605,632,685,690,608,649.0,661.0,-82,5,-87
856,7,20,1,11,0,1408,1739,940,501,805,813,957,836,892,940,1047,835,941.0,941.0,-212,107,-319
86,8,20,1,11,0,332,371,229,113,151,138,130,107,102,135,123,108,116.0,122.0,-15,-12,-3
825,9,20,1,11,0,1644,2216,854,451,986,862,846,947,768,780,800,819,810.0,800.0,19,20,-1
153,10,20,1,11,0,255,372,218,114,237,155,197,163,181,169,173,175,174.0,172.0,2,4,-2
921,11,20,1,11,0,2263,3132,1586,987,1345,1015,1158,1068,1086,1181,1123,952,1038.0,1085.0,-171,-58,-113
426,12,20,1,11,0,870,1144,754,284,498,430,503,444,457,461,471,423,447.0,452.0,-48,10,-58
505,13,20,1,11,0,944,1218,652,442,599,687,716,543,668,679,581,499,540.0,586.0,-82,-98,16
437,14,20,1,11,0,1121,1578,856,471,700,719,644,669,703,653,571,445,508.0,556.0,-126,-82,-44
1084,15,20,1,11,0,2703,3371,1749,893,1369,1150,1156,1037,1172,1334,1278,1146,1212.0,1253.0,-132,-56,-76
435,16,20,1,11,0,988,1333,941,363,579,523,593,600,621,519,533,456,494.0,503.0,-77,14,-91
526,17,20,1,11,0,1081,1561,1003,386,716,610,659,562,594,642,673,494,584.0,603.0,-179,31,-210
306,18,20,1,11,0,905,1102,667,370,551,387,534,372,366,372,338,360,349.0,357.0,22,-34,56
236,19,20,1,11,0,403,555,253,188,258,212,206,203,265,272,248,226,237.0,249.0,-22,-24,2
193,20,20,1,11,0,496,740,452,184,293,290,264,303,274,250,248,200,224.0,233.0,-48,-2,-46
169,21,20,1,11,0,479,533,395,223,292,216,328,233,285,238,205,191,198.0,211.0,-14,-33,19
155,22,20,1,11,0,352,428,213,219,281,217,259,239,210,238,179,150,164.0,189.0,-29,-59,30
666,1,21,2,11,0,685,688,275,231,396,369,368,427,353,607,636,687,662.0,643.0,51,29,22
798,2,21,2,11,0,714,1001,409,321,443,427,437,368,556,556,634,776,705.0,655.0,142,78,64
779,3,21,2,11,0,671,789,370,239,440,455,525,460,522,607,660,829,744.0,699.0,169,53,116
616,4,21,2,11,0,1332,1807,402,360,619,496,497,491,482,542,549,493,521.0,528.0,-56,7,-63
2533,5,21,2,11,0,2913,3590,1589,1106,1523,1538,1537,1666,1861,2475,3069,2341,2705.0,2628.0,-728,594,-1322
1647,6,21,2,11,0,1717,1968,921,593,995,1124,1199,1070,1346,1713,1638,1809,1724.0,1720.0,171,-75,246
2721,7,21,2,11,0,2776,3299,1329,945,1856,2083,2108,1738,2082,2655,2980,2964,2972.0,2866.0,-16,325,-341
926,8,21,2,11,0,782,1130,401,261,510,549,610,526,688,866,791,915,853.0,857.0,124,-75,199
1916,9,21,2,11,0,2171,2397,475,354,1081,908,1044,1235,994,1368,1488,1712,1600.0,1523.0,224,120,104
451,10,21,2,11,0,493,595,225,179,348,224,290,274,316,397,424,502,463.0,441.0,78,27,51
3224,11,21,2,11,0,3579,4302,1623,1477,2234,2129,2434,2155,2485,3088,3158,3744,3451.0,3330.0,586,70,516
916,12,21,2,11,0,885,1016,398,230,537,551,590,548,652,808,842,1004,923.0,885.0,162,34,128
3884,13,21,2,11,0,2989,3954,1565,1311,2239,2725,3260,2705,3344,4173,4034,4164,4099.0,4124.0,130,-139,269
3303,14,21,2,11,0,2638,3291,1489,872,1684,1948,1801,1780,2489,2996,3374,3430,3402.0,3267.0,56,378,-322
2713,15,21,2,11,0,2458,2897,961,793,1491,1417,1453,1417,1645,2472,2753,3040,2896.0,2755.0,287,281,6
938,16,21,2,11,0,1247,1304,805,357,634,667,656,762,898,966,1182,1166,1174.0,1105.0,-16,216,-232
1178,17,21,2,11,0,948,1222,427,264,565,544,561,563,728,991,1080,998,1039.0,1023.0,-82,89,-171
918,18,21,2,11,0,946,924,385,327,518,415,620,444,541,690,728,859,794.0,759.0,131,38,93
1259,19,21,2,11,0,1160,1513,414,423,828,916,847,707,895,1272,1162,1131,1146.0,1188.0,-31,-110,79
545,20,21,2,11,0,493,612,296,209,288,300,336,388,329,435,559,585,572.0,526.0,26,124,-98
886,21,21,2,11,0,946,1143,404,239,410,468,587,452,654,835,911,1108,1010.0,951.0,197,76,121
1078,22,21,2,11,0,1190,1198,462,436,1058,713,772,690,729,1100,842,859,850.0,934.0,17,-258,275
1382,1,22,4,11,0,790,925,325,455,653,555,624,740,612,758,1004,810,907.0,857.0,-194,246,-440
342,2,22,4,11,0,527,546,194,218,317,270,316,211,290,290,300,338,319.0,309.0,38,10,28
334,3,22,4,11,0,359,418,168,163,287,292,335,266,288,328,334,323,328.0,328.0,-11,6,-17
726,4,22,4,11,0,1162,1615,471,523,831,698,714,664,617,559,655,482,568.0,565.0,-173,96,-269
802,5,22,4,11,0,961,1167,445,516,738,665,640,630,656,820,1044,665,854.0,843.0,-379,224,-603
825,6,22,4,11,0,933,1003,374,418,658,653,606,565,618,791,819,792,806.0,801.0,-27,28,-55
2497,7,22,4,11,0,2370,2766,875,984,1739,1860,1899,1420,1615,2002,2507,2148,2328.0,2219.0,-359,505,-864
309,8,22,4,11,0,355,484,139,184,247,243,229,225,247,307,331,274,302.0,304.0,-57,24,-81
919,9,22,4,11,0,1209,1464,402,402,896,629,772,826,680,829,845,876,860.0,850.0,31,16,15
236,10,22,4,11,0,290,384,118,109,224,157,222,215,154,183,203,224,214.0,203.0,21,20,1
2598,11,22,4,11,0,2801,3241,1057,1612,2234,1953,2227,1909,2048,2422,2463,2396,2430.0,2427.0,-67,41,-108
388,12,22,4,11,0,481,511,213,176,385,307,351,273,345,404,431,370,400.0,402.0,-61,27,-88
1881,13,22,4,11,0,1929,2115,754,885,1533,1690,1813,1571,1661,1916,1901,1771,1836.0,1863.0,-130,-15,-115
1448,14,22,4,11,0,1461,1740,591,724,1200,1228,1058,967,1158,1211,1356,1347,1352.0,1305.0,-9,145,-154
2155,15,22,4,11,0,2127,2662,818,1237,1764,1676,1729,1525,1884,2258,2311,2171,2241.0,2247.0,-140,53,-193
433,16,22,4,11,0,616,685,305,279,470,356,444,412,438,504,557,493,525.0,518.0,-64,53,-117
527,17,22,4,11,0,559,768,256,278,497,347,424,341,409,480,525,413,469.0,473.0,-112,45,-157
434,18,22,4,11,0,480,608,216,257,389,262,395,326,356,356,363,428,396.0,382.0,65,7,58
400,19,22,4,11,0,516,595,169,217,412,408,386,321,346,352,385,344,364.0,360.0,-41,33,-74
156,20,22,4,11,0,216,258,69,99,133,100,129,180,126,116,163,123,143.0,134.0,-40,47,-87
470,21,22,4,11,0,487,657,185,238,361,306,395,301,417,437,460,507,484.0,468.0,47,23,24
335,22,22,4,11,0,413,533,157,228,535,404,398,359,345,475,357,314,336.0,382.0,-43,-118,75
26,1,23,1,11,0,114,215,76,41,45,61,38,52,37,39,38,27,32.0,35.0,-11,-1,-10
57,2,23,1,11,0,121,182,95,41,34,36,31,58,44,55,41,52,46.0,49.0,11,-14,25
85,3,23,1,11,0,174,205,99,66,95,76,72,76,74,85,79,66,72.0,77.0,-13,-6,-7
36,4,23,1,11,0,243,439,74,40,54,53,41,27,32,51,39,40,40.0,43.0,1,-12,13
148,5,23,1,11,0,297,513,309,153,136,133,149,150,134,136,183,129,156.0,149.0,-54,47,-101
404,6,23,1,11,0,692,1047,578,273,312,307,331,314,279,347,395,358,376.0,367.0,-37,48,-85
674,7,23,1,11,0,1099,1844,902,381,538,572,675,544,536,649,690,646,668.0,662.0,-44,41,-85
262,8,23,1,11,0,308,545,238,158,237,226,236,217,178,237,265,271,268.0,258.0,6,28,-22
105,9,23,1,11,0,289,373,126,71,118,103,101,96,92,121,141,114,128.0,125.0,-27,20,-47
70,10,23,1,11,0,115,162,93,53,69,35,53,40,48,50,56,61,58.0,56.0,5,6,-1
239,11,23,1,11,0,397,621,300,168,197,206,183,203,185,213,207,225,216.0,215.0,18,-6,24
57,12,23,1,11,0,143,266,151,36,61,68,60,40,53,57,59,62,60.0,59.0,3,2,1
550,13,23,1,11,0,808,1460,748,389,430,459,518,401,452,524,544,517,530.0,528.0,-27,20,-47
329,14,23,1,11,0,617,1100,524,174,251,240,290,254,290,316,303,354,328.0,324.0,51,-13,64
75,15,23,1,11,0,191,260,101,55,63,66,67,90,77,72,74,78,76.0,75.0,4,2,2
155,16,23,1,11,0,313,534,275,79,103,125,96,138,125,127,182,178,180.0,162.0,-4,55,-59
176,17,23,1,11,0,335,535,308,119,163,126,142,139,138,161,166,159,162.0,162.0,-7,5,-12
32,18,23,1,11,0,87,129,60,25,51,31,35,42,33,28,56,34,45.0,39.0,-22,28,-50
203,19,23,1,11,0,265,371,149,91,133,121,130,132,148,200,180,119,150.0,166.0,-61,-20,-41
53,20,23,1,11,0,199,335,168,84,69,66,80,88,67,79,85,68,76.0,77.0,-17,6,-23
105,21,23,1,11,0,186,360,209,62,83,76,106,84,83,85,110,130,120.0,108.0,20,25,-5
154,22,23,1,11,0,223,312,126,95,154,101,143,86,105,123,132,70,101.0,108.0,-62,9,-71
624,1,24,2,11,0,558,362,679,494,731,600,672,772,704,727,654,627,640.0,669.0,-27,-73,46
221,2,24,2,11,0,160,155,229,130,223,186,188,194,250,267,174,213,194.0,218.0,39,-93,132
72,3,24,2,11,0,82,59,106,63,136,99,113,83,99,112,92,79,86.0,94.0,-13,-20,7
647,4,24,2,11,0,654,521,798,532,838,575,694,618,670,630,659,544,602.0,611.0,-115,29,-144
544,5,24,2,11,0,430,474,703,394,653,524,606,614,549,576,507,629,568.0,571.0,122,-69,191
345,6,24,2,11,0,228,187,338,203,372,311,341,346,340,353,335,325,330.0,338.0,-10,-18,8
529,7,24,2,11,0,421,353,610,362,607,527,608,548,531,526,473,504,488.0,501.0,31,-53,84
110,8,24,2,11,0,117,105,129,94,160,139,138,152,130,124,119,114,116.0,119.0,-5,-5,0
1233,9,24,2,11,0,976,1007,1207,847,1361,1093,1267,1219,1095,1304,1161,1178,1170.0,1214.0,17,-143,160
132,10,24,2,11,0,138,119,159,102,172,121,154,153,137,153,146,149,148.0,149.0,3,-7,10
1399,11,24,2,11,0,1186,1077,1735,1066,1713,1523,1554,1639,1493,1583,1338,1428,1383.0,1450.0,90,-245,335
233,12,24,2,11,0,154,152,242,146,291,216,232,253,206,215,224,199,212.0,213.0,-25,9,-34
346,13,24,2,11,0,254,182,340,242,360,379,362,327,372,362,376,325,350.0,354.0,-51,14,-65
322,14,24,2,11,0,284,223,320,199,311,289,319,320,350,407,332,310,321.0,350.0,-22,-75,53
1357,15,24,2,11,0,1136,1024,1529,973,1602,1326,1507,1501,1473,1537,1190,1401,1296.0,1376.0,211,-347,558
327,16,24,2,11,0,273,274,370,238,369,296,339,369,331,321,338,311,324.0,323.0,-27,17,-44
266,17,24,2,11,0,205,215,305,186,346,275,278,289,275,275,299,270,284.0,281.0,-29,24,-53
478,18,24,2,11,0,321,324,518,242,572,350,498,528,403,477,413,401,407.0,430.0,-12,-64,52
255,19,24,2,11,0,207,174,292,205,321,225,242,252,295,316,266,226,246.0,269.0,-40,-50,10
210,20,24,2,11,0,217,217,267,199,277,240,244,232,258,263,190,261,226.0,238.0,71,-73,144
204,21,24,2,11,0,205,197,285,151,281,203,248,250,270,252,210,232,221.0,231.0,22,-42,64
76,22,24,2,11,0,63,53,93,68,133,85,82,113,113,134,92,79,86.0,102.0,-13,-42,29
324,1,25,1,11,0,247,225,315,160,297,263,287,314,230,299,290,307,298.0,299.0,17,-9,26
179,2,25,1,11,0,133,176,164,108,164,133,153,126,180,169,187,139,163.0,165.0,-48,18,-66
91,3,25,1,11,0,85,86,86,62,103,111,102,97,88,89,103,85,94.0,92.0,-18,14,-32
292,4,25,1,11,0,324,417,323,190,356,270,290,257,234,246,289,227,258.0,254.0,-62,43,-105
353,5,25,1,11,0,301,337,483,166,411,313,351,316,288,271,389,298,344.0,319.0,-91,118,-209
232,6,25,1,11,0,169,174,188,119,173,183,210,172,186,222,219,180,200.0,207.0,-39,-3,-36
323,7,25,1,11,0,227,253,339,160,306,297,331,234,253,292,332,281,306.0,302.0,-51,40,-91
77,8,25,1,11,0,81,91,111,56,97,101,97,84,91,94,102,75,88.0,90.0,-27,8,-35
589,9,25,1,11,0,510,512,581,314,531,409,540,562,422,478,505,502,504.0,495.0,-3,27,-30
107,10,25,1,11,0,103,109,128,57,103,59,104,114,85,94,92,94,93.0,93.0,2,-2,4
806,11,25,1,11,0,661,734,807,456,741,678,793,643,655,701,797,673,735.0,724.0,-124,96,-220
140,12,25,1,11,0,129,138,165,79,158,126,152,118,104,127,138,158,148.0,141.0,20,11,9
194,13,25,1,11,0,180,178,203,126,201,195,251,175,165,222,247,198,222.0,222.0,-49,25,-74
191,14,25,1,11,0,189,173,186,103,191,191,194,156,186,216,215,183,199.0,205.0,-32,-1,-31
710,15,25,1,11,0,599,595,656,382,738,625,720,647,584,732,718,681,700.0,710.0,-37,-14,-23
268,16,25,1,11,0,258,266,270,142,257,214,255,256,231,241,262,216,239.0,240.0,-46,21,-67
187,17,25,1,11,0,168,191,210,114,205,161,191,162,167,198,213,168,190.0,193.0,-45,15,-60
219,18,25,1,11,0,201,205,241,127,267,183,283,239,197,201,237,226,232.0,221.0,-11,36,-47
155,19,25,1,11,0,138,128,140,90,113,125,138,146,129,145,130,114,122.0,130.0,-16,-15,-1
137,20,25,1,11,0,106,134,131,54,117,102,136,130,124,110,144,134,139.0,129.0,-10,34,-44
133,21,25,1,11,0,135,145,159,85,142,119,156,144,123,140,138,149,144.0,142.0,11,-2,13
48,22,25,1,11,0,53,61,68,34,78,65,79,70,61,83,81,56,68.0,73.0,-25,-2,-23
572,1,26,1,11,0,493,474,835,424,592,562,626,644,634,694,593,524,558.0,604.0,-69,-101,32
252,2,26,1,11,0,210,215,310,178,234,223,203,223,258,250,238,175,206.0,221.0,-63,-12,-51
97,3,26,1,11,0,82,74,139,87,116,104,125,105,116,128,105,107,106.0,113.0,2,-23,25
773,4,26,1,11,0,747,817,1033,648,841,763,792,726,727,824,751,607,679.0,727.0,-144,-73,-71
469,5,26,1,11,0,361,382,695,383,524,456,456,507,479,440,615,366,490.0,474.0,-249,175,-424
246,6,26,1,11,0,176,177,354,152,225,259,222,223,254,259,255,231,243.0,248.0,-24,-4,-20
427,7,26,1,11,0,348,336,608,328,530,488,475,451,429,468,468,361,414.0,432.0,-107,0,-107
143,8,26,1,11,0,93,100,165,96,130,118,97,142,140,152,138,125,132.0,138.0,-13,-14,1
946,9,26,1,11,0,766,825,1178,690,1101,964,1020,962,1084,1109,1111,990,1050.0,1070.0,-121,2,-123
150,10,26,1,11,0,100,114,160,106,163,133,138,136,134,129,148,137,142.0,138.0,-11,19,-30
978,11,26,1,11,0,915,1007,1591,766,1115,1026,1072,1033,982,1080,1012,891,952.0,994.0,-121,-68,-53
177,12,26,1,11,0,129,108,227,115,167,214,182,168,165,197,175,164,170.0,179.0,-11,-22,11
251,13,26,1,11,0,203,219,376,209,316,289,290,301,301,298,260,239,250.0,266.0,-21,-38,17
301,14,26,1,11,0,283,262,357,201,287,304,275,256,289,287,329,268,298.0,295.0,-61,42,-103
805,15,26,1,11,0,849,908,1436,623,970,967,965,954,954,1063,930,896,913.0,963.0,-34,-133,99
340,16,26,1,11,0,315,356,436,202,366,316,282,393,360,384,379,336,358.0,366.0,-43,-5,-38
211,17,26,1,11,0,174,192,302,179,246,255,226,219,246,249,252,213,232.0,238.0,-39,3,-42
344,18,26,1,11,0,227,256,500,212,338,297,357,330,288,330,361,323,342.0,338.0,-38,31,-69
247,19,26,1,11,0,194,227,304,176,286,261,241,263,276,299,268,233,250.0,267.0,-35,-31,-4
183,20,26,1,11,0,174,194,265,152,205,197,174,223,187,198,223,169,196.0,197.0,-54,25,-79
230,21,26,1,11,0,194,216,307,140,222,205,251,252,248,224,226,202,214.0,217.0,-24,2,-26
84,22,26,1,11,0,83,85,102,84,125,116,121,127,86,123,92,77,84.0,97.0,-15,-31,16
168,1,27,4,11,0,201,262,80,97,160,113,154,142,142,182,210,219,214.0,204.0,9,28,-19
81,2,27,4,11,0,100,59,26,35,34,50,78,51,74,46,58,61,60.0,55.0,3,12,-9
32,3,27,4,11,0,40,37,22,17,26,37,25,21,17,27,25,23,24.0,25.0,-2,-2,0
148,4,27,4,11,0,230,226,93,117,153,137,139,94,88,112,163,169,166.0,148.0,6,51,-45
154,5,27,4,11,0,240,223,57,76,90,137,164,128,144,184,277,125,201.0,195.0,-152,93,-245
95,6,27,4,11,0,130,121,57,59,72,81,74,76,100,108,95,113,104.0,105.0,18,-13,31
188,7,27,4,11,0,231,199,113,137,218,152,167,149,160,180,268,232,250.0,227.0,-36,88,-124
30,8,27,4,11,0,28,33,16,10,28,22,76,22,26,27,34,36,35.0,32.0,2,7,-5
270,9,27,4,11,0,396,384,120,115,231,223,244,188,202,225,232,206,219.0,221.0,-26,7,-33
41,10,27,4,11,0,41,40,20,18,18,25,33,31,30,38,53,32,42.0,41.0,-21,15,-36
468,11,27,4,11,0,635,591,225,325,414,342,390,329,340,426,503,487,495.0,472.0,-16,77,-93
56,12,27,4,11,0,66,85,10,18,37,40,39,37,38,50,58,43,50.0,50.0,-15,8,-23
140,13,27,4,11,0,166,161,78,99,131,131,102,71,97,118,127,156,142.0,134.0,29,9,20
102,14,27,4,11,0,128,163,57,77,90,88,75,84,92,121,128,128,128.0,126.0,0,7,-7
526,15,27,4,11,0,523,567,168,290,344,386,300,355,415,511,575,426,500.0,504.0,-149,64,-213
89,16,27,4,11,0,120,142,48,54,76,88,66,69,75,103,111,77,94.0,97.0,-34,8,-42
62,17,27,4,11,0,112,124,41,43,61,74,75,46,72,85,92,69,80.0,82.0,-23,7,-30
58,18,27,4,11,0,108,127,23,28,50,51,59,58,62,64,70,54,62.0,63.0,-16,6,-22
75,19,27,4,11,0,106,83,28,38,67,45,65,40,54,75,89,57,73.0,74.0,-32,14,-46
56,20,27,4,11,0,77,67,17,20,19,34,34,37,30,40,56,32,44.0,43.0,-24,16,-40
64,21,27,4,11,0,68,82,41,52,48,66,99,56,51,90,75,83,79.0,83.0,8,-15,23
16,22,27,4,11,0,48,45,18,18,48,30,46,28,19,30,30,25,28.0,28.0,-5,0,-5
659,1,28,2,11,0,306,492,378,283,374,311,427,498,475,609,825,487,656.0,640.0,-338,216,-554
219,2,28,2,11,0,142,154,140,101,145,149,178,192,272,277,259,213,236.0,250.0,-46,-18,-28
166,3,28,2,11,0,67,109,121,79,109,124,169,140,135,176,185,176,180.0,179.0,-9,9,-18
639,4,28,2,11,0,311,576,511,299,438,522,580,543,591,697,730,557,644.0,661.0,-173,33,-206
610,5,28,2,11,0,340,526,495,291,361,444,497,529,571,643,1038,541,790.0,741.0,-497,395,-892
464,6,28,2,11,0,219,307,304,148,259,319,271,331,363,453,565,402,484.0,473.0,-163,112,-275
645,7,28,2,11,0,312,378,406,284,400,479,557,520,550,741,941,568,754.0,750.0,-373,200,-573
164,8,28,2,11,0,58,83,94,61,99,97,93,99,121,177,185,168,176.0,177.0,-17,8,-25
958,9,28,2,11,0,593,912,598,355,607,642,701,764,756,899,1094,934,1014.0,976.0,-160,195,-355
132,10,28,2,11,0,50,68,74,33,77,72,113,104,139,145,158,129,144.0,144.0,-29,13,-42
1408,11,28,2,11,0,609,1028,993,652,891,910,1046,1085,1159,1451,1727,1253,1490.0,1477.0,-474,276,-750
272,12,28,2,11,0,107,208,200,69,151,150,175,152,209,258,344,206,275.0,269.0,-138,86,-224
508,13,28,2,11,0,298,340,342,250,323,382,440,423,438,563,630,455,542.0,549.0,-175,67,-242
427,14,28,2,11,0,170,239,290,184,293,341,325,356,405,492,560,422,491.0,491.0,-138,68,-206
1666,15,28,2,11,0,965,1300,996,708,969,1088,1209,1284,1524,1958,2180,1479,1830.0,1872.0,-701,222,-923
410,16,28,2,11,0,212,331,334,134,250,279,305,303,339,437,473,371,422.0,427.0,-102,36,-138
366,17,28,2,11,0,180,310,284,146,251,271,354,267,331,429,484,339,412.0,417.0,-145,55,-200
306,18,28,2,11,0,138,176,229,97,153,164,270,221,253,308,353,274,314.0,312.0,-79,45,-124
431,19,28,2,11,0,189,261,256,190,274,317,341,370,440,648,531,397,464.0,525.0,-134,-117,-17
200,20,28,2,11,0,76,157,115,82,120,97,175,209,162,190,256,142,199.0,196.0,-114,66,-180
344,21,28,2,11,0,127,205,223,136,166,239,247,199,284,366,387,357,372.0,370.0,-30,21,-51
159,22,28,2,11,0,108,145,104,92,153,138,145,157,161,240,210,129,170.0,193.0,-81,-30,-51
528,1,29,1,11,0,341,507,266,214,347,256,335,387,323,471,449,434,442.0,451.0,-15,-22,7
222,2,29,1,11,0,169,225,142,99,142,158,164,176,231,206,157,158,158.0,174.0,1,-49,50
172,3,29,1,11,0,121,169,76,74,105,133,145,136,151,168,178,179,178.0,175.0,1,10,-9
381,4,29,1,11,0,417,450,177,170,259,234,290,279,265,274,353,267,310.0,298.0,-86,79,-165
398,5,29,1,11,0,433,394,242,224,324,333,361,319,358,452,596,393,494.0,480.0,-203,144,-347
307,6,29,1,11,0,256,310,160,139,211,231,217,227,254,298,323,290,306.0,304.0,-33,25,-58
607,7,29,1,11,0,469,507,305,251,332,402,428,398,413,574,597,509,553.0,560.0,-88,23,-111
174,8,29,1,11,0,124,97,55,43,101,86,111,100,106,169,173,150,162.0,164.0,-23,4,-27
849,9,29,1,11,0,821,895,435,271,630,599,641,694,710,772,788,776,782.0,779.0,-12,16,-28
133,10,29,1,11,0,114,124,79,66,108,95,119,99,124,137,118,143,130.0,133.0,25,-19,44
1139,11,29,1,11,0,937,1154,552,589,835,807,903,879,877,1098,1019,1157,1088.0,1091.0,138,-79,217
230,12,29,1,11,0,189,178,106,91,145,142,176,146,152,202,227,235,231.0,221.0,8,25,-17
398,13,29,1,11,0,327,378,179,188,251,302,319,290,307,411,362,402,382.0,392.0,40,-49,89
346,14,29,1,11,0,276,308,156,143,260,258,238,212,252,290,348,286,317.0,308.0,-62,58,-120
1398,15,29,1,11,0,1072,1169,550,543,759,841,892,995,1035,1285,1388,1216,1302.0,1296.0,-172,103,-275
366,16,29,1,11,0,308,378,261,177,285,262,281,264,324,372,438,443,440.0,418.0,5,66,-61
299,17,29,1,11,0,226,309,145,129,251,238,285,222,261,332,310,299,304.0,314.0,-11,-22,11
311,18,29,1,11,0,214,293,168,110,183,202,270,233,236,280,255,305,280.0,280.0,50,-25,75
187,19,29,1,11,0,177,213,86,85,121,151,164,140,139,209,233,143,188.0,195.0,-90,24,-114
131,20,29,1,11,0,89,130,65,59,92,68,101,131,82,96,144,114,129.0,118.0,-30,48,-78
155,21,29,1,11,0,164,174,112,81,131,150,180,137,151,189,198,226,212.0,204.0,28,9,19
74,22,29,1,11,0,95,85,44,40,74,82,95,78,104,128,90,82,86.0,100.0,-8,-38,30
672,1,30,1,11,0,593,748,538,251,456,315,445,485,411,558,671,391,531.0,540.0,-280,113,-393
267,2,30,1,11,0,323,344,263,166,191,198,263,290,341,252,328,261,294.0,280.0,-67,76,-143
185,3,30,1,11,0,206,200,197,109,152,165,213,178,177,172,194,149,172.0,172.0,-45,22,-67
1158,4,30,1,11,0,939,1050,755,424,693,651,781,754,805,949,920,743,832.0,871.0,-177,-29,-148
590,5,30,1,11,0,560,641,624,348,443,468,502,547,611,673,959,435,697.0,689.0,-524,286,-810
394,6,30,1,11,0,331,409,330,200,229,256,264,317,284,317,394,291,342.0,334.0,-103,77,-180
603,7,30,1,11,0,630,646,659,309,458,540,534,523,541,632,768,491,630.0,630.0,-277,136,-413
168,8,30,1,11,0,142,103,120,44,90,120,136,128,136,187,160,129,144.0,159.0,-31,-27,-4
1433,9,30,1,11,0,1408,1829,1269,499,1006,894,1099,1203,1068,1323,1501,1221,1361.0,1348.0,-280,178,-458
169,10,30,1,11,0,142,255,213,82,152,117,156,149,174,198,193,169,181.0,187.0,-24,-5,-19
1276,11,30,1,11,0,1108,1430,1304,649,954,933,1003,955,1112,1268,1354,983,1168.0,1202.0,-371,86,-457
291,12,30,1,11,0,275,247,282,85,186,198,229,203,249,256,341,219,280.0,272.0,-122,85,-207
497,13,30,1,11,0,417,527,425,254,337,412,434,405,458,546,548,398,473.0,497.0,-150,2,-152
431,14,30,1,11,0,382,502,442,251,354,426,325,372,375,398,412,339,376.0,383.0,-73,14,-87
1678,15,30,1,11,0,1214,1500,938,567,836,888,1017,1178,1317,1460,1660,1157,1408.0,1426.0,-503,200,-703
559,16,30,1,11,0,473,526,572,259,428,363,377,445,438,468,503,382,442.0,451.0,-121,35,-156
483,17,30,1,11,0,391,505,374,207,342,370,431,366,451,421,470,359,414.0,417.0,-111,49,-160
355,18,30,1,11,0,320,358,335,144,206,194,282,238,262,319,348,276,312.0,314.0,-72,29,-101
516,19,30,1,11,0,335,454,281,156,268,293,330,277,371,482,484,306,395.0,424.0,-178,2,-180
244,20,30,1,11,0,209,244,199,108,153,121,186,284,146,224,267,164,216.0,218.0,-103,43,-146
311,21,30,1,11,0,242,346,325,174,210,225,299,236,330,298,331,274,302.0,301.0,-57,33,-90
172,22,30,1,11,0,190,198,139,94,144,137,133,149,128,210,136,95,116.0,147.0,-41,-74,33
567,1,31,2,11,0,513,576,543,384,696,487,649,633,685,664,518,503,510.0,562.0,-15,-146,131
210,2,31,2,11,0,236,257,243,199,312,234,314,249,292,267,233,166,200.0,222.0,-67,-34,-33
71,3,31,2,11,0,60,80,54,43,84,76,64,93,74,68,76,58,67.0,67.0,-18,8,-26
581,4,31,2,11,0,585,816,536,311,688,527,617,587,668,640,578,411,494.0,543.0,-167,-62,-105
510,5,31,2,11,0,447,593,591,337,640,478,571,603,551,645,659,365,512.0,556.0,-294,14,-308
325,6,31,2,11,0,275,385,322,230,435,350,391,362,386,364,400,336,368.0,367.0,-64,36,-100
443,7,31,2,11,0,401,440,468,289,622,538,593,498,535,586,540,332,436.0,486.0,-208,-46,-162
83,8,31,2,11,0,61,103,57,64,78,79,91,70,76,114,91,72,82.0,92.0,-19,-23,4
1163,9,31,2,11,0,983,1319,1274,618,1449,1061,1394,1469,1265,1360,1372,1116,1244.0,1283.0,-256,12,-268
138,10,31,2,11,0,126,167,115,84,164,123,176,156,157,172,190,125,158.0,162.0,-65,18,-83
1153,11,31,2,11,0,988,1160,1203,919,1681,1193,1428,1269,1375,1458,1073,894,984.0,1142.0,-179,-385,206
173,12,31,2,11,0,129,200,185,89,224,198,224,201,206,230,203,138,170.0,190.0,-65,-27,-38
360,13,31,2,11,0,281,283,417,232,460,496,484,423,463,437,409,277,343.0,374.0,-132,-28,-104
329,14,31,2,11,0,237,350,258,224,388,425,429,397,410,418,393,275,334.0,362.0,-118,-25,-93
1686,15,31,2,11,0,1465,1724,1540,1004,2273,1596,1876,1650,1852,1906,1579,1310,1444.0,1598.0,-269,-327,58
312,16,31,2,11,0,218,283,271,143,325,266,300,353,314,383,331,242,286.0,319.0,-89,-52,-37
350,17,31,2,11,0,255,374,375,195,380,321,402,363,372,409,397,243,320.0,350.0,-154,-12,-142
333,18,31,2,11,0,251,346,352,161,369,304,419,307,353,366,384,305,344.0,352.0,-79,18,-97
228,19,31,2,11,0,159,186,215,146,225,256,285,240,260,305,212,189,200.0,235.0,-23,-93,70
247,20,31,2,11,0,200,253,198,131,290,195,274,315,277,268,213,164,188.0,215.0,-49,-55,6
186,21,31,2,11,0,134,174,188,135,235,193,286,212,215,219,199,188,194.0,202.0,-11,-20,9
94,22,31,2,11,0,58,76,70,44,104,104,97,90,78,104,69,44,56.0,72.0,-25,-35,10
325,1,32,3,11,0,501,825,333,136,253,217,192,208,169,209,261,157,209.0,209.0,-104,52,-156
622,2,32,3,11,0,928,1393,1050,634,598,559,552,559,568,496,633,817,725.0,649.0,184,137,47
211,3,32,3,11,0,272,405,185,132,207,141,156,128,146,189,194,188,191.0,190.0,-6,5,-11
126,4,32,3,11,0,446,852,178,127,199,127,128,132,116,105,91,84,88.0,93.0,-7,-14,7
423,5,32,3,11,0,934,1509,1063,565,512,413,385,387,456,447,479,394,436.0,440.0,-85,32,-117
994,6,32,3,11,0,1461,2601,1965,1072,936,771,749,842,897,904,1032,1004,1018.0,980.0,-28,128,-156
2048,7,32,3,11,0,3077,5360,2858,1598,1729,1694,1756,1539,1936,1912,2146,2072,2109.0,2043.0,-74,234,-308
572,8,32,3,11,0,803,1442,701,396,447,437,462,390,470,484,542,537,540.0,521.0,-5,58,-63
3185,9,32,3,11,0,5800,8421,3465,1872,3263,2465,2754,2779,2551,2831,3372,3213,3292.0,3139.0,-159,541,-700
1932,10,32,3,11,0,3479,6171,2981,1510,1845,1206,1444,1326,1376,2120,1771,1953,1862.0,1948.0,182,-349,531
1529,11,32,3,11,0,2153,3757,2028,1542,1465,1325,1301,1251,1387,1382,1410,1551,1480.0,1448.0,141,28,113
520,12,32,3,11,0,736,1319,827,443,434,359,341,393,389,426,463,502,482.0,464.0,39,37,2
1412,13,32,3,11,0,1789,2863,1366,1047,1021,1146,1168,1072,1294,1269,1276,1339,1308.0,1295.0,63,7,56
3241,14,32,3,11,0,5194,9539,6024,2842,2528,2423,2523,2603,3162,2973,3080,3382,3231.0,3145.0,302,107,195
1020,15,32,3,11,0,1653,2646,934,580,745,680,733,621,813,822,894,995,944.0,904.0,101,72,29
450,16,32,3,11,0,982,1629,1137,521,524,406,468,397,454,447,595,540,568.0,527.0,-55,148,-203
851,17,32,3,11,0,1513,2352,1658,771,808,663,615,657,743,779,889,856,872.0,841.0,-33,110,-143
542,18,32,3,11,0,738,1086,453,316,456,314,359,319,319,322,371,355,363.0,349.0,-16,49,-65
698,19,32,3,11,0,694,1039,408,313,505,468,482,534,500,483,512,500,506.0,498.0,-12,29,-41
157,20,32,3,11,0,304,514,324,210,169,172,136,158,183,160,169,141,155.0,157.0,-28,9,-37
692,21,32,3,11,0,1045,1704,937,403,499,452,488,436,535,576,634,679,656.0,630.0,45,58,-13
606,22,32,3,11,0,832,1045,394,365,562,482,469,565,521,543,559,428,494.0,510.0,-131,16,-147
944,1,33,2,11,0,1283,1483,389,338,505,521,647,608,619,726,770,537,654.0,678.0,-233,44,-277
339,2,33,2,11,0,360,567,208,160,208,214,226,198,297,263,248,248,248.0,253.0,0,-15,15
451,3,33,2,11,0,698,789,413,215,340,311,387,355,326,370,370,413,392.0,384.0,43,0,43
85,4,33,2,11,0,389,488,143,102,126,84,102,87,71,101,86,53,70.0,80.0,-33,-15,-18
780,5,33,2,11,0,820,1117,531,374,577,521,559,581,527,664,831,558,694.0,684.0,-273,167,-440
462,6,33,2,11,0,615,705,385,198,241,246,257,285,305,420,360,450,405.0,410.0,90,-60,150
1149,7,33,2,11,0,1352,1707,803,424,738,843,928,824,912,1138,1251,1154,1202.0,1181.0,-97,113,-210
296,8,33,2,11,0,352,464,131,87,174,169,231,178,188,345,260,267,264.0,291.0,7,-85,92
291,9,33,2,11,0,407,475,130,117,221,195,239,246,184,249,327,211,269.0,262.0,-116,78,-194
108,10,33,2,11,0,158,231,93,43,77,54,89,79,95,76,109,105,107.0,97.0,-4,33,-37
1500,11,33,2,11,0,1868,2181,991,782,1094,1007,1280,1090,1058,1318,1361,1434,1398.0,1371.0,73,43,30
426,12,33,2,11,0,438,495,251,128,183,180,217,188,232,281,331,328,330.0,313.0,-3,50,-53
710,13,33,2,11,0,978,1229,546,360,592,598,847,611,670,860,765,645,705.0,757.0,-120,-95,-25
765,14,33,2,11,0,835,1053,508,259,492,410,471,586,659,755,577,697,637.0,676.0,120,-178,298
881,15,33,2,11,0,1063,1213,348,291,556,450,632,576,610,714,681,755,718.0,717.0,74,-33,107
273,16,33,2,11,0,358,440,200,80,136,138,174,236,210,228,238,222,230.0,229.0,-16,10,-26
463,17,33,2,11,0,670,749,385,150,254,224,307,284,328,398,464,369,416.0,410.0,-95,66,-161
302,18,33,2,11,0,385,408,188,136,178,176,297,240,200,252,252,280,266.0,261.0,28,0,28
102,19,33,2,11,0,195,210,53,54,81,84,109,71,94,144,110,80,95.0,111.0,-30,-34,4
128,20,33,2,11,0,181,295,131,85,113,117,117,161,107,136,118,97,108.0,117.0,-21,-18,-3
1013,21,33,2,11,0,1012,1286,412,280,531,610,649,548,736,763,674,958,816.0,798.0,284,-89,373
117,22,33,2,11,0,210,228,66,80,160,104,150,105,113,153,106,123,114.0,127.0,17,-47,64
431,1,34,2,11,0,524,679,950,175,263,226,214,231,1376,364,429,271,350.0,355.0,-158,65,-223
219,2,34,2,11,0,215,293,131,118,135,108,106,85,183,133,193,170,182.0,165.0,-23,60,-83
86,3,34,2,11,0,102,118,60,38,63,48,62,45,54,52,67,84,76.0,68.0,17,15,2
148,4,34,2,11,0,231,280,180,87,167,105,117,108,135,120,201,105,153.0,142.0,-96,81,-177
299,5,34,2,11,0,291,404,151,140,210,163,126,156,158,240,401,151,276.0,264.0,-250,161,-411
225,6,34,2,11,0,176,201,116,64,85,74,80,96,91,141,190,131,160.0,154.0,-59,49,-108
495,7,34,2,11,0,383,451,230,146,276,296,237,243,266,313,411,311,361.0,345.0,-100,98,-198
109,8,34,2,11,0,85,95,42,23,68,34,43,37,45,67,94,54,74.0,72.0,-40,27,-67
135,9,34,2,11,0,225,268,104,54,144,101,111,106,100,115,132,132,132.0,126.0,0,17,-17
40,10,34,2,11,0,42,71,30,28,32,17,42,31,35,34,44,32,38.0,37.0,-12,10,-22
723,11,34,2,11,0,644,669,334,279,388,278,361,289,335,427,537,405,471.0,456.0,-132,110,-242
129,12,34,2,11,0,104,86,64,32,40,53,58,44,58,62,97,53,75.0,71.0,-44,35,-79
316,13,34,2,11,0,206,272,140,97,162,151,190,159,151,222,288,202,245.0,237.0,-86,66,-152
360,14,34,2,11,0,219,319,144,90,156,142,133,159,150,253,275,177,226.0,235.0,-98,22,-120
510,15,34,2,11,0,400,452,190,120,235,179,236,184,200,265,399,223,311.0,296.0,-176,134,-310
118,16,34,2,11,0,81,82,146,33,61,41,44,47,128,75,99,64,82.0,79.0,-35,24,-59
193,17,34,2,11,0,135,228,105,59,115,89,71,92,97,142,167,127,147.0,145.0,-40,25,-65
102,18,34,2,11,0,132,139,77,43,64,62,76,55,207,71,81,95,88.0,82.0,14,10,4
66,19,34,2,11,0,62,81,42,40,28,19,48,46,42,41,57,41,49.0,46.0,-16,16,-32
133,20,34,2,11,0,77,87,44,31,56,52,34,81,74,75,97,76,86.0,83.0,-21,22,-43
211,21,34,2,11,0,201,238,124,83,169,151,120,99,145,151,182,131,156.0,155.0,-51,31,-82
50,22,34,2,11,0,56,48,22,17,60,50,40,34,50,39,45,36,40.0,40.0,-9,6,-15
186,1,35,2,11,0,206,317,238,124,175,178,198,247,172,229,295,178,236.0,234.0,-117,66,-183
93,2,35,2,11,0,61,94,64,55,50,58,59,74,82,64,64,71,68.0,66.0,7,0,7
94,3,35,2,11,0,77,114,119,58,88,84,113,93,124,126,127,119,123.0,124.0,-8,1,-9
491,4,35,2,11,0,466,954,488,303,463,422,404,405,524,536,639,464,552.0,546.0,-175,103,-278
373,5,35,2,11,0,270,560,493,212,308,310,321,356,354,476,541,437,489.0,485.0,-104,65,-169
225,6,35,2,11,0,164,192,238,108,126,152,161,181,221,244,275,225,250.0,248.0,-50,31,-81
667,7,35,2,11,0,462,714,609,352,736,802,743,732,752,968,895,828,862.0,897.0,-67,-73,6
193,8,35,2,11,0,152,230,168,75,152,133,162,155,176,214,192,218,205.0,208.0,26,-22,48
1966,9,35,2,11,0,1988,1893,1283,554,1157,1342,1371,1506,1365,1632,2543,2393,2468.0,2189.0,-150,911,-1061
319,10,35,2,11,0,204,333,316,132,218,179,232,209,214,240,299,302,300.0,280.0,3,59,-56
866,11,35,2,11,0,602,865,785,520,701,575,790,696,727,808,884,890,887.0,861.0,6,76,-70
249,12,35,2,11,0,194,280,264,100,195,178,199,185,190,228,334,263,298.0,275.0,-71,106,-177
469,13,35,2,11,0,250,454,387,248,489,372,444,470,561,546,540,446,493.0,511.0,-94,-6,-88
291,14,35,2,11,0,191,300,319,141,195,250,224,252,313,287,373,278,326.0,313.0,-95,86,-181
751,15,35,2,11,0,795,787,577,391,567,562,623,668,663,739,794,766,780.0,766.0,-28,55,-83
592,16,35,2,11,0,374,566,545,193,390,310,389,475,504,667,583,520,552.0,590.0,-63,-84,21
380,17,35,2,11,0,423,412,412,410,531,262,352,341,399,402,522,391,456.0,438.0,-131,120,-251
727,18,35,2,11,0,363,562,555,242,485,658,692,517,589,652,643,659,651.0,651.0,16,-9,25
273,19,35,2,11,0,228,340,230,163,328,229,232,286,261,346,342,250,296.0,313.0,-92,-4,-88
292,20,35,2,11,0,348,846,378,203,261,239,256,499,348,265,359,273,316.0,299.0,-86,94,-180
176,21,35,2,11,0,99,126,138,68,103,103,121,139,167,222,209,183,196.0,205.0,-26,-13,-13
104,22,35,2,11,0,89,107,57,72,88,195,88,95,117,126,705,86,396.0,306.0,-619,579,-1198
224,1,36,1,11,0,276,374,264,140,173,111,133,219,252,305,253,189,221.0,249.0,-64,-52,-12
384,2,36,1,11,0,444,423,403,246,278,240,349,251,370,328,322,342,332.0,331.0,20,-6,26
540,3,36,1,11,0,505,619,534,251,398,363,397,446,439,554,594,520,557.0,556.0,-74,40,-114
804,4,36,1,11,0,1016,1441,741,459,672,521,645,648,738,710,716,555,636.0,660.0,-161,6,-167
750,5,36,1,11,0,743,1078,940,507,616,610,516,696,747,853,964,787,876.0,868.0,-177,111,-288
234,6,36,1,11,0,212,273,247,107,152,149,170,178,202,240,274,256,265.0,257.0,-18,34,-52
824,7,36,1,11,0,681,1011,688,350,548,657,631,628,667,792,970,906,938.0,889.0,-64,178,-242
371,8,36,1,11,0,288,348,274,115,219,218,272,224,246,326,337,407,372.0,357.0,70,11,59
2201,9,36,1,11,0,2144,2562,1849,777,1549,1067,1547,1898,1873,2104,2281,2270,2276.0,2218.0,-11,177,-188
360,10,36,1,11,0,342,443,364,194,278,172,226,248,272,340,365,351,358.0,352.0,-14,25,-39
580,11,36,1,11,0,682,857,658,425,546,407,545,534,592,698,728,718,723.0,715.0,-10,30,-40
286,12,36,1,11,0,277,382,334,121,180,176,242,230,289,241,378,316,347.0,312.0,-62,137,-199
1012,13,36,1,11,0,790,1042,804,407,572,721,849,721,962,1094,1052,1033,1042.0,1060.0,-19,-42,23
651,14,36,1,11,0,567,656,654,303,427,422,450,484,638,714,768,669,718.0,717.0,-99,54,-153
674,15,36,1,11,0,687,970,632,338,464,407,503,544,617,739,738,663,700.0,713.0,-75,-1,-74
1203,16,36,1,11,0,1296,1458,1429,526,890,740,929,1121,1218,1196,1452,1245,1348.0,1298.0,-207,256,-463
506,17,36,1,11,0,579,879,712,262,444,376,475,496,530,587,687,558,622.0,611.0,-129,100,-229
382,18,36,1,11,0,388,523,387,223,336,237,399,355,340,322,385,473,429.0,393.0,88,63,25
829,19,36,1,11,0,786,1105,571,424,658,595,611,583,678,909,852,761,806.0,841.0,-91,-57,-34
430,20,36,1,11,0,568,732,616,327,364,351,290,544,368,383,473,447,460.0,434.0,-26,90,-116
476,21,36,1,11,0,464,618,561,288,381,522,505,419,505,615,617,643,630.0,625.0,26,2,24
440,22,36,1,11,0,348,497,267,165,333,307,314,331,413,428,410,378,394.0,405.0,-32,-18,-14
92,1,37,2,11,0,242,237,68,37,61,48,42,46,60,56,89,75,82.0,73.0,-14,33,-47
182,2,37,2,11,0,182,271,140,100,100,97,72,92,101,116,117,159,138.0,131.0,42,1,41
180,3,37,2,11,0,149,195,78,54,74,78,87,84,89,105,134,146,140.0,128.0,12,29,-17
82,4,37,2,11,0,128,205,34,44,59,36,32,45,41,40,42,48,45.0,43.0,6,2,4
393,5,37,2,11,0,276,560,275,186,178,154,123,197,155,287,297,268,282.0,284.0,-29,10,-39
188,6,37,2,11,0,289,496,209,109,109,97,103,125,123,120,141,192,166.0,151.0,51,21,30
312,7,37,2,11,0,397,599,241,156,188,181,193,211,187,260,255,349,302.0,288.0,94,-5,99
143,8,37,2,11,0,192,226,67,52,65,70,76,81,82,108,105,132,118.0,115.0,27,-3,30
1185,9,37,2,11,0,1273,1753,510,290,467,429,504,568,492,615,692,978,835.0,762.0,286,77,209
230,10,37,2,11,0,209,314,161,76,113,66,89,103,111,120,142,206,174.0,156.0,64,22,42
596,11,37,2,11,0,808,1176,484,399,360,358,395,364,346,423,460,571,516.0,485.0,111,37,74
296,12,37,2,11,0,281,556,258,99,139,120,123,138,130,192,210,317,264.0,240.0,107,18,89
344,13,37,2,11,0,290,435,164,126,133,165,184,178,191,217,243,293,268.0,251.0,50,26,24
425,14,37,2,11,0,364,562,252,130,136,161,188,248,234,365,372,457,414.0,398.0,85,7,78
587,15,37,2,11,0,799,1102,332,255,331,293,293,451,433,549,507,551,529.0,536.0,44,-42,86
243,16,37,2,11,0,362,526,267,110,92,100,79,129,117,148,188,203,196.0,180.0,15,40,-25
359,17,37,2,11,0,313,627,286,115,133,96,119,133,162,229,236,300,268.0,255.0,64,7,57
259,18,37,2,11,0,340,500,185,128,160,130,141,134,138,134,168,231,200.0,178.0,63,34,29
222,19,37,2,11,0,209,299,101,86,133,111,127,127,138,164,160,216,188.0,180.0,56,-4,60
125,20,37,2,11,0,159,317,179,87,70,59,80,101,84,95,112,155,134.0,121.0,43,17,26
113,21,37,2,11,0,141,242,89,58,62,55,62,48,76,86,87,115,101.0,96.0,28,1,27
113,22,37,2,11,0,121,126,60,44,65,66,61,78,87,93,69,84,76.0,82.0,15,-24,39
330,1,38,2,11,0,1289,571,175,135,300,320,311,280,332,341,475,288,382.0,368.0,-187,134,-321
527,2,38,2,11,0,285,393,160,154,201,154,174,208,237,210,296,354,325.0,287.0,58,86,-28
533,3,38,2,11,0,339,631,236,164,278,287,352,354,352,396,368,451,410.0,405.0,83,-28,111
378,4,38,2,11,0,656,980,232,253,315,319,299,344,411,421,374,323,348.0,373.0,-51,-47,-4
1083,5,38,2,11,0,1016,1536,609,478,708,677,703,870,874,1179,1263,1119,1191.0,1187.0,-144,84,-228
778,6,38,2,11,0,550,750,358,257,522,447,450,474,531,638,743,737,740.0,706.0,-6,105,-111
2804,7,38,2,11,0,3502,5481,1788,1203,1635,2012,1985,2046,2150,2770,3225,3176,3200.0,3057.0,-49,455,-504
1289,8,38,2,11,0,919,1474,502,371,567,626,775,870,822,1077,1141,1396,1268.0,1205.0,255,64,191
10485,9,38,2,11,0,12394,15317,5306,3718,8079,6812,7957,8612,8119,10514,11327,10929,11128.0,10923.0,-398,813,-1211
2157,10,38,2,11,0,1789,2693,1195,777,1366,1087,1463,1613,1736,2291,2448,2230,2339.0,2323.0,-218,157,-375
2532,11,38,2,11,0,2622,3296,1247,1529,2148,2087,2259,2343,2472,2603,2698,2915,2806.0,2739.0,217,95,122
1393,12,38,2,11,0,1265,1764,857,484,797,835,979,1050,1189,1342,1563,1467,1515.0,1457.0,-96,221,-317
2518,13,38,2,11,0,2449,3796,1214,995,1259,1697,1832,1815,2279,2449,2337,2523,2430.0,2436.0,186,-112,298
1999,14,38,2,11,0,1951,3130,1278,848,1290,1492,1391,1525,1910,2272,2311,2004,2158.0,2196.0,-307,39,-346
1935,15,38,2,11,0,2019,2088,700,801,1246,1369,1509,1644,1767,1896,1932,1907,1920.0,1912.0,-25,36,-61
1303,16,38,2,11,0,1425,1562,736,376,772,827,842,1061,1101,1051,1206,1327,1266.0,1195.0,121,155,-34
1696,17,38,2,11,0,1769,3168,1244,677,1105,1093,1503,1476,1786,1858,2160,1767,1964.0,1928.0,-393,302,-695
1572,18,38,2,11,0,1591,1981,769,598,1058,945,1316,1163,1316,1476,1544,1688,1616.0,1569.0,144,68,76
2285,19,38,2,11,0,2622,3705,1059,1132,1642,1541,1606,1822,1931,2151,2147,2045,2096.0,2114.0,-102,-4,-98
547,20,38,2,11,0,548,828,333,235,331,330,400,708,364,385,467,671,569.0,508.0,204,82,122
390,21,38,2,11,0,402,722,289,175,287,284,326,299,382,387,425,432,428.0,415.0,7,38,-31
1104,22,38,2,11,0,913,1064,350,347,604,509,589,621,701,1075,927,822,874.0,941.0,-105,-148,43
333,1,39,1,11,0,241,272,250,161,224,213,175,131,62,223,288,334,311.0,282.0,46,65,-19
533,2,39,1,11,0,282,383,494,162,297,298,329,209,81,389,480,466,473.0,445.0,-14,91,-105
458,3,39,1,11,0,331,374,412,213,364,399,353,232,84,339,393,355,374.0,362.0,-38,54,-92
689,4,39,1,11,0,527,798,336,255,324,347,230,135,126,317,411,461,436.0,396.0,50,94,-44
642,5,39,1,11,0,364,502,560,198,280,354,296,108,64,382,522,529,526.0,478.0,7,140,-133
622,6,39,1,11,0,339,449,378,228,339,365,359,86,125,393,488,570,529.0,484.0,82,95,-13
1423,7,39,1,11,0,1020,1083,1132,648,948,1214,1085,369,273,1000,1192,1241,1216.0,1144.0,49,192,-143
595,8,39,1,11,0,347,454,373,276,370,403,345,137,148,396,551,467,509.0,471.0,-84,155,-239
3829,9,39,1,11,0,2842,3119,2859,1337,2735,2621,2524,1566,594,2431,2956,3252,3104.0,2880.0,296,525,-229
407,10,39,1,11,0,279,316,376,154,306,255,297,140,103,277,336,389,362.0,334.0,53,59,-6
1203,11,39,1,11,0,905,1057,1012,579,905,787,820,405,226,838,926,1064,995.0,943.0,138,88,50
437,12,39,1,11,0,334,414,397,195,355,439,342,151,95,317,402,446,424.0,388.0,44,85,-41
1205,13,39,1,11,0,646,778,797,602,842,1066,971,374,253,922,911,1078,994.0,970.0,167,-11,178
1512,14,39,1,11,0,979,1154,954,596,986,1159,919,330,428,1111,1295,1278,1286.0,1228.0,-17,184,-201
1105,15,39,1,11,0,709,819,752,388,650,682,669,277,191,789,847,1023,935.0,886.0,176,58,118
1723,16,39,1,11,0,1292,1497,1405,549,1164,1131,1057,674,316,1053,1385,1304,1344.0,1247.0,-81,332,-413
816,17,39,1,11,0,649,953,623,341,556,689,570,218,194,551,712,695,704.0,653.0,-17,161,-178
700,18,39,1,11,0,610,611,627,347,556,479,612,226,137,543,591,622,606.0,585.0,31,48,-17
1081,19,39,1,11,0,727,851,758,485,709,730,631,387,271,733,853,891,872.0,826.0,38,120,-82
301,20,39,1,11,0,145,208,248,87,111,125,128,35,39,154,285,243,264.0,227.0,-42,131,-173
578,21,39,1,11,0,400,482,463,229,331,386,360,198,125,357,434,525,480.0,439.0,91,77,14
729,22,39,1,11,0,630,549,617,346,607,485,461,268,130,519,630,543,586.0,564.0,-87,111,-198
177,1,40,1,11,0,345,456,114,153,205,172,211,259,235,234,227,143,185.0,201.0,-84,-7,-77
359,2,40,1,11,0,338,442,406,203,364,347,383,359,548,448,420,225,322.0,364.0,-195,-28,-167
215,3,40,1,11,0,331,382,195,193,311,298,379,324,426,353,305,214,260.0,291.0,-91,-48,-43
198,4,40,1,11,0,356,580,121,115,186,128,156,127,143,113,150,121,136.0,128.0,-29,37,-66
364,5,40,1,11,0,569,804,459,234,390,378,467,472,512,561,494,291,392.0,449.0,-203,-67,-136
377,6,40,1,11,0,489,503,403,244,376,434,485,530,589,548,523,287,405.0,453.0,-236,-25,-211
700,7,40,1,11,0,912,1164,554,505,703,953,906,900,978,952,895,531,713.0,793.0,-364,-57,-307
278,8,40,1,11,0,316,428,223,193,301,299,310,314,437,371,333,194,264.0,299.0,-139,-38,-101
2189,9,40,1,11,0,3345,3730,1930,1262,2615,2284,2880,3003,3073,3157,2906,1622,2264.0,2562.0,-1284,-251,-1033
275,10,40,1,11,0,377,417,266,187,309,304,370,332,440,396,386,211,298.0,331.0,-175,-10,-165
913,11,40,1,11,0,1454,1527,877,754,1069,1130,1243,1239,1359,1276,1127,677,902.0,1027.0,-450,-149,-301
301,12,40,1,11,0,350,507,305,161,323,377,500,498,505,477,346,244,295.0,356.0,-102,-131,29
591,13,40,1,11,0,574,797,453,434,572,723,877,842,1076,876,738,454,596.0,689.0,-284,-138,-146
743,14,40,1,11,0,872,1036,630,391,702,797,764,826,1251,974,822,486,654.0,761.0,-336,-152,-184
900,15,40,1,11,0,1151,1258,739,529,861,969,1092,1188,1336,1191,1013,688,850.0,964.0,-325,-178,-147
736,16,40,1,11,0,1189,1511,963,454,719,775,822,1002,1247,1129,844,697,770.0,890.0,-147,-285,138
399,17,40,1,11,0,506,737,420,189,443,430,470,484,597,615,466,266,366.0,449.0,-200,-149,-51
471,18,40,1,11,0,734,779,473,353,640,561,659,677,791,724,521,382,452.0,542.0,-139,-203,64
426,19,40,1,11,0,480,602,285,241,431,475,512,466,627,589,508,353,430.0,483.0,-155,-81,-74
160,20,40,1,11,0,200,305,185,95,179,155,153,233,211,194,180,134,157.0,169.0,-46,-14,-32
229,21,40,1,11,0,345,496,293,157,234,292,346,246,352,406,274,153,214.0,278.0,-121,-132,11
246,22,40,1,11,0,404,422,214,206,322,309,385,388,444,380,359,210,284.0,316.0,-149,-21,-128
199,1,41,3,11,0,277,348,224,140,212,313,130,176,126,150,183,117,150.0,150.0,-66,33,-99
17,2,41,3,11,0,22,33,19,19,18,22,20,12,9,9,13,11,12.0,11.0,-2,4,-6
21,3,41,3,11,0,19,22,21,19,29,36,17,19,26,22,19,25,22.0,22.0,6,-3,9
257,4,41,3,11,0,372,511,424,244,378,320,244,260,250,268,314,181,248.0,254.0,-133,46,-179
31,5,41,3,11,0,42,64,69,42,47,33,29,34,13,37,22,23,22.0,27.0,1,-15,16
61,6,41,3,11,0,74,75,83,59,59,57,45,62,31,45,37,42,40.0,41.0,5,-8,13
268,7,41,3,11,0,286,341,430,189,295,303,192,237,256,222,242,190,216.0,218.0,-52,20,-72
93,8,41,3,11,0,62,78,105,64,83,78,62,75,85,83,109,96,102.0,96.0,-13,26,-39
910,9,41,3,11,0,972,1235,1009,443,848,749,579,865,757,844,906,781,844.0,844.0,-125,62,-187
20,10,41,3,11,0,13,26,34,17,20,12,20,22,16,21,17,17,17.0,18.0,0,-4,4
342,11,41,3,11,0,380,481,397,258,351,301,241,305,301,319,353,284,318.0,319.0,-69,34,-103
32,12,41,3,11,0,35,37,61,16,26,40,25,30,32,20,29,23,26.0,24.0,-6,9,-15
226,13,41,3,11,0,231,316,308,172,236,271,218,215,233,230,258,218,238.0,235.0,-40,28,-68
142,14,41,3,11,0,188,209,242,134,155,146,105,140,155,161,153,126,140.0,147.0,-27,-8,-19
299,15,41,3,11,0,323,375,353,222,270,371,311,449,354,283,365,291,328.0,313.0,-74,82,-156
63,16,41,3,11,0,64,62,54,47,52,51,39,64,44,59,48,34,41.0,47.0,-14,-11,-3
40,17,41,3,11,0,31,44,54,26,27,28,26,30,22,38,28,29,28.0,32.0,1,-10,11
65,18,41,3,11,0,83,105,92,41,56,43,37,75,57,57,54,58,56.0,56.0,4,-3,7
127,19,41,3,11,0,153,187,158,103,124,129,115,148,126,163,128,97,112.0,129.0,-31,-35,4
19,20,41,3,11,0,12,27,22,12,27,12,19,15,18,21,16,10,13.0,16.0,-6,-5,-1
31,21,41,3,11,0,29,46,61,16,38,37,27,23,27,20,22,12,17.0,18.0,-10,2,-12
39,22,41,3,11,0,61,65,66,41,61,62,37,56,42,70,58,32,45.0,53.0,-26,-12,-14
224,1,42,1,11,0,331,369,161,142,190,140,165,214,189,313,284,306,295.0,301.0,22,-29,51
302,2,42,1,11,0,521,651,386,202,309,233,292,232,382,379,387,509,448.0,425.0,122,8,114
142,3,42,1,11,0,190,234,146,90,139,127,131,111,141,187,208,204,206.0,200.0,-4,21,-25
159,4,42,1,11,0,301,382,210,141,181,149,153,130,100,130,167,151,159.0,149.0,-16,37,-53
429,5,42,1,11,0,617,839,509,240,360,342,344,334,430,617,773,547,660.0,646.0,-226,156,-382
286,6,42,1,11,0,504,690,387,163,254,266,293,273,348,415,368,351,360.0,378.0,-17,-47,30
697,7,42,1,11,0,709,964,444,303,464,570,555,507,649,847,877,968,922.0,897.0,91,30,61
213,8,42,1,11,0,302,443,175,132,238,204,221,191,257,331,373,351,362.0,352.0,-22,42,-64
3592,9,42,1,11,0,4901,5547,3229,1517,2906,3040,2996,3064,2940,3296,3858,4197,4028.0,3784.0,339,562,-223
374,10,42,1,11,0,458,665,381,181,321,247,278,230,271,353,423,346,384.0,374.0,-77,70,-147
683,11,42,1,11,0,974,1139,690,508,722,614,698,656,855,923,861,961,911.0,915.0,100,-62,162
246,12,42,1,11,0,499,625,381,184,276,300,321,252,286,354,387,280,334.0,340.0,-107,33,-140
544,13,42,1,11,0,602,830,407,320,433,514,507,400,601,794,756,775,766.0,775.0,19,-38,57
449,14,42,1,11,0,614,920,507,247,499,530,473,405,626,853,641,609,625.0,701.0,-32,-212,180
748,15,42,1,11,0,1169,1424,732,558,806,842,817,859,969,1255,1091,1244,1168.0,1197.0,153,-164,317
630,16,42,1,11,0,1066,1347,698,270,511,498,504,540,672,774,908,619,764.0,767.0,-289,134,-423
384,17,42,1,11,0,700,988,570,203,418,421,498,401,577,729,628,544,586.0,634.0,-84,-101,17
678,18,42,1,11,0,796,1043,605,368,580,595,656,635,615,765,815,822,818.0,801.0,7,50,-43
502,19,42,1,11,0,460,600,253,193,341,357,363,293,369,581,567,618,592.0,589.0,51,-14,65
225,20,42,1,11,0,222,229,139,105,116,140,127,159,132,163,253,237,245.0,218.0,-16,90,-106
178,21,42,1,11,0,229,293,140,96,140,126,155,135,199,252,297,330,314.0,293.0,33,45,-12
239,22,42,1,11,0,199,322,111,123,264,218,232,182,233,390,264,192,228.0,282.0,-72,-126,54
377,1,43,2,11,0,457,516,264,193,369,368,312,223,311,325,374,342,358.0,347.0,-32,49,-81
130,2,43,2,11,0,233,253,206,111,144,116,120,119,120,92,116,114,115.0,107.0,-2,24,-26
210,3,43,2,11,0,200,238,219,114,172,145,184,185,176,175,180,177,178.0,177.0,-3,5,-8
628,4,43,2,11,0,754,1094,601,390,482,397,375,385,359,390,493,438,466.0,440.0,-55,103,-158
331,5,43,2,11,0,489,543,391,237,325,296,251,270,231,353,472,247,360.0,357.0,-225,119,-344
283,6,43,2,11,0,568,578,495,153,185,233,254,279,190,233,316,289,302.0,279.0,-27,83,-110
988,7,43,2,11,0,1094,1221,1031,476,846,727,791,753,709,746,888,910,899.0,848.0,22,142,-120
376,8,43,2,11,0,395,605,316,221,369,335,297,249,379,331,458,381,420.0,390.0,-77,127,-204
2999,9,43,2,11,0,3563,3747,2666,1125,2377,2460,2143,2250,2148,2251,2790,2698,2744.0,2580.0,-92,539,-631
131,10,43,2,11,0,194,174,193,92,119,101,114,104,103,130,136,127,132.0,131.0,-9,6,-15
1098,11,43,2,11,0,1491,1524,1070,552,1008,901,895,803,803,813,980,1039,1010.0,944.0,59,167,-108
216,12,43,2,11,0,340,409,346,81,166,179,201,165,187,208,207,235,221.0,217.0,28,-1,29
973,13,43,2,11,0,971,1119,789,422,734,762,790,652,806,800,941,861,901.0,867.0,-80,141,-221
591,14,43,2,11,0,805,866,692,326,488,531,450,448,469,417,510,471,490.0,466.0,-39,93,-132
1557,15,43,2,11,0,1516,1515,1138,549,969,1010,1108,1385,1507,1239,1522,1512,1517.0,1424.0,-10,283,-293
482,16,43,2,11,0,779,906,749,253,446,434,381,436,412,489,521,449,485.0,486.0,-72,32,-104
452,17,43,2,11,0,767,839,710,238,437,402,430,431,398,373,459,387,423.0,406.0,-72,86,-158
513,18,43,2,11,0,612,638,509,288,542,508,519,527,327,322,360,452,406.0,378.0,92,38,54
1106,19,43,2,11,0,1269,1395,898,506,962,872,971,851,914,875,950,831,890.0,885.0,-119,75,-194
162,20,43,2,11,0,200,213,159,106,164,130,104,160,133,125,141,144,142.0,137.0,3,16,-13
237,21,43,2,11,0,309,371,227,159,225,195,179,129,173,160,195,208,202.0,188.0,13,35,-22
571,22,43,2,11,0,639,783,366,217,537,358,448,306,533,522,375,424,400.0,440.0,49,-147,196
317,1,44,1,11,0,304,291,260,125,252,169,218,208,195,239,288,307,298.0,278.0,19,49,-30
89,2,44,1,11,0,97,95,78,48,59,48,61,43,79,64,53,60,56.0,59.0,7,-11,18
60,3,44,1,11,0,54,64,35,18,51,53,69,55,61,64,72,82,77.0,73.0,10,8,2
408,4,44,1,11,0,551,739,435,233,445,341,391,396,426,482,578,448,513.0,503.0,-130,96,-226
312,5,44,1,11,0,246,296,270,133,178,212,190,231,208,233,444,241,342.0,306.0,-203,211,-414
107,6,44,1,11,0,125,125,156,59,89,69,81,70,72,75,150,124,137.0,116.0,-26,75,-101
263,7,44,1,11,0,228,356,218,112,223,197,226,179,193,249,344,254,299.0,282.0,-90,95,-185
41,8,44,1,11,0,53,51,47,21,35,29,43,35,45,44,57,33,45.0,45.0,-24,13,-37
433,9,44,1,11,0,442,572,437,152,310,246,338,497,305,362,444,473,458.0,426.0,29,82,-53
57,10,44,1,11,0,38,46,44,34,25,32,38,35,50,44,68,69,68.0,60.0,1,24,-23
232,11,44,1,11,0,248,301,251,138,200,177,214,189,187,223,290,301,296.0,271.0,11,67,-56
76,12,44,1,11,0,75,92,84,32,51,53,76,51,70,67,97,77,87.0,80.0,-20,30,-50
139,13,44,1,11,0,123,131,106,79,112,113,144,111,129,162,213,174,194.0,183.0,-39,51,-90
129,14,44,1,11,0,144,187,131,57,111,155,108,118,135,163,164,158,161.0,162.0,-6,1,-7
127,15,44,1,11,0,149,230,149,78,139,107,108,142,110,130,142,139,140.0,137.0,-3,12,-15
138,16,44,1,11,0,148,184,148,61,111,94,101,110,110,157,162,143,152.0,154.0,-19,5,-24
157,17,44,1,11,0,157,211,135,74,132,109,108,118,96,135,209,137,173.0,160.0,-72,74,-146
111,18,44,1,11,0,111,124,108,57,77,71,97,95,75,85,112,118,115.0,105.0,6,27,-21
141,19,44,1,11,0,126,129,69,51,75,76,107,67,96,152,173,146,160.0,157.0,-27,21,-48
145,20,44,1,11,0,132,160,125,77,112,97,87,149,112,142,157,158,158.0,152.0,1,15,-14
152,21,44,1,11,0,150,182,148,77,137,111,172,117,112,144,202,224,213.0,190.0,22,58,-36
68,22,44,1,11,0,71,77,53,34,68,53,50,51,50,100,75,78,76.0,84.0,3,-25,28
143,1,45,1,11,0,244,388,154,85,126,92,105,104,90,95,93,83,88.0,90.0,-10,-2,-8
97,2,45,1,11,0,214,267,194,91,60,53,77,69,54,60,68,102,85.0,77.0,34,8,26
52,3,45,1,11,0,167,259,127,62,61,62,68,40,53,87,64,46,55.0,66.0,-18,-23,5
23,4,45,1,11,0,181,370,71,41,51,25,21,23,21,16,13,11,12.0,13.0,-2,-3,1
173,5,45,1,11,0,432,691,448,194,129,110,118,105,113,152,138,140,139.0,143.0,2,-14,16
381,6,45,1,11,0,699,1253,712,250,227,217,259,222,209,229,284,331,308.0,281.0,47,55,-8
438,7,45,1,11,0,792,1449,549,320,297,347,332,246,290,297,412,443,428.0,384.0,31,115,-84
97,8,45,1,11,0,231,426,153,81,103,83,114,108,86,92,80,88,84.0,87.0,8,-12,20
535,9,45,1,11,0,1204,1628,496,168,342,246,344,349,247,271,470,547,508.0,429.0,77,199,-122
67,10,45,1,11,0,135,240,121,56,54,26,39,23,31,45,41,46,44.0,44.0,5,-4,9
640,11,45,1,11,0,1083,1908,768,543,404,402,487,371,340,347,446,468,457.0,420.0,22,99,-77
313,12,45,1,11,0,434,733,453,153,150,168,191,126,131,163,222,258,240.0,214.0,36,59,-23
304,13,45,1,11,0,667,1158,476,272,257,300,350,276,304,321,274,306,290.0,300.0,32,-47,79
489,14,45,1,11,0,1006,1883,910,372,312,380,366,295,321,290,401,454,428.0,382.0,53,111,-58
779,15,45,1,11,0,1202,2202,744,430,386,337,361,407,360,410,487,673,580.0,523.0,186,77,109
265,16,45,1,11,0,409,749,443,143,138,130,145,146,117,118,165,198,182.0,160.0,33,47,-14
193,17,45,1,11,0,439,744,378,131,137,149,138,134,113,150,189,192,190.0,177.0,3,39,-36
178,18,45,1,11,0,391,594,265,149,173,130,137,127,100,127,140,178,159.0,148.0,38,13,25
54,19,45,1,11,0,186,256,75,62,80,75,84,47,39,66,55,56,56.0,59.0,1,-11,12
32,20,45,1,11,0,92,172,124,38,29,23,20,27,17,21,36,14,25.0,24.0,-22,15,-37
63,21,45,1,11,0,212,325,144,79,70,64,97,57,67,82,80,101,90.0,88.0,21,-2,23
42,22,45,1,11,0,126,152,43,36,52,38,43,41,34,44,43,32,38.0,40.0,-11,-1,-10
21,1,46,1,11,0,88,96,65,19,37,175,5,12,7,8,136,3,70.0,49.0,-133,128,-261
58,2,46,1,11,0,209,182,216,75,82,86,83,57,67,66,46,65,56.0,59.0,19,-20,39
29,3,46,1,11,0,130,141,132,46,66,45,69,41,38,46,34,32,33.0,37.0,-2,-12,10
26,4,46,1,11,0,186,277,124,81,65,48,29,26,33,15,60,11,36.0,29.0,-49,45,-94
88,5,46,1,11,0,205,292,350,117,93,78,81,64,97,44,63,63,63.0,57.0,0,19,-19
193,6,46,1,11,0,341,384,513,121,108,92,90,118,107,99,88,111,100.0,99.0,23,-11,34
468,7,46,1,11,0,480,596,555,214,153,209,203,175,145,127,346,326,336.0,266.0,-20,219,-239
16,8,46,1,11,0,70,67,66,26,12,22,19,12,23,3,3,7,5.0,4.0,4,0,4
30,9,46,1,11,0,101,84,62,19,63,37,30,29,26,25,17,16,16.0,19.0,-1,-8,7
15,10,46,1,11,0,39,50,45,14,26,20,6,2,8,5,11,8,10.0,8.0,-3,6,-9
328,11,46,1,11,0,474,569,538,214,216,188,191,134,129,86,151,201,176.0,146.0,50,65,-15
105,12,46,1,11,0,274,309,360,94,101,91,90,79,82,62,58,77,68.0,66.0,19,-4,23
209,13,46,1,11,0,326,383,353,154,150,162,149,131,144,91,180,201,190.0,157.0,21,89,-68
258,14,46,1,11,0,372,457,538,139,100,129,104,87,70,63,93,117,105.0,91.0,24,30,-6
360,15,46,1,11,0,429,453,388,129,152,151,108,106,91,89,167,264,216.0,173.0,97,78,19
178,16,46,1,11,0,317,421,474,120,139,119,158,186,109,65,89,106,98.0,87.0,17,24,-7
282,17,46,1,11,0,348,428,459,95,148,114,114,115,100,92,163,156,160.0,137.0,-7,71,-78
50,18,46,1,11,0,127,159,136,38,44,37,55,51,15,28,29,27,28.0,28.0,-2,1,-3
71,19,46,1,11,0,174,238,151,59,93,137,105,53,60,48,51,55,53.0,51.0,4,3,1
10,20,46,1,11,0,151,126,110,41,27,16,19,16,22,15,14,6,10.0,12.0,-8,-1,-7
74,21,46,1,11,0,210,288,180,80,67,82,94,70,81,86,60,43,52.0,63.0,-17,-26,9
51,22,46,1,11,0,118,156,75,46,57,45,34,22,28,31,17,28,22.0,25.0,11,-14,25
407,1,47,2,11,0,341,384,208,78,136,169,219,267,195,272,379,301,340.0,317.0,-78,107,-185
120,2,47,2,11,0,186,206,142,56,68,79,116,111,106,126,142,139,140.0,136.0,-3,16,-19
55,3,47,2,11,0,125,115,74,44,45,52,72,39,48,70,69,60,64.0,66.0,-9,-1,-8
213,4,47,2,11,0,553,771,253,139,206,162,160,198,159,181,170,152,161.0,168.0,-18,-11,-7
730,5,47,2,11,0,657,933,673,263,243,304,396,459,464,505,768,629,698.0,634.0,-139,263,-402
659,6,47,2,11,0,764,993,964,338,340,389,526,609,640,679,780,759,770.0,739.0,-21,101,-122
749,7,47,2,11,0,957,1332,1011,383,430,537,623,546,597,690,912,884,898.0,829.0,-28,222,-250
151,8,47,2,11,0,203,275,128,67,102,111,136,137,121,130,151,145,148.0,142.0,-6,21,-27
1385,9,47,2,11,0,1660,1546,767,278,638,579,734,773,669,732,1150,1234,1192.0,1039.0,84,418,-334
199,10,47,2,11,0,188,276,186,86,105,86,125,135,129,121,150,190,170.0,154.0,40,29,11
2157,11,47,2,11,0,2022,2642,2094,991,984,1074,1356,1448,1465,1619,1956,2009,1982.0,1861.0,53,337,-284
502,12,47,2,11,0,453,691,614,157,211,274,326,317,295,445,614,519,566.0,526.0,-95,169,-264
510,13,47,2,11,0,667,773,530,290,330,342,436,385,393,514,507,523,515.0,515.0,16,-7,23
1428,14,47,2,11,0,1577,2409,1865,640,650,891,1055,1267,1138,1176,1439,1566,1502.0,1394.0,127,263,-136
1730,15,47,2,11,0,1832,2222,1022,501,663,715,913,1088,1232,1489,1624,1714,1669.0,1609.0,90,135,-45
510,16,47,2,11,0,492,661,605,178,211,256,312,333,394,414,526,562,544.0,501.0,36,112,-76
509,17,47,2,11,0,547,698,488,170,228,287,352,372,388,447,540,497,518.0,495.0,-43,93,-136
538,18,47,2,11,0,556,601,361,197,246,246,307,332,263,303,408,504,456.0,405.0,96,105,-9
212,19,47,2,11,0,211,328,161,100,120,120,168,137,149,154,182,162,172.0,166.0,-20,28,-48
391,20,47,2,11,0,373,430,326,140,158,145,189,295,272,251,352,358,355.0,320.0,6,101,-95
242,21,47,2,11,0,347,562,349,119,145,167,210,170,185,229,259,243,251.0,244.0,-16,30,-46
216,22,47,2,11,0,97,100,69,37,53,48,62,47,72,53,77,99,88.0,76.0,22,24,-2
53,1,48,2,11,0,41,46,32,19,54,17,10,12,11,6,11,22,16.0,13.0,11,5,6
204,2,48,2,11,0,119,169,142,104,91,53,62,66,54,100,120,234,177.0,151.0,114,20,94
334,3,48,2,11,0,353,430,278,168,258,163,176,174,153,161,172,446,309.0,260.0,274,11,263
42,4,48,2,11,0,78,112,52,38,30,13,7,12,11,3,21,34,28.0,19.0,13,18,-5
454,5,48,2,11,0,517,641,617,336,250,134,145,143,161,174,211,648,430.0,344.0,437,37,400
313,6,48,2,11,0,198,190,278,146,119,59,72,88,63,82,153,349,251.0,195.0,196,71,125
1169,7,48,2,11,0,1562,2281,1763,885,746,509,752,650,656,635,554,1575,1064.0,921.0,1021,-81,1102
768,8,48,2,11,0,768,886,691,295,401,285,317,252,283,337,321,1057,689.0,572.0,736,-16,752
430,9,48,2,11,0,710,1008,472,229,471,212,177,139,130,131,160,443,302.0,245.0,283,29,254
278,10,48,2,11,0,192,308,251,110,119,55,137,102,134,127,148,260,204.0,178.0,112,21,91
373,11,48,2,11,0,307,309,370,299,211,106,111,126,119,95,124,351,238.0,190.0,227,29,198
174,12,48,2,11,0,177,182,224,84,107,42,42,52,41,45,96,201,148.0,114.0,105,51,54
1482,13,48,2,11,0,1644,1840,1468,940,941,733,782,635,713,852,807,2258,1532.0,1306.0,1451,-45,1496
743,14,48,2,11,0,774,911,1101,433,362,211,283,281,280,284,399,1114,756.0,599.0,715,115,600
546,15,48,2,11,0,380,352,327,197,195,168,241,204,240,223,277,513,395.0,338.0,236,54,182
179,16,48,2,11,0,116,125,211,58,65,32,39,46,41,44,51,166,108.0,87.0,115,7,108
357,17,48,2,11,0,141,165,230,105,87,42,50,62,55,47,92,309,200.0,149.0,217,45,172
305,18,48,2,11,0,281,215,204,105,130,66,70,71,48,58,86,260,173.0,135.0,174,28,146
776,19,48,2,11,0,528,619,375,317,409,425,215,168,173,244,317,715,516.0,425.0,398,73,325
121,20,48,2,11,0,80,104,116,61,54,25,34,33,27,26,25,81,53.0,44.0,56,-1,57
274,21,48,2,11,0,214,250,261,108,136,75,123,125,148,123,127,394,260.0,215.0,267,4,263
647,22,48,2,11,0,350,342,207,144,192,137,117,137,97,118,219,569,394.0,302.0,350,101,249
433,1,49,1,11,0,435,596,174,80,151,177,200,272,204,286,381,357,369.0,341.0,-24,95,-119
298,2,49,1,11,0,538,699,444,236,185,176,241,235,239,233,242,311,276.0,262.0,69,9,60
221,3,49,1,11,0,323,485,221,94,125,138,233,182,202,244,226,285,256.0,252.0,59,-18,77
331,4,49,1,11,0,879,1517,309,174,289,242,251,279,287,271,285,203,244.0,253.0,-82,14,-96
497,5,49,1,11,0,770,1305,743,339,285,287,359,363,364,444,612,527,570.0,528.0,-85,168,-253
889,6,49,1,11,0,964,1597,855,344,344,422,524,660,677,843,847,868,858.0,853.0,21,4,17
827,7,49,1,11,0,1107,1740,687,383,327,543,829,670,841,808,972,862,917.0,881.0,-110,164,-274
256,8,49,1,11,0,301,514,192,100,117,126,207,172,186,212,232,248,240.0,231.0,16,20,-4
938,9,49,1,11,0,1586,1899,542,186,403,360,460,604,483,479,704,825,764.0,669.0,121,225,-104
155,10,49,1,11,0,309,514,260,96,110,81,120,111,123,118,114,164,139.0,132.0,50,-4,54
1192,11,49,1,11,0,1446,2279,939,574,593,645,899,941,918,876,1073,1193,1133.0,1047.0,120,197,-77
653,12,49,1,11,0,571,900,502,180,199,229,302,289,342,439,577,631,604.0,549.0,54,138,-84
978,13,49,1,11,0,1108,1749,708,414,412,600,843,768,843,1013,870,860,865.0,914.0,-10,-143,133
1246,14,49,1,11,0,1622,2735,1331,509,557,792,1003,1139,1208,1046,1173,1225,1199.0,1148.0,52,127,-75
1878,15,49,1,11,0,2130,3255,1119,581,616,676,899,1179,1212,1449,1568,1840,1704.0,1619.0,272,119,153
609,16,49,1,11,0,634,1014,597,202,210,256,309,467,354,417,541,558,550.0,505.0,17,124,-107
537,17,49,1,11,0,606,978,498,212,209,272,280,287,311,368,495,434,464.0,432.0,-61,127,-188
357,18,49,1,11,0,552,782,311,141,184,131,214,223,160,193,287,353,320.0,278.0,66,94,-28
199,19,49,1,11,0,258,424,127,80,97,131,161,165,176,170,202,187,194.0,186.0,-15,32,-47
257,20,49,1,11,0,309,532,260,104,78,93,126,161,148,159,170,178,174.0,169.0,8,11,-3
379,21,49,1,11,0,366,620,315,130,154,179,263,204,263,363,295,450,372.0,369.0,155,-68,223
154,22,49,1,11,0,232,274,80,52,66,71,97,87,91,116,90,100,95.0,102.0,10,-26,36
154,1,50,4,11,0,345,396,369,177,174,163,140,140,130,154,202,176,189.0,177.0,-26,48,-74
218,2,50,4,11,0,373,334,203,134,207,159,159,199,202,227,215,226,220.0,223.0,11,-12,23
45,3,50,4,11,0,59,90,51,29,42,27,40,31,39,40,40,103,72.0,61.0,63,0,63
53,4,50,4,11,0,222,242,93,60,87,42,47,47,40,41,55,59,57.0,52.0,4,14,-10
398,5,50,4,11,0,778,781,288,239,321,272,333,406,352,417,499,361,430.0,426.0,-138,82,-220
310,6,50,4,11,0,607,661,309,266,301,237,309,289,297,345,293,432,362.0,357.0,139,-52,191
469,7,50,4,11,0,782,994,540,419,572,464,433,395,383,432,535,703,619.0,557.0,168,103,65
83,8,50,4,11,0,132,201,88,44,87,60,67,72,87,105,82,107,94.0,98.0,25,-23,48
525,9,50,4,11,0,938,1135,331,231,477,411,394,418,380,461,499,508,504.0,489.0,9,38,-29
183,10,50,4,11,0,370,403,140,92,140,131,131,161,121,124,149,158,154.0,144.0,9,25,-16
856,11,50,4,11,0,1286,1781,805,710,885,641,740,693,656,701,768,937,852.0,802.0,169,67,102
240,12,50,4,11,0,444,431,157,97,173,170,210,195,175,219,261,224,242.0,235.0,-37,42,-79
481,13,50,4,11,0,589,806,391,375,484,404,455,438,404,455,455,703,579.0,538.0,248,0,248
459,14,50,4,11,0,729,896,363,334,528,418,445,554,381,446,510,591,550.0,516.0,81,64,17
543,15,50,4,11,0,797,1044,341,386,475,363,466,458,443,473,505,595,550.0,524.0,90,32,58
232,16,50,4,11,0,413,461,270,123,194,119,150,177,181,200,192,242,217.0,211.0,50,-8,58
207,17,50,4,11,0,458,478,157,99,182,167,188,184,200,195,251,207,229.0,218.0,-44,56,-100
273,18,50,4,11,0,455,593,250,154,266,219,283,228,214,225,227,321,274.0,258.0,94,2,92
104,19,50,4,11,0,136,149,45,36,75,66,76,84,71,67,64,113,88.0,81.0,49,-3,52
162,20,50,4,11,0,422,475,136,124,148,136,160,225,137,123,161,136,148.0,140.0,-25,38,-63
174,21,50,4,11,0,355,464,194,145,188,141,176,186,164,204,187,239,213.0,210.0,52,-17,69
78,22,50,4,11,0,82,87,40,47,82,54,34,48,39,38,37,82,60.0,52.0,45,-1,46
419,1,51,2,11,0,228,579,371,131,288,266,225,283,286,352,425,361,393.0,379.0,-64,73,-137
266,2,51,2,11,0,165,338,215,134,179,192,167,169,217,170,285,214,250.0,223.0,-71,115,-186
51,3,51,2,11,0,43,48,41,28,59,37,53,61,54,60,50,57,54.0,56.0,7,-10,17
102,4,51,2,11,0,372,383,131,61,110,108,70,103,89,94,106,75,90.0,92.0,-31,12,-43
689,5,51,2,11,0,484,820,550,286,428,433,456,497,476,571,730,570,650.0,624.0,-160,159,-319
661,6,51,2,11,0,362,758,508,322,432,425,545,563,499,558,654,651,652.0,621.0,-3,96,-99
535,7,51,2,11,0,383,729,410,227,320,381,388,394,345,413,508,427,468.0,449.0,-81,95,-176
70,8,51,2,11,0,91,136,74,57,53,62,47,59,62,56,65,82,74.0,68.0,17,9,8
1711,9,51,2,11,0,1034,2232,1023,444,1072,1007,969,1190,954,1225,1539,1459,1499.0,1408.0,-80,314,-394
253,10,51,2,11,0,191,328,208,107,160,131,178,209,223,211,264,238,251.0,238.0,-26,53,-79
1350,11,51,2,11,0,807,1846,1142,747,1023,870,969,1040,1045,1132,1384,1302,1343.0,1273.0,-82,252,-334
384,12,51,2,11,0,131,436,290,111,237,235,226,237,243,304,361,365,363.0,343.0,4,57,-53
474,13,51,2,11,0,272,475,287,194,265,298,335,339,355,444,469,418,444.0,444.0,-51,25,-76
638,14,51,2,11,0,420,747,459,249,457,513,513,571,508,547,706,610,658.0,621.0,-96,159,-255
1225,15,51,2,11,0,695,1454,752,503,780,679,725,759,836,1202,1060,1245,1152.0,1169.0,185,-142,327
482,16,51,2,11,0,190,481,312,158,246,258,251,428,347,390,481,444,462.0,438.0,-37,91,-128
445,17,51,2,11,0,235,425,324,139,263,238,293,308,308,344,467,351,409.0,387.0,-116,123,-239
645,18,51,2,11,0,415,699,508,260,395,323,426,506,406,485,547,533,540.0,522.0,-14,62,-76
134,19,51,2,11,0,64,125,66,52,82,116,125,102,110,143,125,94,110.0,121.0,-31,-18,-13
322,20,51,2,11,0,256,548,310,185,288,287,285,378,280,285,380,307,344.0,324.0,-73,95,-168
179,21,51,2,11,0,181,259,170,96,124,121,134,165,167,184,227,205,216.0,205.0,-22,43,-65
78,22,51,2,11,0,65,115,61,52,76,85,53,52,53,68,53,58,56.0,60.0,5,-15,20
312,1,52,1,11,0,421,473,415,199,338,303,272,297,230,306,310,217,264.0,278.0,-93,4,-97
309,2,52,1,11,0,485,535,500,259,353,295,304,293,320,299,296,284,290.0,293.0,-12,-3,-9
181,3,52,1,11,0,229,234,273,129,208,180,191,167,194,197,191,163,177.0,184.0,-28,-6,-22
419,4,52,1,11,0,500,681,534,295,402,398,365,374,341,360,397,323,360.0,360.0,-74,37,-111
533,5,52,1,11,0,743,849,933,442,540,493,508,553,476,460,610,426,518.0,499.0,-184,150,-334
197,6,52,1,11,0,334,368,404,198,210,162,176,206,197,185,206,181,194.0,191.0,-25,21,-46
566,7,52,1,11,0,776,936,911,376,595,546,558,596,483,522,642,489,566.0,551.0,-153,120,-273
151,8,52,1,11,0,208,244,213,113,141,101,103,104,107,143,141,135,138.0,140.0,-6,-2,-4
1118,9,52,1,11,0,1836,2078,1526,521,1068,875,905,1067,825,969,1188,973,1080.0,1043.0,-215,219,-434
153,10,52,1,11,0,246,317,323,145,236,156,189,166,140,172,167,131,149.0,157.0,-36,-5,-31
501,11,52,1,11,0,847,820,821,461,589,458,423,545,436,500,549,440,494.0,496.0,-109,49,-158
130,12,52,1,11,0,249,262,297,113,164,151,133,139,150,149,170,140,155.0,153.0,-30,21,-51
480,13,52,1,11,0,746,750,758,431,483,470,474,415,495,501,519,421,470.0,480.0,-98,18,-116
448,14,52,1,11,0,752,820,826,447,615,567,493,543,423,493,437,366,402.0,432.0,-71,-56,-15
355,15,52,1,11,0,623,684,550,252,401,254,311,325,307,322,340,344,342.0,335.0,4,18,-14
247,16,52,1,11,0,385,425,481,197,299,246,238,274,238,273,295,246,270.0,271.0,-49,22,-71
338,17,52,1,11,0,460,493,505,239,383,321,315,341,325,336,378,286,332.0,333.0,-92,42,-134
141,18,52,1,11,0,329,338,400,163,217,128,161,123,141,139,151,131,141.0,140.0,-20,12,-32
202,19,52,1,11,0,369,450,249,117,274,320,298,258,236,274,251,198,224.0,241.0,-53,-23,-30
289,20,52,1,11,0,540,575,576,284,403,314,306,439,296,285,331,263,297.0,293.0,-68,46,-114
225,21,52,1,11,0,346,404,376,178,272,285,266,201,203,229,236,216,226.0,227.0,-20,7,-27
262,22,52,1,11,0,341,410,324,206,341,242,239,273,292,251,258,237,248.0,249.0,-21,7,-28
289,1,53,2,11,0,636,846,241,179,180,191,192,253,247,261,249,228,238.0,246.0,-21,-12,-9
390,2,53,2,11,0,365,493,290,145,117,124,158,128,183,166,200,277,238.0,214.0,77,34,43
181,3,53,2,11,0,310,562,284,123,119,71,119,101,97,110,137,180,158.0,142.0,43,27,16
133,4,53,2,11,0,444,824,105,71,55,60,50,59,51,57,65,85,75.0,69.0,20,8,12
820,5,53,2,11,0,1080,1730,983,504,400,394,380,436,516,607,641,550,596.0,599.0,-91,34,-125
1281,6,53,2,11,0,1260,2243,1186,528,593,566,477,521,594,770,1036,1137,1086.0,981.0,101,266,-165
1155,7,53,2,11,0,1637,2998,1261,553,503,551,645,651,724,836,994,1041,1018.0,957.0,47,158,-111
315,8,53,2,11,0,372,645,313,178,140,164,178,173,195,230,273,274,274.0,259.0,1,43,-42
1092,9,53,2,11,0,1967,3191,905,337,855,959,831,614,794,1007,844,769,806.0,873.0,-75,-163,88
466,10,53,2,11,0,337,697,471,179,227,188,213,224,204,252,332,309,320.0,298.0,-23,80,-103
1300,11,53,2,11,0,2283,3836,1631,972,777,763,993,802,889,897,976,1122,1049.0,998.0,146,79,67
472,12,53,2,11,0,676,1270,658,229,229,221,283,227,273,344,417,442,430.0,401.0,25,73,-48
859,13,53,2,11,0,1064,2232,950,551,442,578,697,555,544,666,625,757,691.0,683.0,132,-41,173
1872,14,53,2,11,0,1720,3243,1894,828,807,1011,1085,1013,1189,1300,1393,1655,1524.0,1449.0,262,93,169
798,15,53,2,11,0,1205,1850,574,328,328,361,426,423,467,565,573,676,624.0,605.0,103,8,95
406,16,53,2,11,0,866,1354,755,244,256,243,222,247,223,230,310,348,329.0,296.0,38,80,-42
904,17,53,2,11,0,982,1756,938,322,403,371,448,412,466,511,628,666,647.0,602.0,38,117,-79
576,18,53,2,11,0,746,1041,462,182,250,215,304,238,233,338,522,511,516.0,457.0,-11,184,-195
205,19,53,2,11,0,422,561,181,92,144,178,144,111,123,123,146,152,149.0,140.0,6,23,-17
420,20,53,2,11,0,643,1136,557,231,195,203,189,260,190,212,306,281,294.0,266.0,-25,94,-119
759,21,53,2,11,0,805,1567,639,298,275,310,369,282,381,491,525,649,587.0,555.0,124,34,90
145,22,53,2,11,0,207,305,102,62,72,62,93,71,101,93,80,111,96.0,95.0,31,-13,44
30,1,54,1,11,0,139,159,95,31,32,33,18,19,21,31,33,32,32.0,32.0,-1,2,-3
74,2,54,1,11,0,116,195,181,91,58,50,67,48,56,60,70,109,90.0,80.0,39,10,29
176,3,54,1,11,0,227,336,327,113,110,91,126,86,83,105,142,150,146.0,132.0,8,37,-29
23,4,54,1,11,0,153,246,99,35,29,28,28,17,19,21,32,18,25.0,24.0,-14,11,-25
88,5,54,1,11,0,267,387,398,155,108,95,80,69,76,114,107,93,100.0,105.0,-14,-7,-7
153,6,54,1,11,0,301,471,484,121,103,101,118,103,101,112,137,149,143.0,133.0,12,25,-13
361,7,54,1,11,0,591,961,723,263,300,312,311,242,273,332,372,387,380.0,364.0,15,40,-25
100,8,54,1,11,0,133,167,149,66,59,57,51,58,45,92,92,77,84.0,87.0,-15,0,-15
58,9,54,1,11,0,134,176,97,19,44,38,31,35,30,38,44,35,40.0,39.0,-9,6,-15
23,10,54,1,11,0,52,62,66,20,31,15,25,9,23,18,12,17,14.0,16.0,5,-6,11
107,11,54,1,11,0,312,450,333,168,137,94,101,95,97,80,87,93,90.0,87.0,6,7,-1
99,12,54,1,11,0,164,252,264,69,58,63,82,66,58,86,106,109,108.0,100.0,3,20,-17
195,13,54,1,11,0,338,473,362,182,165,226,205,142,157,221,184,175,180.0,193.0,-9,-37,28
297,14,54,1,11,0,535,679,669,213,223,212,206,190,239,237,292,323,308.0,284.0,31,55,-24
50,15,54,1,11,0,161,255,131,59,54,69,64,57,47,53,54,59,56.0,55.0,5,1,4
148,16,54,1,11,0,278,385,450,105,110,104,89,90,81,127,134,149,142.0,137.0,15,7,8
451,17,54,1,11,0,533,776,857,222,262,247,257,219,243,308,415,419,417.0,381.0,4,107,-103
17,18,54,1,11,0,83,65,41,21,20,20,33,19,21,25,14,25,20.0,21.0,11,-11,22
76,19,54,1,11,0,129,166,109,50,66,72,45,46,43,59,62,69,66.0,63.0,7,3,4
85,20,54,1,11,0,189,306,256,58,77,65,70,84,67,84,87,77,82.0,83.0,-10,3,-13
276,21,54,1,11,0,381,634,493,193,190,176,193,161,204,222,237,320,278.0,260.0,83,15,68
139,22,54,1,11,0,204,277,131,70,96,70,62,54,66,59,76,95,86.0,77.0,19,17,2
91,1,55,1,11,0,211,361,138,71,95,74,75,111,81,104,108,82,95.0,98.0,-26,4,-30
467,2,55,1,11,0,434,743,406,299,256,259,276,323,373,379,361,567,464.0,436.0,206,-18,224
513,3,55,1,11,0,390,683,304,135,211,181,248,260,314,339,378,412,395.0,376.0,34,39,-5
160,4,55,1,11,0,357,675,173,56,121,79,138,89,102,103,129,115,122.0,116.0,-14,26,-40
1558,5,55,1,11,0,1318,2057,1186,681,782,644,814,979,1044,1182,1106,1202,1154.0,1163.0,96,-76,172
456,6,55,1,11,0,493,865,574,194,213,248,307,345,317,346,361,391,376.0,366.0,30,15,15
848,7,55,1,11,0,894,1538,723,282,412,473,536,614,680,774,720,826,773.0,773.0,106,-54,160
1000,8,55,1,11,0,510,974,417,214,254,346,509,560,656,816,685,1059,872.0,853.0,374,-131,505
790,9,55,1,11,0,768,1105,569,259,493,354,430,585,484,578,575,619,597.0,591.0,44,-3,47
290,10,55,1,11,0,212,406,260,101,165,105,174,218,194,217,225,224,224.0,222.0,-1,8,-9
754,11,55,1,11,0,786,1332,698,402,409,494,495,557,550,609,567,672,620.0,616.0,105,-42,147
389,12,55,1,11,0,356,774,420,110,193,205,216,298,283,295,291,351,321.0,312.0,60,-4,64
1715,13,55,1,11,0,964,2069,891,397,516,929,990,983,1137,1295,1153,1509,1331.0,1319.0,356,-142,498
1276,14,55,1,11,0,934,1916,1026,330,387,521,645,908,946,966,847,1114,980.0,976.0,267,-119,386
528,15,55,1,11,0,556,982,370,195,281,311,304,395,371,467,405,469,437.0,447.0,64,-62,126
353,16,55,1,11,0,389,721,401,105,159,186,195,272,290,243,277,326,302.0,282.0,49,34,15
607,17,55,1,11,0,687,1290,631,205,298,333,363,464,424,425,552,559,556.0,512.0,7,127,-120
231,18,55,1,11,0,253,385,180,95,138,114,150,154,163,198,154,199,176.0,184.0,45,-44,89
219,19,55,1,11,0,226,330,135,104,181,144,138,167,145,200,198,175,186.0,191.0,-23,-2,-21
807,20,55,1,11,0,751,1420,661,420,464,477,481,631,557,639,617,667,642.0,641.0,50,-22,72
892,21,55,1,11,0,639,1234,604,184,336,402,415,468,687,690,661,909,785.0,753.0,248,-29,277
232,22,55,1,11,0,150,236,76,111,111,78,108,134,127,165,146,158,152.0,156.0,12,-19,31
390,1,56,1,11,0,620,805,357,95,198,187,218,252,286,379,461,354,408.0,398.0,-107,82,-189
965,2,56,1,11,0,921,1249,829,418,522,444,470,542,766,801,741,996,868.0,846.0,255,-60,315
960,3,56,1,11,0,675,925,601,288,415,322,461,499,595,688,789,875,832.0,784.0,86,101,-15
368,4,56,1,11,0,779,1421,437,212,313,278,276,253,302,320,338,287,312.0,315.0,-51,18,-69
1869,5,56,1,11,0,1861,2915,2183,903,1084,938,1042,1247,1538,1846,1788,1737,1762.0,1790.0,-51,-58,7
765,6,56,1,11,0,934,1307,1141,304,330,322,356,545,585,712,755,739,747.0,735.0,-16,43,-59
1183,7,56,1,11,0,1192,1610,1006,389,569,611,624,776,1014,1189,1170,1211,1190.0,1190.0,41,-19,60
658,8,56,1,11,0,601,970,406,198,368,305,370,503,552,733,652,718,685.0,701.0,66,-81,147
1989,9,56,1,11,0,1902,2685,1203,341,825,879,785,1142,1134,1550,1490,1748,1619.0,1596.0,258,-60,318
417,10,56,1,11,0,440,665,433,149,235,168,197,226,296,330,369,365,367.0,355.0,-4,39,-43
2033,11,56,1,11,0,1955,2752,1481,650,861,854,961,1280,1420,1671,1770,1868,1819.0,1770.0,98,99,-1
514,12,56,1,11,0,511,802,624,159,229,268,266,354,440,475,407,474,440.0,452.0,67,-68,135
1629,13,56,1,11,0,1021,1551,970,478,608,767,810,890,1254,1423,1432,1560,1496.0,1472.0,128,9,119
1912,14,56,1,11,0,1530,2696,1928,502,672,701,850,1415,1787,1789,1724,2048,1886.0,1854.0,324,-65,389
1925,15,56,1,11,0,1499,2124,704,292,530,641,696,932,1254,1486,1797,1857,1827.0,1713.0,60,311,-251
696,16,56,1,11,0,794,1252,837,201,313,330,347,462,609,643,609,716,662.0,656.0,107,-34,141
1187,17,56,1,11,0,1478,2360,1657,503,671,579,591,827,934,1043,1138,1066,1102.0,1082.0,-72,95,-167
626,18,56,1,11,0,601,698,428,129,211,219,281,359,378,470,543,521,532.0,511.0,-22,73,-95
309,19,56,1,11,0,361,459,235,125,226,187,250,248,334,351,316,290,303.0,319.0,-26,-35,9
1445,20,56,1,11,0,1581,2727,1846,758,896,740,908,1151,1313,1405,1572,1555,1564.0,1511.0,-17,167,-184
967,21,56,1,11,0,896,1319,905,333,426,445,444,565,798,975,991,1110,1050.0,1025.0,119,16,103
403,22,56,1,11,0,312,397,173,117,199,155,143,190,253,271,281,258,270.0,270.0,-23,10,-33
23,1,57,3,11,0,30,34,19,29,28,25,38,29,32,29,27,26,26.0,27.0,-1,-2,1
720,2,57,3,11,0,1547,1939,1680,1190,1187,815,815,786,875,755,817,1016,916.0,863.0,199,62,137
41,3,57,3,11,0,105,108,54,78,117,71,70,60,56,65,70,61,66.0,65.0,-9,5,-14
99,4,57,3,11,0,305,504,106,118,157,120,110,104,70,81,80,59,70.0,73.0,-21,-1,-20
344,5,57,3,11,0,773,955,603,645,678,519,472,474,468,514,523,495,509.0,511.0,-28,9,-37
115,6,57,3,11,0,225,272,216,223,191,165,153,149,145,130,226,119,172.0,158.0,-107,96,-203
283,7,57,3,11,0,636,1105,629,541,513,451,400,375,388,431,348,319,334.0,366.0,-29,-83,54
123,8,57,3,11,0,161,233,166,115,127,118,117,113,93,103,99,118,108.0,107.0,19,-4,23
357,9,57,3,11,0,713,866,346,505,757,513,503,519,390,440,464,326,395.0,410.0,-138,24,-162
18,10,57,3,11,0,75,97,92,50,85,53,57,36,20,17,40,26,33.0,28.0,-14,23,-37
409,11,57,3,11,0,871,1150,610,843,857,623,558,495,522,542,537,383,460.0,487.0,-154,-5,-149
55,12,57,3,11,0,117,148,132,89,105,90,70,62,87,69,109,55,82.0,78.0,-54,40,-94
517,13,57,3,11,0,769,983,537,616,685,621,541,500,570,609,477,446,462.0,511.0,-31,-132,101
431,14,57,3,11,0,952,1314,922,778,753,612,592,519,715,609,950,530,740.0,696.0,-420,341,-761
273,15,57,3,11,0,466,653,312,498,511,368,351,319,353,307,303,303,303.0,304.0,0,-4,4
301,16,57,3,11,0,590,903,514,438,482,408,403,314,306,325,383,287,335.0,332.0,-96,58,-154
210,17,57,3,11,0,426,575,405,314,375,353,267,377,276,257,258,207,232.0,241.0,-51,1,-52
86,18,57,3,11,0,175,195,85,140,157,133,146,133,94,101,94,103,98.0,99.0,9,-7,16
172,19,57,3,11,0,281,370,158,187,236,191,184,170,200,162,165,162,164.0,163.0,-3,3,-6
351,20,57,3,11,0,706,955,636,643,771,438,521,498,470,463,469,462,466.0,465.0,-7,6,-13
145,21,57,3,11,0,280,324,195,155,198,180,157,132,131,161,154,118,136.0,144.0,-36,-7,-29
21,22,57,3,11,0,76,90,35,48,67,46,41,40,28,43,38,20,29.0,34.0,-18,-5,-13
64,1,58,2,11,0,193,281,60,52,74,61,69,81,59,68,101,59,80.0,76.0,-42,33,-75
173,2,58,2,11,0,227,356,181,119,130,103,154,125,106,113,128,230,179.0,157.0,102,15,87
101,3,58,2,11,0,183,244,117,67,81,65,79,55,51,79,82,89,86.0,83.0,7,3,4
116,4,58,2,11,0,417,805,105,52,132,97,103,144,172,170,133,91,112.0,131.0,-42,-37,-5
557,5,58,2,11,0,910,1456,816,454,505,463,516,491,453,624,583,533,558.0,580.0,-50,-41,-9
229,6,58,2,11,0,287,463,251,96,133,88,118,91,110,111,129,108,118.0,116.0,-21,18,-39
280,7,58,2,11,0,738,1182,600,283,311,395,408,271,332,415,347,344,346.0,369.0,-3,-68,65
166,8,58,2,11,0,264,497,192,96,135,117,169,144,132,175,152,197,174.0,175.0,45,-23,68
378,9,58,2,11,0,615,869,297,127,271,262,258,278,238,265,297,267,282.0,276.0,-30,32,-62
128,10,58,2,11,0,233,425,254,71,136,107,135,145,104,103,124,139,132.0,122.0,15,21,-6
313,11,58,2,11,0,749,1017,461,270,342,363,373,289,260,265,382,334,358.0,327.0,-48,117,-165
118,12,58,2,11,0,198,315,211,60,84,84,68,64,78,105,104,111,108.0,107.0,7,-1,8
519,13,58,2,11,0,755,1430,754,390,398,481,498,419,459,630,477,524,500.0,544.0,47,-153,200
417,14,58,2,11,0,865,1601,892,268,371,333,363,396,440,436,415,417,416.0,423.0,2,-21,23
241,15,58,2,11,0,420,845,174,81,170,192,246,204,243,235,258,263,260.0,252.0,5,23,-18
58,16,58,2,11,0,133,246,134,39,47,55,60,48,51,63,57,69,63.0,63.0,12,-6,18
247,17,58,2,11,0,447,756,439,130,231,191,211,178,177,209,244,199,222.0,217.0,-45,35,-80
198,18,58,2,11,0,166,247,102,51,67,60,67,91,79,101,94,80,87.0,92.0,-14,-7,-7
34,19,58,2,11,0,102,113,47,21,29,27,30,22,21,21,18,20,19.0,20.0,2,-3,5
552,20,58,2,11,0,596,1578,630,283,298,337,395,444,428,519,438,436,437.0,464.0,-2,-81,79
355,21,58,2,11,0,558,938,498,189,261,260,236,226,286,349,325,354,340.0,343.0,29,-24,53
32,22,58,2,11,0,45,45,7,10,21,11,20,18,12,17,12,8,10.0,12.0,-4,-5,1
1094,1,59,2,11,0,448,746,228,125,223,190,233,237,1154,290,404,302,353.0,332.0,-102,114,-216
105,2,59,2,11,0,224,235,105,67,68,72,70,100,79,62,75,86,80.0,74.0,11,13,-2
104,3,59,2,11,0,273,340,208,63,95,64,75,89,75,89,111,84,98.0,95.0,-27,22,-49
72,4,59,2,11,0,179,362,72,29,64,61,50,56,417,666,51,34,42.0,250.0,-17,-615,598
307,5,59,2,11,0,631,1027,542,251,246,265,230,226,834,315,368,297,332.0,327.0,-71,53,-124
551,6,59,2,11,0,678,1434,792,244,232,308,344,363,315,452,583,523,553.0,519.0,-60,131,-191
505,7,59,2,11,0,1053,1685,823,326,341,453,371,362,372,520,630,555,592.0,568.0,-75,110,-185
250,8,59,2,11,0,479,604,321,126,162,162,182,154,558,292,187,206,196.0,228.0,19,-105,124
593,9,59,2,11,0,1038,1493,451,130,374,366,407,481,329,409,478,509,494.0,465.0,31,69,-38
227,10,59,2,11,0,312,543,250,76,136,99,136,130,103,145,204,198,201.0,182.0,-6,59,-65
1085,11,59,2,11,0,1467,2828,1205,656,751,787,807,758,1395,929,1015,1091,1053.0,1012.0,76,86,-10
461,12,59,2,11,0,577,1241,549,138,232,271,262,250,268,377,418,451,434.0,415.0,33,41,-8
401,13,59,2,11,0,561,1020,602,249,293,362,351,329,285,374,411,366,388.0,384.0,-45,37,-82
1267,14,59,2,11,0,1021,1584,992,320,512,660,557,721,719,991,1189,1206,1198.0,1129.0,17,198,-181
510,15,59,2,11,0,859,1272,386,193,342,341,375,377,337,402,499,496,498.0,466.0,-3,97,-100
456,16,59,2,11,0,751,1208,523,161,272,326,270,280,775,316,371,390,380.0,359.0,19,55,-36
466,17,59,2,11,0,619,891,508,132,232,212,222,268,261,329,457,434,446.0,407.0,-23,128,-151
172,18,59,2,11,0,291,431,173,74,106,104,121,115,77,91,131,145,138.0,122.0,14,40,-26
48,19,59,2,11,0,186,225,91,51,75,101,66,42,52,68,79,54,66.0,67.0,-25,11,-36
100,20,59,2,11,0,148,242,128,33,53,51,65,76,57,46,63,70,66.0,60.0,7,17,-10
293,21,59,2,11,0,275,432,182,64,143,136,155,142,754,199,271,274,272.0,248.0,3,72,-69
20,22,59,2,11,0,61,140,53,29,33,28,48,27,21,28,21,14,18.0,21.0,-7,-7,0
172,1,60,1,11,0,162,163,142,84,128,99,108,102,143,141,92,87,90.0,107.0,-5,-49,44
103,2,60,1,11,0,152,131,146,84,119,80,84,87,136,120,95,78,86.0,98.0,-17,-25,8
79,3,60,1,11,0,81,90,83,41,62,87,86,67,58,68,69,69,69.0,69.0,0,1,-1
92,4,60,1,11,0,100,123,88,65,74,70,62,63,53,50,55,67,61.0,57.0,12,5,7
237,5,60,1,11,0,279,330,341,184,223,201,224,188,192,262,301,197,249.0,253.0,-104,39,-143
169,6,60,1,11,0,183,198,254,107,149,150,152,146,136,174,138,155,146.0,156.0,17,-36,53
169,7,60,1,11,0,160,191,159,74,162,163,162,117,116,158,179,155,167.0,164.0,-24,21,-45
40,8,60,1,11,0,31,28,41,25,46,41,28,30,28,32,32,26,29.0,30.0,-6,0,-6
728,9,60,1,11,0,658,638,568,264,527,387,410,437,440,502,480,480,480.0,487.0,0,-22,22
158,10,60,1,11,0,172,213,297,121,197,152,163,152,143,162,143,132,138.0,146.0,-11,-19,8
428,11,60,1,11,0,402,439,430,213,408,324,345,284,373,290,342,314,328.0,315.0,-28,52,-80
87,12,60,1,11,0,76,120,103,50,101,76,71,82,82,105,75,85,80.0,88.0,10,-30,40
110,13,60,1,11,0,85,95,109,50,116,95,137,104,134,131,121,110,116.0,121.0,-11,-10,-1
118,14,60,1,11,0,134,164,130,78,142,114,90,124,140,149,132,125,128.0,135.0,-7,-17,10
377,15,60,1,11,0,364,397,466,185,307,317,322,277,351,327,287,278,282.0,297.0,-9,-40,31
225,16,60,1,11,0,244,236,270,129,200,183,140,190,186,222,164,183,174.0,190.0,19,-58,77
301,17,60,1,11,0,355,445,519,215,330,301,296,262,319,373,282,230,256.0,295.0,-52,-91,39
130,18,60,1,11,0,125,99,145,57,96,88,101,91,78,106,100,89,94.0,98.0,-11,-6,-5
119,19,60,1,11,0,126,155,89,59,109,102,100,85,79,140,123,99,111.0,121.0,-24,-17,-7
123,20,60,1,11,0,179,214,160,89,140,134,104,264,151,136,117,92,104.0,115.0,-25,-19,-6
277,21,60,1,11,0,252,263,274,154,228,212,258,163,256,338,207,301,254.0,282.0,94,-131,225
83,22,60,1,11,0,66,57,65,35,91,67,47,50,39,70,62,56,59.0,63.0,-6,-8,2
312,1,1,1,12,0,374,305,193,309,264,241,251,240,298,308,270,286,278.0,288.0,16,-38,54
331,2,1,1,12,0,456,434,194,302,243,321,230,362,323,306,298,333,316.0,312.0,35,-8,43
173,3,1,1,12,0,219,180,128,201,176,192,155,199,170,176,134,180,157.0,163.0,46,-42,88
275,4,1,1,12,0,563,468,432,472,340,407,314,302,310,293,226,297,262.0,272.0,71,-67,138
456,5,1,1,12,0,570,500,253,378,337,331,336,304,330,449,303,332,318.0,361.0,29,-146,175
204,6,1,1,12,0,226,198,76,132,155,144,166,155,166,192,153,158,156.0,168.0,5,-39,44
471,7,1,1,12,0,601,468,290,412,484,450,432,449,413,563,371,467,419.0,467.0,96,-192,288
200,8,1,1,12,0,260,248,146,249,182,251,173,213,197,239,166,188,177.0,198.0,22,-73,95
2821,9,1,1,12,0,3800,2692,1680,2958,2368,2754,2696,2582,2782,2822,2740,2953,2846.0,2838.0,213,-82,295
371,10,1,1,12,0,505,425,248,383,277,377,293,309,331,402,304,307,306.0,338.0,3,-98,101
799,11,1,1,12,0,1010,800,486,817,617,720,689,718,682,759,664,694,679.0,706.0,30,-95,125
181,12,1,1,12,0,262,236,78,191,154,186,149,156,168,164,152,189,170.0,168.0,37,-12,49
349,13,1,1,12,0,305,260,190,297,311,328,293,325,352,363,288,305,296.0,319.0,17,-75,92
369,14,1,1,12,0,505,405,250,355,393,307,297,380,309,344,274,282,278.0,300.0,8,-70,78
853,15,1,1,12,0,865,633,409,621,561,562,591,624,669,649,620,676,648.0,648.0,56,-29,85
502,16,1,1,12,0,474,497,228,445,423,403,455,424,361,409,246,307,276.0,321.0,61,-163,224
369,17,1,1,12,0,474,347,174,297,304,284,259,316,280,304,238,308,273.0,283.0,70,-66,136
308,18,1,1,12,0,404,292,181,307,209,324,299,311,316,288,299,291,295.0,293.0,-8,11,-19
795,19,1,1,12,0,997,650,566,775,692,738,626,805,715,744,592,725,658.0,687.0,133,-152,285
131,20,1,1,12,0,199,115,72,126,107,119,138,135,104,119,88,116,102.0,108.0,28,-31,59
332,21,1,1,12,0,440,305,219,295,292,328,285,305,307,293,289,342,316.0,308.0,53,-4,57
325,22,1,1,12,0,461,292,234,401,305,324,284,313,335,248,234,302,268.0,261.0,68,-14,82
509,1,2,2,12,0,518,268,263,442,321,383,408,481,506,615,423,528,476.0,522.0,105,-192,297
390,2,2,2,12,0,519,292,264,403,325,415,354,487,506,484,430,474,452.0,463.0,44,-54,98
351,3,2,2,12,0,337,175,149,316,260,258,252,263,332,312,348,334,341.0,331.0,-14,36,-50
338,4,2,2,12,0,811,368,359,470,369,376,352,396,326,421,261,344,302.0,342.0,83,-160,243
949,5,2,2,12,0,1125,657,560,806,700,679,724,721,901,1021,668,951,810.0,880.0,283,-353,636
699,6,2,2,12,0,507,301,225,317,315,350,352,460,517,524,468,556,512.0,516.0,88,-56,144
1344,7,2,2,12,0,1574,775,729,1060,1229,1119,1113,1342,1502,1693,1251,1337,1294.0,1427.0,86,-442,528
492,8,2,2,12,0,571,290,239,407,358,384,335,452,519,543,477,486,482.0,502.0,9,-66,75
10504,9,2,2,12,0,11515,5136,4688,10371,8733,8990,9100,9110,10367,11177,10502,10371,10436.0,10683.0,-131,-675,544
968,10,2,2,12,0,1258,750,559,1074,832,939,901,1075,1222,1237,949,1026,988.0,1071.0,77,-288,365
2381,11,2,2,12,0,2877,1445,1635,2184,1828,1916,1948,2090,2406,2465,2160,2416,2288.0,2347.0,256,-305,561
532,12,2,2,12,0,741,435,311,545,463,483,513,576,577,634,470,499,484.0,534.0,29,-164,193
1142,13,2,2,12,0,974,498,486,847,1025,993,829,1052,1183,1231,1018,1146,1082.0,1132.0,128,-213,341
1028,14,2,2,12,0,1234,645,486,968,944,932,1043,1153,1163,1133,861,1082,972.0,1025.0,221,-272,493
2119,15,2,2,12,0,2467,1135,1205,1969,1744,1919,1847,2165,2419,2373,1801,2107,1954.0,2094.0,306,-572,878
1169,16,2,2,12,0,1050,703,508,734,619,699,876,984,989,1033,795,944,870.0,924.0,149,-238,387
773,17,2,2,12,0,1192,689,445,769,687,748,707,821,1006,917,750,869,810.0,845.0,119,-167,286
1463,18,2,2,12,0,1578,856,899,1607,1181,1494,1511,1522,1699,1828,1443,1626,1534.0,1632.0,183,-385,568
1994,19,2,2,12,0,2161,1110,1306,1905,1837,1784,1845,2218,2361,2147,1842,2177,2010.0,2055.0,335,-305,640
349,20,2,2,12,0,398,244,215,285,259,240,371,328,317,303,226,315,270.0,281.0,89,-77,166
547,21,2,2,12,0,607,340,260,369,435,466,394,526,525,529,505,572,538.0,535.0,67,-24,91
892,22,2,2,12,0,1018,447,521,1186,639,827,849,957,1229,987,782,1050,916.0,940.0,268,-205,473
175,1,3,1,12,0,167,157,101,187,162,155,200,158,195,163,105,146,126.0,138.0,41,-58,99
319,2,3,1,12,0,350,290,213,293,226,236,265,410,329,332,296,336,316.0,321.0,40,-36,76
204,3,3,1,12,0,233,279,174,228,241,255,251,306,251,232,183,204,194.0,206.0,21,-49,70
347,4,3,1,12,0,677,549,387,627,524,389,503,552,475,412,404,331,368.0,382.0,-73,-8,-65
404,5,3,1,12,0,434,516,235,377,355,370,404,481,373,432,264,442,353.0,379.0,178,-168,346
133,6,3,1,12,0,138,176,83,127,116,129,142,151,124,165,116,140,128.0,140.0,24,-49,73
386,7,3,1,12,0,400,420,235,353,334,323,407,400,410,471,322,400,361.0,398.0,78,-149,227
165,8,3,1,12,0,197,179,103,189,173,157,177,211,167,160,125,164,144.0,150.0,39,-35,74
1680,9,3,1,12,0,1829,1713,1159,1738,1536,1581,1833,1828,1593,1985,1468,1849,1658.0,1767.0,381,-517,898
213,10,3,1,12,0,173,211,121,197,149,174,163,216,133,185,158,222,190.0,188.0,64,-27,91
456,11,3,1,12,0,427,470,296,446,386,375,444,454,461,476,350,444,397.0,423.0,94,-126,220
111,12,3,1,12,0,109,126,55,113,112,112,126,130,154,177,120,135,128.0,144.0,15,-57,72
361,13,3,1,12,0,328,389,251,371,364,437,425,531,444,375,300,363,332.0,346.0,63,-75,138
285,14,3,1,12,0,337,377,202,331,306,338,396,390,320,382,301,333,317.0,339.0,32,-81,113
433,15,3,1,12,0,424,401,264,349,335,366,380,435,444,478,383,410,396.0,424.0,27,-95,122
238,16,3,1,12,0,280,321,189,271,255,230,322,292,267,293,194,219,206.0,235.0,25,-99,124
198,17,3,1,12,0,275,284,146,275,262,250,285,292,286,299,216,222,219.0,246.0,6,-83,89
116,18,3,1,12,0,157,167,81,107,85,111,132,133,94,129,102,123,112.0,118.0,21,-27,48
570,19,3,1,12,0,567,506,316,529,433,489,457,606,708,531,506,552,529.0,530.0,46,-25,71
150,20,3,1,12,0,155,213,116,188,148,168,179,203,176,174,114,143,128.0,144.0,29,-60,89
274,21,3,1,12,0,267,297,206,288,291,280,277,346,254,290,201,173,187.0,221.0,-28,-89,61
316,22,3,1,12,0,336,315,155,306,267,240,317,304,316,199,191,233,212.0,208.0,42,-8,50
241,1,4,2,12,0,210,117,96,135,131,161,142,167,201,221,204,244,224.0,223.0,40,-17,57
450,2,4,2,12,0,308,173,110,159,185,191,176,253,332,399,317,430,374.0,382.0,113,-82,195
234,3,4,2,12,0,176,89,72,136,148,139,117,145,167,204,226,182,204.0,204.0,-44,22,-66
192,4,4,2,12,0,342,136,109,179,166,96,85,131,159,164,150,176,163.0,163.0,26,-14,40
634,5,4,2,12,0,436,351,212,361,425,290,324,427,553,667,370,470,420.0,502.0,100,-297,397
326,6,4,2,12,0,348,264,151,204,182,203,195,266,313,338,363,329,346.0,343.0,-34,25,-59
608,7,4,2,12,0,556,225,175,357,467,449,285,377,522,729,587,608,598.0,641.0,21,-142,163
280,8,4,2,12,0,181,92,70,148,181,165,127,190,198,230,208,227,218.0,222.0,19,-22,41
5402,9,4,2,12,0,4195,2391,1639,3992,3988,3668,3906,4522,4949,5596,4889,5245,5067.0,5243.0,356,-707,1063
603,10,4,2,12,0,386,248,166,443,418,434,344,461,540,630,553,544,548.0,576.0,-9,-77,68
1289,11,4,2,12,0,1154,680,651,982,1039,1051,947,1072,1268,1400,1213,1183,1198.0,1265.0,-30,-187,157
442,12,4,2,12,0,351,208,96,254,328,298,271,331,451,520,466,388,427.0,458.0,-78,-54,-24
587,13,4,2,12,0,419,248,284,584,570,485,345,559,623,645,615,535,575.0,598.0,-80,-30,-50
750,14,4,2,12,0,651,338,242,578,638,439,516,644,816,854,726,725,726.0,768.0,-1,-128,127
1720,15,4,2,12,0,1310,747,739,1438,1404,1200,1131,1522,1730,1887,1466,1612,1539.0,1655.0,146,-421,567
831,16,4,2,12,0,787,450,226,461,459,468,446,524,665,780,873,715,794.0,789.0,-158,93,-251
705,17,4,2,12,0,674,394,223,436,554,554,548,663,787,891,679,645,662.0,738.0,-34,-212,178
906,18,4,2,12,0,519,231,173,535,612,676,709,737,966,1034,837,825,831.0,899.0,-12,-197,185
827,19,4,2,12,0,848,213,233,610,646,562,459,596,792,810,690,865,778.0,788.0,175,-120,295
214,20,4,2,12,0,208,123,85,166,157,116,162,140,173,200,168,168,168.0,179.0,0,-32,32
356,21,4,2,12,0,317,148,105,202,242,221,226,279,358,344,333,331,332.0,336.0,-2,-11,9
331,22,4,2,12,0,303,90,85,233,244,241,205,236,349,303,327,519,423.0,383.0,192,24,168
319,1,5,3,12,0,477,199,177,267,169,193,170,168,208,216,192,208,200.0,205.0,16,-24,40
3929,2,5,3,12,0,4503,4785,3067,2754,2281,2227,1995,2206,1981,2469,3585,3111,3348.0,3055.0,-474,1116,-1590
679,3,5,3,12,0,675,504,451,680,487,440,356,384,433,467,506,620,563.0,531.0,114,39,75
176,4,5,3,12,0,514,151,92,197,124,132,112,101,80,136,106,116,111.0,119.0,10,-30,40
1656,5,5,3,12,0,1954,1724,1537,1481,1090,1021,990,1018,1119,1242,1321,1366,1344.0,1310.0,45,79,-34
2026,6,5,3,12,0,2328,2152,1881,1518,1284,1266,1165,1072,1126,1266,1339,1314,1326.0,1306.0,-25,73,-98
4723,7,5,3,12,0,6576,4483,3060,2839,2545,2879,2279,2583,2917,2744,3229,2974,3102.0,2982.0,-255,485,-740
2474,8,5,3,12,0,2844,2093,1361,1353,1118,1259,955,1154,1235,1338,1662,1670,1666.0,1557.0,8,324,-316
2071,9,5,3,12,0,3029,1611,1579,2180,1684,1684,1682,1409,1573,1720,1696,1650,1673.0,1689.0,-46,-24,-22
3003,10,5,3,12,0,4443,3084,1836,2310,1540,1616,1343,1308,1943,1360,1586,1801,1694.0,1582.0,215,226,-11
2708,11,5,3,12,0,3067,2165,2419,2029,1601,1578,1375,1523,1501,1651,1865,1898,1882.0,1805.0,33,214,-181
1120,12,5,3,12,0,1510,1290,922,875,668,648,536,537,656,666,811,761,786.0,746.0,-50,145,-195
5765,13,5,3,12,0,6231,3870,3403,2945,3015,3119,2522,2789,2808,2753,3344,3669,3506.0,3255.0,325,591,-266
5332,14,5,3,12,0,7650,5825,3564,3197,2704,2715,2598,2658,2563,2664,3259,3278,3268.0,3067.0,19,595,-576
2159,15,5,3,12,0,2062,1260,1629,1592,1156,1224,1121,1218,1188,1319,1309,1393,1351.0,1340.0,84,-10,94
1688,16,5,3,12,0,2198,1919,1140,1262,895,1069,835,836,949,1018,1151,1055,1103.0,1075.0,-96,133,-229
1897,17,5,3,12,0,2693,2364,1506,1541,1174,1020,997,939,1035,1185,1214,1290,1252.0,1230.0,76,29,47
582,18,5,3,12,0,892,592,650,741,463,546,473,389,402,400,437,440,438.0,426.0,3,37,-34
1651,19,5,3,12,0,1710,924,939,1322,959,988,854,912,964,1041,839,1156,998.0,1012.0,317,-202,519
391,20,5,3,12,0,357,250,248,235,212,191,173,197,218,241,244,273,258.0,253.0,29,3,26
2796,21,5,3,12,0,3217,2072,1105,1314,1222,1105,910,1051,1117,1406,1562,1664,1613.0,1544.0,102,156,-54
737,22,5,3,12,0,982,506,518,806,657,585,602,530,544,540,569,743,656.0,617.0,174,29,145
636,1,6,1,12,0,623,382,114,351,229,285,289,234,347,399,276,363,320.0,346.0,87,-123,210
644,2,6,1,12,0,680,484,300,452,403,419,390,633,639,493,556,594,575.0,548.0,38,63,-25
750,3,6,1,12,0,832,551,317,489,505,604,525,595,623,640,628,626,627.0,631.0,-2,-12,10
103,4,6,1,12,0,598,212,102,180,142,124,93,130,133,130,95,126,110.0,117.0,31,-35,66
1437,5,6,1,12,0,1850,1223,671,850,790,838,870,1020,1346,1101,933,1042,988.0,1025.0,109,-168,277
1681,6,6,1,12,0,1666,1515,717,1018,980,1077,1165,1206,1280,1168,1138,990,1064.0,1099.0,-148,-30,-118
2607,7,6,1,12,0,2737,1706,842,1734,1902,2031,1983,2192,2226,2022,2178,2008,2093.0,2069.0,-170,156,-326
899,8,6,1,12,0,993,533,312,595,582,569,606,683,717,614,692,659,676.0,655.0,-33,78,-111
7407,9,6,1,12,0,6492,5607,2647,5713,4896,5717,5445,4899,5914,5863,5896,5979,5938.0,5913.0,83,33,50
884,10,6,1,12,0,894,799,409,719,453,603,532,611,719,734,660,643,652.0,679.0,-17,-74,57
2285,11,6,1,12,0,2672,1728,1016,1729,1498,1701,1735,1850,1857,1722,1874,1842,1858.0,1813.0,-32,152,-184
1216,12,6,1,12,0,1291,1027,356,690,687,838,753,813,1041,905,884,830,857.0,873.0,-54,-21,-33
3194,13,6,1,12,0,2703,2119,1271,2126,2486,2863,2426,2914,2989,2361,2420,2498,2459.0,2426.0,78,59,19
3491,14,6,1,12,0,3447,2952,1308,2514,2566,2841,2880,3363,3319,2677,2531,2633,2582.0,2614.0,102,-146,248
1758,15,6,1,12,0,1972,795,459,876,905,1141,1077,1165,1379,1241,1255,1301,1278.0,1266.0,46,14,32
1787,16,6,1,12,0,2151,1566,597,1095,1029,1047,1133,1293,1344,1288,1247,1304,1276.0,1280.0,57,-41,98
2118,17,6,1,12,0,2770,1651,844,1487,1573,1636,1382,1564,1802,1482,1432,1538,1485.0,1484.0,106,-50,156
528,18,6,1,12,0,476,264,148,314,267,427,418,348,436,384,415,479,447.0,426.0,64,31,33
569,19,6,1,12,0,513,241,211,360,293,362,342,372,462,408,449,502,476.0,453.0,53,41,12
899,20,6,1,12,0,1149,803,328,472,453,543,623,549,633,579,475,575,525.0,543.0,100,-104,204
863,21,6,1,12,0,845,620,247,468,497,551,436,566,577,553,626,533,580.0,571.0,-93,73,-166
641,22,6,1,12,0,1032,399,306,506,449,585,503,512,594,572,502,654,578.0,576.0,152,-70,222
1307,1,7,3,12,0,1212,1265,890,1247,1119,1184,1456,1316,1194,1258,958,1329,1144.0,1182.0,371,-300,671
353,2,7,3,12,0,119,104,63,214,133,132,248,173,187,150,190,144,167.0,161.0,-46,40,-86
183,3,7,3,12,0,75,86,64,154,131,164,163,146,193,187,137,144,140.0,156.0,7,-50,57
1358,4,7,3,12,0,1627,1352,1114,1508,1132,1430,1670,1367,1416,1463,1056,1425,1240.0,1315.0,369,-407,776
419,5,7,3,12,0,321,208,187,254,335,308,285,276,420,431,254,309,282.0,331.0,55,-177,232
408,6,7,3,12,0,251,253,175,322,340,315,352,311,384,398,291,357,324.0,349.0,66,-107,173
1388,7,7,3,12,0,1047,878,649,1303,1248,1216,1405,1283,1284,1321,1189,1365,1277.0,1292.0,176,-132,308
361,8,7,3,12,0,184,165,123,244,320,272,242,233,292,344,209,376,292.0,310.0,167,-135,302
1508,9,7,3,12,0,819,762,448,944,1100,1025,1038,994,984,1134,946,1148,1047.0,1076.0,202,-188,390
140,10,7,3,12,0,96,92,54,103,134,119,86,123,99,126,97,133,115.0,119.0,36,-29,65
1287,11,7,3,12,0,1002,974,650,1188,1289,1048,1276,1137,1253,1328,1121,1341,1231.0,1263.0,220,-207,427
233,12,7,3,12,0,97,118,85,164,140,153,162,165,154,204,178,201,190.0,194.0,23,-26,49
781,13,7,3,12,0,493,470,361,599,660,769,569,656,773,873,579,821,700.0,758.0,242,-294,536
950,14,7,3,12,0,596,517,345,763,731,685,764,754,849,909,743,742,742.0,798.0,-1,-166,165
1213,15,7,3,12,0,736,534,424,754,915,865,808,908,999,1113,743,1029,886.0,962.0,286,-370,656
368,16,7,3,12,0,173,151,103,240,253,187,234,272,286,270,205,266,236.0,247.0,61,-65,126
229,17,7,3,12,0,119,101,59,203,163,182,206,192,239,250,170,213,192.0,211.0,43,-80,123
234,18,7,3,12,0,170,123,106,206,303,187,204,204,249,241,181,243,212.0,222.0,62,-60,122
456,19,7,3,12,0,300,181,154,357,324,363,378,413,435,413,296,399,348.0,369.0,103,-117,220
208,20,7,3,12,0,100,60,71,130,181,128,151,124,150,168,111,139,125.0,139.0,28,-57,85
372,21,7,3,12,0,313,234,179,320,305,340,358,313,390,434,291,339,315.0,355.0,48,-143,191
260,22,7,3,12,0,177,129,74,323,185,255,260,224,227,281,192,276,234.0,250.0,84,-89,173
777,1,8,2,12,0,697,325,168,288,309,527,516,379,272,357,325,514,420.0,399.0,189,-32,221
159,2,8,2,12,0,112,40,25,38,54,68,55,75,116,109,89,134,112.0,111.0,45,-20,65
65,3,8,2,12,0,75,31,18,29,46,51,51,61,78,46,46,54,50.0,49.0,8,0,8
145,4,8,2,12,0,132,40,51,59,50,54,60,151,111,68,85,105,95.0,86.0,20,17,3
409,5,8,2,12,0,408,216,117,192,175,229,259,209,437,371,295,259,277.0,308.0,-36,-76,40
816,6,8,2,12,0,587,357,148,207,278,368,463,445,401,385,356,460,408.0,400.0,104,-29,133
555,7,8,2,12,0,555,320,180,373,400,374,355,402,517,287,263,333,298.0,294.0,70,-24,94
113,8,8,2,12,0,64,30,23,28,38,44,60,71,103,47,63,79,71.0,63.0,16,16,0
681,9,8,2,12,0,408,121,39,166,158,211,185,222,453,438,420,538,479.0,465.0,118,-18,136
165,10,8,2,12,0,129,68,34,47,50,71,60,56,125,119,131,111,121.0,120.0,-20,12,-32
1853,11,8,2,12,0,1767,893,628,788,879,1067,1002,995,690,648,797,1072,934.0,839.0,275,149,126
371,12,8,2,12,0,302,169,92,161,188,202,170,233,263,198,189,283,236.0,223.0,94,-9,103
334,13,8,2,12,0,215,80,56,93,108,163,149,199,289,190,211,214,212.0,205.0,3,21,-18
640,14,8,2,12,0,368,183,97,185,329,340,259,262,298,278,272,313,292.0,288.0,41,-6,47
1174,15,8,2,12,0,1163,445,309,478,511,775,845,706,532,466,593,691,642.0,583.0,98,127,-29
477,16,8,2,12,0,401,211,94,172,184,195,243,185,256,244,251,275,263.0,257.0,24,7,17
428,17,8,2,12,0,315,201,83,173,167,198,189,202,231,221,183,298,240.0,234.0,115,-38,153
239,18,8,2,12,0,145,54,20,51,78,114,140,134,168,156,185,156,170.0,166.0,-29,29,-58
100,19,8,2,12,0,104,28,21,52,82,45,37,92,119,77,81,81,81.0,80.0,0,4,-4
157,20,8,2,12,0,62,28,20,37,37,33,64,92,101,91,99,133,116.0,108.0,34,8,26
270,21,8,2,12,0,177,107,51,78,83,124,102,102,142,134,146,140,143.0,140.0,-6,12,-18
72,22,8,2,12,0,30,11,11,8,18,20,17,27,60,33,21,34,28.0,29.0,13,-12,25
1476,1,9,1,12,0,1734,940,540,957,807,919,933,755,914,982,870,1135,1002.0,996.0,265,-112,377
460,2,9,1,12,0,732,400,288,346,301,327,290,401,329,345,355,366,360.0,355.0,11,10,1
404,3,9,1,12,0,573,322,195,323,333,363,302,240,293,382,398,354,376.0,378.0,-44,16,-60
601,4,9,1,12,0,1057,659,394,601,489,595,532,503,449,472,373,574,474.0,473.0,201,-99,300
1309,5,9,1,12,0,1876,1072,611,873,761,808,800,793,898,1218,888,1018,953.0,1041.0,130,-330,460
1540,6,9,1,12,0,1597,1015,457,773,664,769,751,688,875,1020,977,994,986.0,997.0,17,-43,60
1912,7,9,1,12,0,2394,1077,522,1253,1236,1215,1019,955,1078,1388,1080,1407,1244.0,1292.0,327,-308,635
603,8,9,1,12,0,742,375,248,450,310,404,335,340,378,448,532,597,564.0,526.0,65,84,-19
1666,9,9,1,12,0,2594,949,463,1024,892,976,1062,838,972,1048,1071,1472,1272.0,1197.0,401,23,378
452,10,9,1,12,0,713,341,210,322,222,345,302,257,262,298,338,411,374.0,349.0,73,40,33
2311,11,9,1,12,0,2647,1466,939,1519,1181,1355,1281,1072,1305,1574,1407,1600,1504.0,1527.0,193,-167,360
1457,12,9,1,12,0,1527,753,397,757,746,837,677,745,886,1080,1037,1127,1082.0,1081.0,90,-43,133
1186,13,9,1,12,0,1235,691,404,655,694,773,655,680,691,793,740,923,832.0,819.0,183,-53,236
1718,14,9,1,12,0,2122,1000,589,1119,1013,903,937,951,1080,1247,1099,1363,1231.0,1236.0,264,-148,412
1599,15,9,1,12,0,2068,1003,537,978,796,1015,879,797,986,1136,1153,1265,1209.0,1185.0,112,17,95
1687,16,9,1,12,0,1632,1025,485,1058,873,1015,949,835,965,1376,1214,1261,1238.0,1284.0,47,-162,209
1665,17,9,1,12,0,2178,1217,467,1068,962,1084,875,893,959,1329,1057,1310,1184.0,1232.0,253,-272,525
610,18,9,1,12,0,913,522,257,433,373,497,408,356,398,487,518,526,522.0,510.0,8,31,-23
528,19,9,1,12,0,594,254,172,277,329,290,263,262,428,438,320,413,366.0,390.0,93,-118,211
653,20,9,1,12,0,762,420,252,342,321,324,387,329,286,390,312,436,374.0,379.0,124,-78,202
545,21,9,1,12,0,651,365,184,306,238,357,732,447,312,423,398,433,416.0,418.0,35,-25,60
253,22,9,1,12,0,372,142,121,207,187,231,186,143,232,203,179,234,206.0,205.0,55,-24,79
1456,1,10,2,12,0,1428,635,513,975,1070,1137,2596,1172,1207,1337,691,798,744.0,942.0,107,-646,753
628,2,10,2,12,0,626,249,167,333,316,408,510,602,649,565,362,313,338.0,413.0,-49,-203,154
528,3,10,2,12,0,701,285,178,320,330,439,413,440,575,685,372,350,361.0,469.0,-22,-313,291
129,4,10,2,12,0,913,106,74,113,101,453,335,314,124,110,37,81,59.0,76.0,44,-73,117
2127,5,10,2,12,0,2691,1134,763,1522,1501,1649,1954,1996,2318,2175,1415,1425,1420.0,1672.0,10,-760,770
3502,6,10,2,12,0,2356,1607,968,1908,2068,2171,2517,2384,2828,2098,1480,1747,1614.0,1775.0,267,-618,885
4833,7,10,2,12,0,4830,2048,1323,3138,3779,4223,3954,4263,5234,4184,2802,2819,2810.0,3268.0,17,-1382,1399
1287,8,10,2,12,0,1073,317,283,629,610,883,1085,1017,1391,967,750,729,740.0,815.0,-21,-217,196
2408,9,10,2,12,0,2500,695,488,1495,1512,1848,2203,1964,2643,2750,2176,1693,1934.0,2206.0,-483,-574,91
1181,10,10,2,12,0,869,475,293,738,554,830,966,1021,1065,1006,598,719,658.0,774.0,121,-408,529
5860,11,10,2,12,0,5865,2657,2401,4119,4083,4704,4995,4877,5866,4453,3479,3686,3582.0,3873.0,207,-974,1181
3171,12,10,2,12,0,1737,923,549,1502,1828,1895,1662,1811,1988,1776,1261,1656,1458.0,1564.0,395,-515,910
3116,13,10,2,12,0,2621,900,720,1379,2198,2809,2761,2856,3219,1969,1711,1899,1805.0,1860.0,188,-258,446
4994,14,10,2,12,0,3243,1683,1042,2558,3199,3067,3400,3871,4333,3047,2328,3052,2690.0,2809.0,724,-719,1443
3947,15,10,2,12,0,3490,1289,1038,1965,1876,2506,2778,3135,3712,3209,2554,2117,2336.0,2627.0,-437,-655,218
2711,16,10,2,12,0,1624,929,480,1234,1278,1437,1882,1699,1835,1719,1162,1291,1226.0,1391.0,129,-557,686
2429,17,10,2,12,0,1952,989,516,1513,1616,1696,1720,1686,2057,2090,1239,1356,1298.0,1562.0,117,-851,968
1548,18,10,2,12,0,958,546,402,859,878,1319,1184,1258,1327,1317,1081,840,960.0,1079.0,-241,-236,-5
716,19,10,2,12,0,821,205,149,446,498,474,571,727,964,874,497,533,515.0,635.0,36,-377,413
838,20,10,2,12,0,597,296,163,296,401,429,660,507,590,674,413,337,375.0,475.0,-76,-261,185
1087,21,10,2,12,0,1151,413,242,475,689,883,1688,1091,1205,1047,626,569,598.0,747.0,-57,-421,364
224,22,10,2,12,0,415,118,130,301,193,254,310,279,412,382,247,186,216.0,272.0,-61,-135,74
272,1,11,2,12,0,270,79,27,45,95,103,101,83,103,129,99,145,122.0,124.0,46,-30,76
526,2,11,2,12,0,384,296,172,285,192,231,213,247,282,327,422,431,426.0,393.0,9,95,-86
414,3,11,2,12,0,450,248,124,211,203,178,177,181,202,244,274,322,298.0,280.0,48,30,18
337,4,11,2,12,0,1287,118,74,556,952,1106,818,968,836,546,268,322,295.0,379.0,54,-278,332
1801,5,11,2,12,0,2805,1326,797,891,676,702,734,761,905,1065,1092,1163,1128.0,1107.0,71,27,44
1197,6,11,2,12,0,1443,903,436,535,520,582,612,532,660,692,828,845,836.0,788.0,17,136,-119
3100,7,11,2,12,0,3785,1878,1009,1343,1575,1488,1335,1337,1747,1744,1960,1965,1962.0,1890.0,5,216,-211
1457,8,11,2,12,0,2925,603,248,417,464,574,426,448,540,518,746,814,780.0,693.0,68,228,-160
2825,9,11,2,12,0,2419,914,399,1078,1095,1082,1215,1038,1245,1500,1591,1867,1729.0,1653.0,276,91,185
1161,10,11,2,12,0,935,666,303,492,403,512,470,474,495,629,719,806,762.0,718.0,87,90,-3
1890,11,11,2,12,0,2308,910,648,752,1041,985,944,821,908,982,1078,1100,1089.0,1053.0,22,96,-74
1287,12,11,2,12,0,1377,999,364,509,561,555,561,469,643,721,910,952,931.0,861.0,42,189,-147
2361,13,11,2,12,0,2067,1110,641,741,953,1002,876,936,1050,1031,1362,1448,1405.0,1280.0,86,331,-245
3785,14,11,2,12,0,3560,2272,888,1199,1423,1368,1487,1652,1740,1822,2212,2155,2184.0,2063.0,-57,390,-447
4449,15,11,2,12,0,4324,1028,639,1114,1097,2340,1882,1700,2222,2001,2752,4073,3412.0,2942.0,1321,751,570
1629,16,11,2,12,0,1534,1004,347,476,456,410,475,460,525,1167,723,753,738.0,881.0,30,-444,474
1881,17,11,2,12,0,1719,1133,438,685,688,650,716,659,750,1015,980,1001,990.0,999.0,21,-35,56
1279,18,11,2,12,0,1967,434,268,656,565,712,722,602,609,775,965,976,970.0,905.0,11,190,-179
480,19,11,2,12,0,520,199,149,205,202,188,167,160,157,192,253,319,286.0,255.0,66,61,5
995,20,11,2,12,0,532,432,291,409,310,302,286,280,366,470,485,545,515.0,500.0,60,15,45
2927,21,11,2,12,0,1651,919,422,609,612,587,580,1155,818,1081,1331,1915,1623.0,1442.0,584,250,334
230,22,11,2,12,0,257,135,104,114,128,104,132,112,136,138,80,126,103.0,115.0,46,-58,104
106,1,12,2,12,0,158,63,40,60,51,45,46,45,48,64,47,74,60.0,62.0,27,-17,44
643,2,12,2,12,0,535,421,246,288,240,252,266,378,341,384,421,469,445.0,425.0,48,37,11
486,3,12,2,12,0,676,363,164,250,212,180,206,169,180,292,330,410,370.0,344.0,80,38,42
115,4,12,2,12,0,496,86,74,109,80,71,61,54,68,80,56,77,66.0,71.0,21,-24,45
1369,5,12,2,12,0,1260,724,451,621,526,535,628,654,720,912,881,794,838.0,862.0,-87,-31,-56
1013,6,12,2,12,0,806,576,272,358,315,316,346,322,391,446,556,617,586.0,540.0,61,110,-49
2076,7,12,2,12,0,2915,1529,762,977,1071,1025,958,930,1153,1156,1444,1428,1436.0,1343.0,-16,288,-304
1389,8,12,2,12,0,1092,615,366,578,543,590,543,530,702,862,804,954,879.0,873.0,150,-58,208
2248,9,12,2,12,0,1437,718,363,821,836,734,867,743,867,1000,961,1391,1176.0,1117.0,430,-39,469
869,10,12,2,12,0,659,452,233,370,288,292,316,346,373,423,428,645,536.0,499.0,217,5,212
1013,11,12,2,12,0,1008,543,405,518,460,406,448,428,481,488,651,828,740.0,656.0,177,163,14
926,12,12,2,12,0,816,634,247,323,301,331,301,285,348,422,444,545,494.0,470.0,101,22,79
2644,13,12,2,12,0,2365,1304,951,1023,1070,1210,930,1140,1221,1304,1511,1557,1534.0,1457.0,46,207,-161
2367,14,12,2,12,0,2228,1526,717,888,888,823,850,1053,1131,1233,1386,1268,1327.0,1296.0,-118,153,-271
1312,15,12,2,12,0,1121,438,306,511,460,520,507,491,573,625,628,936,782.0,730.0,308,3,305
862,16,12,2,12,0,903,635,255,364,342,325,362,407,342,478,502,562,532.0,514.0,60,24,36
1281,17,12,2,12,0,1216,773,321,479,531,540,517,429,513,640,693,667,680.0,667.0,-26,53,-79
439,18,12,2,12,0,420,249,153,274,195,252,248,212,300,311,264,381,322.0,319.0,117,-47,164
798,19,12,2,12,0,641,287,222,321,326,279,247,251,291,348,358,578,468.0,428.0,220,10,210
658,20,12,2,12,0,402,296,142,238,207,233,232,240,260,352,335,350,342.0,346.0,15,-17,32
1597,21,12,2,12,0,1158,815,410,484,484,492,471,470,664,857,802,911,856.0,857.0,109,-55,164
531,22,12,2,12,0,336,166,145,205,161,183,216,199,211,200,279,399,339.0,293.0,120,79,41
161,1,13,1,12,0,461,180,102,190,125,145,92,77,83,77,70,89,80.0,79.0,19,-7,26
1127,2,13,1,12,0,1396,1059,575,778,650,682,486,654,573,601,737,746,742.0,695.0,9,136,-127
699,3,13,1,12,0,720,520,270,473,409,472,356,344,415,453,477,480,478.0,470.0,3,24,-21
96,4,13,1,12,0,487,101,86,162,127,117,78,41,43,61,36,66,51.0,54.0,30,-25,55
1876,5,13,1,12,0,2433,1860,1194,1302,1156,1192,925,872,1055,1302,1043,1171,1107.0,1172.0,128,-259,387
1487,6,13,1,12,0,2298,1440,720,878,861,934,738,651,739,952,974,954,964.0,960.0,-20,22,-42
2685,7,13,1,12,0,3804,2217,1109,1504,1812,1956,1321,1432,1563,1725,1648,1598,1623.0,1657.0,-50,-77,27
1125,8,13,1,12,0,1215,772,404,591,661,732,531,562,597,623,673,692,682.0,663.0,19,50,-31
1541,9,13,1,12,0,2021,1040,446,977,1064,948,854,663,649,829,797,933,865.0,853.0,136,-32,168
837,10,13,1,12,0,880,738,330,660,454,586,385,399,303,460,395,496,446.0,450.0,101,-65,166
1779,11,13,1,12,0,2525,1540,1130,1441,1246,1265,930,913,863,957,1065,1077,1071.0,1033.0,12,108,-96
1306,12,13,1,12,0,1320,1015,377,598,631,632,491,445,477,574,678,645,662.0,632.0,-33,104,-137
2875,13,13,1,12,0,3281,1882,1126,1456,2041,2368,1518,1714,1628,1540,1628,1737,1682.0,1635.0,109,88,21
2708,14,13,1,12,0,2975,2324,1002,1413,1518,1509,1135,1362,1395,1473,1530,1501,1516.0,1501.0,-29,57,-86
1439,15,13,1,12,0,2235,958,565,880,893,948,697,814,804,930,965,959,962.0,951.0,-6,35,-41
1562,16,13,1,12,0,1557,1148,463,782,723,758,663,696,627,825,791,880,836.0,832.0,89,-34,123
1306,17,13,1,12,0,1281,1235,439,733,664,655,498,506,508,651,664,797,730.0,704.0,133,13,120
628,18,13,1,12,0,877,518,365,529,461,541,380,328,306,337,330,453,392.0,373.0,123,-7,130
410,19,13,1,12,0,542,311,224,349,397,405,266,303,286,359,298,341,320.0,333.0,43,-61,104
641,20,13,1,12,0,666,489,274,346,334,368,358,284,258,335,284,301,292.0,307.0,17,-51,68
1015,21,13,1,12,0,1549,1036,394,463,535,597,405,487,551,603,672,616,644.0,630.0,-56,69,-125
645,22,13,1,12,0,998,401,372,684,679,736,526,592,672,585,481,632,556.0,566.0,151,-104,255
578,1,14,1,12,0,1047,423,192,279,354,355,429,362,376,371,244,388,316.0,334.0,144,-127,271
2038,2,14,1,12,0,1879,1354,680,631,992,1295,955,1148,1036,994,1360,1355,1358.0,1236.0,-5,366,-371
1503,3,14,1,12,0,1442,814,347,566,786,1042,724,802,839,925,923,1180,1052.0,1009.0,257,-2,259
475,4,14,1,12,0,1295,274,176,281,280,376,386,433,291,293,235,405,320.0,311.0,170,-58,228
4075,5,14,1,12,0,4188,2540,1081,1111,1488,1668,1412,1619,1860,2342,1859,2496,2178.0,2232.0,637,-483,1120
3368,6,14,1,12,0,3650,2495,863,893,1218,1582,1360,1404,1555,1685,1690,1970,1830.0,1782.0,280,5,275
5833,7,14,1,12,0,6275,3467,1356,2002,3249,3444,2666,3057,2942,3377,3085,3780,3432.0,3414.0,695,-292,987
1551,8,14,1,12,0,1576,743,357,500,790,998,720,798,855,911,936,1098,1017.0,982.0,162,25,137
4934,9,14,1,12,0,4342,1784,653,1364,1722,2162,2247,2038,2128,2302,2021,3107,2564.0,2477.0,1086,-281,1367
1408,10,14,1,12,0,1316,892,381,556,538,802,574,699,609,693,620,871,746.0,728.0,251,-73,324
5381,11,14,1,12,0,5864,3032,1760,2316,2607,3244,2604,2564,2570,2743,2663,3457,3060.0,2954.0,794,-80,874
2144,12,14,1,12,0,2160,1579,453,603,962,960,811,902,887,1133,1043,1296,1170.0,1157.0,253,-90,343
4576,13,14,1,12,0,4551,2375,1231,1427,2467,3049,2213,2567,2481,2466,2211,2880,2546.0,2519.0,669,-255,924
6966,14,14,1,12,0,8018,5309,1586,1915,2716,3025,2701,2930,3143,3339,3184,4188,3686.0,3570.0,1004,-155,1159
4554,15,14,1,12,0,4336,1679,826,1161,1890,2275,1899,2230,2234,2335,2198,3021,2610.0,2518.0,823,-137,960
2842,16,14,1,12,0,3179,2049,551,906,1028,1278,1264,1359,1217,1693,1417,1849,1633.0,1653.0,432,-276,708
3453,17,14,1,12,0,3747,2461,732,1157,1395,1621,1288,1479,1482,1887,1640,2246,1943.0,1924.0,606,-247,853
1342,18,14,1,12,0,1306,596,364,463,616,759,757,740,708,723,786,928,857.0,812.0,142,63,79
1902,19,14,1,12,0,1784,769,415,765,1227,1203,969,1200,1102,1144,952,1415,1184.0,1170.0,463,-192,655
1620,20,14,1,12,0,1417,877,373,399,529,594,627,619,620,836,742,844,793.0,807.0,102,-94,196
1875,21,14,1,12,0,1546,1008,303,361,648,917,661,790,773,918,1016,1193,1104.0,1042.0,177,98,79
1034,22,14,1,12,0,1290,579,365,604,725,778,831,876,865,867,758,1022,890.0,882.0,264,-109,373
668,1,15,2,12,0,1293,851,433,764,667,727,689,522,968,719,517,661,589.0,632.0,144,-202,346
482,2,15,2,12,0,639,509,300,415,361,462,414,443,436,471,370,430,400.0,424.0,60,-101,161
503,3,15,2,12,0,580,494,276,556,527,562,528,446,576,531,533,499,516.0,521.0,-34,2,-36
839,4,15,2,12,0,2146,1327,923,1308,982,1002,1096,834,1075,842,705,996,850.0,848.0,291,-137,428
880,5,15,2,12,0,1105,856,454,680,597,621,651,776,861,835,604,738,671.0,726.0,134,-231,365
1238,6,15,2,12,0,1070,953,364,644,584,685,706,708,895,856,786,924,855.0,855.0,138,-70,208
1662,7,15,2,12,0,1837,1329,778,1244,1284,1298,1141,1319,1334,1363,1113,1322,1218.0,1266.0,209,-250,459
772,8,15,2,12,0,1203,945,474,746,713,727,660,639,991,794,659,777,718.0,743.0,118,-135,253
621,9,15,2,12,0,825,423,180,427,549,477,696,389,618,526,381,555,468.0,487.0,174,-145,319
176,10,15,2,12,0,243,179,71,140,141,183,151,137,141,191,116,136,126.0,148.0,20,-75,95
1918,11,15,2,12,0,2643,1820,1058,1565,1288,1340,1313,1263,1676,1620,1295,1548,1422.0,1488.0,253,-325,578
460,12,15,2,12,0,571,408,151,325,301,312,293,255,351,379,320,372,346.0,357.0,52,-59,111
1772,13,15,2,12,0,1923,1604,884,1377,1523,1631,1539,1425,1590,1515,1285,1653,1469.0,1484.0,368,-230,598
1516,14,15,2,12,0,1482,1178,548,1003,1062,1044,1052,1125,1238,1016,988,1131,1060.0,1045.0,143,-28,171
909,15,15,2,12,0,1112,767,352,679,681,651,616,628,814,733,614,823,718.0,723.0,209,-119,328
378,16,15,2,12,0,483,446,164,271,261,296,275,330,388,373,300,273,286.0,315.0,-27,-73,46
630,17,15,2,12,0,783,487,262,452,359,428,383,395,447,527,425,461,443.0,471.0,36,-102,138
275,18,15,2,12,0,456,397,140,227,217,291,297,182,259,217,256,253,254.0,242.0,-3,39,-42
194,19,15,2,12,0,310,270,165,356,218,179,255,221,255,217,176,183,180.0,192.0,7,-41,48
452,20,15,2,12,0,644,555,263,408,381,378,462,374,447,448,311,353,332.0,371.0,42,-137,179
602,21,15,2,12,0,758,719,361,603,579,645,499,553,624,536,522,551,536.0,536.0,29,-14,43
91,22,15,2,12,0,169,104,79,149,106,141,121,123,121,96,100,74,87.0,90.0,-26,4,-30
50,1,16,2,12,0,117,63,37,86,109,100,151,123,42,55,43,69,56.0,56.0,26,-12,38
1707,2,16,2,12,0,1590,946,692,1035,755,884,765,1277,1207,1465,1333,1653,1493.0,1484.0,320,-132,452
1157,3,16,2,12,0,982,602,413,714,724,743,629,652,1139,1161,1060,1217,1138.0,1146.0,157,-101,258
470,4,16,2,12,0,985,300,271,404,282,274,292,278,289,341,277,438,358.0,352.0,161,-64,225
3557,5,16,2,12,0,3340,1470,1639,3175,2405,2457,2398,2530,2754,3201,2401,2911,2656.0,2838.0,510,-800,1310
647,6,16,2,12,0,575,248,260,384,279,286,452,366,371,478,493,479,486.0,483.0,-14,15,-29
4485,7,16,2,12,0,4024,1903,1708,2748,2376,2932,2420,2797,3096,3668,3505,3426,3466.0,3533.0,-79,-163,84
1661,8,16,2,12,0,1616,679,442,672,792,892,815,1028,1189,1434,1465,1372,1418.0,1424.0,-93,31,-124
2864,9,16,2,12,0,2398,1196,1075,2249,1558,2005,1936,1682,1885,2157,2044,2682,2363.0,2294.0,638,-113,751
553,10,16,2,12,0,435,440,301,449,664,501,523,446,573,488,369,373,371.0,410.0,4,-119,123
1047,11,16,2,12,0,930,527,626,655,605,586,670,623,694,810,917,910,914.0,879.0,-7,107,-114
567,12,16,2,12,0,540,354,189,356,270,359,296,244,355,399,425,430,428.0,418.0,5,26,-21
4404,13,16,2,12,0,4206,2068,1780,2633,2656,3148,2856,3242,3648,3843,3840,3797,3818.0,3827.0,-43,-3,-40
2932,14,16,2,12,0,2962,1570,1050,1823,1515,1509,1506,1785,1836,2094,2086,2076,2081.0,2085.0,-10,-8,-2
979,15,16,2,12,0,886,424,422,628,555,606,538,517,542,822,660,837,748.0,773.0,177,-162,339
704,16,16,2,12,0,920,483,270,442,304,376,403,430,440,533,573,565,569.0,557.0,-8,40,-48
1505,17,16,2,12,0,2336,1714,653,1232,835,1023,1076,1149,1284,1450,1174,1327,1250.0,1317.0,153,-276,429
648,18,16,2,12,0,622,308,292,460,424,486,428,470,413,661,640,624,632.0,642.0,-16,-21,5
1895,19,16,2,12,0,1878,681,691,1319,1119,1215,1237,1419,1601,1582,1557,1850,1704.0,1663.0,293,-25,318
348,20,16,2,12,0,247,131,105,125,160,126,176,161,199,234,262,286,274.0,261.0,24,28,-4
1137,21,16,2,12,0,1051,558,384,605,487,577,560,603,780,777,886,963,924.0,875.0,77,109,-32
2042,22,16,2,12,0,1781,730,952,1556,1254,1336,1463,1649,2283,2187,1730,2069,1900.0,1995.0,339,-457,796
4031,1,17,2,12,0,3060,1909,501,2672,4039,883,4181,1421,1782,1879,887,1453,1170.0,1406.0,566,-992,1558
2108,2,17,2,12,0,1402,656,504,651,603,785,827,1300,1307,1367,1252,1286,1269.0,1302.0,34,-115,149
1015,3,17,2,12,0,827,268,214,376,413,543,491,575,777,749,772,819,796.0,780.0,47,23,24
1168,4,17,2,12,0,2145,217,200,2331,1550,280,361,498,297,355,265,923,594.0,514.0,658,-90,748
4160,5,17,2,12,0,2450,1355,937,1478,2078,1399,1459,1801,2351,2567,2053,2483,2268.0,2368.0,430,-514,944
3814,6,17,2,12,0,3132,1460,775,1436,1362,1591,1598,1947,2510,2710,2516,2761,2638.0,2662.0,245,-194,439
5881,7,17,2,12,0,5401,1885,1225,2010,2269,2615,2569,3263,3929,4366,4122,4579,4350.0,4356.0,457,-244,701
2204,8,17,2,12,0,2066,692,491,877,974,1192,1135,1670,2019,1865,1828,1763,1796.0,1819.0,-65,-37,-28
2576,9,17,2,12,0,2519,625,462,1475,1506,1216,1544,1515,1754,1731,1687,1766,1726.0,1728.0,79,-44,123
935,10,17,2,12,0,616,308,176,366,289,407,451,518,551,689,586,649,618.0,641.0,63,-103,166
6650,11,17,2,12,0,5643,2143,1862,2644,2631,3008,3307,4299,4173,4430,4745,5223,4984.0,4799.0,478,315,163
2823,12,17,2,12,0,2357,973,442,916,895,1031,1009,1333,1810,1734,1615,1930,1772.0,1760.0,315,-119,434
6715,13,17,2,12,0,5424,1723,1261,2043,2652,2981,2611,4091,4869,4197,4377,4580,4478.0,4385.0,203,180,23
7066,14,17,2,12,0,5119,2463,1238,2429,2562,2723,3091,4009,4961,4989,4481,4887,4684.0,4786.0,406,-508,914
3570,15,17,2,12,0,2755,895,768,1359,1321,1533,1474,1767,2205,2322,2259,2546,2402.0,2376.0,287,-63,350
2455,16,17,2,12,0,1985,1002,357,841,848,822,1085,1431,1415,1567,1474,1785,1630.0,1609.0,311,-93,404
3403,17,17,2,12,0,2533,1085,531,1104,1014,1204,1328,1663,1969,2202,1856,2467,2162.0,2175.0,611,-346,957
1980,18,17,2,12,0,1549,440,400,775,721,1235,973,1141,1223,1242,1298,1293,1296.0,1278.0,-5,56,-61
1220,19,17,2,12,0,1098,268,212,386,587,555,690,977,861,746,692,979,836.0,806.0,287,-54,341
1756,20,17,2,12,0,1120,617,359,603,607,619,800,1027,1072,1122,870,978,924.0,990.0,108,-252,360
2002,21,17,2,12,0,1748,631,397,661,1831,842,1735,1691,1436,1577,1777,1588,1682.0,1647.0,-189,200,-389
463,22,17,2,12,0,480,162,156,276,218,323,452,354,467,458,427,445,436.0,443.0,18,-31,49
544,1,18,2,12,0,754,315,362,767,319,351,300,314,334,352,238,335,286.0,308.0,97,-114,211
1391,2,18,2,12,0,866,452,295,448,404,525,442,543,578,599,835,753,794.0,729.0,-82,236,-318
1616,3,18,2,12,0,941,427,254,591,556,550,476,504,704,679,805,969,887.0,818.0,164,126,38
195,4,18,2,12,0,546,125,89,159,100,115,114,150,110,113,75,167,121.0,118.0,92,-38,130
2230,5,18,2,12,0,1812,1017,704,1344,1235,1081,1056,878,1050,1236,1013,1386,1200.0,1212.0,373,-223,596
2414,6,18,2,12,0,1669,741,475,869,701,638,694,733,857,812,1004,1382,1193.0,1066.0,378,192,186
8288,7,18,2,12,0,5496,2330,1515,2865,2841,2834,2558,2825,3266,3132,3700,4698,4199.0,3843.0,998,568,430
3670,8,18,2,12,0,2626,1165,641,1247,1425,1531,1329,1557,1538,1282,1762,2132,1947.0,1725.0,370,480,-110
892,9,18,2,12,0,1055,368,255,433,540,513,805,467,681,614,408,685,546.0,569.0,277,-206,483
582,10,18,2,12,0,448,365,155,240,485,249,405,222,128,107,185,206,196.0,166.0,21,78,-57
2594,11,18,2,12,0,2261,1167,1028,1507,1281,827,792,892,955,1053,993,1433,1213.0,1160.0,440,-60,500
814,12,18,2,12,0,847,641,223,316,236,253,238,242,217,309,282,453,368.0,348.0,171,-27,198
8972,13,18,2,12,0,5478,1932,1551,2981,3513,3250,2524,3284,3386,2904,3615,5099,4357.0,3873.0,1484,711,773
4199,14,18,2,12,0,3092,1731,893,1695,1504,1408,1487,1714,1721,1597,1924,2619,2272.0,2047.0,695,327,368
1272,15,18,2,12,0,1205,504,467,741,598,514,446,578,432,623,523,753,638.0,633.0,230,-100,330
565,16,18,2,12,0,657,298,154,273,222,166,164,170,172,198,208,244,226.0,217.0,36,10,26
993,17,18,2,12,0,1351,576,253,448,437,409,373,484,393,425,410,464,437.0,433.0,54,-15,69
663,18,18,2,12,0,617,215,148,255,232,240,199,231,301,352,251,383,317.0,329.0,132,-101,233
1855,19,18,2,12,0,1026,394,408,768,721,776,679,667,892,902,982,1252,1117.0,1045.0,270,80,190
621,20,18,2,12,0,694,353,248,346,329,249,207,249,199,233,246,277,262.0,252.0,31,13,18
1652,21,18,2,12,0,1400,754,418,791,600,553,553,625,614,777,930,1142,1036.0,950.0,212,153,59
1204,22,18,2,12,0,710,280,266,503,464,518,466,471,859,943,658,999,828.0,867.0,341,-285,626
398,1,19,2,12,0,359,339,177,321,249,248,328,254,307,237,241,314,278.0,264.0,73,4,69
537,2,19,2,12,0,485,409,248,357,375,412,347,430,418,363,355,506,430.0,408.0,151,-8,159
562,3,19,2,12,0,434,519,319,522,443,583,484,431,411,444,497,501,499.0,481.0,4,53,-49
1146,4,19,2,12,0,1802,1263,877,1267,1047,1549,1033,967,860,855,791,996,894.0,881.0,205,-64,269
1191,5,19,2,12,0,1083,1390,565,951,827,852,794,845,1009,1048,823,948,886.0,940.0,125,-225,350
754,6,19,2,12,0,629,667,315,471,534,553,570,581,499,590,552,657,604.0,600.0,105,-38,143
2059,7,19,2,12,0,1642,1861,878,1578,1694,1792,1554,1627,1927,1942,1727,2049,1888.0,1906.0,322,-215,537
527,8,19,2,12,0,414,426,317,451,395,445,395,431,409,455,463,508,486.0,475.0,45,8,37
1278,9,19,2,12,0,1243,727,322,827,693,791,804,769,839,878,889,996,942.0,921.0,107,11,96
363,10,19,2,12,0,214,225,119,204,139,193,190,168,192,190,217,221,219.0,209.0,4,27,-23
1479,11,19,2,12,0,1374,1336,868,1301,1124,1278,1241,1197,1296,1046,1162,1396,1279.0,1201.0,234,116,118
456,12,19,2,12,0,329,364,141,291,237,315,278,285,309,268,301,381,341.0,317.0,80,33,47
1970,13,19,2,12,0,1615,1768,1165,1697,1805,2074,1714,1806,1864,1750,1625,1780,1702.0,1718.0,155,-125,280
1901,14,19,2,12,0,1443,1429,856,1325,1403,1419,1413,1478,1579,1504,1582,1735,1658.0,1607.0,153,78,75
1059,15,19,2,12,0,863,742,356,707,633,707,646,663,732,701,734,955,844.0,797.0,221,33,188
709,16,19,2,12,0,566,558,262,443,396,470,482,493,546,551,501,557,529.0,536.0,56,-50,106
648,17,19,2,12,0,494,519,230,424,383,397,379,387,399,409,410,492,451.0,437.0,82,1,81
518,18,19,2,12,0,402,404,188,330,251,340,301,284,315,604,431,529,480.0,521.0,98,-173,271
881,19,19,2,12,0,1082,704,546,870,783,781,790,785,765,828,793,792,792.0,804.0,-1,-35,34
463,20,19,2,12,0,391,433,202,335,319,317,436,335,381,329,373,351,362.0,351.0,-22,44,-66
610,21,19,2,12,0,497,487,257,378,390,460,393,519,500,482,768,590,679.0,613.0,-178,286,-464
992,22,19,2,12,0,964,785,666,1198,1070,1179,970,890,1044,870,813,1027,920.0,903.0,214,-57,271
347,1,20,1,12,0,1504,815,447,731,532,612,632,552,602,639,404,495,450.0,513.0,91,-235,326
208,2,20,1,12,0,785,585,277,403,310,422,368,501,439,383,371,382,376.0,379.0,11,-12,23
66,3,20,1,12,0,430,303,110,229,177,183,153,136,170,141,127,115,121.0,128.0,-12,-14,2
95,4,20,1,12,0,1127,376,284,427,371,462,336,275,270,272,206,198,202.0,225.0,-8,-66,58
284,5,20,1,12,0,1775,1096,562,764,657,680,772,616,717,828,542,499,520.0,623.0,-43,-286,243
399,6,20,1,12,0,1490,952,364,600,581,589,605,632,685,690,608,574,591.0,624.0,-34,-82,48
606,7,20,1,12,0,1739,940,501,805,813,957,836,892,940,1047,835,856,846.0,913.0,21,-212,233
60,8,20,1,12,0,371,229,113,151,138,130,107,102,135,123,108,86,97.0,106.0,-22,-15,-7
454,9,20,1,12,0,2216,854,451,986,862,846,947,768,780,800,819,825,822.0,815.0,6,19,-13
123,10,20,1,12,0,372,218,114,237,155,197,163,181,169,173,175,153,164.0,167.0,-22,2,-24
694,11,20,1,12,0,3132,1586,987,1345,1015,1158,1068,1086,1181,1123,952,921,936.0,999.0,-31,-171,140
274,12,20,1,12,0,1144,754,284,498,430,503,444,457,461,471,423,426,424.0,440.0,3,-48,51
287,13,20,1,12,0,1218,652,442,599,687,716,543,668,679,581,499,505,502.0,528.0,6,-82,88
283,14,20,1,12,0,1578,856,471,700,719,644,669,703,653,571,445,437,441.0,484.0,-8,-126,118
656,15,20,1,12,0,3371,1749,893,1369,1150,1156,1037,1172,1334,1278,1146,1084,1115.0,1169.0,-62,-132,70
234,16,20,1,12,0,1333,941,363,579,523,593,600,621,519,533,456,435,446.0,475.0,-21,-77,56
344,17,20,1,12,0,1561,1003,386,716,610,659,562,594,642,673,494,526,510.0,564.0,32,-179,211
160,18,20,1,12,0,1102,667,370,551,387,534,372,366,372,338,360,306,333.0,335.0,-54,22,-76
141,19,20,1,12,0,555,253,188,258,212,206,203,265,272,248,226,236,231.0,237.0,10,-22,32
167,20,20,1,12,0,740,452,184,293,290,264,303,274,250,248,200,193,196.0,214.0,-7,-48,41
107,21,20,1,12,0,533,395,223,292,216,328,233,285,238,205,191,169,180.0,188.0,-22,-14,-8
115,22,20,1,12,0,428,213,219,281,217,259,239,210,238,179,150,155,152.0,161.0,5,-29,34
864,1,21,2,12,0,688,275,231,396,369,368,427,353,607,636,687,666,676.0,663.0,-21,51,-72
899,2,21,2,12,0,1001,409,321,443,427,437,368,556,556,634,776,798,787.0,736.0,22,142,-120
887,3,21,2,12,0,789,370,239,440,455,525,460,522,607,660,829,779,804.0,756.0,-50,169,-219
559,4,21,2,12,0,1807,402,360,619,496,497,491,482,542,549,493,616,554.0,553.0,123,-56,179
3143,5,21,2,12,0,3590,1589,1106,1523,1538,1537,1666,1861,2475,3069,2341,2533,2437.0,2648.0,192,-728,920
2187,6,21,2,12,0,1968,921,593,995,1124,1199,1070,1346,1713,1638,1809,1647,1728.0,1698.0,-162,171,-333
3294,7,21,2,12,0,3299,1329,945,1856,2083,2108,1738,2082,2655,2980,2964,2721,2842.0,2888.0,-243,-16,-227
940,8,21,2,12,0,1130,401,261,510,549,610,526,688,866,791,915,926,920.0,877.0,11,124,-113
1928,9,21,2,12,0,2397,475,354,1081,908,1044,1235,994,1368,1488,1712,1916,1814.0,1705.0,204,224,-20
551,10,21,2,12,0,595,225,179,348,224,290,274,316,397,424,502,451,476.0,459.0,-51,78,-129
4141,11,21,2,12,0,4302,1623,1477,2234,2129,2434,2155,2485,3088,3158,3744,3224,3484.0,3375.0,-520,586,-1106
1012,12,21,2,12,0,1016,398,230,537,551,590,548,652,808,842,1004,916,960.0,921.0,-88,162,-250
4237,13,21,2,12,0,3954,1565,1311,2239,2725,3260,2705,3344,4173,4034,4164,3884,4024.0,4027.0,-280,130,-410
3906,14,21,2,12,0,3291,1489,872,1684,1948,1801,1780,2489,2996,3374,3430,3303,3366.0,3369.0,-127,56,-183
3228,15,21,2,12,0,2897,961,793,1491,1417,1453,1417,1645,2472,2753,3040,2713,2876.0,2835.0,-327,287,-614
1298,16,21,2,12,0,1304,805,357,634,667,656,762,898,966,1182,1166,938,1052.0,1095.0,-228,-16,-212
1312,17,21,2,12,0,1222,427,264,565,544,561,563,728,991,1080,998,1178,1088.0,1085.0,180,-82,262
1080,18,21,2,12,0,924,385,327,518,415,620,444,541,690,728,859,918,888.0,835.0,59,131,-72
1282,19,21,2,12,0,1513,414,423,828,916,847,707,895,1272,1162,1131,1259,1195.0,1184.0,128,-31,159
635,20,21,2,12,0,612,296,209,288,300,336,388,329,435,559,585,545,565.0,563.0,-40,26,-66
1184,21,21,2,12,0,1143,404,239,410,468,587,452,654,835,911,1108,886,997.0,968.0,-222,197,-419
1104,22,21,2,12,0,1198,462,436,1058,713,772,690,729,1100,842,859,1078,968.0,926.0,219,17,202
1012,1,22,4,12,0,925,325,455,653,555,624,740,612,758,1004,810,1382,1096.0,1065.0,572,-194,766
428,2,22,4,12,0,546,194,218,317,270,316,211,290,290,300,338,342,340.0,327.0,4,38,-34
349,3,22,4,12,0,418,168,163,287,292,335,266,288,328,334,323,334,328.0,330.0,11,-11,22
739,4,22,4,12,0,1615,471,523,831,698,714,664,617,559,655,482,726,604.0,621.0,244,-173,417
910,5,22,4,12,0,1167,445,516,738,665,640,630,656,820,1044,665,802,734.0,837.0,137,-379,516
887,6,22,4,12,0,1003,374,418,658,653,606,565,618,791,819,792,825,808.0,812.0,33,-27,60
2250,7,22,4,12,0,2766,875,984,1739,1860,1899,1420,1615,2002,2507,2148,2497,2322.0,2384.0,349,-359,708
316,8,22,4,12,0,484,139,184,247,243,229,225,247,307,331,274,309,292.0,305.0,35,-57,92
953,9,22,4,12,0,1464,402,402,896,629,772,826,680,829,845,876,919,898.0,880.0,43,31,12
298,10,22,4,12,0,384,118,109,224,157,222,215,154,183,203,224,236,230.0,221.0,12,21,-9
2732,11,22,4,12,0,3241,1057,1612,2234,1953,2227,1909,2048,2422,2463,2396,2598,2497.0,2486.0,202,-67,269
478,12,22,4,12,0,511,213,176,385,307,351,273,345,404,431,370,388,379.0,396.0,18,-61,79
1907,13,22,4,12,0,2115,754,885,1533,1690,1813,1571,1661,1916,1901,1771,1881,1826.0,1851.0,110,-130,240
1630,14,22,4,12,0,1740,591,724,1200,1228,1058,967,1158,1211,1356,1347,1448,1398.0,1384.0,101,-9,110
2406,15,22,4,12,0,2662,818,1237,1764,1676,1729,1525,1884,2258,2311,2171,2155,2163.0,2212.0,-16,-140,124
518,16,22,4,12,0,685,305,279,470,356,444,412,438,504,557,493,433,463.0,494.0,-60,-64,4
552,17,22,4,12,0,768,256,278,497,347,424,341,409,480,525,413,527,470.0,488.0,114,-112,226
448,18,22,4,12,0,608,216,257,389,262,395,326,356,356,363,428,434,431.0,408.0,6,65,-59
393,19,22,4,12,0,595,169,217,412,408,386,321,346,352,385,344,400,372.0,376.0,56,-41,97
165,20,22,4,12,0,258,69,99,133,100,129,180,126,116,163,123,156,140.0,147.0,33,-40,73
556,21,22,4,12,0,657,185,238,361,306,395,301,417,437,460,507,470,488.0,479.0,-37,47,-84
347,22,22,4,12,0,533,157,228,535,404,398,359,345,475,357,314,335,324.0,335.0,21,-43,64
50,1,23,1,12,0,215,76,41,45,61,38,52,37,39,38,27,26,26.0,30.0,-1,-11,10
69,2,23,1,12,0,182,95,41,34,36,31,58,44,55,41,52,57,54.0,50.0,5,11,-6
69,3,23,1,12,0,205,99,66,95,76,72,76,74,85,79,66,85,76.0,77.0,19,-13,32
60,4,23,1,12,0,439,74,40,54,53,41,27,32,51,39,40,36,38.0,38.0,-4,1,-5
217,5,23,1,12,0,513,309,153,136,133,149,150,134,136,183,129,148,138.0,153.0,19,-54,73
568,6,23,1,12,0,1047,578,273,312,307,331,314,279,347,395,358,404,381.0,386.0,46,-37,83
979,7,23,1,12,0,1844,902,381,538,572,675,544,536,649,690,646,674,660.0,670.0,28,-44,72
378,8,23,1,12,0,545,238,158,237,226,236,217,178,237,265,271,262,266.0,266.0,-9,6,-15
121,9,23,1,12,0,373,126,71,118,103,101,96,92,121,141,114,105,110.0,120.0,-9,-27,18
143,10,23,1,12,0,162,93,53,69,35,53,40,48,50,56,61,70,66.0,62.0,9,5,4
327,11,23,1,12,0,621,300,168,197,206,183,203,185,213,207,225,239,232.0,224.0,14,18,-4
105,12,23,1,12,0,266,151,36,61,68,60,40,53,57,59,62,57,60.0,59.0,-5,3,-8
930,13,23,1,12,0,1460,748,389,430,459,518,401,452,524,544,517,550,534.0,537.0,33,-27,60
527,14,23,1,12,0,1100,524,174,251,240,290,254,290,316,303,354,329,342.0,329.0,-25,51,-76
102,15,23,1,12,0,260,101,55,63,66,67,90,77,72,74,78,75,76.0,76.0,-3,4,-7
240,16,23,1,12,0,534,275,79,103,125,96,138,125,127,182,178,155,166.0,172.0,-23,-4,-19
228,17,23,1,12,0,535,308,119,163,126,142,139,138,161,166,159,176,168.0,167.0,17,-7,24
58,18,23,1,12,0,129,60,25,51,31,35,42,33,28,56,34,32,33.0,41.0,-2,-22,20
247,19,23,1,12,0,371,149,91,133,121,130,132,148,200,180,119,203,161.0,167.0,84,-61,145
101,20,23,1,12,0,335,168,84,69,66,80,88,67,79,85,68,53,60.0,69.0,-15,-17,2
170,21,23,1,12,0,360,209,62,83,76,106,84,83,85,110,130,105,118.0,115.0,-25,20,-45
125,22,23,1,12,0,312,126,95,154,101,143,86,105,123,132,70,154,112.0,119.0,84,-62,146
616,1,24,2,12,0,362,679,494,731,600,672,772,704,727,654,627,624,626.0,635.0,-3,-27,24
250,2,24,2,12,0,155,229,130,223,186,188,194,250,267,174,213,221,217.0,203.0,8,39,-31
88,3,24,2,12,0,59,106,63,136,99,113,83,99,112,92,79,72,76.0,81.0,-7,-13,6
640,4,24,2,12,0,521,798,532,838,575,694,618,670,630,659,544,647,596.0,617.0,103,-115,218
597,5,24,2,12,0,474,703,394,653,524,606,614,549,576,507,629,544,586.0,560.0,-85,122,-207
315,6,24,2,12,0,187,338,203,372,311,341,346,340,353,335,325,345,335.0,335.0,20,-10,30
480,7,24,2,12,0,353,610,362,607,527,608,548,531,526,473,504,529,516.0,502.0,25,31,-6
121,8,24,2,12,0,105,129,94,160,139,138,152,130,124,119,114,110,112.0,114.0,-4,-5,1
1182,9,24,2,12,0,1007,1207,847,1361,1093,1267,1219,1095,1304,1161,1178,1233,1206.0,1191.0,55,17,38
165,10,24,2,12,0,119,159,102,172,121,154,153,137,153,146,149,132,140.0,142.0,-17,3,-20
1340,11,24,2,12,0,1077,1735,1066,1713,1523,1554,1639,1493,1583,1338,1428,1399,1414.0,1388.0,-29,90,-119
209,12,24,2,12,0,152,242,146,291,216,232,253,206,215,224,199,233,216.0,219.0,34,-25,59
334,13,24,2,12,0,182,340,242,360,379,362,327,372,362,376,325,346,336.0,349.0,21,-51,72
311,14,24,2,12,0,223,320,199,311,289,319,320,350,407,332,310,322,316.0,321.0,12,-22,34
1295,15,24,2,12,0,1024,1529,973,1602,1326,1507,1501,1473,1537,1190,1401,1357,1379.0,1316.0,-44,211,-255
342,16,24,2,12,0,274,370,238,369,296,339,369,331,321,338,311,327,319.0,325.0,16,-27,43
301,17,24,2,12,0,215,305,186,346,275,278,289,275,275,299,270,266,268.0,278.0,-4,-29,25
365,18,24,2,12,0,324,518,242,572,350,498,528,403,477,413,401,478,440.0,431.0,77,-12,89
206,19,24,2,12,0,174,292,205,321,225,242,252,295,316,266,226,255,240.0,249.0,29,-40,69
255,20,24,2,12,0,217,267,199,277,240,244,232,258,263,190,261,210,236.0,220.0,-51,71,-122
197,21,24,2,12,0,197,285,151,281,203,248,250,270,252,210,232,204,218.0,215.0,-28,22,-50
51,22,24,2,12,0,53,93,68,133,85,82,113,113,134,92,79,76,78.0,82.0,-3,-13,10
451,1,25,1,12,0,225,315,160,297,263,287,314,230,299,290,307,324,316.0,307.0,17,17,0
190,2,25,1,12,0,176,164,108,164,133,153,126,180,169,187,139,179,159.0,168.0,40,-48,88
114,3,25,1,12,0,86,86,62,103,111,102,97,88,89,103,85,91,88.0,93.0,6,-18,24
373,4,25,1,12,0,417,323,190,356,270,290,257,234,246,289,227,292,260.0,269.0,65,-62,127
421,5,25,1,12,0,337,483,166,411,313,351,316,288,271,389,298,353,326.0,347.0,55,-91,146
251,6,25,1,12,0,174,188,119,173,183,210,172,186,222,219,180,232,206.0,210.0,52,-39,91
381,7,25,1,12,0,253,339,160,306,297,331,234,253,292,332,281,323,302.0,312.0,42,-51,93
115,8,25,1,12,0,91,111,56,97,101,97,84,91,94,102,75,77,76.0,85.0,2,-27,29
765,9,25,1,12,0,512,581,314,531,409,540,562,422,478,505,502,589,546.0,532.0,87,-3,90
169,10,25,1,12,0,109,128,57,103,59,104,114,85,94,92,94,107,100.0,98.0,13,2,11
941,11,25,1,12,0,734,807,456,741,678,793,643,655,701,797,673,806,740.0,759.0,133,-124,257
181,12,25,1,12,0,138,165,79,158,126,152,118,104,127,138,158,140,149.0,145.0,-18,20,-38
244,13,25,1,12,0,178,203,126,201,195,251,175,165,222,247,198,194,196.0,213.0,-4,-49,45
264,14,25,1,12,0,173,186,103,191,191,194,156,186,216,215,183,191,187.0,196.0,8,-32,40
950,15,25,1,12,0,595,656,382,738,625,720,647,584,732,718,681,710,696.0,703.0,29,-37,66
332,16,25,1,12,0,266,270,142,257,214,255,256,231,241,262,216,268,242.0,249.0,52,-46,98
270,17,25,1,12,0,191,210,114,205,161,191,162,167,198,213,168,187,178.0,189.0,19,-45,64
366,18,25,1,12,0,205,241,127,267,183,283,239,197,201,237,226,219,222.0,227.0,-7,-11,4
173,19,25,1,12,0,128,140,90,113,125,138,146,129,145,130,114,155,134.0,133.0,41,-16,57
190,20,25,1,12,0,134,131,54,117,102,136,130,124,110,144,134,137,136.0,138.0,3,-10,13
169,21,25,1,12,0,145,159,85,142,119,156,144,123,140,138,149,133,141.0,140.0,-16,11,-27
66,22,25,1,12,0,61,68,34,78,65,79,70,61,83,81,56,48,52.0,62.0,-8,-25,17
554,1,26,1,12,0,474,835,424,592,562,626,644,634,694,593,524,572,548.0,563.0,48,-69,117
267,2,26,1,12,0,215,310,178,234,223,203,223,258,250,238,175,252,214.0,222.0,77,-63,140
106,3,26,1,12,0,74,139,87,116,104,125,105,116,128,105,107,97,102.0,103.0,-10,2,-12
703,4,26,1,12,0,817,1033,648,841,763,792,726,727,824,751,607,773,690.0,710.0,166,-144,310
485,5,26,1,12,0,382,695,383,524,456,456,507,479,440,615,366,469,418.0,483.0,103,-249,352
238,6,26,1,12,0,177,354,152,225,259,222,223,254,259,255,231,246,238.0,244.0,15,-24,39
439,7,26,1,12,0,336,608,328,530,488,475,451,429,468,468,361,427,394.0,419.0,66,-107,173
137,8,26,1,12,0,100,165,96,130,118,97,142,140,152,138,125,143,134.0,135.0,18,-13,31
1060,9,26,1,12,0,825,1178,690,1101,964,1020,962,1084,1109,1111,990,946,968.0,1016.0,-44,-121,77
144,10,26,1,12,0,114,160,106,163,133,138,136,134,129,148,137,150,144.0,145.0,13,-11,24
967,11,26,1,12,0,1007,1591,766,1115,1026,1072,1033,982,1080,1012,891,978,934.0,960.0,87,-121,208
167,12,26,1,12,0,108,227,115,167,214,182,168,165,197,175,164,177,170.0,172.0,13,-11,24
244,13,26,1,12,0,219,376,209,316,289,290,301,301,298,260,239,251,245.0,250.0,12,-21,33
249,14,26,1,12,0,262,357,201,287,304,275,256,289,287,329,268,301,284.0,299.0,33,-61,94
870,15,26,1,12,0,908,1436,623,970,967,965,954,954,1063,930,896,805,850.0,877.0,-91,-34,-57
405,16,26,1,12,0,356,436,202,366,316,282,393,360,384,379,336,340,338.0,352.0,4,-43,47
272,17,26,1,12,0,192,302,179,246,255,226,219,246,249,252,213,211,212.0,225.0,-2,-39,37
278,18,26,1,12,0,256,500,212,338,297,357,330,288,330,361,323,344,334.0,343.0,21,-38,59
210,19,26,1,12,0,227,304,176,286,261,241,263,276,299,268,233,247,240.0,249.0,14,-35,49
227,20,26,1,12,0,194,265,152,205,197,174,223,187,198,223,169,183,176.0,192.0,14,-54,68
173,21,26,1,12,0,216,307,140,222,205,251,252,248,224,226,202,230,216.0,219.0,28,-24,52
69,22,26,1,12,0,85,102,84,125,116,121,127,86,123,92,77,84,80.0,84.0,7,-15,22
333,1,27,4,12,0,262,80,97,160,113,154,142,142,182,210,219,168,194.0,199.0,-51,9,-60
75,2,27,4,12,0,59,26,35,34,50,78,51,74,46,58,61,81,71.0,67.0,20,3,17
40,3,27,4,12,0,37,22,17,26,37,25,21,17,27,25,23,32,28.0,27.0,9,-2,11
284,4,27,4,12,0,226,93,117,153,137,139,94,88,112,163,169,148,158.0,160.0,-21,6,-27
180,5,27,4,12,0,223,57,76,90,137,164,128,144,184,277,125,154,140.0,185.0,29,-152,181
190,6,27,4,12,0,121,57,59,72,81,74,76,100,108,95,113,95,104.0,101.0,-18,18,-36
338,7,27,4,12,0,199,113,137,218,152,167,149,160,180,268,232,188,210.0,229.0,-44,-36,-8
43,8,27,4,12,0,33,16,10,28,22,76,22,26,27,34,36,30,33.0,33.0,-6,2,-8
254,9,27,4,12,0,384,120,115,231,223,244,188,202,225,232,206,270,238.0,236.0,64,-26,90
48,10,27,4,12,0,40,20,18,18,25,33,31,30,38,53,32,41,36.0,42.0,9,-21,30
693,11,27,4,12,0,591,225,325,414,342,390,329,340,426,503,487,468,478.0,486.0,-19,-16,-3
67,12,27,4,12,0,85,10,18,37,40,39,37,38,50,58,43,56,50.0,52.0,13,-15,28
248,13,27,4,12,0,161,78,99,131,131,102,71,97,118,127,156,140,148.0,141.0,-16,29,-45
148,14,27,4,12,0,163,57,77,90,88,75,84,92,121,128,128,102,115.0,119.0,-26,0,-26
747,15,27,4,12,0,567,168,290,344,386,300,355,415,511,575,426,526,476.0,509.0,100,-149,249
104,16,27,4,12,0,142,48,54,76,88,66,69,75,103,111,77,89,83.0,92.0,12,-34,46
94,17,27,4,12,0,124,41,43,61,74,75,46,72,85,92,69,62,66.0,74.0,-7,-23,16
63,18,27,4,12,0,127,23,28,50,51,59,58,62,64,70,54,58,56.0,61.0,4,-16,20
104,19,27,4,12,0,83,28,38,67,45,65,40,54,75,89,57,75,66.0,74.0,18,-32,50
63,20,27,4,12,0,67,17,20,19,34,34,37,30,40,56,32,56,44.0,48.0,24,-24,48
79,21,27,4,12,0,82,41,52,48,66,99,56,51,90,75,83,64,74.0,74.0,-19,8,-27
30,22,27,4,12,0,45,18,18,48,30,46,28,19,30,30,25,16,20.0,24.0,-9,-5,-4
794,1,28,2,12,0,492,378,283,374,311,427,498,475,609,825,487,659,573.0,657.0,172,-338,510
219,2,28,2,12,0,154,140,101,145,149,178,192,272,277,259,213,219,216.0,230.0,6,-46,52
162,3,28,2,12,0,109,121,79,109,124,169,140,135,176,185,176,166,171.0,176.0,-10,-9,-1
628,4,28,2,12,0,576,511,299,438,522,580,543,591,697,730,557,639,598.0,642.0,82,-173,255
689,5,28,2,12,0,526,495,291,361,444,497,529,571,643,1038,541,610,576.0,730.0,69,-497,566
434,6,28,2,12,0,307,304,148,259,319,271,331,363,453,565,402,464,433.0,477.0,62,-163,225
659,7,28,2,12,0,378,406,284,400,479,557,520,550,741,941,568,645,606.0,718.0,77,-373,450
162,8,28,2,12,0,83,94,61,99,97,93,99,121,177,185,168,164,166.0,172.0,-4,-17,13
1130,9,28,2,12,0,912,598,355,607,642,701,764,756,899,1094,934,958,946.0,995.0,24,-160,184
149,10,28,2,12,0,68,74,33,77,72,113,104,139,145,158,129,132,130.0,140.0,3,-29,32
1571,11,28,2,12,0,1028,993,652,891,910,1046,1085,1159,1451,1727,1253,1408,1330.0,1463.0,155,-474,629
305,12,28,2,12,0,208,200,69,151,150,175,152,209,258,344,206,272,239.0,274.0,66,-138,204
489,13,28,2,12,0,340,342,250,323,382,440,423,438,563,630,455,508,482.0,531.0,53,-175,228
432,14,28,2,12,0,239,290,184,293,341,325,356,405,492,560,422,427,424.0,470.0,5,-138,143
1916,15,28,2,12,0,1300,996,708,969,1088,1209,1284,1524,1958,2180,1479,1666,1572.0,1775.0,187,-701,888
425,16,28,2,12,0,331,334,134,250,279,305,303,339,437,473,371,410,390.0,418.0,39,-102,141
420,17,28,2,12,0,310,284,146,251,271,354,267,331,429,484,339,366,352.0,396.0,27,-145,172
278,18,28,2,12,0,176,229,97,153,164,270,221,253,308,353,274,306,290.0,311.0,32,-79,111
531,19,28,2,12,0,261,256,190,274,317,341,370,440,648,531,397,431,414.0,453.0,34,-134,168
240,20,28,2,12,0,157,115,82,120,97,175,209,162,190,256,142,200,171.0,199.0,58,-114,172
353,21,28,2,12,0,205,223,136,166,239,247,199,284,366,387,357,344,350.0,363.0,-13,-30,17
156,22,28,2,12,0,145,104,92,153,138,145,157,161,240,210,129,159,144.0,166.0,30,-81,111
525,1,29,1,12,0,507,266,214,347,256,335,387,323,471,449,434,528,481.0,470.0,94,-15,109
201,2,29,1,12,0,225,142,99,142,158,164,176,231,206,157,158,222,190.0,179.0,64,1,63
167,3,29,1,12,0,169,76,74,105,133,145,136,151,168,178,179,172,176.0,176.0,-7,1,-8
361,4,29,1,12,0,450,177,170,259,234,290,279,265,274,353,267,381,324.0,334.0,114,-86,200
446,5,29,1,12,0,394,242,224,324,333,361,319,358,452,596,393,398,396.0,462.0,5,-203,208
331,6,29,1,12,0,310,160,139,211,231,217,227,254,298,323,290,307,298.0,307.0,17,-33,50
626,7,29,1,12,0,507,305,251,332,402,428,398,413,574,597,509,607,558.0,571.0,98,-88,186
158,8,29,1,12,0,97,55,43,101,86,111,100,106,169,173,150,174,162.0,166.0,24,-23,47
864,9,29,1,12,0,895,435,271,630,599,641,694,710,772,788,776,849,812.0,804.0,73,-12,85
153,10,29,1,12,0,124,79,66,108,95,119,99,124,137,118,143,133,138.0,131.0,-10,25,-35
1181,11,29,1,12,0,1154,552,589,835,807,903,879,877,1098,1019,1157,1139,1148.0,1105.0,-18,138,-156
242,12,29,1,12,0,178,106,91,145,142,176,146,152,202,227,235,230,232.0,231.0,-5,8,-13
400,13,29,1,12,0,378,179,188,251,302,319,290,307,411,362,402,398,400.0,387.0,-4,40,-44
347,14,29,1,12,0,308,156,143,260,258,238,212,252,290,348,286,346,316.0,327.0,60,-62,122
1499,15,29,1,12,0,1169,550,543,759,841,892,995,1035,1285,1388,1216,1398,1307.0,1334.0,182,-172,354
464,16,29,1,12,0,378,261,177,285,262,281,264,324,372,438,443,366,404.0,416.0,-77,5,-82
386,17,29,1,12,0,309,145,129,251,238,285,222,261,332,310,299,299,299.0,303.0,0,-11,11
287,18,29,1,12,0,293,168,110,183,202,270,233,236,280,255,305,311,308.0,290.0,6,50,-44
206,19,29,1,12,0,213,86,85,121,151,164,140,139,209,233,143,187,165.0,188.0,44,-90,134
156,20,29,1,12,0,130,65,59,92,68,101,131,82,96,144,114,131,122.0,130.0,17,-30,47
158,21,29,1,12,0,174,112,81,131,150,180,137,151,189,198,226,155,190.0,193.0,-71,28,-99
97,22,29,1,12,0,85,44,40,74,82,95,78,104,128,90,82,74,78.0,82.0,-8,-8,0
610,1,30,1,12,0,748,538,251,456,315,445,485,411,558,671,391,672,532.0,578.0,281,-280,561
228,2,30,1,12,0,344,263,166,191,198,263,290,341,252,328,261,267,264.0,285.0,6,-67,73
153,3,30,1,12,0,200,197,109,152,165,213,178,177,172,194,149,185,167.0,176.0,36,-45,81
1126,4,30,1,12,0,1050,755,424,693,651,781,754,805,949,920,743,1158,950.0,940.0,415,-177,592
584,5,30,1,12,0,641,624,348,443,468,502,547,611,673,959,435,590,512.0,661.0,155,-524,679
348,6,30,1,12,0,409,330,200,229,256,264,317,284,317,394,291,394,342.0,360.0,103,-103,206
661,7,30,1,12,0,646,659,309,458,540,534,523,541,632,768,491,603,547.0,621.0,112,-277,389
160,8,30,1,12,0,103,120,44,90,120,136,128,136,187,160,129,168,148.0,152.0,39,-31,70
1586,9,30,1,12,0,1829,1269,499,1006,894,1099,1203,1068,1323,1501,1221,1433,1327.0,1385.0,212,-280,492
210,10,30,1,12,0,255,213,82,152,117,156,149,174,198,193,169,169,169.0,177.0,0,-24,24
1308,11,30,1,12,0,1430,1304,649,954,933,1003,955,1112,1268,1354,983,1276,1130.0,1204.0,293,-371,664
309,12,30,1,12,0,247,282,85,186,198,229,203,249,256,341,219,291,255.0,284.0,72,-122,194
452,13,30,1,12,0,527,425,254,337,412,434,405,458,546,548,398,497,448.0,481.0,99,-150,249
428,14,30,1,12,0,502,442,251,354,426,325,372,375,398,412,339,431,385.0,394.0,92,-73,165
1605,15,30,1,12,0,1500,938,567,836,888,1017,1178,1317,1460,1660,1157,1678,1418.0,1498.0,521,-503,1024
488,16,30,1,12,0,526,572,259,428,363,377,445,438,468,503,382,559,470.0,481.0,177,-121,298
448,17,30,1,12,0,505,374,207,342,370,431,366,451,421,470,359,483,421.0,437.0,124,-111,235
312,18,30,1,12,0,358,335,144,206,194,282,238,262,319,348,276,355,316.0,326.0,79,-72,151
495,19,30,1,12,0,454,281,156,268,293,330,277,371,482,484,306,516,411.0,435.0,210,-178,388
210,20,30,1,12,0,244,199,108,153,121,186,284,146,224,267,164,244,204.0,225.0,80,-103,183
309,21,30,1,12,0,346,325,174,210,225,299,236,330,298,331,274,311,292.0,305.0,37,-57,94
173,22,30,1,12,0,198,139,94,144,137,133,149,128,210,136,95,172,134.0,134.0,77,-41,118
648,1,31,2,12,0,576,543,384,696,487,649,633,685,664,518,503,567,535.0,529.0,64,-15,79
281,2,31,2,12,0,257,243,199,312,234,314,249,292,267,233,166,210,188.0,203.0,44,-67,111
89,3,31,2,12,0,80,54,43,84,76,64,93,74,68,76,58,71,64.0,68.0,13,-18,31
696,4,31,2,12,0,816,536,311,688,527,617,587,668,640,578,411,581,496.0,523.0,170,-167,337
580,5,31,2,12,0,593,591,337,640,478,571,603,551,645,659,365,510,438.0,511.0,145,-294,439
466,6,31,2,12,0,385,322,230,435,350,391,362,386,364,400,336,325,330.0,354.0,-11,-64,53
491,7,31,2,12,0,440,468,289,622,538,593,498,535,586,540,332,443,388.0,438.0,111,-208,319
89,8,31,2,12,0,103,57,64,78,79,91,70,76,114,91,72,83,78.0,82.0,11,-19,30
1468,9,31,2,12,0,1319,1274,618,1449,1061,1394,1469,1265,1360,1372,1116,1163,1140.0,1217.0,47,-256,303
185,10,31,2,12,0,167,115,84,164,123,176,156,157,172,190,125,138,132.0,151.0,13,-65,78
1432,11,31,2,12,0,1160,1203,919,1681,1193,1428,1269,1375,1458,1073,894,1153,1024.0,1040.0,259,-179,438
230,12,31,2,12,0,200,185,89,224,198,224,201,206,230,203,138,173,156.0,171.0,35,-65,100
380,13,31,2,12,0,283,417,232,460,496,484,423,463,437,409,277,360,318.0,349.0,83,-132,215
390,14,31,2,12,0,350,258,224,388,425,429,397,410,418,393,275,329,302.0,332.0,54,-118,172
2059,15,31,2,12,0,1724,1540,1004,2273,1596,1876,1650,1852,1906,1579,1310,1686,1498.0,1525.0,376,-269,645
325,16,31,2,12,0,283,271,143,325,266,300,353,314,383,331,242,312,277.0,295.0,70,-89,159
430,17,31,2,12,0,374,375,195,380,321,402,363,372,409,397,243,350,296.0,330.0,107,-154,261
320,18,31,2,12,0,346,352,161,369,304,419,307,353,366,384,305,333,319.0,341.0,28,-79,107
246,19,31,2,12,0,186,215,146,225,256,285,240,260,305,212,189,228,208.0,210.0,39,-23,62
248,20,31,2,12,0,253,198,131,290,195,274,315,277,268,213,164,247,206.0,208.0,83,-49,132
234,21,31,2,12,0,174,188,135,235,193,286,212,215,219,199,188,186,187.0,191.0,-2,-11,9
86,22,31,2,12,0,76,70,44,104,104,97,90,78,104,69,44,94,69.0,69.0,50,-25,75
395,1,32,3,12,0,825,333,136,253,217,192,208,169,209,261,157,325,241.0,248.0,168,-104,272
908,2,32,3,12,0,1393,1050,634,598,559,552,559,568,496,633,817,622,720.0,691.0,-195,184,-379
222,3,32,3,12,0,405,185,132,207,141,156,128,146,189,194,188,211,200.0,198.0,23,-6,29
164,4,32,3,12,0,852,178,127,199,127,128,132,116,105,91,84,126,105.0,100.0,42,-7,49
589,5,32,3,12,0,1509,1063,565,512,413,385,387,456,447,479,394,423,408.0,432.0,29,-85,114
1540,6,32,3,12,0,2601,1965,1072,936,771,749,842,897,904,1032,1004,994,999.0,1010.0,-10,-28,18
3244,7,32,3,12,0,5360,2858,1598,1729,1694,1756,1539,1936,1912,2146,2072,2048,2060.0,2089.0,-24,-74,50
839,8,32,3,12,0,1442,701,396,447,437,462,390,470,484,542,537,572,554.0,550.0,35,-5,40
4687,9,32,3,12,0,8421,3465,1872,3263,2465,2754,2779,2551,2831,3372,3213,3185,3199.0,3257.0,-28,-159,131
3603,10,32,3,12,0,6171,2981,1510,1845,1206,1444,1326,1376,2120,1771,1953,1932,1942.0,1885.0,-21,182,-203
2577,11,32,3,12,0,3757,2028,1542,1465,1325,1301,1251,1387,1382,1410,1551,1529,1540.0,1497.0,-22,141,-163
707,12,32,3,12,0,1319,827,443,434,359,341,393,389,426,463,502,520,511.0,495.0,18,39,-21
2104,13,32,3,12,0,2863,1366,1047,1021,1146,1168,1072,1294,1269,1276,1339,1412,1376.0,1342.0,73,63,10
5667,14,32,3,12,0,9539,6024,2842,2528,2423,2523,2603,3162,2973,3080,3382,3241,3312.0,3234.0,-141,302,-443
1628,15,32,3,12,0,2646,934,580,745,680,733,621,813,822,894,995,1020,1008.0,970.0,25,101,-76
719,16,32,3,12,0,1629,1137,521,524,406,468,397,454,447,595,540,450,495.0,528.0,-90,-55,-35
1368,17,32,3,12,0,2352,1658,771,808,663,615,657,743,779,889,856,851,854.0,865.0,-5,-33,28
493,18,32,3,12,0,1086,453,316,456,314,359,319,319,322,371,355,542,448.0,423.0,187,-16,203
911,19,32,3,12,0,1039,408,313,505,468,482,534,500,483,512,500,698,599.0,570.0,198,-12,210
244,20,32,3,12,0,514,324,210,169,172,136,158,183,160,169,141,157,149.0,156.0,16,-28,44
1112,21,32,3,12,0,1704,937,403,499,452,488,436,535,576,634,679,692,686.0,668.0,13,45,-32
668,22,32,3,12,0,1045,394,365,562,482,469,565,521,543,559,428,606,517.0,531.0,178,-131,309
1335,1,33,2,12,0,1483,389,338,505,521,647,608,619,726,770,537,944,740.0,750.0,407,-233,640
451,2,33,2,12,0,567,208,160,208,214,226,198,297,263,248,248,339,294.0,278.0,91,0,91
646,3,33,2,12,0,789,413,215,340,311,387,355,326,370,370,413,451,432.0,411.0,38,43,-5
127,4,33,2,12,0,488,143,102,126,84,102,87,71,101,86,53,85,69.0,75.0,32,-33,65
1310,5,33,2,12,0,1117,531,374,577,521,559,581,527,664,831,558,780,669.0,723.0,222,-273,495
680,6,33,2,12,0,705,385,198,241,246,257,285,305,420,360,450,462,456.0,424.0,12,90,-78
1682,7,33,2,12,0,1707,803,424,738,843,928,824,912,1138,1251,1154,1149,1152.0,1185.0,-5,-97,92
508,8,33,2,12,0,464,131,87,174,169,231,178,188,345,260,267,296,282.0,274.0,29,7,22
352,9,33,2,12,0,475,130,117,221,195,239,246,184,249,327,211,291,251.0,276.0,80,-116,196
153,10,33,2,12,0,231,93,43,77,54,89,79,95,76,109,105,108,106.0,107.0,3,-4,7
2275,11,33,2,12,0,2181,991,782,1094,1007,1280,1090,1058,1318,1361,1434,1500,1467.0,1432.0,66,73,-7
660,12,33,2,12,0,495,251,128,183,180,217,188,232,281,331,328,426,377.0,362.0,98,-3,101
1339,13,33,2,12,0,1229,546,360,592,598,847,611,670,860,765,645,710,678.0,707.0,65,-120,185
1234,14,33,2,12,0,1053,508,259,492,410,471,586,659,755,577,697,765,731.0,680.0,68,120,-52
1267,15,33,2,12,0,1213,348,291,556,450,632,576,610,714,681,755,881,818.0,772.0,126,74,52
442,16,33,2,12,0,440,200,80,136,138,174,236,210,228,238,222,273,248.0,244.0,51,-16,67
847,17,33,2,12,0,749,385,150,254,224,307,284,328,398,464,369,463,416.0,432.0,94,-95,189
451,18,33,2,12,0,408,188,136,178,176,297,240,200,252,252,280,302,291.0,278.0,22,28,-6
161,19,33,2,12,0,210,53,54,81,84,109,71,94,144,110,80,102,91.0,97.0,22,-30,52
244,20,33,2,12,0,295,131,85,113,117,117,161,107,136,118,97,128,112.0,114.0,31,-21,52
1617,21,33,2,12,0,1286,412,280,531,610,649,548,736,763,674,958,1013,986.0,882.0,55,284,-229
168,22,33,2,12,0,228,66,80,160,104,150,105,113,153,106,123,117,120.0,115.0,-6,17,-23
485,1,34,2,12,0,679,950,175,263,226,214,231,1376,364,429,271,431,351.0,377.0,160,-158,318
197,2,34,2,12,0,293,131,118,135,108,106,85,183,133,193,170,219,194.0,194.0,49,-23,72
95,3,34,2,12,0,118,60,38,63,48,62,45,54,52,67,84,86,85.0,79.0,2,17,-15
112,4,34,2,12,0,280,180,87,167,105,117,108,135,120,201,105,148,126.0,151.0,43,-96,139
273,5,34,2,12,0,404,151,140,210,163,126,156,158,240,401,151,299,225.0,284.0,148,-250,398
203,6,34,2,12,0,201,116,64,85,74,80,96,91,141,190,131,225,178.0,182.0,94,-59,153
430,7,34,2,12,0,451,230,146,276,296,237,243,266,313,411,311,495,403.0,406.0,184,-100,284
101,8,34,2,12,0,95,42,23,68,34,43,37,45,67,94,54,109,82.0,86.0,55,-40,95
199,9,34,2,12,0,268,104,54,144,101,111,106,100,115,132,132,135,134.0,133.0,3,0,3
59,10,34,2,12,0,71,30,28,32,17,42,31,35,34,44,32,40,36.0,39.0,8,-12,20
651,11,34,2,12,0,669,334,279,388,278,361,289,335,427,537,405,723,564.0,555.0,318,-132,450
100,12,34,2,12,0,86,64,32,40,53,58,44,58,62,97,53,129,91.0,93.0,76,-44,120
304,13,34,2,12,0,272,140,97,162,151,190,159,151,222,288,202,316,259.0,269.0,114,-86,200
337,14,34,2,12,0,319,144,90,156,142,133,159,150,253,275,177,360,268.0,271.0,183,-98,281
533,15,34,2,12,0,452,190,120,235,179,236,184,200,265,399,223,510,366.0,377.0,287,-176,463
89,16,34,2,12,0,82,146,33,61,41,44,47,128,75,99,64,118,91.0,94.0,54,-35,89
199,17,34,2,12,0,228,105,59,115,89,71,92,97,142,167,127,193,160.0,162.0,66,-40,106
116,18,34,2,12,0,139,77,43,64,62,76,55,207,71,81,95,102,98.0,93.0,7,14,-7
54,19,34,2,12,0,81,42,40,28,19,48,46,42,41,57,41,66,54.0,55.0,25,-16,41
135,20,34,2,12,0,87,44,31,56,52,34,81,74,75,97,76,133,104.0,102.0,57,-21,78
159,21,34,2,12,0,238,124,83,169,151,120,99,145,151,182,131,211,171.0,175.0,80,-51,131
43,22,34,2,12,0,48,22,17,60,50,40,34,50,39,45,36,50,43.0,44.0,14,-9,23
249,1,35,2,12,0,317,238,124,175,178,198,247,172,229,295,178,186,182.0,220.0,8,-117,125
104,2,35,2,12,0,94,64,55,50,58,59,74,82,64,64,71,93,82.0,76.0,22,7,15
105,3,35,2,12,0,114,119,58,88,84,113,93,124,126,127,119,94,106.0,113.0,-25,-8,-17
620,4,35,2,12,0,954,488,303,463,422,404,405,524,536,639,464,491,478.0,531.0,27,-175,202
471,5,35,2,12,0,560,493,212,308,310,321,356,354,476,541,437,373,405.0,450.0,-64,-104,40
258,6,35,2,12,0,192,238,108,126,152,161,181,221,244,275,225,225,225.0,242.0,0,-50,50
861,7,35,2,12,0,714,609,352,736,802,743,732,752,968,895,828,667,748.0,797.0,-161,-67,-94
234,8,35,2,12,0,230,168,75,152,133,162,155,176,214,192,218,193,206.0,201.0,-25,26,-51
2769,9,35,2,12,0,1893,1283,554,1157,1342,1371,1506,1365,1632,2543,2393,1966,2180.0,2301.0,-427,-150,-277
419,10,35,2,12,0,333,316,132,218,179,232,209,214,240,299,302,319,310.0,307.0,17,3,14
1053,11,35,2,12,0,865,785,520,701,575,790,696,727,808,884,890,866,878.0,880.0,-24,6,-30
328,12,35,2,12,0,280,264,100,195,178,199,185,190,228,334,263,249,256.0,282.0,-14,-71,57
591,13,35,2,12,0,454,387,248,489,372,444,470,561,546,540,446,469,458.0,485.0,23,-94,117
360,14,35,2,12,0,300,319,141,195,250,224,252,313,287,373,278,291,284.0,314.0,13,-95,108
883,15,35,2,12,0,787,577,391,567,562,623,668,663,739,794,766,751,758.0,770.0,-15,-28,13
676,16,35,2,12,0,566,545,193,390,310,389,475,504,667,583,520,592,556.0,565.0,72,-63,135
513,17,35,2,12,0,412,412,410,531,262,352,341,399,402,522,391,380,386.0,431.0,-11,-131,120
678,18,35,2,12,0,562,555,242,485,658,692,517,589,652,643,659,727,693.0,676.0,68,16,52
328,19,35,2,12,0,340,230,163,328,229,232,286,261,346,342,250,273,262.0,288.0,23,-92,115
412,20,35,2,12,0,846,378,203,261,239,256,499,348,265,359,273,292,282.0,308.0,19,-86,105
227,21,35,2,12,0,126,138,68,103,103,121,139,167,222,209,183,176,180.0,189.0,-7,-26,19
90,22,35,2,12,0,107,57,72,88,195,88,95,117,126,705,86,104,95.0,298.0,18,-619,637
252,1,36,1,12,0,374,264,140,173,111,133,219,252,305,253,189,224,206.0,222.0,35,-64,99
400,2,36,1,12,0,423,403,246,278,240,349,251,370,328,322,342,384,363.0,349.0,42,20,22
578,3,36,1,12,0,619,534,251,398,363,397,446,439,554,594,520,540,530.0,551.0,20,-74,94
747,4,36,1,12,0,1441,741,459,672,521,645,648,738,710,716,555,804,680.0,692.0,249,-161,410
896,5,36,1,12,0,1078,940,507,616,610,516,696,747,853,964,787,750,768.0,834.0,-37,-177,140
302,6,36,1,12,0,273,247,107,152,149,170,178,202,240,274,256,234,245.0,255.0,-22,-18,-4
1000,7,36,1,12,0,1011,688,350,548,657,631,628,667,792,970,906,824,865.0,900.0,-82,-64,-18
427,8,36,1,12,0,348,274,115,219,218,272,224,246,326,337,407,371,389.0,372.0,-36,70,-106
2378,9,36,1,12,0,2562,1849,777,1549,1067,1547,1898,1873,2104,2281,2270,2201,2236.0,2251.0,-69,-11,-58
383,10,36,1,12,0,443,364,194,278,172,226,248,272,340,365,351,360,356.0,359.0,9,-14,23
750,11,36,1,12,0,857,658,425,546,407,545,534,592,698,728,718,580,649.0,675.0,-138,-10,-128
363,12,36,1,12,0,382,334,121,180,176,242,230,289,241,378,316,286,301.0,327.0,-30,-62,32
1203,13,36,1,12,0,1042,804,407,572,721,849,721,962,1094,1052,1033,1012,1022.0,1032.0,-21,-19,-2
892,14,36,1,12,0,656,654,303,427,422,450,484,638,714,768,669,651,660.0,696.0,-18,-99,81
820,15,36,1,12,0,970,632,338,464,407,503,544,617,739,738,663,674,668.0,692.0,11,-75,86
1482,16,36,1,12,0,1458,1429,526,890,740,929,1121,1218,1196,1452,1245,1203,1224.0,1300.0,-42,-207,165
749,17,36,1,12,0,879,712,262,444,376,475,496,530,587,687,558,506,532.0,584.0,-52,-129,77
401,18,36,1,12,0,523,387,223,336,237,399,355,340,322,385,473,382,428.0,413.0,-91,88,-179
1011,19,36,1,12,0,1105,571,424,658,595,611,583,678,909,852,761,829,795.0,814.0,68,-91,159
591,20,36,1,12,0,732,616,327,364,351,290,544,368,383,473,447,430,438.0,450.0,-17,-26,9
635,21,36,1,12,0,618,561,288,381,522,505,419,505,615,617,643,476,560.0,579.0,-167,26,-193
508,22,36,1,12,0,497,267,165,333,307,314,331,413,428,410,378,440,409.0,409.0,62,-32,94
180,1,37,2,12,0,237,68,37,61,48,42,46,60,56,89,75,92,84.0,85.0,17,-14,31
275,2,37,2,12,0,271,140,100,100,97,72,92,101,116,117,159,182,170.0,153.0,23,42,-19
211,3,37,2,12,0,195,78,54,74,78,87,84,89,105,134,146,180,163.0,153.0,34,12,22
105,4,37,2,12,0,205,34,44,59,36,32,45,41,40,42,48,82,65.0,57.0,34,6,28
654,5,37,2,12,0,560,275,186,178,154,123,197,155,287,297,268,393,330.0,319.0,125,-29,154
376,6,37,2,12,0,496,209,109,109,97,103,125,123,120,141,192,188,190.0,174.0,-4,51,-55
574,7,37,2,12,0,599,241,156,188,181,193,211,187,260,255,349,312,330.0,305.0,-37,94,-131
214,8,37,2,12,0,226,67,52,65,70,76,81,82,108,105,132,143,138.0,127.0,11,27,-16
1862,9,37,2,12,0,1753,510,290,467,429,504,568,492,615,692,978,1185,1082.0,952.0,207,286,-79
372,10,37,2,12,0,314,161,76,113,66,89,103,111,120,142,206,230,218.0,193.0,24,64,-40
995,11,37,2,12,0,1176,484,399,360,358,395,364,346,423,460,571,596,584.0,542.0,25,111,-86
521,12,37,2,12,0,556,258,99,139,120,123,138,130,192,210,317,296,306.0,274.0,-21,107,-128
523,13,37,2,12,0,435,164,126,133,165,184,178,191,217,243,293,344,318.0,293.0,51,50,1
819,14,37,2,12,0,562,252,130,136,161,188,248,234,365,372,457,425,441.0,418.0,-32,85,-117
1015,15,37,2,12,0,1102,332,255,331,293,293,451,433,549,507,551,587,569.0,548.0,36,44,-8
368,16,37,2,12,0,526,267,110,92,100,79,129,117,148,188,203,243,223.0,211.0,40,15,25
656,17,37,2,12,0,627,286,115,133,96,119,133,162,229,236,300,359,330.0,298.0,59,64,-5
409,18,37,2,12,0,500,185,128,160,130,141,134,138,134,168,231,259,245.0,219.0,28,63,-35
386,19,37,2,12,0,299,101,86,133,111,127,127,138,164,160,216,222,219.0,199.0,6,56,-50
230,20,37,2,12,0,317,179,87,70,59,80,101,84,95,112,155,125,140.0,131.0,-30,43,-73
186,21,37,2,12,0,242,89,58,62,55,62,48,76,86,87,115,113,114.0,105.0,-2,28,-30
161,22,37,2,12,0,126,60,44,65,66,61,78,87,93,69,84,113,98.0,89.0,29,15,14
454,1,38,2,12,0,571,175,135,300,320,311,280,332,341,475,288,330,309.0,364.0,42,-187,229
438,2,38,2,12,0,393,160,154,201,154,174,208,237,210,296,354,527,440.0,392.0,173,58,115
736,3,38,2,12,0,631,236,164,278,287,352,354,352,396,368,451,533,492.0,451.0,82,83,-1
489,4,38,2,12,0,980,232,253,315,319,299,344,411,421,374,323,378,350.0,358.0,55,-51,106
1713,5,38,2,12,0,1536,609,478,708,677,703,870,874,1179,1263,1119,1083,1101.0,1155.0,-36,-144,108
951,6,38,2,12,0,750,358,257,522,447,450,474,531,638,743,737,778,758.0,753.0,41,-6,47
3961,7,38,2,12,0,5481,1788,1203,1635,2012,1985,2046,2150,2770,3225,3176,2804,2990.0,3068.0,-372,-49,-323
2044,8,38,2,12,0,1474,502,371,567,626,775,870,822,1077,1141,1396,1289,1342.0,1275.0,-107,255,-362
12138,9,38,2,12,0,15317,5306,3718,8079,6812,7957,8612,8119,10514,11327,10929,10485,10707.0,10914.0,-444,-398,-46
2963,10,38,2,12,0,2693,1195,777,1366,1087,1463,1613,1736,2291,2448,2230,2157,2194.0,2278.0,-73,-218,145
3369,11,38,2,12,0,3296,1247,1529,2148,2087,2259,2343,2472,2603,2698,2915,2532,2724.0,2715.0,-383,217,-600
1982,12,38,2,12,0,1764,857,484,797,835,979,1050,1189,1342,1563,1467,1393,1430.0,1474.0,-74,-96,22
3609,13,38,2,12,0,3796,1214,995,1259,1697,1832,1815,2279,2449,2337,2523,2518,2520.0,2459.0,-5,186,-191
3105,14,38,2,12,0,3130,1278,848,1290,1492,1391,1525,1910,2272,2311,2004,1999,2002.0,2105.0,-5,-307,302
2419,15,38,2,12,0,2088,700,801,1246,1369,1509,1644,1767,1896,1932,1907,1935,1921.0,1925.0,28,-25,53
2165,16,38,2,12,0,1562,736,376,772,827,842,1061,1101,1051,1206,1327,1303,1315.0,1279.0,-24,121,-145
2417,17,38,2,12,0,3168,1244,677,1105,1093,1503,1476,1786,1858,2160,1767,1696,1732.0,1874.0,-71,-393,322
1920,18,38,2,12,0,1981,769,598,1058,945,1316,1163,1316,1476,1544,1688,1572,1630.0,1601.0,-116,144,-260
3014,19,38,2,12,0,3705,1059,1132,1642,1541,1606,1822,1931,2151,2147,2045,2285,2165.0,2159.0,240,-102,342
866,20,38,2,12,0,828,333,235,331,330,400,708,364,385,467,671,547,609.0,562.0,-124,204,-328
642,21,38,2,12,0,722,289,175,287,284,326,299,382,387,425,432,390,411.0,416.0,-42,7,-49
1521,22,38,2,12,0,1064,350,347,604,509,589,621,701,1075,927,822,1104,963.0,951.0,282,-105,387
405,1,39,1,12,0,272,250,161,224,213,175,131,62,223,288,334,333,334.0,318.0,-1,46,-47
555,2,39,1,12,0,383,494,162,297,298,329,209,81,389,480,466,533,500.0,493.0,67,-14,81
507,3,39,1,12,0,374,412,213,364,399,353,232,84,339,393,355,458,406.0,402.0,103,-38,141
676,4,39,1,12,0,798,336,255,324,347,230,135,126,317,411,461,689,575.0,520.0,228,50,178
649,5,39,1,12,0,502,560,198,280,354,296,108,64,382,522,529,642,586.0,564.0,113,7,106
681,6,39,1,12,0,449,378,228,339,365,359,86,125,393,488,570,622,596.0,560.0,52,82,-30
1640,7,39,1,12,0,1083,1132,648,948,1214,1085,369,273,1000,1192,1241,1423,1332.0,1285.0,182,49,133
723,8,39,1,12,0,454,373,276,370,403,345,137,148,396,551,467,595,531.0,538.0,128,-84,212
4066,9,39,1,12,0,3119,2859,1337,2735,2621,2524,1566,594,2431,2956,3252,3829,3540.0,3346.0,577,296,281
481,10,39,1,12,0,316,376,154,306,255,297,140,103,277,336,389,407,398.0,377.0,18,53,-35
1390,11,39,1,12,0,1057,1012,579,905,787,820,405,226,838,926,1064,1203,1134.0,1064.0,139,138,1
576,12,39,1,12,0,414,397,195,355,439,342,151,95,317,402,446,437,442.0,428.0,-9,44,-53
1370,13,39,1,12,0,778,797,602,842,1066,971,374,253,922,911,1078,1205,1142.0,1065.0,127,167,-40
1705,14,39,1,12,0,1154,954,596,986,1159,919,330,428,1111,1295,1278,1512,1395.0,1362.0,234,-17,251
1341,15,39,1,12,0,819,752,388,650,682,669,277,191,789,847,1023,1105,1064.0,992.0,82,176,-94
2055,16,39,1,12,0,1497,1405,549,1164,1131,1057,674,316,1053,1385,1304,1723,1514.0,1471.0,419,-81,500
911,17,39,1,12,0,953,623,341,556,689,570,218,194,551,712,695,816,756.0,741.0,121,-17,138
796,18,39,1,12,0,611,627,347,556,479,612,226,137,543,591,622,700,661.0,638.0,78,31,47
1243,19,39,1,12,0,851,758,485,709,730,631,387,271,733,853,891,1081,986.0,942.0,190,38,152
322,20,39,1,12,0,208,248,87,111,125,128,35,39,154,285,243,301,272.0,276.0,58,-42,100
587,21,39,1,12,0,482,463,229,331,386,360,198,125,357,434,525,578,552.0,512.0,53,91,-38
814,22,39,1,12,0,549,617,346,607,485,461,268,130,519,630,543,729,636.0,634.0,186,-87,273
229,1,40,1,12,0,456,114,153,205,172,211,259,235,234,227,143,177,160.0,182.0,34,-84,118
309,2,40,1,12,0,442,406,203,364,347,383,359,548,448,420,225,359,292.0,335.0,134,-195,329
246,3,40,1,12,0,382,195,193,311,298,379,324,426,353,305,214,215,214.0,245.0,1,-91,92
257,4,40,1,12,0,580,121,115,186,128,156,127,143,113,150,121,198,160.0,156.0,77,-29,106
424,5,40,1,12,0,804,459,234,390,378,467,472,512,561,494,291,364,328.0,383.0,73,-203,276
457,6,40,1,12,0,503,403,244,376,434,485,530,589,548,523,287,377,332.0,396.0,90,-236,326
713,7,40,1,12,0,1164,554,505,703,953,906,900,978,952,895,531,700,616.0,709.0,169,-364,533
361,8,40,1,12,0,428,223,193,301,299,310,314,437,371,333,194,278,236.0,268.0,84,-139,223
2412,9,40,1,12,0,3730,1930,1262,2615,2284,2880,3003,3073,3157,2906,1622,2189,1906.0,2239.0,567,-1284,1851
313,10,40,1,12,0,417,266,187,309,304,370,332,440,396,386,211,275,243.0,291.0,64,-175,239
1015,11,40,1,12,0,1527,877,754,1069,1130,1243,1239,1359,1276,1127,677,913,795.0,906.0,236,-450,686
374,12,40,1,12,0,507,305,161,323,377,500,498,505,477,346,244,301,272.0,297.0,57,-102,159
612,13,40,1,12,0,797,453,434,572,723,877,842,1076,876,738,454,591,522.0,594.0,137,-284,421
867,14,40,1,12,0,1036,630,391,702,797,764,826,1251,974,822,486,743,614.0,684.0,257,-336,593
1000,15,40,1,12,0,1258,739,529,861,969,1092,1188,1336,1191,1013,688,900,794.0,867.0,212,-325,537
962,16,40,1,12,0,1511,963,454,719,775,822,1002,1247,1129,844,697,736,716.0,759.0,39,-147,186
440,17,40,1,12,0,737,420,189,443,430,470,484,597,615,466,266,399,332.0,377.0,133,-200,333
497,18,40,1,12,0,779,473,353,640,561,659,677,791,724,521,382,471,426.0,458.0,89,-139,228
510,19,40,1,12,0,602,285,241,431,475,512,466,627,589,508,353,426,390.0,429.0,73,-155,228
155,20,40,1,12,0,305,185,95,179,155,153,233,211,194,180,134,160,147.0,158.0,26,-46,72
287,21,40,1,12,0,496,293,157,234,292,346,246,352,406,274,153,229,191.0,219.0,76,-121,197
353,22,40,1,12,0,422,214,206,322,309,385,388,444,380,359,210,246,228.0,272.0,36,-149,185
194,1,41,3,12,0,348,224,140,212,313,130,176,126,150,183,117,199,158.0,166.0,82,-66,148
12,2,41,3,12,0,33,19,19,18,22,20,12,9,9,13,11,17,14.0,14.0,6,-2,8
27,3,41,3,12,0,22,21,19,29,36,17,19,26,22,19,25,21,23.0,22.0,-4,6,-10
216,4,41,3,12,0,511,424,244,378,320,244,260,250,268,314,181,257,219.0,251.0,76,-133,209
40,5,41,3,12,0,64,69,42,47,33,29,34,13,37,22,23,31,27.0,25.0,8,1,7
57,6,41,3,12,0,75,83,59,59,57,45,62,31,45,37,42,61,52.0,47.0,19,5,14
293,7,41,3,12,0,341,430,189,295,303,192,237,256,222,242,190,268,229.0,233.0,78,-52,130
97,8,41,3,12,0,78,105,64,83,78,62,75,85,83,109,96,93,94.0,99.0,-3,-13,10
847,9,41,3,12,0,1235,1009,443,848,749,579,865,757,844,906,781,910,846.0,866.0,129,-125,254
20,10,41,3,12,0,26,34,17,20,12,20,22,16,21,17,17,20,18.0,18.0,3,0,3
325,11,41,3,12,0,481,397,258,351,301,241,305,301,319,353,284,342,313.0,326.0,58,-69,127
32,12,41,3,12,0,37,61,16,26,40,25,30,32,20,29,23,32,28.0,28.0,9,-6,15
223,13,41,3,12,0,316,308,172,236,271,218,215,233,230,258,218,226,222.0,234.0,8,-40,48
148,14,41,3,12,0,209,242,134,155,146,105,140,155,161,153,126,142,134.0,140.0,16,-27,43
471,15,41,3,12,0,375,353,222,270,371,311,449,354,283,365,291,299,295.0,318.0,8,-74,82
47,16,41,3,12,0,62,54,47,52,51,39,64,44,59,48,34,63,48.0,48.0,29,-14,43
27,17,41,3,12,0,44,54,26,27,28,26,30,22,38,28,29,40,34.0,32.0,11,1,10
58,18,41,3,12,0,105,92,41,56,43,37,75,57,57,54,58,65,62.0,59.0,7,4,3
127,19,41,3,12,0,187,158,103,124,129,115,148,126,163,128,97,127,112.0,117.0,30,-31,61
21,20,41,3,12,0,27,22,12,27,12,19,15,18,21,16,10,19,14.0,15.0,9,-6,15
20,21,41,3,12,0,46,61,16,38,37,27,23,27,20,22,12,31,22.0,22.0,19,-10,29
37,22,41,3,12,0,65,66,41,61,62,37,56,42,70,58,32,39,36.0,43.0,7,-26,33
333,1,42,1,12,0,369,161,142,190,140,165,214,189,313,284,306,224,265.0,271.0,-82,22,-104
333,2,42,1,12,0,651,386,202,309,233,292,232,382,379,387,509,302,406.0,399.0,-207,122,-329
161,3,42,1,12,0,234,146,90,139,127,131,111,141,187,208,204,142,173.0,185.0,-62,-4,-58
272,4,42,1,12,0,382,210,141,181,149,153,130,100,130,167,151,159,155.0,159.0,8,-16,24
508,5,42,1,12,0,839,509,240,360,342,344,334,430,617,773,547,429,488.0,583.0,-118,-226,108
330,6,42,1,12,0,690,387,163,254,266,293,273,348,415,368,351,286,318.0,335.0,-65,-17,-48
970,7,42,1,12,0,964,444,303,464,570,555,507,649,847,877,968,697,832.0,847.0,-271,91,-362
284,8,42,1,12,0,443,175,132,238,204,221,191,257,331,373,351,213,282.0,312.0,-138,-22,-116
3599,9,42,1,12,0,5547,3229,1517,2906,3040,2996,3064,2940,3296,3858,4197,3592,3894.0,3882.0,-605,339,-944
345,10,42,1,12,0,665,381,181,321,247,278,230,271,353,423,346,374,360.0,381.0,28,-77,105
959,11,42,1,12,0,1139,690,508,722,614,698,656,855,923,861,961,683,822.0,835.0,-278,100,-378
358,12,42,1,12,0,625,381,184,276,300,321,252,286,354,387,280,246,263.0,304.0,-34,-107,73
757,13,42,1,12,0,830,407,320,433,514,507,400,601,794,756,775,544,660.0,692.0,-231,19,-250
509,14,42,1,12,0,920,507,247,499,530,473,405,626,853,641,609,449,529.0,566.0,-160,-32,-128
1215,15,42,1,12,0,1424,732,558,806,842,817,859,969,1255,1091,1244,748,996.0,1028.0,-496,153,-649
730,16,42,1,12,0,1347,698,270,511,498,504,540,672,774,908,619,630,624.0,719.0,11,-289,300
557,17,42,1,12,0,988,570,203,418,421,498,401,577,729,628,544,384,464.0,519.0,-160,-84,-76
644,18,42,1,12,0,1043,605,368,580,595,656,635,615,765,815,822,678,750.0,772.0,-144,7,-151
542,19,42,1,12,0,600,253,193,341,357,363,293,369,581,567,618,502,560.0,562.0,-116,51,-167
183,20,42,1,12,0,229,139,105,116,140,127,159,132,163,253,237,225,231.0,238.0,-12,-16,4
185,21,42,1,12,0,293,140,96,140,126,155,135,199,252,297,330,178,254.0,268.0,-152,33,-185
251,22,42,1,12,0,322,111,123,264,218,232,182,233,390,264,192,239,216.0,232.0,47,-72,119
462,1,43,2,12,0,516,264,193,369,368,312,223,311,325,374,342,377,360.0,364.0,35,-32,67
141,2,43,2,12,0,253,206,111,144,116,120,119,120,92,116,114,130,122.0,120.0,16,-2,18
254,3,43,2,12,0,238,219,114,172,145,184,185,176,175,180,177,210,194.0,189.0,33,-3,36
498,4,43,2,12,0,1094,601,390,482,397,375,385,359,390,493,438,628,533.0,520.0,190,-55,245
475,5,43,2,12,0,543,391,237,325,296,251,270,231,353,472,247,331,289.0,350.0,84,-225,309
437,6,43,2,12,0,578,495,153,185,233,254,279,190,233,316,289,283,286.0,296.0,-6,-27,21
1080,7,43,2,12,0,1221,1031,476,846,727,791,753,709,746,888,910,988,949.0,929.0,78,22,56
495,8,43,2,12,0,605,316,221,369,335,297,249,379,331,458,381,376,378.0,405.0,-5,-77,72
2800,9,43,2,12,0,3747,2666,1125,2377,2460,2143,2250,2148,2251,2790,2698,2999,2848.0,2829.0,301,-92,393
152,10,43,2,12,0,174,193,92,119,101,114,104,103,130,136,127,131,129.0,131.0,4,-9,13
1164,11,43,2,12,0,1524,1070,552,1008,901,895,803,803,813,980,1039,1098,1068.0,1039.0,59,59,0
262,12,43,2,12,0,409,346,81,166,179,201,165,187,208,207,235,216,226.0,219.0,-19,28,-47
985,13,43,2,12,0,1119,789,422,734,762,790,652,806,800,941,861,973,917.0,925.0,112,-80,192
795,14,43,2,12,0,866,692,326,488,531,450,448,469,417,510,471,591,531.0,524.0,120,-39,159
1724,15,43,2,12,0,1515,1138,549,969,1010,1108,1385,1507,1239,1522,1512,1557,1534.0,1530.0,45,-10,55
653,16,43,2,12,0,906,749,253,446,434,381,436,412,489,521,449,482,466.0,484.0,33,-72,105
628,17,43,2,12,0,839,710,238,437,402,430,431,398,373,459,387,452,420.0,433.0,65,-72,137
487,18,43,2,12,0,638,509,288,542,508,519,527,327,322,360,452,513,482.0,442.0,61,92,-31
1150,19,43,2,12,0,1395,898,506,962,872,971,851,914,875,950,831,1106,968.0,962.0,275,-119,394
180,20,43,2,12,0,213,159,106,164,130,104,160,133,125,141,144,162,153.0,149.0,18,3,15
296,21,43,2,12,0,371,227,159,225,195,179,129,173,160,195,208,237,222.0,213.0,29,13,16
573,22,43,2,12,0,783,366,217,537,358,448,306,533,522,375,424,571,498.0,457.0,147,49,98
270,1,44,1,12,0,291,260,125,252,169,218,208,195,239,288,307,317,312.0,304.0,10,19,-9
57,2,44,1,12,0,95,78,48,59,48,61,43,79,64,53,60,89,74.0,67.0,29,7,22
47,3,44,1,12,0,64,35,18,51,53,69,55,61,64,72,82,60,71.0,71.0,-22,10,-32
290,4,44,1,12,0,739,435,233,445,341,391,396,426,482,578,448,408,428.0,478.0,-40,-130,90
209,5,44,1,12,0,296,270,133,178,212,190,231,208,233,444,241,312,276.0,332.0,71,-203,274
113,6,44,1,12,0,125,156,59,89,69,81,70,72,75,150,124,107,116.0,127.0,-17,-26,9
213,7,44,1,12,0,356,218,112,223,197,226,179,193,249,344,254,263,258.0,287.0,9,-90,99
43,8,44,1,12,0,51,47,21,35,29,43,35,45,44,57,33,41,37.0,44.0,8,-24,32
321,9,44,1,12,0,572,437,152,310,246,338,497,305,362,444,473,433,453.0,450.0,-40,29,-69
17,10,44,1,12,0,46,44,34,25,32,38,35,50,44,68,69,57,63.0,65.0,-12,1,-13
212,11,44,1,12,0,301,251,138,200,177,214,189,187,223,290,301,232,266.0,274.0,-69,11,-80
48,12,44,1,12,0,92,84,32,51,53,76,51,70,67,97,77,76,76.0,83.0,-1,-20,19
126,13,44,1,12,0,131,106,79,112,113,144,111,129,162,213,174,139,156.0,175.0,-35,-39,4
112,14,44,1,12,0,187,131,57,111,155,108,118,135,163,164,158,129,144.0,150.0,-29,-6,-23
99,15,44,1,12,0,230,149,78,139,107,108,142,110,130,142,139,127,133.0,136.0,-12,-3,-9
114,16,44,1,12,0,184,148,61,111,94,101,110,110,157,162,143,138,140.0,148.0,-5,-19,14
109,17,44,1,12,0,211,135,74,132,109,108,118,96,135,209,137,157,147.0,168.0,20,-72,92
89,18,44,1,12,0,124,108,57,77,71,97,95,75,85,112,118,111,114.0,114.0,-7,6,-13
74,19,44,1,12,0,129,69,51,75,76,107,67,96,152,173,146,141,144.0,153.0,-5,-27,22
101,20,44,1,12,0,160,125,77,112,97,87,149,112,142,157,158,145,152.0,153.0,-13,1,-14
83,21,44,1,12,0,182,148,77,137,111,172,117,112,144,202,224,152,188.0,193.0,-72,22,-94
51,22,44,1,12,0,77,53,34,68,53,50,51,50,100,75,78,68,73.0,74.0,-10,3,-13
239,1,45,1,12,0,388,154,85,126,92,105,104,90,95,93,83,143,113.0,106.0,60,-10,70
123,2,45,1,12,0,267,194,91,60,53,77,69,54,60,68,102,97,100.0,89.0,-5,34,-39
85,3,45,1,12,0,259,127,62,61,62,68,40,53,87,64,46,52,49.0,54.0,6,-18,24
25,4,45,1,12,0,370,71,41,51,25,21,23,21,16,13,11,23,17.0,16.0,12,-2,14
282,5,45,1,12,0,691,448,194,129,110,118,105,113,152,138,140,173,156.0,150.0,33,2,31
745,6,45,1,12,0,1253,712,250,227,217,259,222,209,229,284,331,381,356.0,332.0,50,47,3
746,7,45,1,12,0,1449,549,320,297,347,332,246,290,297,412,443,438,440.0,431.0,-5,31,-36
182,8,45,1,12,0,426,153,81,103,83,114,108,86,92,80,88,97,92.0,88.0,9,8,1
684,9,45,1,12,0,1628,496,168,342,246,344,349,247,271,470,547,535,541.0,517.0,-12,77,-89
86,10,45,1,12,0,240,121,56,54,26,39,23,31,45,41,46,67,56.0,51.0,21,5,16
1207,11,45,1,12,0,1908,768,543,404,402,487,371,340,347,446,468,640,554.0,518.0,172,22,150
552,12,45,1,12,0,733,453,153,150,168,191,126,131,163,222,258,313,286.0,264.0,55,36,19
458,13,45,1,12,0,1158,476,272,257,300,350,276,304,321,274,306,304,305.0,295.0,-2,32,-34
892,14,45,1,12,0,1883,910,372,312,380,366,295,321,290,401,454,489,472.0,448.0,35,53,-18
1459,15,45,1,12,0,2202,744,430,386,337,361,407,360,410,487,673,779,726.0,646.0,106,186,-80
413,16,45,1,12,0,749,443,143,138,130,145,146,117,118,165,198,265,232.0,209.0,67,33,34
361,17,45,1,12,0,744,378,131,137,149,138,134,113,150,189,192,193,192.0,191.0,1,3,-2
275,18,45,1,12,0,594,265,149,173,130,137,127,100,127,140,178,178,178.0,165.0,0,38,-38
59,19,45,1,12,0,256,75,62,80,75,84,47,39,66,55,56,54,55.0,55.0,-2,1,-3
45,20,45,1,12,0,172,124,38,29,23,20,27,17,21,36,14,32,23.0,27.0,18,-22,40
111,21,45,1,12,0,325,144,79,70,64,97,57,67,82,80,101,63,82.0,81.0,-38,21,-59
50,22,45,1,12,0,152,43,36,52,38,43,41,34,44,43,32,42,37.0,39.0,10,-11,21
134,1,46,1,12,0,96,65,19,37,175,5,12,7,8,136,3,21,12.0,53.0,18,-133,151
103,2,46,1,12,0,182,216,75,82,86,83,57,67,66,46,65,58,62.0,56.0,-7,19,-26
101,3,46,1,12,0,141,132,46,66,45,69,41,38,46,34,32,29,30.0,32.0,-3,-2,-1
109,4,46,1,12,0,277,124,81,65,48,29,26,33,15,60,11,26,18.0,32.0,15,-49,64
320,5,46,1,12,0,292,350,117,93,78,81,64,97,44,63,63,88,76.0,71.0,25,0,25
375,6,46,1,12,0,384,513,121,108,92,90,118,107,99,88,111,193,152.0,131.0,82,23,59
664,7,46,1,12,0,596,555,214,153,209,203,175,145,127,346,326,468,397.0,380.0,142,-20,162
128,8,46,1,12,0,67,66,26,12,22,19,12,23,3,3,7,16,12.0,9.0,9,4,5
599,9,46,1,12,0,84,62,19,63,37,30,29,26,25,17,16,30,23.0,21.0,14,-1,15
99,10,46,1,12,0,50,45,14,26,20,6,2,8,5,11,8,15,12.0,11.0,7,-3,10
770,11,46,1,12,0,569,538,214,216,188,191,134,129,86,151,201,328,264.0,227.0,127,50,77
275,12,46,1,12,0,309,360,94,101,91,90,79,82,62,58,77,105,91.0,80.0,28,19,9
827,13,46,1,12,0,383,353,154,150,162,149,131,144,91,180,201,209,205.0,197.0,8,21,-13
924,14,46,1,12,0,457,538,139,100,129,104,87,70,63,93,117,258,188.0,156.0,141,24,117
1039,15,46,1,12,0,453,388,129,152,151,108,106,91,89,167,264,360,312.0,264.0,96,97,-1
356,16,46,1,12,0,421,474,120,139,119,158,186,109,65,89,106,178,142.0,124.0,72,17,55
450,17,46,1,12,0,428,459,95,148,114,114,115,100,92,163,156,282,219.0,200.0,126,-7,133
263,18,46,1,12,0,159,136,38,44,37,55,51,15,28,29,27,50,38.0,35.0,23,-2,25
208,19,46,1,12,0,238,151,59,93,137,105,53,60,48,51,55,71,63.0,59.0,16,4,12
121,20,46,1,12,0,126,110,41,27,16,19,16,22,15,14,6,10,8.0,10.0,4,-8,12
306,21,46,1,12,0,288,180,80,67,82,94,70,81,86,60,43,74,58.0,59.0,31,-17,48
153,22,46,1,12,0,156,75,46,57,45,34,22,28,31,17,28,51,40.0,32.0,23,11,12
587,1,47,2,12,0,384,208,78,136,169,219,267,195,272,379,301,407,354.0,362.0,106,-78,184
146,2,47,2,12,0,206,142,56,68,79,116,111,106,126,142,139,120,130.0,134.0,-19,-3,-16
61,3,47,2,12,0,115,74,44,45,52,72,39,48,70,69,60,55,58.0,61.0,-5,-9,4
226,4,47,2,12,0,771,253,139,206,162,160,198,159,181,170,152,213,182.0,178.0,61,-18,79
1067,5,47,2,12,0,933,673,263,243,304,396,459,464,505,768,629,730,680.0,709.0,101,-139,240
862,6,47,2,12,0,993,964,338,340,389,526,609,640,679,780,759,659,709.0,733.0,-100,-21,-79
1059,7,47,2,12,0,1332,1011,383,430,537,623,546,597,690,912,884,749,816.0,848.0,-135,-28,-107
211,8,47,2,12,0,275,128,67,102,111,136,137,121,130,151,145,151,148.0,149.0,6,-6,12
1784,9,47,2,12,0,1546,767,278,638,579,734,773,669,732,1150,1234,1385,1310.0,1256.0,151,84,67
271,10,47,2,12,0,276,186,86,105,86,125,135,129,121,150,190,199,194.0,180.0,9,40,-31
2888,11,47,2,12,0,2642,2094,991,984,1074,1356,1448,1465,1619,1956,2009,2157,2083.0,2041.0,148,53,95
634,12,47,2,12,0,691,614,157,211,274,326,317,295,445,614,519,502,510.0,545.0,-17,-95,78
731,13,47,2,12,0,773,530,290,330,342,436,385,393,514,507,523,510,516.0,513.0,-13,16,-29
2402,14,47,2,12,0,2409,1865,640,650,891,1055,1267,1138,1176,1439,1566,1428,1497.0,1478.0,-138,127,-265
2496,15,47,2,12,0,2222,1022,501,663,715,913,1088,1232,1489,1624,1714,1730,1722.0,1689.0,16,90,-74
632,16,47,2,12,0,661,605,178,211,256,312,333,394,414,526,562,510,536.0,533.0,-52,36,-88
704,17,47,2,12,0,698,488,170,228,287,352,372,388,447,540,497,509,503.0,515.0,12,-43,55
626,18,47,2,12,0,601,361,197,246,246,307,332,263,303,408,504,538,521.0,483.0,34,96,-62
233,19,47,2,12,0,328,161,100,120,120,168,137,149,154,182,162,212,187.0,185.0,50,-20,70
406,20,47,2,12,0,430,326,140,158,145,189,295,272,251,352,358,391,374.0,367.0,33,6,27
340,21,47,2,12,0,562,349,119,145,167,210,170,185,229,259,243,242,242.0,248.0,-1,-16,15
77,22,47,2,12,0,100,69,37,53,48,62,47,72,53,77,99,216,158.0,131.0,117,22,95
96,1,48,2,12,0,46,32,19,54,17,10,12,11,6,11,22,53,38.0,29.0,31,11,20
321,2,48,2,12,0,169,142,104,91,53,62,66,54,100,120,234,204,219.0,186.0,-30,114,-144
691,3,48,2,12,0,430,278,168,258,163,176,174,153,161,172,446,334,390.0,317.0,-112,274,-386
57,4,48,2,12,0,112,52,38,30,13,7,12,11,3,21,34,42,38.0,32.0,8,13,-5
1053,5,48,2,12,0,641,617,336,250,134,145,143,161,174,211,648,454,551.0,438.0,-194,437,-631
501,6,48,2,12,0,190,278,146,119,59,72,88,63,82,153,349,313,331.0,272.0,-36,196,-232
3022,7,48,2,12,0,2281,1763,885,746,509,752,650,656,635,554,1575,1169,1372.0,1099.0,-406,1021,-1427
1957,8,48,2,12,0,886,691,295,401,285,317,252,283,337,321,1057,768,912.0,715.0,-289,736,-1025
905,9,48,2,12,0,1008,472,229,471,212,177,139,130,131,160,443,430,436.0,344.0,-13,283,-296
461,10,48,2,12,0,308,251,110,119,55,137,102,134,127,148,260,278,269.0,229.0,18,112,-94
715,11,48,2,12,0,309,370,299,211,106,111,126,119,95,124,351,373,362.0,283.0,22,227,-205
319,12,48,2,12,0,182,224,84,107,42,42,52,41,45,96,201,174,188.0,157.0,-27,105,-132
4005,13,48,2,12,0,1840,1468,940,941,733,782,635,713,852,807,2258,1482,1870.0,1516.0,-776,1451,-2227
1909,14,48,2,12,0,911,1101,433,362,211,283,281,280,284,399,1114,743,928.0,752.0,-371,715,-1086
901,15,48,2,12,0,352,327,197,195,168,241,204,240,223,277,513,546,530.0,445.0,33,236,-203
377,16,48,2,12,0,125,211,58,65,32,39,46,41,44,51,166,179,172.0,132.0,13,115,-102
544,17,48,2,12,0,165,230,105,87,42,50,62,55,47,92,309,357,333.0,253.0,48,217,-169
597,18,48,2,12,0,215,204,105,130,66,70,71,48,58,86,260,305,282.0,217.0,45,174,-129
1725,19,48,2,12,0,619,375,317,409,425,215,168,173,244,317,715,776,746.0,603.0,61,398,-337
159,20,48,2,12,0,104,116,61,54,25,34,33,27,26,25,81,121,101.0,76.0,40,56,-16
815,21,48,2,12,0,250,261,108,136,75,123,125,148,123,127,394,274,334.0,265.0,-120,267,-387
873,22,48,2,12,0,342,207,144,192,137,117,137,97,118,219,569,647,608.0,478.0,78,350,-272
753,1,49,1,12,0,596,174,80,151,177,200,272,204,286,381,357,433,395.0,390.0,76,-24,100
449,2,49,1,12,0,699,444,236,185,176,241,235,239,233,242,311,298,304.0,284.0,-13,69,-82
357,3,49,1,12,0,485,221,94,125,138,233,182,202,244,226,285,221,253.0,244.0,-64,59,-123
547,4,49,1,12,0,1517,309,174,289,242,251,279,287,271,285,203,331,267.0,273.0,128,-82,210
1008,5,49,1,12,0,1305,743,339,285,287,359,363,364,444,612,527,497,512.0,545.0,-30,-85,55
1522,6,49,1,12,0,1597,855,344,344,422,524,660,677,843,847,868,889,878.0,868.0,21,21,0
1459,7,49,1,12,0,1740,687,383,327,543,829,670,841,808,972,862,827,844.0,887.0,-35,-110,75
389,8,49,1,12,0,514,192,100,117,126,207,172,186,212,232,248,256,252.0,245.0,8,16,-8
1566,9,49,1,12,0,1899,542,186,403,360,460,604,483,479,704,825,938,882.0,822.0,113,121,-8
290,10,49,1,12,0,514,260,96,110,81,120,111,123,118,114,164,155,160.0,144.0,-9,50,-59
2267,11,49,1,12,0,2279,939,574,593,645,899,941,918,876,1073,1193,1192,1192.0,1153.0,-1,120,-121
1102,12,49,1,12,0,900,502,180,199,229,302,289,342,439,577,631,653,642.0,620.0,22,54,-32
1451,13,49,1,12,0,1749,708,414,412,600,843,768,843,1013,870,860,978,919.0,903.0,118,-10,128
2375,14,49,1,12,0,2735,1331,509,557,792,1003,1139,1208,1046,1173,1225,1246,1236.0,1215.0,21,52,-31
3318,15,49,1,12,0,3255,1119,581,616,676,899,1179,1212,1449,1568,1840,1878,1859.0,1762.0,38,272,-234
992,16,49,1,12,0,1014,597,202,210,256,309,467,354,417,541,558,609,584.0,569.0,51,17,34
796,17,49,1,12,0,978,498,212,209,272,280,287,311,368,495,434,537,486.0,489.0,103,-61,164
586,18,49,1,12,0,782,311,141,184,131,214,223,160,193,287,353,357,355.0,332.0,4,66,-62
281,19,49,1,12,0,424,127,80,97,131,161,165,176,170,202,187,199,193.0,196.0,12,-15,27
543,20,49,1,12,0,532,260,104,78,93,126,161,148,159,170,178,257,218.0,202.0,79,8,71
624,21,49,1,12,0,620,315,130,154,179,263,204,263,363,295,450,379,414.0,375.0,-71,155,-226
208,22,49,1,12,0,274,80,52,66,71,97,87,91,116,90,100,154,127.0,115.0,54,10,44
255,1,50,4,12,0,396,369,177,174,163,140,140,130,154,202,176,154,165.0,177.0,-22,-26,4
272,2,50,4,12,0,334,203,134,207,159,159,199,202,227,215,226,218,222.0,220.0,-8,11,-19
62,3,50,4,12,0,90,51,29,42,27,40,31,39,40,40,103,45,74.0,63.0,-58,63,-121
96,4,50,4,12,0,242,93,60,87,42,47,47,40,41,55,59,53,56.0,56.0,-6,4,-10
476,5,50,4,12,0,781,288,239,321,272,333,406,352,417,499,361,398,380.0,419.0,37,-138,175
418,6,50,4,12,0,661,309,266,301,237,309,289,297,345,293,432,310,371.0,345.0,-122,139,-261
860,7,50,4,12,0,994,540,419,572,464,433,395,383,432,535,703,469,586.0,569.0,-234,168,-402
142,8,50,4,12,0,201,88,44,87,60,67,72,87,105,82,107,83,95.0,91.0,-24,25,-49
719,9,50,4,12,0,1135,331,231,477,411,394,418,380,461,499,508,525,516.0,511.0,17,9,8
224,10,50,4,12,0,403,140,92,140,131,131,161,121,124,149,158,183,170.0,163.0,25,9,16
1203,11,50,4,12,0,1781,805,710,885,641,740,693,656,701,768,937,856,896.0,854.0,-81,169,-250
330,12,50,4,12,0,431,157,97,173,170,210,195,175,219,261,224,240,232.0,242.0,16,-37,53
909,13,50,4,12,0,806,391,375,484,404,455,438,404,455,455,703,481,592.0,546.0,-222,248,-470
767,14,50,4,12,0,896,363,334,528,418,445,554,381,446,510,591,459,525.0,520.0,-132,81,-213
830,15,50,4,12,0,1044,341,386,475,363,466,458,443,473,505,595,543,569.0,548.0,-52,90,-142
342,16,50,4,12,0,461,270,123,194,119,150,177,181,200,192,242,232,237.0,222.0,-10,50,-60
304,17,50,4,12,0,478,157,99,182,167,188,184,200,195,251,207,207,207.0,222.0,0,-44,44
345,18,50,4,12,0,593,250,154,266,219,283,228,214,225,227,321,273,297.0,274.0,-48,94,-142
124,19,50,4,12,0,149,45,36,75,66,76,84,71,67,64,113,104,108.0,94.0,-9,49,-58
203,20,50,4,12,0,475,136,124,148,136,160,225,137,123,161,136,162,149.0,153.0,26,-25,51
255,21,50,4,12,0,464,194,145,188,141,176,186,164,204,187,239,174,206.0,200.0,-65,52,-117
74,22,50,4,12,0,87,40,47,82,54,34,48,39,38,37,82,78,80.0,66.0,-4,45,-49
656,1,51,2,12,0,579,371,131,288,266,225,283,286,352,425,361,419,390.0,402.0,58,-64,122
282,2,51,2,12,0,338,215,134,179,192,167,169,217,170,285,214,266,240.0,255.0,52,-71,123
53,3,51,2,12,0,48,41,28,59,37,53,61,54,60,50,57,51,54.0,53.0,-6,7,-13
160,4,51,2,12,0,383,131,61,110,108,70,103,89,94,106,75,102,88.0,94.0,27,-31,58
958,5,51,2,12,0,820,550,286,428,433,456,497,476,571,730,570,689,630.0,663.0,119,-160,279
929,6,51,2,12,0,758,508,322,432,425,545,563,499,558,654,651,661,656.0,655.0,10,-3,13
673,7,51,2,12,0,729,410,227,320,381,388,394,345,413,508,427,535,481.0,490.0,108,-81,189
82,8,51,2,12,0,136,74,57,53,62,47,59,62,56,65,82,70,76.0,72.0,-12,17,-29
2187,9,51,2,12,0,2232,1023,444,1072,1007,969,1190,954,1225,1539,1459,1711,1585.0,1570.0,252,-80,332
331,10,51,2,12,0,328,208,107,160,131,178,209,223,211,264,238,253,246.0,252.0,15,-26,41
1804,11,51,2,12,0,1846,1142,747,1023,870,969,1040,1045,1132,1384,1302,1350,1326.0,1345.0,48,-82,130
505,12,51,2,12,0,436,290,111,237,235,226,237,243,304,361,365,384,374.0,370.0,19,4,15
584,13,51,2,12,0,475,287,194,265,298,335,339,355,444,469,418,474,446.0,454.0,56,-51,107
840,14,51,2,12,0,747,459,249,457,513,513,571,508,547,706,610,638,624.0,651.0,28,-96,124
1568,15,51,2,12,0,1454,752,503,780,679,725,759,836,1202,1060,1245,1225,1235.0,1177.0,-20,185,-205
614,16,51,2,12,0,481,312,158,246,258,251,428,347,390,481,444,482,463.0,469.0,38,-37,75
571,17,51,2,12,0,425,324,139,263,238,293,308,308,344,467,351,445,398.0,421.0,94,-116,210
739,18,51,2,12,0,699,508,260,395,323,426,506,406,485,547,533,645,589.0,575.0,112,-14,126
136,19,51,2,12,0,125,66,52,82,116,125,102,110,143,125,94,134,114.0,118.0,40,-31,71
522,20,51,2,12,0,548,310,185,288,287,285,378,280,285,380,307,322,314.0,336.0,15,-73,88
240,21,51,2,12,0,259,170,96,124,121,134,165,167,184,227,205,179,192.0,204.0,-26,-22,-4
86,22,51,2,12,0,115,61,52,76,85,53,52,53,68,53,58,78,68.0,63.0,20,5,15
338,1,52,1,12,0,473,415,199,338,303,272,297,230,306,310,217,312,264.0,280.0,95,-93,188
334,2,52,1,12,0,535,500,259,353,295,304,293,320,299,296,284,309,296.0,296.0,25,-12,37
181,3,52,1,12,0,234,273,129,208,180,191,167,194,197,191,163,181,172.0,178.0,18,-28,46
494,4,52,1,12,0,681,534,295,402,398,365,374,341,360,397,323,419,371.0,380.0,96,-74,170
566,5,52,1,12,0,849,933,442,540,493,508,553,476,460,610,426,533,480.0,523.0,107,-184,291
252,6,52,1,12,0,368,404,198,210,162,176,206,197,185,206,181,197,189.0,195.0,16,-25,41
640,7,52,1,12,0,936,911,376,595,546,558,596,483,522,642,489,566,528.0,566.0,77,-153,230
173,8,52,1,12,0,244,213,113,141,101,103,104,107,143,141,135,151,143.0,142.0,16,-6,22
1350,9,52,1,12,0,2078,1526,521,1068,875,905,1067,825,969,1188,973,1118,1046.0,1093.0,145,-215,360
168,10,52,1,12,0,317,323,145,236,156,189,166,140,172,167,131,153,142.0,150.0,22,-36,58
550,11,52,1,12,0,820,821,461,589,458,423,545,436,500,549,440,501,470.0,497.0,61,-109,170
180,12,52,1,12,0,262,297,113,164,151,133,139,150,149,170,140,130,135.0,147.0,-10,-30,20
538,13,52,1,12,0,750,758,431,483,470,474,415,495,501,519,421,480,450.0,473.0,59,-98,157
485,14,52,1,12,0,820,826,447,615,567,493,543,423,493,437,366,448,407.0,417.0,82,-71,153
467,15,52,1,12,0,684,550,252,401,254,311,325,307,322,340,344,355,350.0,346.0,11,4,7
291,16,52,1,12,0,425,481,197,299,246,238,274,238,273,295,246,247,246.0,263.0,1,-49,50
357,17,52,1,12,0,493,505,239,383,321,315,341,325,336,378,286,338,312.0,334.0,52,-92,144
185,18,52,1,12,0,338,400,163,217,128,161,123,141,139,151,131,141,136.0,141.0,10,-20,30
282,19,52,1,12,0,450,249,117,274,320,298,258,236,274,251,198,202,200.0,217.0,4,-53,57
445,20,52,1,12,0,575,576,284,403,314,306,439,296,285,331,263,289,276.0,294.0,26,-68,94
232,21,52,1,12,0,404,376,178,272,285,266,201,203,229,236,216,225,220.0,226.0,9,-20,29
265,22,52,1,12,0,410,324,206,341,242,239,273,292,251,258,237,262,250.0,252.0,25,-21,46
414,1,53,2,12,0,846,241,179,180,191,192,253,247,261,249,228,289,258.0,255.0,61,-21,82
500,2,53,2,12,0,493,290,145,117,124,158,128,183,166,200,277,390,334.0,289.0,113,77,36
272,3,53,2,12,0,562,284,123,119,71,119,101,97,110,137,180,181,180.0,166.0,1,43,-42
215,4,53,2,12,0,824,105,71,55,60,50,59,51,57,65,85,133,109.0,94.0,48,20,28
1207,5,53,2,12,0,1730,983,504,400,394,380,436,516,607,641,550,820,685.0,670.0,270,-91,361
2004,6,53,2,12,0,2243,1186,528,593,566,477,521,594,770,1036,1137,1281,1209.0,1151.0,144,101,43
1782,7,53,2,12,0,2998,1261,553,503,551,645,651,724,836,994,1041,1155,1098.0,1063.0,114,47,67
537,8,53,2,12,0,645,313,178,140,164,178,173,195,230,273,274,315,294.0,287.0,41,1,40
1686,9,53,2,12,0,3191,905,337,855,959,831,614,794,1007,844,769,1092,930.0,902.0,323,-75,398
660,10,53,2,12,0,697,471,179,227,188,213,224,204,252,332,309,466,388.0,369.0,157,-23,180
2188,11,53,2,12,0,3836,1631,972,777,763,993,802,889,897,976,1122,1300,1211.0,1133.0,178,146,32
683,12,53,2,12,0,1270,658,229,229,221,283,227,273,344,417,442,472,457.0,444.0,30,25,5
1263,13,53,2,12,0,2232,950,551,442,578,697,555,544,666,625,757,859,808.0,747.0,102,132,-30
2832,14,53,2,12,0,3243,1894,828,807,1011,1085,1013,1189,1300,1393,1655,1872,1764.0,1640.0,217,262,-45
1040,15,53,2,12,0,1850,574,328,328,361,426,423,467,565,573,676,798,737.0,682.0,122,103,19
558,16,53,2,12,0,1354,755,244,256,243,222,247,223,230,310,348,406,377.0,355.0,58,38,20
1420,17,53,2,12,0,1756,938,322,403,371,448,412,466,511,628,666,904,785.0,733.0,238,38,200
655,18,53,2,12,0,1041,462,182,250,215,304,238,233,338,522,511,576,544.0,536.0,65,-11,76
284,19,53,2,12,0,561,181,92,144,178,144,111,123,123,146,152,205,178.0,168.0,53,6,47
698,20,53,2,12,0,1136,557,231,195,203,189,260,190,212,306,281,420,350.0,336.0,139,-25,164
1410,21,53,2,12,0,1567,639,298,275,310,369,282,381,491,525,649,759,704.0,644.0,110,124,-14
159,22,53,2,12,0,305,102,62,72,62,93,71,101,93,80,111,145,128.0,112.0,34,31,3
48,1,54,1,12,0,159,95,31,32,33,18,19,21,31,33,32,30,31.0,32.0,-2,-1,-1
74,2,54,1,12,0,195,181,91,58,50,67,48,56,60,70,109,74,92.0,84.0,-35,39,-74
164,3,54,1,12,0,336,327,113,110,91,126,86,83,105,142,150,176,163.0,156.0,26,8,18
42,4,54,1,12,0,246,99,35,29,28,28,17,19,21,32,18,23,20.0,24.0,5,-14,19
168,5,54,1,12,0,387,398,155,108,95,80,69,76,114,107,93,88,90.0,96.0,-5,-14,9
204,6,54,1,12,0,471,484,121,103,101,118,103,101,112,137,149,153,151.0,146.0,4,12,-8
486,7,54,1,12,0,961,723,263,300,312,311,242,273,332,372,387,361,374.0,373.0,-26,15,-41
101,8,54,1,12,0,167,149,66,59,57,51,58,45,92,92,77,100,88.0,90.0,23,-15,38
48,9,54,1,12,0,176,97,19,44,38,31,35,30,38,44,35,58,46.0,46.0,23,-9,32
19,10,54,1,12,0,62,66,20,31,15,25,9,23,18,12,17,23,20.0,17.0,6,5,1
128,11,54,1,12,0,450,333,168,137,94,101,95,97,80,87,93,107,100.0,96.0,14,6,8
160,12,54,1,12,0,252,264,69,58,63,82,66,58,86,106,109,99,104.0,105.0,-10,3,-13
268,13,54,1,12,0,473,362,182,165,226,205,142,157,221,184,175,195,185.0,185.0,20,-9,29
454,14,54,1,12,0,679,669,213,223,212,206,190,239,237,292,323,297,310.0,304.0,-26,31,-57
94,15,54,1,12,0,255,131,59,54,69,64,57,47,53,54,59,50,54.0,54.0,-9,5,-14
207,16,54,1,12,0,385,450,105,110,104,89,90,81,127,134,149,148,148.0,144.0,-1,15,-16
688,17,54,1,12,0,776,857,222,262,247,257,219,243,308,415,419,451,435.0,428.0,32,4,28
25,18,54,1,12,0,65,41,21,20,20,33,19,21,25,14,25,17,21.0,19.0,-8,11,-19
88,19,54,1,12,0,166,109,50,66,72,45,46,43,59,62,69,76,72.0,69.0,7,7,0
121,20,54,1,12,0,306,256,58,77,65,70,84,67,84,87,77,85,81.0,83.0,8,-10,18
432,21,54,1,12,0,634,493,193,190,176,193,161,204,222,237,320,276,298.0,278.0,-44,83,-127
128,22,54,1,12,0,277,131,70,96,70,62,54,66,59,76,95,139,117.0,103.0,44,19,25
166,1,55,1,12,0,361,138,71,95,74,75,111,81,104,108,82,91,86.0,94.0,9,-26,35
688,2,55,1,12,0,743,406,299,256,259,276,323,373,379,361,567,467,517.0,465.0,-100,206,-306
779,3,55,1,12,0,683,304,135,211,181,248,260,314,339,378,412,513,462.0,434.0,101,34,67
209,4,55,1,12,0,675,173,56,121,79,138,89,102,103,129,115,160,138.0,135.0,45,-14,59
2246,5,55,1,12,0,2057,1186,681,782,644,814,979,1044,1182,1106,1202,1558,1380.0,1289.0,356,96,260
731,6,55,1,12,0,865,574,194,213,248,307,345,317,346,361,391,456,424.0,403.0,65,30,35
1563,7,55,1,12,0,1538,723,282,412,473,536,614,680,774,720,826,848,837.0,798.0,22,106,-84
1703,8,55,1,12,0,974,417,214,254,346,509,560,656,816,685,1059,1000,1030.0,915.0,-59,374,-433
1064,9,55,1,12,0,1105,569,259,493,354,430,585,484,578,575,619,790,704.0,661.0,171,44,127
377,10,55,1,12,0,406,260,101,165,105,174,218,194,217,225,224,290,257.0,246.0,66,-1,67
1164,11,55,1,12,0,1332,698,402,409,494,495,557,550,609,567,672,754,713.0,664.0,82,105,-23
589,12,55,1,12,0,774,420,110,193,205,216,298,283,295,291,351,389,370.0,344.0,38,60,-22
2807,13,55,1,12,0,2069,891,397,516,929,990,983,1137,1295,1153,1509,1715,1612.0,1459.0,206,356,-150
2183,14,55,1,12,0,1916,1026,330,387,521,645,908,946,966,847,1114,1276,1195.0,1079.0,162,267,-105
796,15,55,1,12,0,982,370,195,281,311,304,395,371,467,405,469,528,498.0,467.0,59,64,-5
531,16,55,1,12,0,721,401,105,159,186,195,272,290,243,277,326,353,340.0,319.0,27,49,-22
995,17,55,1,12,0,1290,631,205,298,333,363,464,424,425,552,559,607,583.0,573.0,48,7,41
359,18,55,1,12,0,385,180,95,138,114,150,154,163,198,154,199,231,215.0,195.0,32,45,-13
287,19,55,1,12,0,330,135,104,181,144,138,167,145,200,198,175,219,197.0,197.0,44,-23,67
1321,20,55,1,12,0,1420,661,420,464,477,481,631,557,639,617,667,807,737.0,697.0,140,50,90
1582,21,55,1,12,0,1234,604,184,336,402,415,468,687,690,661,909,892,900.0,821.0,-17,248,-265
236,22,55,1,12,0,236,76,111,111,78,108,134,127,165,146,158,232,195.0,179.0,74,12,62
600,1,56,1,12,0,805,357,95,198,187,218,252,286,379,461,354,390,372.0,402.0,36,-107,143
1227,2,56,1,12,0,1249,829,418,522,444,470,542,766,801,741,996,965,980.0,901.0,-31,255,-286
1163,3,56,1,12,0,925,601,288,415,322,461,499,595,688,789,875,960,918.0,875.0,85,86,-1
362,4,56,1,12,0,1421,437,212,313,278,276,253,302,320,338,287,368,328.0,331.0,81,-51,132
2632,5,56,1,12,0,2915,2183,903,1084,938,1042,1247,1538,1846,1788,1737,1869,1803.0,1798.0,132,-51,183
1083,6,56,1,12,0,1307,1141,304,330,322,356,545,585,712,755,739,765,752.0,753.0,26,-16,42
1637,7,56,1,12,0,1610,1006,389,569,611,624,776,1014,1189,1170,1211,1183,1197.0,1188.0,-28,41,-69
959,8,56,1,12,0,970,406,198,368,305,370,503,552,733,652,718,658,688.0,676.0,-60,66,-126
2001,9,56,1,12,0,2685,1203,341,825,879,785,1142,1134,1550,1490,1748,1989,1868.0,1742.0,241,258,-17
463,10,56,1,12,0,665,433,149,235,168,197,226,296,330,369,365,417,391.0,384.0,52,-4,56
2479,11,56,1,12,0,2752,1481,650,861,854,961,1280,1420,1671,1770,1868,2033,1950.0,1890.0,165,98,67
644,12,56,1,12,0,802,624,159,229,268,266,354,440,475,407,474,514,494.0,465.0,40,67,-27
2397,13,56,1,12,0,1551,970,478,608,767,810,890,1254,1423,1432,1560,1629,1594.0,1540.0,69,128,-59
3060,14,56,1,12,0,2696,1928,502,672,701,850,1415,1787,1789,1724,2048,1912,1980.0,1895.0,-136,324,-460
2439,15,56,1,12,0,2124,704,292,530,641,696,932,1254,1486,1797,1857,1925,1891.0,1860.0,68,60,8
916,16,56,1,12,0,1252,837,201,313,330,347,462,609,643,609,716,696,706.0,674.0,-20,107,-127
1811,17,56,1,12,0,2360,1657,503,671,579,591,827,934,1043,1138,1066,1187,1126.0,1130.0,121,-72,193
605,18,56,1,12,0,698,428,129,211,219,281,359,378,470,543,521,626,574.0,563.0,105,-22,127
323,19,56,1,12,0,459,235,125,226,187,250,248,334,351,316,290,309,300.0,305.0,19,-26,45
2262,20,56,1,12,0,2727,1846,758,896,740,908,1151,1313,1405,1572,1555,1445,1500.0,1524.0,-110,-17,-93
1581,21,56,1,12,0,1319,905,333,426,445,444,565,798,975,991,1110,967,1038.0,1023.0,-143,119,-262
326,22,56,1,12,0,397,173,117,199,155,143,190,253,271,281,258,403,330.0,314.0,145,-23,168
36,1,57,3,12,0,34,19,29,28,25,38,29,32,29,27,26,23,24.0,25.0,-3,-1,-2
852,2,57,3,12,0,1939,1680,1190,1187,815,815,786,875,755,817,1016,720,868.0,851.0,-296,199,-495
46,3,57,3,12,0,108,54,78,117,71,70,60,56,65,70,61,41,51.0,57.0,-20,-9,-11
321,4,57,3,12,0,504,106,118,157,120,110,104,70,81,80,59,99,79.0,79.0,40,-21,61
445,5,57,3,12,0,955,603,645,678,519,472,474,468,514,523,495,344,420.0,454.0,-151,-28,-123
113,6,57,3,12,0,272,216,223,191,165,153,149,145,130,226,119,115,117.0,153.0,-4,-107,103
400,7,57,3,12,0,1105,629,541,513,451,400,375,388,431,348,319,283,301.0,317.0,-36,-29,-7
111,8,57,3,12,0,233,166,115,127,118,117,113,93,103,99,118,123,120.0,113.0,5,19,-14
661,9,57,3,12,0,866,346,505,757,513,503,519,390,440,464,326,357,342.0,382.0,31,-138,169
30,10,57,3,12,0,97,92,50,85,53,57,36,20,17,40,26,18,22.0,28.0,-8,-14,6
533,11,57,3,12,0,1150,610,843,857,623,558,495,522,542,537,383,409,396.0,443.0,26,-154,180
55,12,57,3,12,0,148,132,89,105,90,70,62,87,69,109,55,55,55.0,73.0,0,-54,54
641,13,57,3,12,0,983,537,616,685,621,541,500,570,609,477,446,517,482.0,480.0,71,-31,102
596,14,57,3,12,0,1314,922,778,753,612,592,519,715,609,950,530,431,480.0,637.0,-99,-420,321
380,15,57,3,12,0,653,312,498,511,368,351,319,353,307,303,303,273,288.0,293.0,-30,0,-30
352,16,57,3,12,0,903,514,438,482,408,403,314,306,325,383,287,301,294.0,324.0,14,-96,110
249,17,57,3,12,0,575,405,314,375,353,267,377,276,257,258,207,210,208.0,225.0,3,-51,54
109,18,57,3,12,0,195,85,140,157,133,146,133,94,101,94,103,86,94.0,94.0,-17,9,-26
216,19,57,3,12,0,370,158,187,236,191,184,170,200,162,165,162,172,167.0,166.0,10,-3,13
641,20,57,3,12,0,955,636,643,771,438,521,498,470,463,469,462,351,406.0,427.0,-111,-7,-104
195,21,57,3,12,0,324,195,155,198,180,157,132,131,161,154,118,145,132.0,139.0,27,-36,63
54,22,57,3,12,0,90,35,48,67,46,41,40,28,43,38,20,21,20.0,26.0,1,-18,19
157,1,58,2,12,0,281,60,52,74,61,69,81,59,68,101,59,64,62.0,75.0,5,-42,47
201,2,58,2,12,0,356,181,119,130,103,154,125,106,113,128,230,173,202.0,177.0,-57,102,-159
194,3,58,2,12,0,244,117,67,81,65,79,55,51,79,82,89,101,95.0,91.0,12,7,5
135,4,58,2,12,0,805,105,52,132,97,103,144,172,170,133,91,116,104.0,113.0,25,-42,67
825,5,58,2,12,0,1456,816,454,505,463,516,491,453,624,583,533,557,545.0,558.0,24,-50,74
408,6,58,2,12,0,463,251,96,133,88,118,91,110,111,129,108,229,168.0,155.0,121,-21,142
507,7,58,2,12,0,1182,600,283,311,395,408,271,332,415,347,344,280,312.0,324.0,-64,-3,-61
233,8,58,2,12,0,497,192,96,135,117,169,144,132,175,152,197,166,182.0,172.0,-31,45,-76
448,9,58,2,12,0,869,297,127,271,262,258,278,238,265,297,267,378,322.0,314.0,111,-30,141
219,10,58,2,12,0,425,254,71,136,107,135,145,104,103,124,139,128,134.0,130.0,-11,15,-26
874,11,58,2,12,0,1017,461,270,342,363,373,289,260,265,382,334,313,324.0,343.0,-21,-48,27
201,12,58,2,12,0,315,211,60,84,84,68,64,78,105,104,111,118,114.0,111.0,7,7,0
901,13,58,2,12,0,1430,754,390,398,481,498,419,459,630,477,524,519,522.0,507.0,-5,47,-52
777,14,58,2,12,0,1601,892,268,371,333,363,396,440,436,415,417,417,417.0,416.0,0,2,-2
362,15,58,2,12,0,845,174,81,170,192,246,204,243,235,258,263,241,252.0,254.0,-22,5,-27
76,16,58,2,12,0,246,134,39,47,55,60,48,51,63,57,69,58,64.0,61.0,-11,12,-23
350,17,58,2,12,0,756,439,130,231,191,211,178,177,209,244,199,247,223.0,230.0,48,-45,93
138,18,58,2,12,0,247,102,51,67,60,67,91,79,101,94,80,198,139.0,124.0,118,-14,132
52,19,58,2,12,0,113,47,21,29,27,30,22,21,21,18,20,34,27.0,24.0,14,2,12
2478,20,58,2,12,0,1578,630,283,298,337,395,444,428,519,438,436,552,494.0,475.0,116,-2,118
723,21,58,2,12,0,938,498,189,261,260,236,226,286,349,325,354,355,354.0,345.0,1,29,-28
31,22,58,2,12,0,45,7,10,21,11,20,18,12,17,12,8,32,20.0,17.0,24,-4,28
3668,1,59,2,12,0,746,228,125,223,190,233,237,1154,290,404,302,1094,698.0,600.0,792,-102,894
124,2,59,2,12,0,235,105,67,68,72,70,100,79,62,75,86,105,96.0,89.0,19,11,8
121,3,59,2,12,0,340,208,63,95,64,75,89,75,89,111,84,104,94.0,100.0,20,-27,47
50,4,59,2,12,0,362,72,29,64,61,50,56,417,666,51,34,72,53.0,52.0,38,-17,55
1150,5,59,2,12,0,1027,542,251,246,265,230,226,834,315,368,297,307,302.0,324.0,10,-71,81
669,6,59,2,12,0,1434,792,244,232,308,344,363,315,452,583,523,551,537.0,552.0,28,-60,88
698,7,59,2,12,0,1685,823,326,341,453,371,362,372,520,630,555,505,530.0,563.0,-50,-75,25
283,8,59,2,12,0,604,321,126,162,162,182,154,558,292,187,206,250,228.0,214.0,44,19,25
810,9,59,2,12,0,1493,451,130,374,366,407,481,329,409,478,509,593,551.0,527.0,84,31,53
261,10,59,2,12,0,543,250,76,136,99,136,130,103,145,204,198,227,212.0,210.0,29,-6,35
1420,11,59,2,12,0,2828,1205,656,751,787,807,758,1395,929,1015,1091,1085,1088.0,1064.0,-6,76,-82
560,12,59,2,12,0,1241,549,138,232,271,262,250,268,377,418,451,461,456.0,443.0,10,33,-23
579,13,59,2,12,0,1020,602,249,293,362,351,329,285,374,411,366,401,384.0,393.0,35,-45,80
1764,14,59,2,12,0,1584,992,320,512,660,557,721,719,991,1189,1206,1267,1236.0,1221.0,61,17,44
668,15,59,2,12,0,1272,386,193,342,341,375,377,337,402,499,496,510,503.0,502.0,14,-3,17
542,16,59,2,12,0,1208,523,161,272,326,270,280,775,316,371,390,456,423.0,406.0,66,19,47
706,17,59,2,12,0,891,508,132,232,212,222,268,261,329,457,434,466,450.0,452.0,32,-23,55
201,18,59,2,12,0,431,173,74,106,104,121,115,77,91,131,145,172,158.0,149.0,27,14,13
75,19,59,2,12,0,225,91,51,75,101,66,42,52,68,79,54,48,51.0,60.0,-6,-25,19
123,20,59,2,12,0,242,128,33,53,51,65,76,57,46,63,70,100,85.0,78.0,30,7,23
321,21,59,2,12,0,432,182,64,143,136,155,142,754,199,271,274,293,284.0,279.0,19,3,16
25,22,59,2,12,0,140,53,29,33,28,48,27,21,28,21,14,20,17.0,18.0,6,-7,13
143,1,60,1,12,0,163,142,84,128,99,108,102,143,141,92,87,172,130.0,117.0,85,-5,90
102,2,60,1,12,0,131,146,84,119,80,84,87,136,120,95,78,103,90.0,92.0,25,-17,42
70,3,60,1,12,0,90,83,41,62,87,86,67,58,68,69,69,79,74.0,72.0,10,0,10
75,4,60,1,12,0,123,88,65,74,70,62,63,53,50,55,67,92,80.0,71.0,25,12,13
221,5,60,1,12,0,330,341,184,223,201,224,188,192,262,301,197,237,217.0,245.0,40,-104,144
193,6,60,1,12,0,198,254,107,149,150,152,146,136,174,138,155,169,162.0,154.0,14,17,-3
165,7,60,1,12,0,191,159,74,162,163,162,117,116,158,179,155,169,162.0,168.0,14,-24,38
33,8,60,1,12,0,28,41,25,46,41,28,30,28,32,32,26,40,33.0,33.0,14,-6,20
677,9,60,1,12,0,638,568,264,527,387,410,437,440,502,480,480,728,604.0,563.0,248,0,248
190,10,60,1,12,0,213,297,121,197,152,163,152,143,162,143,132,158,145.0,144.0,26,-11,37
412,11,60,1,12,0,439,430,213,408,324,345,284,373,290,342,314,428,371.0,361.0,114,-28,142
101,12,60,1,12,0,120,103,50,101,76,71,82,82,105,75,85,87,86.0,82.0,2,10,-8
125,13,60,1,12,0,95,109,50,116,95,137,104,134,131,121,110,110,110.0,114.0,0,-11,11
153,14,60,1,12,0,164,130,78,142,114,90,124,140,149,132,125,118,122.0,125.0,-7,-7,0
354,15,60,1,12,0,397,466,185,307,317,322,277,351,327,287,278,377,328.0,314.0,99,-9,108
230,16,60,1,12,0,236,270,129,200,183,140,190,186,222,164,183,225,204.0,191.0,42,19,23
283,17,60,1,12,0,445,519,215,330,301,296,262,319,373,282,230,301,266.0,271.0,71,-52,123
112,18,60,1,12,0,99,145,57,96,88,101,91,78,106,100,89,130,110.0,106.0,41,-11,52
104,19,60,1,12,0,155,89,59,109,102,100,85,79,140,123,99,119,109.0,114.0,20,-24,44
125,20,60,1,12,0,214,160,89,140,134,104,264,151,136,117,92,123,108.0,111.0,31,-25,56
265,21,60,1,12,0,263,274,154,228,212,258,163,256,338,207,301,277,289.0,262.0,-24,94,-118
58,22,60,1,12,0,57,65,35,91,67,47,50,39,70,62,56,83,70.0,67.0,27,-6,33
