label,province,model,month,isSpringFestival,sales12MonthAgo,sales11MonthAgo,sales10MonthAgo,sales9MonthAgo,sales8MonthAgo,sales7MonthAgo,sales6MonthAgo,sales5MonthAgo,sales4MonthAgo,sales3MonthAgo,sales2MonthAgo,sales1MonthAgo,averageSales2Month,averageSales3Month,firstOrderTrend1,firstOrderTrend2,secondOrderTrend
305,310000,3c974920a76ac9c1,1,1,292,134,323,266,271,235,260,162,265,228,369,374,372,324,5,141,-136
434,530000,3c974920a76ac9c1,1,1,466,227,260,216,308,279,419,246,217,310,402,456,429,389,54,92,-38
180,150000,3c974920a76ac9c1,1,1,257,123,206,149,236,164,187,153,157,178,204,219,212,200,15,26,-11
468,110000,3c974920a76ac9c1,1,1,408,160,362,404,445,351,322,244,337,371,460,563,512,465,103,89,14
500,510000,3c974920a76ac9c1,1,1,610,311,358,373,360,329,335,345,623,350,453,570,512,458,117,103,14
198,340000,3c974920a76ac9c1,1,1,206,125,152,155,154,138,108,127,159,136,179,226,202,180,47,43,4
468,370000,3c974920a76ac9c1,1,1,503,254,418,482,482,353,339,259,422,394,483,601,542,493,118,89,29
248,140000,3c974920a76ac9c1,1,1,236,126,197,211,250,166,178,189,194,233,215,260,238,236,45,-18,63
2692,440000,3c974920a76ac9c1,1,1,3635,932,2407,2080,2897,2187,2183,1804,2265,2711,3532,3800,3666,3348,268,821,-553
425,450000,3c974920a76ac9c1,1,1,450,224,347,259,363,291,276,249,267,349,472,505,488,442,33,123,-90
800,320000,3c974920a76ac9c1,1,1,876,540,791,629,780,561,554,569,631,764,871,1010,940,882,139,107,32
236,360000,3c974920a76ac9c1,1,1,253,86,138,143,167,149,136,95,156,166,204,262,233,211,58,38,20
260,130000,3c974920a76ac9c1,1,1,306,138,237,254,280,252,227,235,225,228,291,305,298,275,14,63,-49
405,410000,3c974920a76ac9c1,1,1,537,225,304,394,313,330,384,256,301,351,521,505,513,459,-16,170,-186
633,330000,3c974920a76ac9c1,1,1,650,342,504,483,638,453,457,422,545,702,660,865,762,742,205,-42,247
497,420000,3c974920a76ac9c1,1,1,635,275,418,368,357,440,329,325,381,447,480,474,477,467,-6,33,-39
347,430000,3c974920a76ac9c1,1,1,525,157,288,266,308,275,250,286,299,327,364,474,419,388,110,37,73
292,350000,3c974920a76ac9c1,1,1,462,150,315,287,307,223,276,226,258,368,331,404,368,368,73,-37,110
650,210000,3c974920a76ac9c1,1,1,791,433,807,807,900,645,700,556,721,769,941,997,969,902,56,172,-116
115,500000,3c974920a76ac9c1,1,1,195,141,127,106,114,181,131,111,101,120,155,199,177,158,44,35,9
305,610000,3c974920a76ac9c1,1,1,298,116,246,259,414,206,262,204,187,324,393,440,416,386,47,69,-22
292,230000,3c974920a76ac9c1,1,1,309,148,482,356,398,288,194,351,302,310,458,461,460,410,3,148,-145
268,310000,3d7554f1f56dd664,1,1,389,262,484,342,349,376,356,410,417,271,639,518,578,476,-121,368,-489
292,530000,3d7554f1f56dd664,1,1,306,222,275,246,290,259,337,266,368,334,609,519,564,487,-90,275,-365
175,150000,3d7554f1f56dd664,1,1,260,125,189,191,270,175,231,216,208,216,370,337,354,308,-33,154,-187
368,110000,3d7554f1f56dd664,1,1,449,209,527,412,406,405,459,464,449,231,675,811,743,572,136,444,-308
657,510000,3d7554f1f56dd664,1,1,757,504,885,758,701,656,684,758,1227,469,1053,1125,1089,882,72,584,-512
301,340000,3d7554f1f56dd664,1,1,275,169,202,232,224,252,293,358,325,253,574,507,540,445,-67,321,-388
775,370000,3d7554f1f56dd664,1,1,890,445,807,1100,977,862,990,917,1222,876,1567,1574,1570,1339,7,691,-684
290,140000,3d7554f1f56dd664,1,1,387,164,299,314,339,253,284,382,372,320,590,571,580,494,-19,270,-289
5136,440000,3d7554f1f56dd664,1,1,8330,2585,8611,7234,9327,8266,8709,10596,10140,6925,13598,11515,12556,10679,-2083,6673,-8756
750,450000,3d7554f1f56dd664,1,1,801,411,855,658,835,723,792,866,969,642,1386,1258,1322,1095,-128,744,-872
1445,320000,3d7554f1f56dd664,1,1,1685,1328,2057,1655,2026,1678,1827,2216,2075,1763,3112,2877,2994,2584,-235,1349,-1584
435,360000,3d7554f1f56dd664,1,1,393,167,359,359,396,344,400,420,535,356,595,741,668,564,146,239,-93
498,130000,3d7554f1f56dd664,1,1,788,354,516,591,633,520,604,569,722,520,1137,974,1056,877,-163,617,-780
645,410000,3d7554f1f56dd664,1,1,850,396,544,698,673,695,718,785,808,565,1273,1234,1254,1024,-39,708,-747
1135,330000,3d7554f1f56dd664,1,1,1438,1026,1659,1539,1625,1420,1737,1785,1658,1293,2709,2467,2588,2156,-242,1416,-1658
703,420000,3d7554f1f56dd664,1,1,762,375,804,713,668,835,675,883,908,742,1001,1050,1026,931,49,259,-210
689,430000,3d7554f1f56dd664,1,1,678,402,678,683,657,625,567,721,958,582,1112,1192,1152,962,80,530,-450
856,350000,3d7554f1f56dd664,1,1,1115,577,1254,1127,1467,1202,1533,1388,1310,817,2205,1578,1892,1533,-627,1388,-2015
1110,210000,3d7554f1f56dd664,1,1,1304,783,1838,1870,2279,1544,2253,2301,1915,1064,2892,2161,2526,2039,-731,1828,-2559
244,500000,3d7554f1f56dd664,1,1,188,130,218,213,199,327,300,319,331,173,470,398,434,347,-72,297,-369
340,610000,3d7554f1f56dd664,1,1,240,138,255,320,486,412,553,492,462,375,582,607,594,521,25,207,-182
447,230000,3d7554f1f56dd664,1,1,467,291,946,626,765,687,670,1107,843,480,1076,1018,1047,858,-58,596,-654
157,310000,2d0d2c3403909fdb,1,1,232,77,213,184,219,211,160,159,169,112,163,167,165,147,4,51,-47
290,530000,2d0d2c3403909fdb,1,1,297,206,253,260,265,254,351,309,270,218,354,350,352,307,-4,136,-140
279,150000,2d0d2c3403909fdb,1,1,259,91,210,228,261,237,261,246,234,155,184,233,208,191,49,29,20
549,110000,2d0d2c3403909fdb,1,1,805,257,551,670,627,552,633,554,583,457,611,677,644,582,66,154,-88
516,510000,2d0d2c3403909fdb,1,1,423,187,348,327,372,413,373,319,387,300,411,434,422,382,23,111,-88
176,340000,2d0d2c3403909fdb,1,1,138,64,119,116,119,126,118,108,157,129,128,138,133,132,10,-1,11
420,370000,2d0d2c3403909fdb,1,1,337,152,316,317,345,393,358,328,376,327,415,400,408,381,-15,88,-103
179,140000,2d0d2c3403909fdb,1,1,166,63,160,161,165,161,170,152,135,111,141,197,169,150,56,30,26
1713,440000,2d0d2c3403909fdb,1,1,1775,549,1579,1472,1652,1649,1691,1490,1683,1421,1989,1829,1909,1746,-160,568,-728
211,450000,2d0d2c3403909fdb,1,1,207,109,184,157,187,179,178,141,192,165,181,173,177,173,-8,16,-24
470,320000,2d0d2c3403909fdb,1,1,463,218,361,393,413,417,373,340,401,333,437,427,432,399,-10,104,-114
126,360000,2d0d2c3403909fdb,1,1,97,40,75,95,119,89,94,84,108,90,107,109,108,102,2,17,-15
389,130000,2d0d2c3403909fdb,1,1,326,139,233,302,305,302,324,321,309,274,302,328,315,301,26,28,-2
377,410000,2d0d2c3403909fdb,1,1,271,172,259,323,298,340,309,300,327,262,352,337,344,317,-15,90,-105
401,330000,2d0d2c3403909fdb,1,1,381,174,327,357,357,351,316,352,336,342,428,424,426,398,-4,86,-90
321,420000,2d0d2c3403909fdb,1,1,226,130,210,242,242,268,203,201,303,211,267,280,274,253,13,56,-43
284,430000,2d0d2c3403909fdb,1,1,259,118,212,237,248,277,255,193,250,211,244,275,260,243,31,33,-2
167,350000,2d0d2c3403909fdb,1,1,137,66,105,124,113,128,123,95,124,106,151,157,154,138,6,45,-39
506,210000,2d0d2c3403909fdb,1,1,543,246,417,495,542,501,506,466,488,346,464,567,516,459,103,118,-15
213,500000,2d0d2c3403909fdb,1,1,172,105,176,130,156,186,166,134,169,138,184,155,170,159,-29,46,-75
297,610000,2d0d2c3403909fdb,1,1,248,114,253,239,271,255,273,253,271,195,252,267,260,238,15,57,-42
315,230000,2d0d2c3403909fdb,1,1,362,187,216,276,357,324,293,304,239,208,258,336,297,267,78,50,28
117,310000,a28bb927b6fcb33c,1,1,243,118,232,238,251,282,229,249,216,166,212,210,211,196,-2,46,-48
173,530000,a28bb927b6fcb33c,1,1,238,105,163,123,154,116,231,232,256,209,270,308,289,262,38,61,-23
89,150000,a28bb927b6fcb33c,1,1,190,69,114,106,123,97,118,134,193,128,165,176,170,156,11,37,-26
136,110000,a28bb927b6fcb33c,1,1,335,190,324,305,237,267,308,309,286,179,246,342,294,256,96,67,29
351,510000,a28bb927b6fcb33c,1,1,528,292,452,413,430,414,426,492,712,401,438,436,437,425,-2,37,-39
264,340000,a28bb927b6fcb33c,1,1,308,191,244,230,261,218,300,368,358,250,325,348,336,308,23,75,-52
225,370000,a28bb927b6fcb33c,1,1,424,173,389,484,405,407,399,489,606,454,468,556,512,493,88,14,74
92,140000,a28bb927b6fcb33c,1,1,182,74,128,130,124,127,123,233,187,181,144,181,162,169,37,-37,74
2391,440000,a28bb927b6fcb33c,1,1,4260,1368,3766,3317,3840,3624,4020,4618,5211,4012,4216,4195,4206,4141,-21,204,-225
248,450000,a28bb927b6fcb33c,1,1,414,192,344,277,350,329,360,409,444,331,432,386,409,383,-46,101,-147
680,320000,a28bb927b6fcb33c,1,1,902,507,940,829,888,876,892,1148,1130,943,1033,1154,1094,1043,121,90,31
208,360000,a28bb927b6fcb33c,1,1,248,140,184,170,221,210,194,288,380,260,302,351,326,304,49,42,7
248,130000,a28bb927b6fcb33c,1,1,409,191,358,362,423,480,475,550,584,385,397,419,408,400,22,12,10
338,410000,a28bb927b6fcb33c,1,1,455,244,376,449,371,468,562,658,673,556,567,651,609,591,84,11,73
747,330000,a28bb927b6fcb33c,1,1,1040,511,990,1039,1012,1006,1138,1244,1296,1228,1343,1310,1326,1294,-33,115,-148
450,420000,a28bb927b6fcb33c,1,1,675,282,547,533,457,595,544,655,744,726,677,787,732,730,110,-49,159
394,430000,a28bb927b6fcb33c,1,1,547,238,482,529,476,494,503,610,619,436,474,674,574,528,200,38,162
231,350000,a28bb927b6fcb33c,1,1,464,152,423,426,506,417,546,535,615,563,615,519,567,566,-96,52,-148
213,210000,a28bb927b6fcb33c,1,1,649,305,554,649,665,803,867,1031,840,522,652,848,750,674,196,130,66
123,500000,a28bb927b6fcb33c,1,1,187,100,193,183,200,348,324,316,208,150,157,208,182,172,51,7,44
148,610000,a28bb927b6fcb33c,1,1,259,112,192,194,239,237,272,274,262,219,225,317,271,254,92,6,86
90,230000,a28bb927b6fcb33c,1,1,291,125,253,261,255,248,232,335,334,222,288,303,296,271,15,66,-51
199,310000,17bc272c93f19d56,1,1,365,138,302,182,202,234,212,256,234,168,249,477,363,298,228,81,147
4785,530000,17bc272c93f19d56,1,1,4147,2559,2705,2130,2397,2353,2868,2565,3307,3096,3216,4503,3860,3605,1287,120,1167
504,150000,17bc272c93f19d56,1,1,567,257,434,313,361,329,346,368,502,360,520,675,598,518,155,160,-5
151,110000,17bc272c93f19d56,1,1,456,125,304,246,278,163,179,202,242,199,305,514,410,339,209,106,103
1724,510000,17bc272c93f19d56,1,1,1772,1289,1498,1056,1064,1118,1183,1230,1449,1007,1411,1954,1682,1457,543,404,139
2152,340000,17bc272c93f19d56,1,1,2289,1946,1532,1224,1396,1210,1260,1418,1458,1238,1535,2328,1932,1700,793,297,496
4483,370000,17bc272c93f19d56,1,1,5481,3478,2813,2653,3587,2963,3398,3600,3519,3268,3907,6576,5242,4584,2669,639,2030
2093,140000,17bc272c93f19d56,1,1,2166,1096,1300,1076,1493,1193,1334,1452,1749,1354,1585,2844,2214,1928,1259,231,1028
1611,440000,17bc272c93f19d56,1,1,2118,794,1712,1309,1820,1577,1457,1550,1999,1555,2007,3029,2518,2197,1022,452,570
3084,450000,17bc272c93f19d56,1,1,4779,2843,2715,1831,2371,1991,2051,2291,2515,2293,2687,4443,3565,3141,1756,394,1362
2165,320000,17bc272c93f19d56,1,1,2358,1736,2075,1392,1679,1539,1776,1799,1764,1493,1942,3067,2504,2167,1125,449,676
1290,360000,17bc272c93f19d56,1,1,1882,1085,1047,877,1066,892,885,890,1111,824,980,1510,1245,1105,530,156,374
3870,130000,17bc272c93f19d56,1,1,4112,2579,2548,2351,2960,2437,2748,3368,3303,2808,3641,6231,4936,4227,2590,833,1757
5825,410000,17bc272c93f19d56,1,1,7051,4158,3545,2891,3967,3302,3413,3591,3584,3821,4668,7650,6159,5380,2982,847,2135
1260,330000,17bc272c93f19d56,1,1,1411,1111,1340,943,1216,1213,1206,1016,1295,1112,1294,2062,1678,1489,768,182,586
1919,420000,17bc272c93f19d56,1,1,1923,1058,1238,1013,1221,954,900,992,1202,958,1353,2198,1776,1503,845,395,450
2364,430000,17bc272c93f19d56,1,1,2637,1476,1924,1609,1715,1491,1500,1678,1773,1354,1770,2693,2232,1939,923,416,507
592,350000,17bc272c93f19d56,1,1,670,399,702,458,576,545,512,565,573,523,688,892,790,701,204,165,39
924,210000,17bc272c93f19d56,1,1,1203,557,1124,894,1170,1034,1023,1010,1135,824,1154,1710,1432,1229,556,330,226
250,500000,17bc272c93f19d56,1,1,370,194,204,191,258,225,203,204,284,201,250,357,304,269,107,49,58
2072,610000,17bc272c93f19d56,1,1,2683,1145,1221,1008,1213,1083,1173,1245,1658,1590,1877,3217,2547,2228,1340,287,1053
506,230000,17bc272c93f19d56,1,1,721,458,819,646,736,776,785,835,795,518,816,982,899,772,166,298,-132
382,310000,2a2ab41f8f6ff1cb,1,1,431,80,202,198,232,330,331,445,555,272,582,623,602,492,41,310,-269
484,530000,2a2ab41f8f6ff1cb,1,1,248,178,199,246,327,333,428,409,543,553,546,680,613,593,134,-7,141
551,150000,2a2ab41f8f6ff1cb,1,1,939,321,444,472,638,517,552,645,831,715,836,832,834,794,-4,121,-125
212,110000,2a2ab41f8f6ff1cb,1,1,458,72,162,260,324,331,345,369,502,362,440,598,519,467,158,78,80
1223,510000,2a2ab41f8f6ff1cb,1,1,1221,607,864,847,961,1004,1032,1165,1460,1050,1385,1850,1618,1428,465,335,130
1515,340000,2a2ab41f8f6ff1cb,1,1,1440,758,744,849,934,1047,1058,1409,1565,1256,1491,1666,1578,1471,175,235,-60
1706,370000,2a2ab41f8f6ff1cb,1,1,1657,614,897,1413,1635,1575,1773,2139,2580,2061,2146,2737,2442,2315,591,85,506
533,140000,2a2ab41f8f6ff1cb,1,1,639,250,365,433,477,430,532,655,690,724,762,993,878,826,231,38,193
5607,440000,2a2ab41f8f6ff1cb,1,1,6442,1441,3854,3887,5187,5010,5237,6544,8215,6582,6734,6492,6613,6603,-242,152,-394
799,450000,2a2ab41f8f6ff1cb,1,1,719,385,570,472,589,632,639,680,913,743,853,894,874,830,41,110,-69
1728,320000,2a2ab41f8f6ff1cb,1,1,2063,799,1459,1467,1717,1679,1859,2252,2410,2283,2584,2672,2628,2513,88,301,-213
1027,360000,2a2ab41f8f6ff1cb,1,1,1070,496,549,619,761,704,848,964,1340,1065,1086,1291,1188,1147,205,21,184
2119,130000,2a2ab41f8f6ff1cb,1,1,1775,770,1146,1445,1808,1966,2293,2864,3253,2277,2327,2703,2515,2436,376,50,326
2952,410000,2a2ab41f8f6ff1cb,1,1,2481,1247,1386,1910,2169,2264,2690,3318,3446,2827,2797,3447,3122,3024,650,-30,680
795,330000,2a2ab41f8f6ff1cb,1,1,1156,264,593,721,949,928,974,1151,1369,1262,1632,1972,1802,1622,340,370,-30
1566,420000,2a2ab41f8f6ff1cb,1,1,1769,799,1011,1012,1027,1207,1181,1412,1938,1686,1663,2151,1907,1833,488,-23,511
1651,430000,2a2ab41f8f6ff1cb,1,1,1843,832,1249,1396,1570,1605,1889,1918,2573,2247,1966,2770,2368,2328,804,-281,1085
264,350000,2a2ab41f8f6ff1cb,1,1,356,83,172,208,292,259,301,348,390,371,447,476,462,431,29,76,-47
241,210000,2a2ab41f8f6ff1cb,1,1,299,109,187,283,311,261,323,369,397,317,403,513,458,411,110,86,24
803,500000,2a2ab41f8f6ff1cb,1,1,771,312,479,530,585,806,750,810,888,646,803,1149,976,866,346,157,189
620,610000,2a2ab41f8f6ff1cb,1,1,524,176,306,358,387,403,502,566,687,665,655,845,750,722,190,-10,200
399,230000,2a2ab41f8f6ff1cb,1,1,605,218,468,492,550,570,602,652,669,544,740,1032,886,772,292,196,96
1265,310000,c06a2a387c0ee510,1,1,1178,527,1063,994,1124,945,1154,1068,958,710,977,1212,1094,966,235,267,-32
104,530000,c06a2a387c0ee510,1,1,77,43,70,57,124,99,83,62,79,45,66,119,92,77,53,21,32
86,150000,c06a2a387c0ee510,1,1,67,19,65,50,51,85,56,51,54,43,56,75,66,58,19,13,6
1352,110000,c06a2a387c0ee510,1,1,1071,361,867,872,926,824,1014,976,1027,677,793,1627,1210,1032,834,116,718
208,510000,c06a2a387c0ee510,1,1,156,82,223,166,175,144,210,234,199,102,145,321,233,189,176,43,133
253,340000,c06a2a387c0ee510,1,1,149,96,149,190,155,149,157,167,182,145,176,251,214,191,75,31,44
878,370000,c06a2a387c0ee510,1,1,635,335,562,729,614,644,701,698,710,494,739,1047,893,760,308,245,63
165,140000,c06a2a387c0ee510,1,1,133,53,106,96,90,115,93,101,121,83,105,184,144,124,79,22,57
762,440000,c06a2a387c0ee510,1,1,585,183,472,491,557,511,479,453,514,463,571,819,695,618,248,108,140
92,450000,c06a2a387c0ee510,1,1,58,32,56,38,32,27,46,65,36,87,45,96,70,76,51,-42,93
974,320000,c06a2a387c0ee510,1,1,739,394,680,808,786,664,704,653,923,563,731,1002,866,765,271,168,103
118,360000,c06a2a387c0ee510,1,1,91,42,55,107,79,54,83,56,89,43,74,97,86,71,23,31,-8
470,130000,c06a2a387c0ee510,1,1,250,130,229,240,232,241,288,302,284,232,288,493,390,338,205,56,149
517,410000,c06a2a387c0ee510,1,1,383,182,314,390,376,374,353,356,387,282,366,596,481,415,230,84,146
534,330000,c06a2a387c0ee510,1,1,395,262,365,466,382,390,895,578,350,278,533,736,634,516,203,255,-52
151,420000,c06a2a387c0ee510,1,1,109,47,93,139,123,130,108,119,115,66,94,173,134,111,79,28,51
101,430000,c06a2a387c0ee510,1,1,80,46,72,140,72,59,68,91,68,60,83,119,101,87,36,23,13
123,350000,c06a2a387c0ee510,1,1,77,35,128,219,92,103,107,123,99,106,97,170,134,124,73,-9,82
181,210000,c06a2a387c0ee510,1,1,160,72,139,266,153,169,211,178,184,111,151,300,226,187,149,40,109
60,500000,c06a2a387c0ee510,1,1,81,39,102,106,65,63,75,66,120,43,58,100,79,67,42,15,27
234,610000,c06a2a387c0ee510,1,1,175,81,169,185,153,156,195,228,164,136,164,313,238,204,149,28,121
129,230000,c06a2a387c0ee510,1,1,108,54,90,127,69,65,102,113,130,76,95,177,136,116,82,19,63
325,310000,7023efdab9cedc03,1,1,992,253,606,561,484,494,547,504,605,431,543,697,620,557,154,112,42
40,530000,7023efdab9cedc03,1,1,191,100,83,82,70,56,86,60,80,64,106,112,109,94,6,42,-36
31,150000,7023efdab9cedc03,1,1,102,48,55,66,70,55,54,65,50,48,60,75,68,61,15,12,3
40,110000,7023efdab9cedc03,1,1,210,76,141,177,131,96,96,105,107,59,86,132,109,92,46,27,19
216,510000,7023efdab9cedc03,1,1,429,195,188,226,211,185,192,194,379,187,278,408,343,291,130,91,39
357,340000,7023efdab9cedc03,1,1,762,275,330,375,352,304,284,383,452,363,447,587,517,466,140,84,56
320,370000,7023efdab9cedc03,1,1,898,281,405,655,512,403,384,434,524,437,477,555,516,490,78,40,38
30,140000,7023efdab9cedc03,1,1,114,28,50,77,84,53,53,40,61,59,55,64,60,59,9,-4,13
121,440000,7023efdab9cedc03,1,1,609,57,219,282,274,225,205,191,284,225,342,408,375,325,66,117,-51
68,450000,7023efdab9cedc03,1,1,170,66,75,77,81,56,48,72,86,66,86,129,108,94,43,20,23
893,320000,7023efdab9cedc03,1,1,1906,974,1119,1203,1261,881,934,1240,1311,1156,1271,1767,1519,1398,496,115,381
169,360000,7023efdab9cedc03,1,1,344,118,149,241,252,167,187,201,205,175,224,302,263,234,78,49,29
80,130000,7023efdab9cedc03,1,1,279,88,169,204,145,156,130,129,149,129,127,215,171,157,88,-2,90
183,410000,7023efdab9cedc03,1,1,558,189,277,347,264,222,222,264,300,257,320,368,344,315,48,63,-15
445,330000,7023efdab9cedc03,1,1,1566,633,762,810,793,638,611,791,867,742,941,1163,1052,949,222,199,23
211,420000,7023efdab9cedc03,1,1,453,152,191,266,209,221,204,189,253,233,287,401,344,307,114,54,60
201,430000,7023efdab9cedc03,1,1,459,160,191,256,228,177,169,202,213,182,259,315,287,252,56,77,-21
54,350000,7023efdab9cedc03,1,1,237,56,96,99,97,66,59,77,86,70,117,145,131,111,28,47,-19
28,210000,7023efdab9cedc03,1,1,158,40,89,169,79,56,94,56,78,81,68,104,86,84,36,-13,49
28,500000,7023efdab9cedc03,1,1,81,39,57,50,37,61,45,63,77,40,57,62,60,53,5,17,-12
107,610000,7023efdab9cedc03,1,1,275,100,108,169,156,96,102,126,137,141,113,177,145,144,64,-28,92
11,230000,7023efdab9cedc03,1,1,38,20,36,50,45,25,30,29,39,29,28,30,29,29,2,-1,3
940,310000,af6f4f548684e14d,1,1,1572,511,1006,969,925,835,829,878,839,851,1537,1734,1636,1374,197,686,-489
400,530000,af6f4f548684e14d,1,1,612,360,410,333,370,297,444,406,375,464,639,732,686,612,93,175,-82
322,150000,af6f4f548684e14d,1,1,463,213,302,350,427,288,345,346,426,433,493,573,533,500,80,60,20
659,110000,af6f4f548684e14d,1,1,895,307,553,585,621,593,551,572,648,532,915,1057,986,835,142,383,-241
1072,510000,af6f4f548684e14d,1,1,1417,680,747,869,835,754,816,821,1394,1020,1293,1876,1584,1396,583,273,310
1015,340000,af6f4f548684e14d,1,1,1219,528,678,800,749,648,689,782,938,1018,1287,1597,1442,1301,310,269,41
1077,370000,af6f4f548684e14d,1,1,2241,744,1062,1662,1314,1119,1240,1232,1497,1547,1722,2394,2058,1888,672,175,497
375,140000,af6f4f548684e14d,1,1,677,222,358,423,462,359,317,365,407,489,581,742,662,604,161,92,69
949,440000,af6f4f548684e14d,1,1,2250,484,919,955,1092,904,1023,986,1197,1508,2163,2594,2378,2088,431,655,-224
341,450000,af6f4f548684e14d,1,1,594,202,368,262,320,307,308,261,338,373,502,713,608,529,211,129,82
1466,320000,af6f4f548684e14d,1,1,2192,1018,1351,1369,1459,1195,1141,1497,1413,1635,2059,2647,2353,2114,588,424,164
753,360000,af6f4f548684e14d,1,1,1062,383,549,710,757,635,717,687,798,900,1083,1527,1305,1170,444,183,261
691,130000,af6f4f548684e14d,1,1,1028,449,745,695,817,660,609,745,771,828,1012,1235,1124,1025,223,184,39
1000,410000,af6f4f548684e14d,1,1,1627,672,938,1124,951,899,929,998,1228,1191,1470,2122,1796,1594,652,279,373
1003,330000,af6f4f548684e14d,1,1,1657,604,799,913,926,862,813,942,1042,1090,1626,2068,1847,1595,442,536,-94
1025,420000,af6f4f548684e14d,1,1,1510,552,799,894,947,966,785,977,1135,1284,1519,1632,1576,1478,113,235,-122
1217,430000,af6f4f548684e14d,1,1,1650,634,928,1065,1061,902,924,1034,1175,1168,1619,2178,1898,1655,559,451,108
522,350000,af6f4f548684e14d,1,1,850,264,347,323,473,273,417,426,426,568,767,913,840,749,146,199,-53
254,210000,af6f4f548684e14d,1,1,446,195,288,386,363,316,315,365,365,407,443,594,518,481,151,36,115
420,500000,af6f4f548684e14d,1,1,540,203,303,331,291,407,357,329,386,354,500,762,631,539,262,146,116
365,610000,af6f4f548684e14d,1,1,746,267,401,396,383,263,316,283,360,444,478,651,564,524,173,34,139
142,230000,af6f4f548684e14d,1,1,266,123,274,347,288,202,213,233,201,203,289,372,330,288,83,86,-3
635,310000,7cf283430b3b5e38,1,1,1709,545,1276,1391,1398,1353,1616,1715,1560,1261,1546,1428,1487,1412,-118,285,-403
249,530000,7cf283430b3b5e38,1,1,390,240,300,304,335,298,451,462,412,350,412,626,519,463,214,62,152
285,150000,7cf283430b3b5e38,1,1,558,212,323,304,432,328,313,335,434,451,516,701,608,556,185,65,120
106,110000,7cf283430b3b5e38,1,1,334,101,202,284,280,232,247,248,278,174,264,913,588,450,649,90,559
1134,510000,7cf283430b3b5e38,1,1,1710,1083,1323,1763,1713,1549,1800,1833,2351,1555,1783,2691,2237,2010,908,228,680
1607,340000,7cf283430b3b5e38,1,1,2375,1182,1314,1838,2005,1957,2071,2572,2578,2110,2138,2356,2247,2201,218,28,190
2048,370000,7cf283430b3b5e38,1,1,3723,1428,1837,3584,3723,2665,3185,3623,4079,3911,3787,4830,4308,4176,1043,-124,1167
317,140000,7cf283430b3b5e38,1,1,646,264,390,562,695,612,635,770,774,678,852,1073,962,868,221,174,47
695,440000,7cf283430b3b5e38,1,1,1777,393,1288,1748,2151,1841,2105,2230,2219,1912,2435,2500,2468,2282,65,523,-458
475,450000,7cf283430b3b5e38,1,1,677,309,481,401,605,509,467,597,723,646,783,869,826,766,86,137,-51
2657,320000,7cf283430b3b5e38,1,1,4998,2924,3351,4265,5237,4119,4343,5439,5089,5170,5016,5865,5440,5350,849,-154,1003
923,360000,7cf283430b3b5e38,1,1,1261,548,685,1136,1339,997,1282,1228,1446,1175,1376,1737,1556,1429,361,201,160
900,130000,7cf283430b3b5e38,1,1,1931,954,1178,1462,1915,1717,1730,2030,2166,1672,1926,2621,2274,2073,695,254,441
1683,410000,7cf283430b3b5e38,1,1,2603,1210,1347,2464,2148,2124,2569,3033,2794,2644,2874,3243,3058,2920,369,230,139
1289,330000,7cf283430b3b5e38,1,1,3101,1398,2016,2464,3027,2635,2644,3079,3258,3003,3295,3490,3392,3263,195,292,-97
929,420000,7cf283430b3b5e38,1,1,1782,664,796,1212,1354,1346,1388,1694,1779,1500,1547,1624,1586,1557,77,47,30
989,430000,7cf283430b3b5e38,1,1,1687,733,970,1484,1556,1388,1464,1556,1793,1457,1585,1952,1768,1665,367,128,239
546,350000,7cf283430b3b5e38,1,1,893,228,546,695,1147,600,1040,913,859,836,1130,958,1044,975,-172,294,-466
205,210000,7cf283430b3b5e38,1,1,589,209,435,639,553,466,570,710,667,540,619,821,720,660,202,79,123
296,500000,7cf283430b3b5e38,1,1,370,225,233,248,344,487,446,463,501,422,419,597,508,479,178,-3,181
413,610000,7cf283430b3b5e38,1,1,741,258,403,620,717,590,762,830,880,891,912,1151,1032,985,239,21,218
118,230000,7cf283430b3b5e38,1,1,299,175,240,355,391,233,247,332,298,250,347,415,381,337,68,97,-29
79,310000,d4efbebb087fd03f,1,1,204,38,145,116,132,121,130,170,225,144,225,270,248,213,45,81,-36
296,530000,d4efbebb087fd03f,1,1,184,103,104,130,150,124,141,193,215,192,267,384,326,281,117,75,42
248,150000,d4efbebb087fd03f,1,1,389,174,191,134,180,155,165,211,257,237,359,450,404,349,91,122,-31
118,110000,d4efbebb087fd03f,1,1,207,72,213,666,671,764,635,596,755,684,938,1287,1112,970,349,254,95
1326,510000,d4efbebb087fd03f,1,1,955,807,671,665,754,743,840,1135,1134,707,1002,2805,1904,1505,1803,295,1508
903,340000,d4efbebb087fd03f,1,1,792,626,432,458,431,427,626,807,752,716,977,1443,1210,1045,466,261,205
1878,370000,d4efbebb087fd03f,1,1,1924,1342,1025,1289,1432,1325,1510,2013,2253,1752,2198,3785,2992,2578,1587,446,1141
603,140000,d4efbebb087fd03f,1,1,452,270,276,293,383,273,396,591,635,370,1993,2925,2459,1763,932,1623,-691
914,440000,d4efbebb087fd03f,1,1,1224,289,994,1031,1203,1183,1216,1851,1526,1065,2044,2419,2232,1843,375,979,-604
666,450000,d4efbebb087fd03f,1,1,498,276,260,250,385,389,373,565,452,368,493,935,714,599,442,125,317
910,320000,d4efbebb087fd03f,1,1,1062,779,828,897,1057,971,1038,1263,1231,1184,1531,2308,1920,1674,777,347,430
999,360000,d4efbebb087fd03f,1,1,1049,652,459,469,546,479,591,657,831,701,917,1377,1147,998,460,216,244
1110,130000,d4efbebb087fd03f,1,1,919,741,471,479,696,616,754,991,941,754,1144,2067,1606,1322,923,390,533
2272,410000,d4efbebb087fd03f,1,1,2130,1382,887,1161,1258,1321,1528,1922,1491,1090,1965,3560,2762,2205,1595,875,720
1028,330000,d4efbebb087fd03f,1,1,1779,823,1584,1570,1718,1900,1877,2534,1978,2287,3147,4324,3736,3253,1177,860,317
1004,420000,d4efbebb087fd03f,1,1,890,443,424,420,420,475,487,636,528,521,941,1534,1238,999,593,420,173
1133,430000,d4efbebb087fd03f,1,1,1524,937,896,945,1034,885,1014,1148,1102,762,1142,1719,1430,1208,577,380,197
434,350000,d4efbebb087fd03f,1,1,671,190,590,596,665,596,710,861,605,468,762,1967,1364,1066,1205,294,911
199,210000,d4efbebb087fd03f,1,1,214,132,202,209,189,242,328,373,319,239,291,520,406,350,229,52,177
432,500000,d4efbebb087fd03f,1,1,378,271,206,305,265,352,383,500,317,253,326,532,429,370,206,73,133
919,610000,d4efbebb087fd03f,1,1,927,421,382,511,669,670,984,1191,1013,830,1010,1651,1330,1164,641,180,461
135,230000,d4efbebb087fd03f,1,1,193,79,88,79,102,96,114,179,154,114,204,257,230,192,53,90,-37
63,310000,7245e0ee27b195cd,1,1,78,23,47,54,61,91,84,82,78,75,125,158,142,119,33,50,-17
421,530000,7245e0ee27b195cd,1,1,341,217,206,208,229,212,242,297,409,425,375,535,455,445,160,-50,210
363,150000,7245e0ee27b195cd,1,1,352,150,198,157,157,141,155,186,321,287,448,676,562,470,228,161,67
86,110000,7245e0ee27b195cd,1,1,235,72,142,158,142,166,192,229,328,289,360,496,428,382,136,71,65
724,510000,7245e0ee27b195cd,1,1,756,453,466,458,502,542,612,740,894,870,831,1260,1046,987,429,-39,468
576,340000,7245e0ee27b195cd,1,1,363,266,304,266,327,272,360,423,570,478,510,806,658,598,296,32,264
1529,370000,7245e0ee27b195cd,1,1,1789,1114,946,977,950,814,1067,1385,1544,1660,1778,2915,2346,2118,1137,118,1019
615,140000,7245e0ee27b195cd,1,1,429,225,305,328,438,304,387,526,657,689,668,1092,880,816,424,-21,445
718,440000,7245e0ee27b195cd,1,1,641,221,467,644,800,706,726,1003,987,1170,1384,1437,1410,1330,53,214,-161
452,450000,7245e0ee27b195cd,1,1,285,206,238,200,244,215,205,275,336,321,463,659,561,481,196,142,54
543,320000,7245e0ee27b195cd,1,1,444,284,374,406,417,417,424,503,619,691,743,1008,876,814,265,52,213
634,360000,7245e0ee27b195cd,1,1,527,325,271,316,324,321,323,384,576,518,577,816,696,637,239,59,180
1304,130000,7245e0ee27b195cd,1,1,1277,883,734,754,897,796,976,1190,1442,1308,1432,2365,1898,1702,933,124,809
1526,410000,7245e0ee27b195cd,1,1,1463,751,731,764,796,796,921,1180,1362,1148,1406,2228,1817,1594,822,258,564
438,330000,7245e0ee27b195cd,1,1,450,256,491,555,599,497,546,656,656,660,874,1121,998,885,247,214,33
635,420000,7245e0ee27b195cd,1,1,427,284,280,340,316,308,353,445,594,534,655,903,779,697,248,121,127
773,430000,7245e0ee27b195cd,1,1,899,477,571,590,590,570,561,665,852,609,763,1216,990,863,453,154,299
249,350000,7245e0ee27b195cd,1,1,201,95,214,227,185,203,218,279,280,218,239,420,330,292,181,21,160
287,210000,7245e0ee27b195cd,1,1,295,149,240,267,276,253,308,361,450,328,514,641,578,494,127,186,-59
296,500000,7245e0ee27b195cd,1,1,218,155,141,187,187,221,263,289,325,272,292,402,347,322,110,20,90
815,610000,7245e0ee27b195cd,1,1,785,388,397,433,446,383,562,667,705,729,755,1158,956,881,403,26,377
166,230000,7245e0ee27b195cd,1,1,272,131,179,118,155,141,189,179,249,176,328,336,332,280,8,152,-144
180,310000,8c915fe4632fb9fa,1,1,320,130,160,94,156,130,143,149,181,158,314,461,388,311,147,156,-9
1059,530000,8c915fe4632fb9fa,1,1,785,338,404,239,336,248,387,336,447,627,757,1396,1076,927,639,130,509
520,150000,8c915fe4632fb9fa,1,1,363,137,199,117,165,174,186,216,287,324,527,720,624,524,193,203,-10
101,110000,8c915fe4632fb9fa,1,1,362,109,157,85,99,100,137,177,237,199,242,487,364,309,245,43,202
1860,510000,8c915fe4632fb9fa,1,1,1794,901,983,554,759,618,741,845,1263,1243,1605,2433,2019,1760,828,362,466
1440,340000,8c915fe4632fb9fa,1,1,1233,660,594,483,561,546,651,840,1069,1269,1370,2298,1834,1646,928,101,827
2217,370000,8c915fe4632fb9fa,1,1,1412,621,625,585,723,768,927,999,1485,1686,2126,3804,2965,2539,1678,440,1238
772,140000,8c915fe4632fb9fa,1,1,494,232,272,166,255,224,271,379,496,642,748,1215,982,868,467,106,361
1040,440000,8c915fe4632fb9fa,1,1,1574,298,728,449,600,502,550,650,835,848,1467,2021,1744,1445,554,619,-65
738,450000,8c915fe4632fb9fa,1,1,527,174,351,170,257,240,225,284,342,388,511,880,696,593,369,123,246
1540,320000,8c915fe4632fb9fa,1,1,1591,861,985,648,883,678,762,1001,1116,1451,1816,2525,2170,1931,709,365,344
1015,360000,8c915fe4632fb9fa,1,1,905,504,443,270,410,377,409,440,725,733,889,1320,1104,981,431,156,275
1882,130000,8c915fe4632fb9fa,1,1,1293,623,634,487,781,785,958,1014,1437,1548,2026,3281,2654,2285,1255,478,777
2324,410000,8c915fe4632fb9fa,1,1,1515,786,582,542,634,719,857,953,1313,1473,1843,2975,2409,2097,1132,370,762
958,330000,8c915fe4632fb9fa,1,1,1861,640,897,591,746,723,731,805,1089,1175,1502,2235,1868,1637,733,327,406
1148,420000,8c915fe4632fb9fa,1,1,1123,492,599,444,503,489,505,669,868,924,1339,1557,1448,1273,218,415,-197
1235,430000,8c915fe4632fb9fa,1,1,1080,399,488,309,371,399,407,438,633,772,835,1281,1058,963,446,63,383
518,350000,8c915fe4632fb9fa,1,1,489,190,303,174,227,178,234,282,307,414,622,877,750,638,255,208,47
311,210000,8c915fe4632fb9fa,1,1,351,155,236,155,177,191,236,231,291,296,396,542,469,411,146,100,46
489,500000,8c915fe4632fb9fa,1,1,459,252,295,169,207,227,218,259,311,316,419,666,542,467,247,103,144
1036,610000,8c915fe4632fb9fa,1,1,709,331,283,202,287,271,303,362,519,627,715,1549,1132,964,834,88,746
401,230000,8c915fe4632fb9fa,1,1,587,248,377,252,344,319,336,422,442,411,616,998,807,675,382,205,177
423,310000,6155b214590c66e6,1,1,871,360,517,534,459,422,464,522,661,472,781,1047,914,767,266,309,-43
1354,530000,6155b214590c66e6,1,1,1704,825,894,856,985,706,939,877,1084,1148,1159,1879,1519,1395,720,11,709
814,150000,6155b214590c66e6,1,1,744,297,457,492,583,433,551,578,725,701,941,1442,1192,1028,501,240,261
274,110000,6155b214590c66e6,1,1,963,297,397,406,411,391,454,496,664,474,569,1295,932,779,726,95,631
2540,510000,6155b214590c66e6,1,1,3386,1779,1779,1892,1614,1306,1417,1488,2289,1556,2162,4188,3175,2635,2026,606,1420
2495,340000,6155b214590c66e6,1,1,2327,1365,1104,1361,1443,1295,1412,1803,1996,1889,2073,3650,2862,2537,1577,184,1393
3467,370000,6155b214590c66e6,1,1,3259,1514,1781,2492,2580,2168,2583,2886,3461,3252,3594,6275,4934,4374,2681,342,2339
743,140000,6155b214590c66e6,1,1,885,293,482,602,630,509,619,652,805,800,914,1576,1245,1097,662,114,548
1784,440000,6155b214590c66e6,1,1,3438,552,1659,1766,2201,1866,1837,2246,2808,2902,3269,4342,3806,3504,1073,367,706
892,450000,6155b214590c66e6,1,1,898,312,603,500,655,477,518,574,670,621,739,1316,1028,892,577,118,459
3032,320000,6155b214590c66e6,1,1,3796,2048,2831,2838,3224,2468,2600,3230,3453,3560,3776,5864,4820,4400,2088,216,1872
1579,360000,6155b214590c66e6,1,1,1595,796,783,897,980,839,839,860,1325,1195,1285,2160,1722,1547,875,90,785
2375,130000,6155b214590c66e6,1,1,2546,1405,1287,1778,2039,1774,2024,2258,2481,2298,2594,4551,3572,3148,1957,296,1661
5309,410000,6155b214590c66e6,1,1,4567,2208,2034,2494,2508,2539,3103,3396,3571,3427,4047,8018,6032,5164,3971,620,3351
1679,330000,6155b214590c66e6,1,1,3658,1317,1705,1980,2136,1905,1897,2229,2579,2724,3014,4336,3675,3358,1322,290,1032
2049,420000,6155b214590c66e6,1,1,2416,1019,1237,1346,1186,1236,1304,1341,1747,1512,1848,3179,2514,2180,1331,336,995
2461,430000,6155b214590c66e6,1,1,2539,944,1417,1610,1468,1450,1536,1679,2187,1872,2355,3747,3051,2658,1392,483,909
596,350000,6155b214590c66e6,1,1,820,377,549,639,683,519,626,618,738,859,1140,1306,1223,1102,166,281,-115
769,210000,6155b214590c66e6,1,1,967,439,737,900,949,846,1022,1132,1218,970,1188,1784,1486,1314,596,218,378
877,500000,6155b214590c66e6,1,1,1093,523,596,660,656,695,635,655,770,622,761,1417,1089,933,656,139,517
1008,610000,6155b214590c66e6,1,1,1187,455,425,548,688,468,587,654,727,899,841,1546,1194,1095,705,-58,763
579,230000,6155b214590c66e6,1,1,797,417,638,624,692,573,663,777,675,517,944,1290,1117,917,346,427,-81
851,310000,28e29f2c03dcd84c,1,1,1357,406,900,712,656,680,680,720,820,623,807,1293,1050,908,486,184,302
509,530000,28e29f2c03dcd84c,1,1,572,255,271,184,252,242,468,405,456,394,535,639,587,523,104,141,-37
494,150000,28e29f2c03dcd84c,1,1,624,266,342,266,364,340,407,480,482,477,451,580,516,503,129,-26,155
1327,110000,28e29f2c03dcd84c,1,1,1794,612,1376,1000,1124,1019,1062,1143,1276,969,1288,2146,1717,1468,858,319,539
856,510000,28e29f2c03dcd84c,1,1,933,548,541,447,452,487,585,715,1123,634,781,1105,943,840,324,147,177
953,340000,28e29f2c03dcd84c,1,1,1168,475,554,507,478,422,472,667,840,774,803,1070,936,882,267,29,238
1329,370000,28e29f2c03dcd84c,1,1,1944,957,1035,932,915,988,988,1162,1315,1224,1513,1837,1675,1525,324,289,35
945,140000,28e29f2c03dcd84c,1,1,1214,558,679,602,669,598,604,750,729,770,798,1203,1000,924,405,28,377
423,440000,28e29f2c03dcd84c,1,1,542,134,313,221,266,335,313,351,438,425,536,825,680,595,289,111,178
179,450000,28e29f2c03dcd84c,1,1,218,128,156,79,110,114,93,121,141,135,160,243,202,179,83,25,58
1820,320000,28e29f2c03dcd84c,1,1,2309,1242,1350,1122,1198,1215,1276,1793,1838,1848,1951,2643,2297,2147,692,103,589
408,360000,28e29f2c03dcd84c,1,1,722,233,355,293,295,274,321,334,419,377,424,571,498,457,147,47,100
1604,130000,28e29f2c03dcd84c,1,1,1886,842,1063,923,1024,961,977,1321,1377,1264,1433,1923,1678,1540,490,169,321
1178,410000,28e29f2c03dcd84c,1,1,1577,731,827,723,780,738,834,1010,1081,952,1113,1482,1298,1182,369,161,208
767,330000,28e29f2c03dcd84c,1,1,1114,584,577,432,444,464,536,601,733,722,894,1112,1003,909,218,172,46
446,420000,28e29f2c03dcd84c,1,1,523,233,258,236,284,317,260,295,373,329,377,483,430,396,106,48,58
487,430000,28e29f2c03dcd84c,1,1,747,340,403,317,301,333,339,383,464,438,477,783,630,566,306,39,267
397,350000,28e29f2c03dcd84c,1,1,584,162,321,213,189,158,212,189,235,212,345,456,400,338,111,133,-22
270,210000,28e29f2c03dcd84c,1,1,263,160,216,236,253,279,277,296,261,247,251,310,280,269,59,4,55
555,500000,28e29f2c03dcd84c,1,1,800,413,369,328,342,482,408,414,486,426,491,644,568,520,153,65,88
719,610000,28e29f2c03dcd84c,1,1,789,424,439,293,395,348,388,413,568,617,622,758,690,666,136,5,131
104,230000,28e29f2c03dcd84c,1,1,183,116,156,121,150,115,124,187,159,142,152,169,160,154,17,10,7
63,310000,37aa9169b575ef79,1,1,46,35,64,37,32,39,46,46,41,395,67,117,92,193,50,-328,378
946,530000,37aa9169b575ef79,1,1,1285,757,1431,1186,1072,971,1395,1426,1254,988,1142,1590,1366,1240,448,154,294
602,150000,37aa9169b575ef79,1,1,1314,514,769,698,895,690,744,864,895,802,945,982,964,910,37,143,-106
300,110000,37aa9169b575ef79,1,1,945,466,982,803,698,717,716,794,737,477,625,985,805,696,360,148,212
1470,510000,37aa9169b575ef79,1,1,2222,1370,2758,2537,2734,2651,2620,2791,2955,1733,2221,3340,2780,2431,1119,488,631
248,340000,37aa9169b575ef79,1,1,607,352,581,410,402,479,502,552,488,424,410,575,492,470,165,-14,179
1903,370000,37aa9169b575ef79,1,1,4027,2068,3709,3356,3511,2812,3126,3130,3837,3617,3662,4024,3843,3768,362,45,317
679,140000,37aa9169b575ef79,1,1,1234,571,1176,933,1057,828,993,1217,1561,1243,1188,1616,1402,1349,428,-55,483
1196,440000,37aa9169b575ef79,1,1,1556,627,1889,1775,1785,1654,1766,1963,2010,1906,2111,2398,2254,2138,287,205,82
440,450000,37aa9169b575ef79,1,1,493,278,462,403,353,331,405,319,409,384,459,435,447,426,-24,75,-99
527,320000,37aa9169b575ef79,1,1,917,541,942,753,875,786,701,745,840,781,777,930,854,829,153,-4,157
354,360000,37aa9169b575ef79,1,1,496,261,379,339,330,292,330,358,538,488,482,540,511,503,58,-6,64
2068,130000,37aa9169b575ef79,1,1,3740,2309,3367,3025,3349,3221,3102,3388,3910,3483,3233,4206,3720,3641,973,-250,1223
1570,410000,37aa9169b575ef79,1,1,2560,1238,2093,1984,2022,1974,2200,2100,2323,1931,2018,2962,2490,2304,944,87,857
424,330000,37aa9169b575ef79,1,1,800,384,837,836,827,820,769,777,723,606,634,886,760,709,252,28,224
483,420000,37aa9169b575ef79,1,1,841,389,867,611,610,623,595,715,725,585,544,920,732,683,376,-41,417
1714,430000,37aa9169b575ef79,1,1,2251,1115,2020,1616,1475,1358,1456,1533,1680,1444,1489,2336,1912,1756,847,45,802
308,350000,37aa9169b575ef79,1,1,788,302,657,579,484,487,627,773,710,690,597,622,610,636,25,-93,118
681,210000,37aa9169b575ef79,1,1,1349,854,1439,1484,1508,1498,1804,1815,1871,1308,1478,1878,1678,1555,400,170,230
131,500000,37aa9169b575ef79,1,1,234,167,284,211,204,370,530,502,347,184,172,247,210,201,75,-12,87
558,610000,37aa9169b575ef79,1,1,1113,499,771,729,604,479,874,1106,695,580,634,1051,842,755,417,54,363
730,230000,37aa9169b575ef79,1,1,1494,1179,1914,1499,1291,1253,1193,1427,1562,1308,1636,1781,1708,1575,145,328,-183
1909,310000,63065128401bb3ff,1,1,2375,573,2243,2672,2922,2462,1180,1500,2397,1674,2362,3060,2711,2365,698,688,10
656,530000,63065128401bb3ff,1,1,1009,563,707,630,647,551,884,974,1076,1038,1033,1402,1218,1158,369,-5,374
268,150000,63065128401bb3ff,1,1,744,335,525,430,507,344,410,446,541,468,630,827,728,642,197,162,35
217,110000,63065128401bb3ff,1,1,1468,353,2808,1941,2551,971,995,1118,835,516,1494,2145,1820,1385,651,978,-327
1355,510000,63065128401bb3ff,1,1,2462,1405,2143,1834,1543,1533,1662,1864,2707,1708,2119,2450,2284,2092,331,411,-80
1460,340000,63065128401bb3ff,1,1,3082,1494,1764,1722,1828,1799,2028,2809,2863,2529,2927,3132,3030,2863,205,398,-193
1885,370000,63065128401bb3ff,1,1,5502,2478,3115,3589,3471,2715,3147,4018,4409,4129,4087,5401,4744,4539,1314,-42,1356
692,140000,63065128401bb3ff,1,1,2073,779,1146,1022,1337,977,1223,1490,1510,1452,1547,2066,1806,1688,519,95,424
625,440000,63065128401bb3ff,1,1,2669,535,2905,1816,1983,1796,1715,2112,2192,2036,2188,2519,2354,2248,331,152,179
308,450000,63065128401bb3ff,1,1,722,397,549,377,518,379,413,503,589,568,596,616,606,593,20,28,-8
2143,320000,63065128401bb3ff,1,1,5630,3297,3990,3393,3757,3219,3369,4854,5016,4475,5007,5643,5325,5042,636,532,104
973,360000,63065128401bb3ff,1,1,2694,1077,1305,1276,1370,1233,1308,1681,2044,1627,1981,2357,2169,1988,376,354,22
1723,130000,63065128401bb3ff,1,1,4516,1882,2484,2675,3198,2587,2964,3829,3951,3277,3711,5424,4568,4137,1713,434,1279
2463,410000,63065128401bb3ff,1,1,4592,1915,2442,2757,2736,2702,3421,4398,4500,3793,4237,5119,4678,4383,882,444,438
895,330000,63065128401bb3ff,1,1,3120,1321,2050,1853,2092,1953,2021,2513,2777,2324,2401,2755,2578,2493,354,77,277
1002,420000,63065128401bb3ff,1,1,2590,916,1381,1205,1158,1213,1120,1591,1818,1296,1466,1985,1726,1582,519,170,349
1085,430000,63065128401bb3ff,1,1,2791,1083,1689,1645,1561,1517,1583,1906,2187,1670,2078,2533,2306,2094,455,408,47
440,350000,63065128401bb3ff,1,1,1609,446,1142,977,1082,843,1055,1347,1279,1170,1218,1549,1384,1312,331,48,283
268,210000,63065128401bb3ff,1,1,916,394,781,766,859,586,702,806,897,700,869,1098,984,889,229,169,60
617,500000,63065128401bb3ff,1,1,1039,586,936,946,870,1013,987,1230,1171,824,938,1120,1029,961,182,114,68
631,610000,63065128401bb3ff,1,1,1658,688,869,1036,1284,861,1113,1278,1300,1165,1199,1748,1474,1371,549,34,515
162,230000,63065128401bb3ff,1,1,399,210,484,451,421,327,303,404,404,286,466,480,473,411,14,180,-166
315,310000,ea489c253676aafc,1,1,968,300,906,709,759,629,425,535,502,314,574,754,664,547,180,260,-80
452,530000,ea489c253676aafc,1,1,612,389,500,421,595,461,551,450,435,635,692,866,779,731,174,57,117
427,150000,ea489c253676aafc,1,1,712,383,577,507,561,440,380,452,427,495,612,941,776,683,329,117,212
125,110000,ea489c253676aafc,1,1,529,209,482,498,353,301,382,397,346,199,341,546,444,362,205,142,63
1017,510000,ea489c253676aafc,1,1,1515,991,1444,1326,1270,1055,1379,1197,903,838,1187,1812,1500,1279,625,349,276
741,340000,ea489c253676aafc,1,1,1394,887,1184,1065,1021,869,1109,958,734,813,952,1669,1310,1145,717,139,578
2330,370000,ea489c253676aafc,1,1,5127,2475,3780,3634,3404,2787,3450,3299,2451,2995,3812,5496,4654,4101,1684,817,867
1165,140000,ea489c253676aafc,1,1,2427,1042,1482,1678,1725,1270,1462,1588,1052,1126,1234,2626,1930,1662,1392,108,1284
368,440000,ea489c253676aafc,1,1,467,178,510,397,473,460,457,448,529,384,525,1055,790,655,530,141,389
365,450000,ea489c253676aafc,1,1,403,173,461,182,302,352,363,291,255,362,355,448,402,388,93,-7,100
1167,320000,ea489c253676aafc,1,1,1366,941,1639,1304,1178,1368,1353,1085,864,1310,1728,2261,1994,1766,533,418,115
641,360000,ea489c253676aafc,1,1,955,332,492,421,412,315,365,335,301,356,946,847,896,716,-99,590,-689
1932,130000,ea489c253676aafc,1,1,4674,2876,2946,3004,3190,2715,3210,3609,2265,2586,3058,5478,4268,3707,2420,472,1948
1731,410000,ea489c253676aafc,1,1,2819,1336,1920,1867,1905,1469,1701,1452,1141,1472,1941,3092,2516,2168,1151,469,682
504,330000,ea489c253676aafc,1,1,1400,560,1342,916,1100,1016,1000,913,659,638,706,1205,956,850,499,68,431
298,420000,ea489c253676aafc,1,1,677,332,433,470,347,353,277,263,202,272,348,657,502,426,309,76,233
576,430000,ea489c253676aafc,1,1,1213,599,989,827,849,769,962,701,698,568,587,1351,969,835,764,19,745
215,350000,ea489c253676aafc,1,1,500,127,369,321,335,225,356,355,342,307,452,617,534,459,165,145,20
394,210000,ea489c253676aafc,1,1,790,461,979,733,783,589,621,716,684,572,853,1026,940,817,173,281,-108
353,500000,ea489c253676aafc,1,1,587,370,549,493,497,413,558,474,304,408,379,694,536,494,315,-29,344
754,610000,ea489c253676aafc,1,1,916,406,608,683,599,723,667,832,623,693,804,1400,1102,966,596,111,485
280,230000,ea489c253676aafc,1,1,447,551,532,645,383,283,369,508,307,324,496,710,603,510,214,172,42
339,310000,cd5841d44fd7625e,1,1,317,162,289,246,249,228,201,232,150,148,312,359,336,273,47,164,-117
409,530000,cd5841d44fd7625e,1,1,523,215,264,283,346,330,388,290,304,344,442,485,464,424,43,98,-55
519,150000,cd5841d44fd7625e,1,1,445,173,236,276,395,262,398,348,325,432,401,434,418,422,33,-31,64
1263,110000,cd5841d44fd7625e,1,1,1279,607,1252,1112,1156,1039,990,1183,1150,795,1121,1802,1462,1239,681,326,355
1390,510000,cd5841d44fd7625e,1,1,985,485,639,702,679,596,623,519,741,610,732,1083,908,808,351,122,229
667,340000,cd5841d44fd7625e,1,1,594,265,335,339,414,403,381,360,323,440,519,629,574,529,110,79,31
1861,370000,cd5841d44fd7625e,1,1,1527,694,1162,1362,1499,1162,1256,1311,1391,1370,1666,1642,1654,1559,-24,296,-320
426,140000,cd5841d44fd7625e,1,1,453,225,381,342,380,264,316,332,330,480,421,414,418,438,-7,-59,52
727,440000,cd5841d44fd7625e,1,1,752,132,499,400,553,537,509,516,523,704,995,1243,1119,981,248,291,-43
225,450000,cd5841d44fd7625e,1,1,211,72,100,87,113,102,97,101,156,159,192,214,203,188,22,33,-11
1336,320000,cd5841d44fd7625e,1,1,1523,733,1051,1024,1236,925,785,871,1280,881,1099,1374,1236,1118,275,218,57
364,360000,cd5841d44fd7625e,1,1,379,114,198,208,246,191,199,169,178,237,276,329,302,281,53,39,14
1768,130000,cd5841d44fd7625e,1,1,1612,874,1322,1150,1563,1391,1238,1360,1115,1052,1461,1615,1538,1376,154,409,-255
1429,410000,cd5841d44fd7625e,1,1,1352,536,792,984,996,913,957,1047,1104,1357,1223,1443,1333,1341,220,-134,354
742,330000,cd5841d44fd7625e,1,1,764,311,485,482,592,492,475,404,404,512,747,863,805,707,116,235,-119
558,420000,cd5841d44fd7625e,1,1,493,217,350,350,345,337,298,379,393,374,473,566,520,471,93,99,-6
519,430000,cd5841d44fd7625e,1,1,508,193,301,261,307,277,273,291,253,248,418,494,456,387,76,170,-94
404,350000,cd5841d44fd7625e,1,1,492,162,288,229,307,216,229,183,186,285,325,402,364,337,77,40,37
704,210000,cd5841d44fd7625e,1,1,638,324,566,616,593,769,652,721,569,738,644,1082,863,821,438,-94,532
433,500000,cd5841d44fd7625e,1,1,313,158,224,260,274,314,254,213,262,251,282,391,336,308,109,31,78
487,610000,cd5841d44fd7625e,1,1,491,184,273,411,522,312,356,360,419,276,346,497,422,373,151,70,81
785,230000,cd5841d44fd7625e,1,1,789,427,986,775,794,828,639,929,731,657,664,964,814,762,300,7,293
815,310000,b25c4e2e3856af22,1,1,1571,568,1144,987,982,1141,897,946,1150,1010,1563,1504,1534,1359,-59,553,-612
585,530000,b25c4e2e3856af22,1,1,844,407,491,429,522,373,681,595,570,759,692,785,738,745,93,-67,160
303,150000,b25c4e2e3856af22,1,1,349,174,204,243,365,254,296,333,327,407,342,430,386,393,88,-65,153
376,110000,b25c4e2e3856af22,1,1,1075,395,672,745,768,998,675,772,925,740,925,1127,1026,931,202,185,17
1096,510000,b25c4e2e3856af22,1,1,1631,779,913,980,978,903,990,1085,1885,1100,1320,1775,1548,1398,455,220,235
952,340000,b25c4e2e3856af22,1,1,1305,600,798,764,823,725,769,980,1023,1001,1064,1490,1277,1185,426,63,363
940,370000,b25c4e2e3856af22,1,1,1420,681,940,1108,1210,1082,1134,1323,1432,1303,1408,1739,1574,1483,331,105,226
229,140000,b25c4e2e3856af22,1,1,469,235,312,291,326,221,257,295,289,333,332,371,352,345,39,-1,40
854,440000,b25c4e2e3856af22,1,1,2185,423,1174,995,1269,1114,1097,1195,1320,1463,1644,2216,1930,1774,572,181,391
218,450000,b25c4e2e3856af22,1,1,412,211,246,212,277,223,187,218,240,280,255,372,314,302,117,-25,142
1586,320000,b25c4e2e3856af22,1,1,2303,1323,1686,1487,1639,1433,1571,1947,1897,1872,2263,3132,2698,2422,869,391,478
754,360000,b25c4e2e3856af22,1,1,1219,454,671,722,759,661,681,684,855,798,870,1144,1007,937,274,72,202
652,130000,b25c4e2e3856af22,1,1,1075,517,776,716,788,622,676,985,861,883,944,1218,1081,1015,274,61,213
856,410000,b25c4e2e3856af22,1,1,1463,652,810,959,936,866,965,1056,1067,1021,1121,1578,1350,1240,457,100,357
1749,330000,b25c4e2e3856af22,1,1,3182,1395,1880,1823,1961,1826,1921,2037,2367,2323,2703,3371,3037,2799,668,380,288
941,420000,b25c4e2e3856af22,1,1,1269,532,746,751,751,798,730,829,920,1033,988,1333,1160,1118,345,-45,390
1003,430000,b25c4e2e3856af22,1,1,1418,612,798,869,852,770,811,908,1056,973,1081,1561,1321,1205,480,108,372
667,350000,b25c4e2e3856af22,1,1,1432,407,744,580,799,587,681,684,714,853,905,1102,1004,953,197,52,145
253,210000,b25c4e2e3856af22,1,1,417,172,302,339,376,332,444,478,491,437,403,555,479,465,152,-34,186
452,500000,b25c4e2e3856af22,1,1,651,350,388,450,403,448,421,422,477,428,496,740,618,555,244,68,176
395,610000,b25c4e2e3856af22,1,1,640,275,327,347,397,335,338,351,433,450,479,533,506,487,54,29,25
213,230000,b25c4e2e3856af22,1,1,352,146,415,369,422,399,362,461,359,320,352,428,390,367,76,32,44
275,310000,4a103c30d593fbbe,1,1,502,184,494,480,438,464,464,563,552,450,685,688,686,608,3,235,-232
409,530000,4a103c30d593fbbe,1,1,704,407,551,494,611,509,837,743,640,687,714,1001,858,801,287,27,260
370,150000,4a103c30d593fbbe,1,1,749,281,409,555,665,393,509,544,557,650,671,789,730,703,118,21,97
402,110000,4a103c30d593fbbe,1,1,1396,555,1236,1175,1102,1018,1021,1288,1431,1045,1332,1807,1570,1395,475,287,188
1589,510000,4a103c30d593fbbe,1,1,2380,1439,1972,2107,1866,1748,1887,2009,2921,2017,2913,3590,3252,2840,677,896,-219
921,340000,4a103c30d593fbbe,1,1,1207,517,1041,1182,1170,1110,1307,1431,1596,1491,1717,1968,1842,1725,251,226,25
1329,370000,4a103c30d593fbbe,1,1,2790,1121,2092,2449,2486,1895,2003,2387,2615,2547,2776,3299,3038,2874,523,229,294
401,140000,4a103c30d593fbbe,1,1,831,373,673,634,789,589,641,800,787,813,782,1130,956,908,348,-31,379
475,440000,4a103c30d593fbbe,1,1,1467,323,1264,996,1286,1093,1029,1303,1438,1702,2171,2397,2284,2090,226,469,-243
225,450000,4a103c30d593fbbe,1,1,447,161,369,263,323,295,287,282,358,395,493,595,544,494,102,98,4
1623,320000,4a103c30d593fbbe,1,1,2903,1522,2786,2473,3080,2334,2394,3107,2962,3228,3579,4302,3940,3703,723,351,372
398,360000,4a103c30d593fbbe,1,1,698,252,491,598,657,503,672,641,755,781,885,1016,950,894,131,104,27
1565,130000,4a103c30d593fbbe,1,1,2975,1404,2330,2475,2921,2392,2559,2979,2860,2877,2989,3954,3472,3273,965,112,853
1489,410000,4a103c30d593fbbe,1,1,2415,955,1587,2122,1817,1841,2115,2398,2493,2358,2638,3291,2964,2762,653,280,373
961,330000,4a103c30d593fbbe,1,1,2040,893,1688,1755,1827,1550,1572,1914,1992,2163,2458,2897,2678,2506,439,295,144
805,420000,4a103c30d593fbbe,1,1,1338,473,870,703,828,848,789,996,1142,948,1247,1304,1276,1166,57,299,-242
427,430000,4a103c30d593fbbe,1,1,901,394,710,632,689,696,720,817,950,757,948,1222,1085,976,274,191,83
385,350000,4a103c30d593fbbe,1,1,813,280,669,569,777,495,680,640,694,837,946,924,935,902,-22,109,-131
414,210000,4a103c30d593fbbe,1,1,1069,487,985,1021,1093,717,904,1088,1057,1007,1160,1513,1336,1227,353,153,200
296,500000,4a103c30d593fbbe,1,1,402,214,312,317,246,378,375,374,365,407,493,612,552,504,119,86,33
404,610000,4a103c30d593fbbe,1,1,832,352,582,607,926,472,701,761,801,945,946,1143,1044,1011,197,1,196
462,230000,4a103c30d593fbbe,1,1,857,475,987,974,825,774,757,1154,914,753,1190,1198,1194,1047,8,437,-429
325,310000,7a7885e2d7c00bcf,1,1,532,350,778,523,603,553,600,670,690,633,790,925,858,783,135,157,-22
194,530000,7a7885e2d7c00bcf,1,1,384,244,415,322,387,317,493,447,408,431,527,546,536,501,19,96,-77
168,150000,7a7885e2d7c00bcf,1,1,353,150,300,265,350,301,313,341,355,371,359,418,388,383,59,-12,71
471,110000,7a7885e2d7c00bcf,1,1,817,426,1017,846,916,826,879,911,1074,915,1162,1615,1388,1231,453,247,206
445,510000,7a7885e2d7c00bcf,1,1,707,562,879,706,738,715,745,722,1155,772,961,1167,1064,967,206,189,17
374,340000,7a7885e2d7c00bcf,1,1,569,357,675,647,692,656,677,767,841,878,933,1003,968,938,70,55,15
875,370000,7a7885e2d7c00bcf,1,1,1583,860,1928,1822,1978,1685,1638,1852,2308,2307,2370,2766,2568,2481,396,63,333
139,140000,7a7885e2d7c00bcf,1,1,271,166,314,241,352,275,285,300,313,320,355,484,420,386,129,35,94
402,440000,7a7885e2d7c00bcf,1,1,817,342,1042,810,979,912,937,951,992,1092,1209,1464,1336,1255,255,117,138
118,450000,7a7885e2d7c00bcf,1,1,263,125,288,186,265,233,260,262,246,259,290,384,337,311,94,31,63
1057,320000,7a7885e2d7c00bcf,1,1,1924,1512,2488,1949,2522,2016,2112,2209,2679,2595,2801,3241,3021,2879,440,206,234
213,360000,7a7885e2d7c00bcf,1,1,394,200,434,361,405,347,434,393,442,498,481,511,496,497,30,-17,47
754,130000,7a7885e2d7c00bcf,1,1,1284,764,1561,1277,1469,1298,1298,1461,1525,1603,1929,2115,2022,1882,186,326,-140
591,410000,7a7885e2d7c00bcf,1,1,972,578,1090,1137,1026,959,1096,1283,1383,1309,1461,1740,1600,1503,279,152,127
818,330000,7a7885e2d7c00bcf,1,1,1451,1062,1999,1632,1956,1671,1999,1697,1991,2033,2127,2662,2394,2274,535,94,441
305,420000,7a7885e2d7c00bcf,1,1,472,314,537,473,508,574,499,596,611,603,616,685,650,635,69,13,56
256,430000,7a7885e2d7c00bcf,1,1,503,263,575,412,494,442,503,514,645,501,559,768,664,609,209,58,151
216,350000,7a7885e2d7c00bcf,1,1,482,236,512,409,530,373,503,451,397,473,480,608,544,520,128,7,121
169,210000,7a7885e2d7c00bcf,1,1,401,246,558,476,514,420,483,505,553,489,516,595,556,533,79,27,52
69,500000,7a7885e2d7c00bcf,1,1,153,94,156,120,135,198,189,145,189,159,216,258,237,211,42,57,-15
185,610000,7a7885e2d7c00bcf,1,1,384,259,468,393,540,321,402,487,425,510,487,657,572,551,170,-23,193
157,230000,7a7885e2d7c00bcf,1,1,285,242,628,493,470,454,420,611,511,443,413,533,473,463,120,-30,150
76,310000,346393c2c6305fb1,1,1,305,80,117,123,63,113,83,134,126,104,114,215,164,144,101,10,91
95,530000,346393c2c6305fb1,1,1,251,186,114,92,106,89,141,121,133,139,121,182,152,147,61,-18,79
99,150000,346393c2c6305fb1,1,1,312,114,123,107,124,111,114,92,121,108,174,205,190,162,31,66,-35
74,110000,346393c2c6305fb1,1,1,432,148,234,172,132,149,201,202,250,161,243,439,341,281,196,82,114
309,510000,346393c2c6305fb1,1,1,824,509,328,331,262,301,284,317,459,291,297,513,405,367,216,6,210
578,340000,346393c2c6305fb1,1,1,1721,870,680,514,529,526,633,733,655,600,692,1047,870,780,355,92,263
902,370000,346393c2c6305fb1,1,1,1900,1101,802,922,771,855,1000,1063,1138,1097,1099,1844,1472,1347,745,2,743
238,140000,346393c2c6305fb1,1,1,488,211,155,211,195,143,212,261,250,277,308,545,426,377,237,31,206
126,440000,346393c2c6305fb1,1,1,375,89,154,162,145,223,291,295,282,277,289,373,331,313,84,12,72
93,450000,346393c2c6305fb1,1,1,188,104,97,54,71,100,108,107,108,100,115,162,138,126,47,15,32
300,320000,346393c2c6305fb1,1,1,859,502,454,332,411,403,402,461,370,406,397,621,509,475,224,-9,233
151,360000,346393c2c6305fb1,1,1,386,200,101,96,91,121,141,112,150,164,143,266,204,191,123,-21,144
748,130000,346393c2c6305fb1,1,1,1327,753,620,514,537,455,575,645,742,699,808,1460,1134,989,652,109,543
524,410000,346393c2c6305fb1,1,1,1147,528,298,313,364,453,477,544,566,471,617,1100,858,729,483,146,337
101,330000,346393c2c6305fb1,1,1,368,143,158,153,145,161,194,181,198,211,191,260,226,221,69,-20,89
275,420000,346393c2c6305fb1,1,1,689,242,211,178,180,285,274,266,326,324,313,534,424,390,221,-11,232
308,430000,346393c2c6305fb1,1,1,638,234,247,217,180,205,282,273,347,286,335,535,435,385,200,49,151
60,350000,346393c2c6305fb1,1,1,177,45,82,56,58,88,101,114,102,89,87,129,108,102,42,-2,44
149,210000,346393c2c6305fb1,1,1,514,232,279,252,262,234,252,331,280,278,265,371,318,305,106,-13,119
168,500000,346393c2c6305fb1,1,1,518,271,178,190,138,222,247,251,250,189,199,335,267,241,136,10,126
209,610000,346393c2c6305fb1,1,1,356,166,118,112,151,113,180,161,167,197,186,360,273,248,174,-11,185
126,230000,346393c2c6305fb1,1,1,328,152,215,165,177,206,165,264,248,169,223,312,268,235,89,54,35
679,310000,02aab221aabc03b9,1,1,617,279,554,507,485,527,653,687,651,489,558,362,460,470,-196,69,-265
229,530000,02aab221aabc03b9,1,1,238,87,174,151,202,185,247,209,201,174,160,155,158,163,-5,-14,9
106,150000,02aab221aabc03b9,1,1,92,51,90,76,95,106,108,130,97,99,82,59,70,80,-23,-17,-6
798,110000,02aab221aabc03b9,1,1,799,424,733,545,566,646,748,847,831,642,654,521,588,606,-133,12,-145
703,510000,02aab221aabc03b9,1,1,559,325,439,421,431,486,460,559,615,471,430,474,452,458,44,-41,85
338,340000,02aab221aabc03b9,1,1,285,144,198,252,223,244,244,344,348,248,228,187,208,221,-41,-20,-21
610,370000,02aab221aabc03b9,1,1,516,240,412,457,437,443,584,549,525,474,421,353,387,416,-68,-53,-15
129,140000,02aab221aabc03b9,1,1,102,58,112,93,114,101,121,154,121,105,117,105,111,109,-12,12,-24
1207,440000,02aab221aabc03b9,1,1,1364,384,1124,891,1008,1160,1083,1238,1180,1049,976,1007,992,1011,31,-73,104
159,450000,02aab221aabc03b9,1,1,125,68,133,79,114,129,142,161,151,126,138,119,128,128,-19,12,-31
1735,320000,02aab221aabc03b9,1,1,1709,960,1400,1291,1323,1469,1509,1821,1585,1270,1186,1077,1132,1178,-109,-84,-25
242,360000,02aab221aabc03b9,1,1,204,93,153,158,177,165,198,224,232,164,154,152,153,157,-2,-10,8
340,130000,02aab221aabc03b9,1,1,325,118,239,297,312,337,350,330,362,307,254,182,218,248,-72,-53,-19
320,410000,02aab221aabc03b9,1,1,355,161,301,358,277,291,353,389,339,239,284,223,254,249,-61,45,-106
1529,330000,02aab221aabc03b9,1,1,1444,745,1150,1124,1121,1210,1486,1568,1439,1239,1136,1024,1080,1133,-112,-103,-9
370,420000,02aab221aabc03b9,1,1,264,166,276,286,265,300,346,383,407,272,273,274,274,273,1,1,0
305,430000,02aab221aabc03b9,1,1,313,113,209,229,207,229,257,270,285,213,205,215,210,211,10,-8,18
518,350000,02aab221aabc03b9,1,1,456,187,331,340,375,354,394,437,448,353,321,324,322,333,3,-32,35
292,210000,02aab221aabc03b9,1,1,231,150,206,234,226,254,291,346,299,229,207,174,190,203,-33,-22,-11
267,500000,02aab221aabc03b9,1,1,275,140,226,204,204,232,259,222,255,197,217,217,217,210,0,20,-20
285,610000,02aab221aabc03b9,1,1,270,145,192,213,288,241,238,319,283,263,205,197,201,222,-8,-58,50
93,230000,02aab221aabc03b9,1,1,39,46,74,80,87,80,75,119,71,81,63,53,58,66,-10,-18,8
315,310000,5d7fb682edd0f937,1,1,379,164,397,283,308,272,297,303,281,281,247,225,236,251,-22,-34,12
164,530000,5d7fb682edd0f937,1,1,201,89,159,143,175,143,190,187,165,167,133,176,154,159,43,-34,77
86,150000,5d7fb682edd0f937,1,1,103,51,91,82,115,109,112,117,120,96,85,86,86,89,1,-11,12
323,110000,5d7fb682edd0f937,1,1,484,232,428,353,385,362,331,427,429,308,324,417,370,350,93,16,77
483,510000,5d7fb682edd0f937,1,1,426,224,376,344,382,380,359,376,389,305,301,337,319,314,36,-4,40
188,340000,5d7fb682edd0f937,1,1,228,119,169,162,175,187,156,227,205,162,169,174,172,168,5,7,-2
339,370000,5d7fb682edd0f937,1,1,357,185,290,276,307,309,263,302,292,265,227,253,240,248,26,-38,64
111,140000,5d7fb682edd0f937,1,1,99,50,77,59,95,91,82,103,99,83,81,91,86,85,10,-2,12
581,440000,5d7fb682edd0f937,1,1,663,212,629,501,543,522,480,565,575,462,510,512,511,495,2,48,-46
128,450000,5d7fb682edd0f937,1,1,110,67,86,103,113,124,96,117,108,102,103,109,106,105,6,1,5
807,320000,5d7fb682edd0f937,1,1,896,478,831,673,752,698,733,823,757,642,661,734,698,679,73,19,54
165,360000,5d7fb682edd0f937,1,1,153,65,143,134,157,139,120,153,155,115,129,138,134,127,9,14,-5
203,130000,5d7fb682edd0f937,1,1,244,109,201,188,230,197,195,219,226,184,180,178,179,181,-2,-4,2
186,410000,5d7fb682edd0f937,1,1,199,105,163,205,180,189,189,186,187,161,189,173,181,174,-16,28,-44
656,330000,5d7fb682edd0f937,1,1,771,473,696,636,660,565,645,709,620,587,599,595,597,594,-4,12,-16
270,420000,5d7fb682edd0f937,1,1,287,151,282,230,266,292,242,319,331,219,258,266,262,248,8,39,-31
210,430000,5d7fb682edd0f937,1,1,244,96,191,206,200,169,164,219,179,160,168,191,180,173,23,8,15
241,350000,5d7fb682edd0f937,1,1,300,129,246,219,230,256,240,260,259,202,201,205,203,203,4,-1,5
140,210000,5d7fb682edd0f937,1,1,163,84,157,166,150,154,152,161,165,130,138,128,133,132,-10,8,-18
131,500000,5d7fb682edd0f937,1,1,167,74,152,134,144,142,148,158,109,123,106,134,120,121,28,-17,45
159,610000,5d7fb682edd0f937,1,1,190,115,156,163,199,168,161,205,192,172,135,145,140,151,10,-37,47
68,230000,5d7fb682edd0f937,1,1,57,45,84,72,91,70,67,99,74,50,53,61,57,55,8,3,5
835,310000,a207df29ec9583f0,1,1,445,276,461,355,455,551,438,559,478,428,493,474,484,465,-19,65,-84
310,530000,a207df29ec9583f0,1,1,146,96,197,123,203,222,190,240,237,204,210,215,212,210,5,6,-1
139,150000,a207df29ec9583f0,1,1,75,55,85,62,91,81,74,115,91,72,82,74,78,76,-8,10,-18
1033,110000,a207df29ec9583f0,1,1,751,419,597,509,573,717,674,824,853,604,747,817,782,723,70,143,-73
695,510000,a207df29ec9583f0,1,1,405,265,377,334,442,494,344,458,388,382,361,382,372,375,21,-21,42
354,340000,a207df29ec9583f0,1,1,197,113,164,138,167,188,148,226,228,183,176,177,176,179,1,-7,8
608,370000,a207df29ec9583f0,1,1,345,221,286,259,291,346,365,453,344,338,348,336,342,341,-12,10,-22
165,140000,a207df29ec9583f0,1,1,100,51,78,95,88,102,105,108,108,84,93,100,96,92,7,9,-2
1178,440000,a207df29ec9583f0,1,1,781,299,866,560,678,769,689,886,875,627,766,825,796,739,59,139,-80
160,450000,a207df29ec9583f0,1,1,90,44,91,57,97,100,90,105,124,72,100,114,107,95,14,28,-14
1591,320000,a207df29ec9583f0,1,1,839,575,787,801,890,962,857,1124,918,791,915,1007,961,904,92,124,-32
227,360000,a207df29ec9583f0,1,1,113,57,129,99,112,125,115,140,155,101,129,108,118,113,-21,28,-49
376,130000,a207df29ec9583f0,1,1,230,131,173,183,199,229,221,266,200,202,203,219,211,208,16,1,15
357,410000,a207df29ec9583f0,1,1,217,145,193,185,185,207,254,276,252,194,283,262,272,246,-21,89,-110
1436,330000,a207df29ec9583f0,1,1,742,438,716,641,723,810,824,880,834,733,849,908,878,830,59,116,-57
436,420000,a207df29ec9583f0,1,1,251,130,265,212,243,260,260,327,326,230,315,356,336,300,41,85,-44
302,430000,a207df29ec9583f0,1,1,158,71,152,121,164,200,157,190,184,143,174,192,183,170,18,31,-13
500,350000,a207df29ec9583f0,1,1,250,119,238,208,225,265,234,296,266,197,227,256,242,227,29,30,-1
304,210000,a207df29ec9583f0,1,1,233,145,170,172,190,254,215,281,225,176,194,227,210,199,33,18,15
265,500000,a207df29ec9583f0,1,1,151,113,138,114,168,164,192,184,176,151,174,194,184,173,20,23,-3
307,610000,a207df29ec9583f0,1,1,241,141,184,186,174,206,235,213,228,210,194,216,205,207,22,-16,38
102,230000,a207df29ec9583f0,1,1,65,52,69,62,72,97,59,106,77,74,83,85,84,81,2,9,-7
80,310000,b4be3a4917289c82,1,1,185,90,185,166,151,149,152,203,190,188,201,262,232,217,61,13,48
26,530000,b4be3a4917289c82,1,1,48,23,65,81,86,43,35,60,52,76,100,59,80,78,-41,24,-65
22,150000,b4be3a4917289c82,1,1,30,20,44,34,38,23,35,33,31,42,40,37,38,40,-3,-2,-1
93,110000,b4be3a4917289c82,1,1,175,106,251,267,259,192,172,203,232,200,230,226,228,219,-4,30,-34
57,510000,b4be3a4917289c82,1,1,142,100,155,124,131,94,121,152,216,166,240,223,232,210,-17,74,-91
57,340000,b4be3a4917289c82,1,1,64,58,93,91,91,85,90,104,106,110,130,121,126,120,-9,20,-29
113,370000,b4be3a4917289c82,1,1,172,97,238,273,264,203,199,232,258,215,231,199,215,215,-32,16,-48
16,140000,b4be3a4917289c82,1,1,29,17,30,23,35,28,32,37,31,31,28,33,30,31,5,-3,8
120,440000,b4be3a4917289c82,1,1,215,83,239,207,253,209,182,223,290,309,396,384,390,363,-12,87,-99
20,450000,b4be3a4917289c82,1,1,32,18,29,21,31,23,25,29,35,34,41,40,40,38,-1,7,-8
225,320000,b4be3a4917289c82,1,1,418,314,442,327,438,345,389,471,447,420,635,591,613,549,-44,215,-259
10,360000,b4be3a4917289c82,1,1,62,29,37,44,50,31,41,43,50,52,66,85,76,68,19,14,5
78,130000,b4be3a4917289c82,1,1,125,87,128,105,161,119,127,130,145,141,166,161,164,156,-5,25,-30
57,410000,b4be3a4917289c82,1,1,97,59,126,107,118,88,93,86,118,117,128,163,146,136,35,11,24
168,330000,b4be3a4917289c82,1,1,325,270,423,431,415,297,361,382,415,422,523,567,545,504,44,101,-57
48,420000,b4be3a4917289c82,1,1,88,58,96,72,86,72,79,106,110,92,120,142,131,118,22,28,-6
41,430000,b4be3a4917289c82,1,1,79,38,74,84,62,48,45,64,96,79,112,124,118,105,12,33,-21
23,350000,b4be3a4917289c82,1,1,86,35,60,68,83,59,50,84,61,85,108,127,118,107,19,23,-4
28,210000,b4be3a4917289c82,1,1,143,51,101,79,77,61,82,88,87,77,106,83,94,89,-23,29,-52
17,500000,b4be3a4917289c82,1,1,26,28,40,35,34,28,26,35,47,43,77,67,72,62,-10,34,-44
41,610000,b4be3a4917289c82,1,1,70,35,72,77,99,52,57,82,79,83,68,82,75,78,14,-15,29
18,230000,b4be3a4917289c82,1,1,13,36,71,63,68,50,44,61,42,40,48,45,46,44,-3,8,-11
378,310000,ef76a85c4b39f693,1,1,699,285,625,493,512,736,581,360,145,129,306,492,399,309,186,177,9
140,530000,ef76a85c4b39f693,1,1,272,144,215,224,243,237,221,153,83,75,142,154,148,124,12,67,-55
121,150000,ef76a85c4b39f693,1,1,156,85,133,133,164,131,165,105,47,48,67,109,88,75,42,19,23
511,110000,ef76a85c4b39f693,1,1,802,303,713,701,789,881,663,502,321,175,311,576,444,354,265,136,129
495,510000,ef76a85c4b39f693,1,1,730,397,598,495,600,609,554,488,356,206,340,526,433,357,186,134,52
304,340000,ef76a85c4b39f693,1,1,402,181,295,315,306,319,309,208,104,111,219,307,263,212,88,108,-20
406,370000,ef76a85c4b39f693,1,1,609,326,543,643,668,672,573,446,246,241,312,378,345,310,66,71,-5
94,140000,ef76a85c4b39f693,1,1,168,91,129,126,145,145,138,80,47,46,58,83,70,62,25,12,13
598,440000,ef76a85c4b39f693,1,1,883,191,803,692,927,973,869,740,398,282,593,912,752,596,319,311,8
74,450000,ef76a85c4b39f693,1,1,143,51,92,69,104,120,85,95,39,30,50,68,59,49,18,20,-2
993,320000,ef76a85c4b39f693,1,1,1261,705,1330,1133,1369,1500,1116,610,270,351,609,1028,818,663,419,258,161
200,360000,ef76a85c4b39f693,1,1,248,111,177,180,188,194,175,130,47,59,107,208,158,125,101,48,53
342,130000,ef76a85c4b39f693,1,1,460,274,446,396,489,506,429,351,172,141,298,340,319,260,42,157,-115
290,410000,ef76a85c4b39f693,1,1,440,194,359,443,350,442,406,206,143,136,170,239,204,182,69,34,35
996,330000,ef76a85c4b39f693,1,1,1571,893,1531,1481,1596,1826,1257,815,643,498,965,1300,1132,921,335,467,-132
334,420000,ef76a85c4b39f693,1,1,405,186,290,320,331,346,286,253,116,101,212,331,272,215,119,111,8
284,430000,ef76a85c4b39f693,1,1,423,183,302,305,370,344,325,229,78,92,180,310,245,194,130,88,42
229,350000,ef76a85c4b39f693,1,1,317,100,249,210,345,285,288,200,69,95,138,176,157,136,38,43,-5
256,210000,ef76a85c4b39f693,1,1,358,174,359,364,390,459,433,291,193,157,189,261,225,202,72,32,40
115,500000,ef76a85c4b39f693,1,1,224,111,157,161,172,225,158,135,51,35,76,157,116,89,81,41,40
223,610000,ef76a85c4b39f693,1,1,337,163,253,275,312,315,249,241,115,96,127,205,166,143,78,31,47
104,230000,ef76a85c4b39f693,1,1,165,153,325,234,241,211,111,123,58,56,108,145,126,103,37,52,-15
266,310000,bb9fbec9a2833839,1,1,400,161,390,364,320,327,408,528,494,298,341,507,424,382,166,43,123
142,530000,bb9fbec9a2833839,1,1,199,126,173,191,127,108,198,213,197,180,169,225,197,191,56,-11,67
76,150000,bb9fbec9a2833839,1,1,149,83,156,132,135,136,178,178,174,157,121,169,145,149,48,-36,84
177,110000,bb9fbec9a2833839,1,1,436,187,418,394,364,332,388,450,529,355,417,450,434,407,33,62,-29
242,510000,bb9fbec9a2833839,1,1,450,292,385,337,371,406,440,533,641,403,433,394,414,410,-39,30,-69
160,340000,bb9fbec9a2833839,1,1,314,133,230,208,185,223,244,297,328,172,256,310,283,246,54,84,-30
305,370000,bb9fbec9a2833839,1,1,375,238,402,377,302,378,352,487,582,453,469,507,488,476,38,16,22
55,140000,bb9fbec9a2833839,1,1,142,77,141,107,116,114,132,168,143,117,124,97,110,113,-27,7,-34
435,440000,bb9fbec9a2833839,1,1,782,200,616,587,591,684,704,813,867,710,821,895,858,809,74,111,-37
79,450000,bb9fbec9a2833839,1,1,131,77,129,95,81,120,108,129,137,85,114,124,119,108,10,29,-19
552,320000,bb9fbec9a2833839,1,1,865,510,885,789,826,854,952,1272,1166,688,937,1154,1046,926,217,249,-32
106,360000,bb9fbec9a2833839,1,1,192,99,172,121,144,151,183,202,193,186,189,178,184,184,-11,3,-14
179,130000,bb9fbec9a2833839,1,1,246,170,325,291,244,275,310,427,423,324,327,378,352,343,51,3,48
156,410000,bb9fbec9a2833839,1,1,284,161,241,351,217,257,301,336,420,237,276,308,292,274,32,39,-7
550,330000,bb9fbec9a2833839,1,1,894,537,1058,811,816,971,1162,1196,1045,917,1072,1169,1120,1053,97,155,-58
261,420000,bb9fbec9a2833839,1,1,375,173,366,272,236,352,315,395,429,270,308,378,343,319,70,38,32
145,430000,bb9fbec9a2833839,1,1,397,132,288,231,235,286,268,360,359,193,226,309,268,243,83,33,50
168,350000,bb9fbec9a2833839,1,1,310,107,228,247,214,238,244,281,263,253,214,293,254,253,79,-39,118
86,210000,bb9fbec9a2833839,1,1,201,110,199,192,184,149,191,241,242,174,177,213,195,188,36,3,33
65,500000,bb9fbec9a2833839,1,1,119,62,91,84,83,135,121,146,128,96,89,130,110,105,41,-7,48
112,610000,bb9fbec9a2833839,1,1,186,76,153,141,143,148,200,229,215,165,164,174,169,168,10,-1,11
44,230000,bb9fbec9a2833839,1,1,89,83,190,96,96,121,92,130,140,82,95,85,90,87,-10,13,-23
538,310000,da457d15788fe8ee,1,1,616,224,524,428,462,576,421,521,504,402,593,748,670,581,155,191,-36
263,530000,da457d15788fe8ee,1,1,351,173,285,234,259,204,306,266,231,316,323,344,334,328,21,7,14
197,150000,da457d15788fe8ee,1,1,187,106,139,167,203,169,162,217,201,207,206,200,203,204,-6,-1,-5
755,110000,da457d15788fe8ee,1,1,924,395,929,887,986,1008,845,898,731,715,939,1050,994,901,111,224,-113
624,510000,da457d15788fe8ee,1,1,821,418,657,632,753,748,554,658,1072,583,560,641,600,595,81,-23,104
330,340000,da457d15788fe8ee,1,1,342,151,261,270,316,300,257,346,329,282,331,409,370,341,78,49,29
659,370000,da457d15788fe8ee,1,1,603,383,514,607,578,623,481,543,678,438,630,646,638,571,16,192,-176
120,140000,da457d15788fe8ee,1,1,162,83,103,127,142,127,114,155,143,139,142,103,122,128,-39,3,-42
1269,440000,da457d15788fe8ee,1,1,1584,325,1013,985,1219,1303,1074,1237,1342,1295,1408,1829,1618,1511,421,113,308
213,450000,da457d15788fe8ee,1,1,206,70,170,96,158,161,124,125,189,162,142,255,198,186,113,-20,133
1304,320000,da457d15788fe8ee,1,1,1186,635,1034,965,1031,1078,842,1106,1255,1040,1108,1430,1269,1193,322,68,254
282,360000,da457d15788fe8ee,1,1,311,105,194,206,264,228,177,230,275,218,275,247,261,247,-28,57,-85
425,130000,da457d15788fe8ee,1,1,413,205,365,330,420,442,396,476,471,407,417,527,472,450,110,10,100
442,410000,da457d15788fe8ee,1,1,511,240,352,404,359,472,400,422,469,405,382,502,442,430,120,-23,143
938,330000,da457d15788fe8ee,1,1,1337,585,1059,1028,1051,1251,1000,1181,1241,932,1214,1500,1357,1215,286,282,4
572,420000,da457d15788fe8ee,1,1,558,243,406,406,395,467,358,427,529,447,473,526,500,482,53,26,27
374,430000,da457d15788fe8ee,1,1,602,204,413,420,443,451,322,451,476,369,391,505,448,422,114,22,92
335,350000,da457d15788fe8ee,1,1,426,140,232,234,345,272,282,266,282,298,320,358,339,325,38,22,16
281,210000,da457d15788fe8ee,1,1,399,232,362,315,405,340,365,459,418,357,335,454,394,382,119,-22,141
199,500000,da457d15788fe8ee,1,1,257,121,206,221,225,291,189,230,259,188,209,244,226,214,35,21,14
325,610000,da457d15788fe8ee,1,1,363,168,242,253,346,302,281,312,352,366,242,346,294,318,104,-124,228
139,230000,da457d15788fe8ee,1,1,178,130,276,201,264,224,175,240,219,123,190,198,194,170,8,67,-59
543,310000,6858d6dfe680bdf7,1,1,673,306,722,679,634,547,444,607,438,357,513,576,544,482,63,156,-93
243,530000,6858d6dfe680bdf7,1,1,272,151,279,225,250,183,177,213,139,117,236,257,246,203,21,119,-98
54,150000,6858d6dfe680bdf7,1,1,68,26,82,69,87,52,46,43,47,37,60,80,70,59,20,23,-3
536,110000,6858d6dfe680bdf7,1,1,694,262,673,614,681,595,494,449,410,328,585,816,700,576,231,257,-26
591,510000,6858d6dfe680bdf7,1,1,562,275,561,619,591,569,444,445,455,290,447,593,520,443,146,157,-11
322,340000,6858d6dfe680bdf7,1,1,361,174,315,300,376,284,251,265,236,233,275,385,330,298,110,42,68
468,370000,6858d6dfe680bdf7,1,1,484,202,484,554,521,386,382,358,297,285,401,440,420,375,39,116,-77
57,140000,6858d6dfe680bdf7,1,1,61,35,81,62,68,61,45,60,31,30,61,103,82,65,42,31,11
1274,440000,6858d6dfe680bdf7,1,1,1303,316,1135,1224,1221,1023,972,1033,800,773,983,1319,1151,1025,336,210,126
115,450000,6858d6dfe680bdf7,1,1,142,61,151,132,140,110,112,99,93,94,126,167,146,129,41,32,9
1203,320000,6858d6dfe680bdf7,1,1,1221,611,1328,1233,1314,879,894,893,729,862,988,1160,1074,1003,172,126,46
185,360000,6858d6dfe680bdf7,1,1,211,72,178,202,203,160,175,134,144,96,129,200,164,142,71,33,38
417,130000,6858d6dfe680bdf7,1,1,290,131,280,289,334,287,249,266,194,192,281,283,282,252,2,89,-87
258,410000,6858d6dfe680bdf7,1,1,302,144,309,370,322,315,276,272,209,174,237,350,294,254,113,63,50
1540,330000,6858d6dfe680bdf7,1,1,1803,930,1725,1897,1719,1389,1189,1547,1208,929,1465,1724,1594,1373,259,536,-277
271,420000,6858d6dfe680bdf7,1,1,272,118,290,306,263,266,203,235,199,144,218,283,250,215,65,74,-9
375,430000,6858d6dfe680bdf7,1,1,420,181,345,396,354,336,258,251,209,203,255,374,314,277,119,52,67
352,350000,6858d6dfe680bdf7,1,1,336,139,298,266,319,252,323,276,236,214,251,346,298,270,95,37,58
215,210000,6858d6dfe680bdf7,1,1,204,138,306,327,247,205,195,187,133,91,159,186,172,145,27,68,-41
198,500000,6858d6dfe680bdf7,1,1,206,140,246,273,262,227,183,189,132,105,200,253,226,186,53,95,-42
188,610000,6858d6dfe680bdf7,1,1,188,116,215,204,258,182,135,163,159,132,134,174,154,147,40,2,38
70,230000,6858d6dfe680bdf7,1,1,67,38,108,94,88,66,52,57,23,28,58,76,67,54,18,30,-12
333,310000,79de4e4b24c35b04,1,1,754,130,248,205,249,256,328,379,426,299,501,825,663,542,324,202,122
1050,530000,79de4e4b24c35b04,1,1,1235,715,584,517,594,552,695,707,913,926,928,1393,1160,1082,465,2,463
185,150000,79de4e4b24c35b04,1,1,207,80,151,118,129,99,134,132,200,230,272,405,338,302,133,42,91
178,110000,79de4e4b24c35b04,1,1,920,174,284,352,376,194,240,313,370,330,446,852,649,543,406,116,290
1063,510000,79de4e4b24c35b04,1,1,1477,971,753,633,599,569,778,755,971,792,934,1509,1222,1078,575,142,433
1965,340000,79de4e4b24c35b04,1,1,2000,1583,836,765,835,790,1052,1349,1421,1263,1461,2601,2031,1775,1140,198,942
2858,370000,79de4e4b24c35b04,1,1,3560,2065,1669,1567,2055,1628,2244,2677,2814,2975,3077,5360,4218,3804,2283,102,2181
701,140000,79de4e4b24c35b04,1,1,629,273,351,377,360,353,542,640,778,791,803,1442,1122,1012,639,12,627
3465,440000,79de4e4b24c35b04,1,1,6216,1524,3366,2719,3307,2768,3295,4086,5098,5032,5800,8421,7110,6418,2621,768,1853
2981,450000,79de4e4b24c35b04,1,1,4995,2862,2406,1619,1976,1690,1981,2497,3110,3025,3479,6171,4825,4225,2692,454,2238
2028,320000,79de4e4b24c35b04,1,1,2589,1515,1369,1121,1352,1272,1577,1829,2045,1978,2153,3757,2955,2629,1604,175,1429
827,360000,79de4e4b24c35b04,1,1,1019,578,516,412,417,410,598,635,806,703,736,1319,1028,919,583,33,550
1366,130000,79de4e4b24c35b04,1,1,1562,921,863,830,1060,888,1184,1505,1631,1500,1789,2863,2326,2051,1074,289,785
6024,410000,79de4e4b24c35b04,1,1,7181,3619,2609,2474,2930,3020,3796,4302,4617,4700,5194,9539,7366,6478,4345,494,3851
934,330000,79de4e4b24c35b04,1,1,1860,626,867,616,852,799,1096,1291,1435,1528,1653,2646,2150,1942,993,125,868
1137,420000,79de4e4b24c35b04,1,1,1580,792,578,459,481,488,678,753,891,696,982,1629,1306,1102,647,286,361
1658,430000,79de4e4b24c35b04,1,1,1663,846,806,812,802,747,984,1113,1544,1234,1513,2352,1932,1700,839,279,560
453,350000,79de4e4b24c35b04,1,1,897,279,474,380,411,360,626,548,706,724,738,1086,912,849,348,14,334
408,210000,79de4e4b24c35b04,1,1,494,214,377,398,383,376,528,616,644,644,694,1039,866,792,345,50,295
324,500000,79de4e4b24c35b04,1,1,745,422,371,270,261,287,297,277,359,279,304,514,409,366,210,25,185
937,610000,79de4e4b24c35b04,1,1,954,433,412,456,460,358,538,648,785,855,1045,1704,1374,1201,659,190,469
394,230000,79de4e4b24c35b04,1,1,474,292,439,350,475,475,643,791,839,638,832,1045,938,838,213,194,19
389,310000,12f8b7e14947c34d,1,1,1329,432,848,740,785,835,1350,1065,2065,1032,1283,1483,1383,1266,200,251,-51
208,530000,12f8b7e14947c34d,1,1,412,240,292,229,244,208,404,346,402,396,360,567,464,441,207,-36,243
413,150000,12f8b7e14947c34d,1,1,836,289,446,450,527,415,569,575,712,648,698,789,744,712,91,50,41
143,110000,12f8b7e14947c34d,1,1,595,219,346,342,374,346,429,397,451,276,389,488,438,384,99,113,-14
531,510000,12f8b7e14947c34d,1,1,1109,594,746,756,677,695,682,820,1286,786,820,1117,968,908,297,34,263
385,340000,12f8b7e14947c34d,1,1,676,322,351,363,414,357,477,644,726,594,615,705,660,638,90,21,69
803,370000,12f8b7e14947c34d,1,1,2189,844,1400,1356,1271,1075,1292,1454,1777,1435,1352,1707,1530,1498,355,-83,438
131,140000,12f8b7e14947c34d,1,1,439,139,326,295,376,259,310,346,391,347,352,464,408,388,112,5,107
130,440000,12f8b7e14947c34d,1,1,385,70,223,205,277,296,248,286,326,342,407,475,441,408,68,65,3
93,450000,12f8b7e14947c34d,1,1,217,114,135,110,154,153,106,135,181,167,158,231,194,185,73,-9,82
991,320000,12f8b7e14947c34d,1,1,2487,1375,2036,1589,1718,1504,1598,2024,2099,1880,1868,2181,2024,1976,313,-12,325
251,360000,12f8b7e14947c34d,1,1,719,227,332,338,384,268,290,349,532,430,438,495,466,454,57,8,49
546,130000,12f8b7e14947c34d,1,1,1190,526,697,668,745,713,769,1026,1153,782,978,1229,1104,996,251,196,55
508,410000,12f8b7e14947c34d,1,1,1052,432,507,691,656,595,849,951,954,750,835,1053,944,879,218,85,133
348,330000,12f8b7e14947c34d,1,1,1069,476,727,703,696,655,723,773,920,884,1063,1213,1138,1053,150,179,-29
200,420000,12f8b7e14947c34d,1,1,473,168,248,264,212,303,273,340,406,336,358,440,399,378,82,22,60
385,430000,12f8b7e14947c34d,1,1,736,271,375,384,428,388,473,550,688,528,670,749,710,649,79,142,-63
188,350000,12f8b7e14947c34d,1,1,545,170,319,281,308,207,297,275,314,302,385,408,396,365,23,83,-60
53,210000,12f8b7e14947c34d,1,1,215,103,162,132,162,151,156,254,246,156,195,210,202,187,15,39,-24
131,500000,12f8b7e14947c34d,1,1,212,110,142,161,182,218,192,205,240,178,181,295,238,218,114,3,111
412,610000,12f8b7e14947c34d,1,1,1380,510,777,772,950,666,1062,1276,1109,958,1012,1286,1149,1085,274,54,220
66,230000,12f8b7e14947c34d,1,1,237,157,262,257,265,200,199,236,256,202,210,228,219,213,18,8,10
950,310000,04e66e578f653ab9,1,1,388,191,341,301,229,293,265,342,422,337,524,679,602,513,155,187,-32
131,530000,04e66e578f653ab9,1,1,55,23,57,93,77,88,123,129,142,173,215,293,254,227,78,42,36
60,150000,04e66e578f653ab9,1,1,44,20,43,68,68,57,63,80,87,94,102,118,110,105,16,8,8
180,110000,04e66e578f653ab9,1,1,135,57,160,141,144,157,165,158,241,166,231,280,256,226,49,65,-16
151,510000,04e66e578f653ab9,1,1,120,80,119,165,176,134,135,208,419,226,291,404,348,307,113,65,48
116,340000,04e66e578f653ab9,1,1,71,32,69,84,82,105,84,146,172,127,176,201,188,168,25,49,-24
230,370000,04e66e578f653ab9,1,1,219,87,288,336,249,208,207,253,405,274,383,451,417,369,68,109,-41
42,140000,04e66e578f653ab9,1,1,37,21,25,37,54,47,58,68,104,75,85,95,90,85,10,10,0
104,440000,04e66e578f653ab9,1,1,126,21,94,95,114,119,105,149,140,175,225,268,246,223,43,50,-7
30,450000,04e66e578f653ab9,1,1,41,19,28,27,26,35,28,43,42,39,42,71,56,51,29,3,26
334,320000,04e66e578f653ab9,1,1,265,167,319,322,305,326,286,477,566,501,644,669,656,605,25,143,-118
64,360000,04e66e578f653ab9,1,1,79,25,53,46,68,55,61,72,97,83,104,86,95,91,-18,21,-39
140,130000,04e66e578f653ab9,1,1,119,50,125,133,124,117,113,185,186,192,206,272,239,223,66,14,52
144,410000,04e66e578f653ab9,1,1,95,57,78,115,86,115,109,191,156,169,219,319,269,236,100,50,50
190,330000,04e66e578f653ab9,1,1,146,62,153,241,174,199,216,262,293,289,400,452,426,380,52,111,-59
146,420000,04e66e578f653ab9,1,1,61,17,36,44,55,47,45,58,71,47,81,82,82,70,1,34,-33
105,430000,04e66e578f653ab9,1,1,127,44,96,96,123,93,121,118,158,115,135,228,182,159,93,20,73
77,350000,04e66e578f653ab9,1,1,85,32,69,44,77,80,72,82,93,107,132,139,136,126,7,25,-18
42,210000,04e66e578f653ab9,1,1,39,14,35,39,48,22,42,64,69,52,62,81,72,65,19,10,9
44,500000,04e66e578f653ab9,1,1,22,14,28,31,19,68,61,42,66,46,77,87,82,70,10,31,-21
124,610000,04e66e578f653ab9,1,1,77,45,125,134,132,92,109,169,208,170,201,238,220,203,37,31,6
22,230000,04e66e578f653ab9,1,1,30,14,33,46,45,30,38,60,45,45,56,48,52,50,-8,11,-19
238,310000,dff803b4024d261d,1,1,344,119,239,228,169,138,110,96,130,129,206,317,262,217,111,77,34
64,530000,dff803b4024d261d,1,1,106,51,78,75,180,62,53,48,150,68,61,94,78,74,33,-7,40
119,150000,dff803b4024d261d,1,1,126,54,113,86,107,104,115,80,59,69,77,114,96,87,37,8,29
488,110000,dff803b4024d261d,1,1,391,190,502,679,1478,362,522,549,341,411,466,954,710,610,488,55,433
493,510000,dff803b4024d261d,1,1,670,362,298,337,329,313,287,213,226,219,270,560,415,350,290,51,239
238,340000,dff803b4024d261d,1,1,289,151,173,287,132,112,137,105,226,131,164,192,178,162,28,33,-5
609,370000,dff803b4024d261d,1,1,594,229,452,634,622,583,483,376,451,391,462,714,588,522,252,71,181
168,140000,dff803b4024d261d,1,1,222,106,160,138,173,121,88,87,81,104,152,230,191,162,78,48,30
1283,440000,dff803b4024d261d,1,1,1663,446,1134,1049,1151,1204,796,688,783,887,1988,1893,1940,1589,-95,1101,-1196
316,450000,dff803b4024d261d,1,1,402,172,287,232,292,302,238,333,211,167,204,333,268,235,129,37,92
785,320000,dff803b4024d261d,1,1,829,528,715,817,757,633,614,701,409,489,602,865,734,652,263,113,150
264,360000,dff803b4024d261d,1,1,276,130,160,214,361,199,120,104,272,168,194,280,237,214,86,26,60
387,130000,dff803b4024d261d,1,1,374,156,276,257,299,271,278,358,279,275,250,454,352,326,204,-25,229
319,410000,dff803b4024d261d,1,1,282,134,161,254,201,225,287,201,184,168,191,300,246,220,109,23,86
577,330000,dff803b4024d261d,1,1,747,387,571,611,676,536,359,406,355,572,795,787,791,718,-8,223,-231
545,420000,dff803b4024d261d,1,1,647,280,556,499,394,422,178,222,287,394,374,566,470,445,192,-20,212
412,430000,dff803b4024d261d,1,1,472,189,281,349,524,267,270,181,332,203,423,412,418,346,-11,220,-231
555,350000,dff803b4024d261d,1,1,572,172,320,297,502,255,324,353,331,397,363,562,462,441,199,-34,233
230,210000,dff803b4024d261d,1,1,375,169,322,331,310,263,240,234,219,239,228,340,284,269,112,-11,123
378,500000,dff803b4024d261d,1,1,324,201,377,423,567,467,292,184,281,158,348,846,597,451,498,190,308
138,610000,dff803b4024d261d,1,1,163,51,99,165,127,82,202,64,63,62,99,126,112,96,27,37,-10
57,230000,dff803b4024d261d,1,1,105,67,124,102,107,81,71,56,91,46,89,107,98,81,18,43,-25
264,310000,61e73e32ad101892,1,1,480,172,381,276,268,259,263,265,263,222,276,374,325,291,98,54,44
403,530000,61e73e32ad101892,1,1,456,233,291,288,287,259,444,328,322,420,444,423,434,429,-21,24,-45
534,150000,61e73e32ad101892,1,1,507,191,345,439,598,415,527,467,541,608,505,619,562,577,114,-103,217
741,110000,61e73e32ad101892,1,1,929,334,863,864,925,776,823,803,1019,845,1016,1441,1228,1101,425,171,254
940,510000,61e73e32ad101892,1,1,1262,708,697,804,780,668,723,668,1080,712,743,1078,910,844,335,31,304
247,340000,61e73e32ad101892,1,1,324,148,191,191,212,209,143,177,210,217,212,273,242,234,61,-5,66
688,370000,61e73e32ad101892,1,1,697,229,560,823,816,666,592,643,866,764,681,1011,846,819,330,-83,413
274,140000,61e73e32ad101892,1,1,281,110,206,261,279,232,228,276,283,280,288,348,318,305,60,8,52
1849,440000,61e73e32ad101892,1,1,2451,557,1603,1334,1757,1676,1516,1456,1686,2097,2144,2562,2353,2268,418,47,371
364,450000,61e73e32ad101892,1,1,425,173,357,308,368,312,289,221,333,376,342,443,392,387,101,-34,135
658,320000,61e73e32ad101892,1,1,897,397,732,642,720,594,521,656,670,713,682,857,770,751,175,-31,206
334,360000,61e73e32ad101892,1,1,329,183,215,284,272,228,226,207,304,324,277,382,330,328,105,-47,152
804,130000,61e73e32ad101892,1,1,770,350,512,623,789,655,636,756,829,875,790,1042,916,902,252,-85,337
654,410000,61e73e32ad101892,1,1,563,314,442,561,418,478,457,520,525,514,567,656,612,579,89,53,36
632,330000,61e73e32ad101892,1,1,876,397,692,688,672,696,609,628,658,707,687,970,828,788,283,-20,303
1429,420000,61e73e32ad101892,1,1,1485,607,1019,976,969,1189,812,879,1194,1234,1296,1458,1377,1329,162,62,100
712,430000,61e73e32ad101892,1,1,776,324,451,527,529,432,433,504,586,532,579,879,729,663,300,47,253
387,350000,61e73e32ad101892,1,1,586,200,378,320,437,254,309,324,331,423,388,523,456,445,135,-35,170
571,210000,61e73e32ad101892,1,1,777,379,785,855,952,717,778,859,919,871,786,1105,946,921,319,-85,404
616,500000,61e73e32ad101892,1,1,547,319,482,469,390,863,400,378,452,406,568,732,650,569,164,162,2
561,610000,61e73e32ad101892,1,1,645,204,415,526,586,401,428,429,480,618,464,618,541,567,154,-154,308
267,230000,61e73e32ad101892,1,1,397,172,403,364,391,379,393,463,364,346,348,497,422,397,149,2,147
68,310000,a432c483b5beb856,1,1,202,74,148,107,138,95,119,125,135,111,242,237,240,197,-5,131,-136
140,530000,a432c483b5beb856,1,1,204,101,116,126,123,110,141,143,170,165,182,271,226,206,89,17,72
78,150000,a432c483b5beb856,1,1,185,94,127,130,150,140,118,135,135,144,149,195,172,163,46,5,41
34,110000,a432c483b5beb856,1,1,179,94,161,133,142,156,136,151,163,97,128,205,166,143,77,31,46
275,510000,a432c483b5beb856,1,1,521,440,394,366,331,297,273,290,355,284,276,560,418,373,284,-8,292
209,340000,a432c483b5beb856,1,1,340,185,162,134,155,164,187,210,258,234,289,496,392,340,207,55,152
241,370000,a432c483b5beb856,1,1,523,264,365,376,429,398,297,370,455,430,397,599,498,475,202,-33,235
67,140000,a432c483b5beb856,1,1,218,124,155,134,191,136,138,154,165,187,192,226,209,202,34,5,29
510,440000,a432c483b5beb856,1,1,1448,467,1001,803,902,957,908,969,966,1096,1273,1753,1513,1374,480,177,303
161,450000,a432c483b5beb856,1,1,265,158,173,112,150,145,121,133,163,183,209,314,262,235,105,26,79
484,320000,a432c483b5beb856,1,1,695,533,542,500,626,524,494,659,663,720,808,1176,992,901,368,88,280
258,360000,a432c483b5beb856,1,1,357,227,159,167,200,179,156,182,243,282,281,556,418,373,275,-1,276
164,130000,a432c483b5beb856,1,1,350,201,227,222,334,278,240,275,311,284,290,435,362,336,145,6,139
252,410000,a432c483b5beb856,1,1,499,268,207,216,293,353,273,313,316,283,364,562,463,403,198,81,117
332,330000,a432c483b5beb856,1,1,693,426,580,534,604,578,536,581,660,738,799,1102,950,880,303,61,242
267,420000,a432c483b5beb856,1,1,525,248,298,272,226,274,204,230,271,257,362,526,444,382,164,105,59
286,430000,a432c483b5beb856,1,1,468,212,198,189,225,184,208,271,292,260,313,627,470,400,314,53,261
185,350000,a432c483b5beb856,1,1,448,191,273,232,272,218,246,274,282,315,340,500,420,385,160,25,135
101,210000,a432c483b5beb856,1,1,466,252,378,382,339,300,311,310,311,260,209,299,254,256,90,-51,141
179,500000,a432c483b5beb856,1,1,242,182,208,200,174,215,160,199,165,151,159,317,238,209,158,8,150
89,610000,a432c483b5beb856,1,1,167,74,107,132,119,143,116,126,114,163,141,242,192,182,101,-22,123
60,230000,a432c483b5beb856,1,1,154,91,139,139,154,146,135,155,139,103,121,126,124,117,5,18,-13
175,310000,0797526c057dcf5b,1,1,359,125,152,176,401,401,321,346,427,336,1289,571,930,732,-718,953,-1671
160,530000,0797526c057dcf5b,1,1,276,106,125,149,202,186,247,218,226,257,285,393,339,312,108,28,80
236,150000,0797526c057dcf5b,1,1,439,102,151,182,235,185,198,218,291,326,339,631,485,432,292,13,279
232,110000,0797526c057dcf5b,1,1,309,106,458,579,619,663,697,743,797,664,656,980,818,767,324,-8,332
609,510000,0797526c057dcf5b,1,1,1085,517,383,511,577,808,786,904,1230,923,1016,1536,1276,1158,520,93,427
358,340000,0797526c057dcf5b,1,1,445,168,141,183,258,304,319,476,565,666,550,750,650,655,200,-116,316
1788,370000,0797526c057dcf5b,1,1,2478,846,1159,1838,2095,1935,1835,2200,2915,3148,3502,5481,4492,4044,1979,354,1625
502,140000,0797526c057dcf5b,1,1,729,276,388,385,544,496,521,585,792,899,919,1474,1196,1097,555,20,535
5306,440000,0797526c057dcf5b,1,1,9433,2322,6681,6500,8617,8587,8085,9999,11167,12710,12394,15317,13856,13474,2923,-316,3239
1195,450000,0797526c057dcf5b,1,1,1169,509,777,650,933,1046,1010,1186,1639,1709,1789,2693,2241,2064,904,80,824
1247,320000,0797526c057dcf5b,1,1,1739,775,917,1039,1356,1362,1273,1726,2274,2226,2622,3296,2959,2715,674,396,278
857,360000,0797526c057dcf5b,1,1,712,298,301,380,537,595,606,715,1083,1277,1265,1764,1514,1435,499,-12,511
1214,130000,0797526c057dcf5b,1,1,1469,607,575,834,1174,1117,1091,1516,1988,2221,2449,3796,3122,2822,1347,228,1119
1278,410000,0797526c057dcf5b,1,1,1652,766,966,1035,851,918,1151,1553,1783,1739,1951,3130,2540,2273,1179,212,967
700,330000,0797526c057dcf5b,1,1,775,268,670,888,1084,1050,1140,1443,1709,2001,2019,2088,2054,2036,69,18,51
736,420000,0797526c057dcf5b,1,1,786,283,464,568,585,851,689,870,1071,1120,1425,1562,1494,1369,137,305,-168
1244,430000,0797526c057dcf5b,1,1,1956,826,1099,1123,1343,1265,1384,1668,1721,1444,1769,3168,2468,2127,1399,325,1074
769,350000,0797526c057dcf5b,1,1,1153,324,743,748,1047,978,991,1227,1477,1846,1591,1981,1786,1806,390,-255,645
1059,210000,0797526c057dcf5b,1,1,2384,1130,2185,2416,2738,2351,2715,3298,3035,2443,2622,3705,3164,2923,1083,179,904
333,500000,0797526c057dcf5b,1,1,216,134,130,208,307,592,510,660,624,494,548,828,688,623,280,54,226
289,610000,0797526c057dcf5b,1,1,354,91,148,246,335,408,480,451,462,457,402,722,562,527,320,-55,375
350,230000,0797526c057dcf5b,1,1,569,195,290,315,472,426,421,630,651,605,913,1064,988,861,151,308,-157
250,310000,936168bd4850913d,1,1,295,124,267,256,231,232,275,253,330,234,241,272,256,249,31,7,24
494,530000,936168bd4850913d,1,1,412,150,218,222,273,237,317,281,288,285,282,383,332,317,101,-3,104
412,150000,936168bd4850913d,1,1,339,145,261,297,409,278,346,325,397,353,331,374,352,353,43,-22,65
336,110000,936168bd4850913d,1,1,541,169,385,428,423,454,541,459,651,432,527,798,662,586,271,95,176
560,510000,936168bd4850913d,1,1,519,255,328,404,345,365,374,356,560,353,364,502,433,406,138,11,127
378,340000,936168bd4850913d,1,1,480,224,248,311,364,321,347,370,464,369,339,449,394,386,110,-30,140
1132,370000,936168bd4850913d,1,1,1193,436,794,1159,1092,1036,1063,896,1347,1014,1020,1083,1052,1039,63,6,57
373,140000,936168bd4850913d,1,1,509,163,407,327,404,319,311,334,462,394,347,454,400,398,107,-47,154
2859,440000,936168bd4850913d,1,1,3704,894,2297,2056,2432,2474,2478,2391,3040,2810,2842,3119,2980,2924,277,32,245
376,450000,936168bd4850913d,1,1,369,114,277,228,279,260,273,237,346,287,279,316,298,294,37,-8,45
1012,320000,936168bd4850913d,1,1,1101,503,864,875,944,898,914,919,1153,908,905,1057,981,957,152,-3,155
397,360000,936168bd4850913d,1,1,496,183,259,334,387,321,370,350,407,325,334,414,374,358,80,9,71
797,130000,936168bd4850913d,1,1,689,304,529,645,721,619,623,691,837,696,646,778,712,707,132,-50,182
954,410000,936168bd4850913d,1,1,1153,524,743,938,870,860,976,801,1165,786,979,1154,1066,973,175,193,-18
752,330000,936168bd4850913d,1,1,915,336,591,647,679,619,746,631,767,611,709,819,764,713,110,98,12
1405,420000,936168bd4850913d,1,1,1600,713,1120,1091,1131,1321,1289,1127,1463,1111,1292,1497,1394,1300,205,181,24
623,430000,936168bd4850913d,1,1,877,371,605,681,762,693,656,726,776,563,649,953,801,722,304,86,218
627,350000,936168bd4850913d,1,1,851,264,561,623,627,554,655,558,641,586,610,611,610,602,1,24,-23
758,210000,936168bd4850913d,1,1,870,348,596,668,714,579,727,667,816,696,727,851,789,758,124,31,93
248,500000,936168bd4850913d,1,1,281,106,151,162,139,215,222,181,222,152,145,208,176,168,63,-7,70
463,610000,936168bd4850913d,1,1,508,150,307,362,418,335,362,360,429,415,400,482,441,432,82,-15,97
617,230000,936168bd4850913d,1,1,579,233,643,636,673,545,503,567,621,450,630,549,590,543,-81,180,-261
114,310000,cc21c7e91a3b5a0c,1,1,278,193,307,268,271,242,256,281,287,238,345,456,400,346,111,107,4
406,530000,cc21c7e91a3b5a0c,1,1,291,184,287,277,288,270,381,345,327,285,338,442,390,355,104,53,51
195,150000,cc21c7e91a3b5a0c,1,1,213,130,221,205,287,238,235,267,246,282,331,382,356,332,51,49,2
121,110000,cc21c7e91a3b5a0c,1,1,270,124,239,243,275,251,253,208,303,262,356,580,468,399,224,94,130
459,510000,cc21c7e91a3b5a0c,1,1,432,303,495,459,461,461,453,451,636,487,569,804,686,620,235,82,153
403,340000,cc21c7e91a3b5a0c,1,1,409,276,362,355,346,364,377,400,439,428,489,503,496,473,14,61,-47
554,370000,cc21c7e91a3b5a0c,1,1,768,424,741,891,877,768,778,692,815,855,912,1164,1038,977,252,57,195
223,140000,cc21c7e91a3b5a0c,1,1,300,131,274,256,316,230,226,277,310,284,316,428,372,343,112,32,80
1930,440000,cc21c7e91a3b5a0c,1,1,2724,1092,2312,2006,2367,2317,2288,2219,2478,2450,3345,3730,3538,3175,385,895,-510
266,450000,cc21c7e91a3b5a0c,1,1,282,164,296,226,316,262,277,270,290,313,377,417,397,369,40,64,-24
877,320000,cc21c7e91a3b5a0c,1,1,1090,663,1174,1098,1171,1053,1035,1139,1193,1114,1454,1527,1490,1365,73,340,-267
305,360000,cc21c7e91a3b5a0c,1,1,310,179,286,283,344,324,354,314,340,317,350,507,428,391,157,33,124
453,130000,cc21c7e91a3b5a0c,1,1,439,276,466,466,575,563,517,521,590,551,574,797,686,641,223,23,200
630,410000,cc21c7e91a3b5a0c,1,1,622,387,631,701,609,620,657,647,687,548,872,1036,954,819,164,324,-160
739,330000,cc21c7e91a3b5a0c,1,1,868,560,868,916,952,851,928,863,800,942,1151,1258,1204,1117,107,209,-102
963,420000,cc21c7e91a3b5a0c,1,1,1097,649,859,860,857,1022,954,876,1065,918,1189,1511,1350,1206,322,271,51
420,430000,cc21c7e91a3b5a0c,1,1,557,265,432,418,440,412,436,456,456,452,506,737,622,565,231,54,177
473,350000,cc21c7e91a3b5a0c,1,1,657,320,585,524,634,509,574,525,556,643,734,779,756,719,45,91,-46
285,210000,cc21c7e91a3b5a0c,1,1,414,229,394,433,415,359,423,434,437,390,480,602,541,491,122,90,32
185,500000,cc21c7e91a3b5a0c,1,1,180,111,154,208,153,256,232,218,203,186,200,305,252,230,105,14,91
293,610000,cc21c7e91a3b5a0c,1,1,357,159,255,282,291,238,303,301,293,309,345,496,420,383,151,36,115
214,230000,cc21c7e91a3b5a0c,1,1,323,238,410,348,422,361,360,329,347,306,404,422,413,377,18,98,-80
224,310000,7aab7fca2470987e,1,1,246,127,288,255,249,227,228,228,248,166,277,348,312,264,71,111,-40
19,530000,7aab7fca2470987e,1,1,30,18,26,19,19,13,29,23,22,12,22,33,28,22,11,10,1
21,150000,7aab7fca2470987e,1,1,19,9,22,31,32,22,34,26,20,16,19,22,20,19,3,3,0
424,110000,7aab7fca2470987e,1,1,406,155,342,385,371,412,397,450,433,353,372,511,442,412,139,19,120
69,510000,7aab7fca2470987e,1,1,59,28,61,40,41,50,45,33,53,34,42,64,53,47,22,8,14
83,340000,7aab7fca2470987e,1,1,66,58,96,94,77,54,58,60,65,52,74,75,74,67,1,22,-21
430,370000,7aab7fca2470987e,1,1,346,131,279,291,321,323,323,300,349,309,286,341,314,312,55,-23,78
105,140000,7aab7fca2470987e,1,1,118,47,101,97,85,61,83,86,76,58,62,78,70,66,16,4,12
1009,440000,7aab7fca2470987e,1,1,1350,320,938,782,929,824,845,827,959,887,972,1235,1104,1031,263,85,178
34,450000,7aab7fca2470987e,1,1,37,19,27,25,33,22,15,35,23,23,13,26,20,21,13,-10,23
397,320000,7aab7fca2470987e,1,1,384,239,397,361,372,366,390,384,352,323,380,481,430,395,101,57,44
61,360000,7aab7fca2470987e,1,1,52,21,43,45,28,35,34,41,44,29,35,37,36,34,2,6,-4
308,130000,7aab7fca2470987e,1,1,221,115,209,215,221,251,231,259,229,234,231,316,274,260,85,-3,88
242,410000,7aab7fca2470987e,1,1,191,117,183,203,189,186,204,209,192,150,188,209,198,182,21,38,-17
353,330000,7aab7fca2470987e,1,1,296,167,351,324,279,263,302,300,252,293,323,375,349,330,52,30,22
54,420000,7aab7fca2470987e,1,1,65,33,64,65,48,56,41,58,58,26,64,62,63,51,-2,38,-40
54,430000,7aab7fca2470987e,1,1,46,26,45,53,33,37,54,26,47,25,31,44,38,33,13,6,7
92,350000,7aab7fca2470987e,1,1,96,36,100,71,65,63,56,64,42,57,83,105,94,82,22,26,-4
158,210000,7aab7fca2470987e,1,1,144,88,143,201,173,177,170,176,181,127,153,187,170,156,34,26,8
22,500000,7aab7fca2470987e,1,1,20,15,27,25,16,43,25,22,19,17,12,27,20,19,15,-5,20
61,610000,7aab7fca2470987e,1,1,22,15,29,33,50,39,32,34,19,25,29,46,38,33,17,4,13
66,230000,7aab7fca2470987e,1,1,82,40,94,92,117,107,90,78,77,62,61,65,63,63,4,-1,5
161,310000,fde95ea242abd896,1,1,409,143,279,297,244,231,222,233,237,260,331,369,350,320,38,71,-33
386,530000,fde95ea242abd896,1,1,380,236,312,304,293,280,397,351,388,519,521,651,586,564,130,2,128
146,150000,fde95ea242abd896,1,1,170,96,126,103,173,112,115,149,181,185,190,234,212,203,44,5,39
210,110000,fde95ea242abd896,1,1,405,149,302,248,267,240,223,271,313,223,301,382,342,302,81,78,3
509,510000,fde95ea242abd896,1,1,599,310,417,389,401,386,408,384,645,492,617,839,728,649,222,125,97
387,340000,fde95ea242abd896,1,1,571,255,336,313,328,323,371,429,508,453,504,690,597,549,186,51,135
444,370000,fde95ea242abd896,1,1,685,296,546,625,677,569,603,642,825,774,709,964,836,816,255,-65,320
175,140000,fde95ea242abd896,1,1,358,136,255,277,268,247,194,300,278,277,302,443,372,341,141,25,116
3229,440000,fde95ea242abd896,1,1,5181,1286,3265,2736,3407,3034,2769,3466,3967,4449,4901,5547,5224,4966,646,452,194
381,450000,fde95ea242abd896,1,1,523,241,394,300,323,305,295,375,362,434,458,665,562,519,207,24,183
690,320000,fde95ea242abd896,1,1,1233,551,920,905,886,740,767,910,875,888,974,1139,1056,1000,165,86,79
381,360000,fde95ea242abd896,1,1,493,221,252,298,296,306,326,283,440,408,499,625,562,511,126,91,35
407,130000,fde95ea242abd896,1,1,576,281,454,470,518,437,434,560,591,602,602,830,716,678,228,0,228
507,410000,fde95ea242abd896,1,1,650,307,448,487,451,445,414,574,666,620,614,920,767,718,306,-6,312
732,330000,fde95ea242abd896,1,1,1364,648,939,1038,954,959,917,968,1148,998,1169,1424,1296,1197,255,171,84
698,420000,fde95ea242abd896,1,1,1295,481,744,646,667,730,629,764,987,818,1066,1347,1206,1077,281,248,33
570,430000,fde95ea242abd896,1,1,1022,381,522,540,567,522,526,503,752,630,700,988,844,773,288,70,218
605,350000,fde95ea242abd896,1,1,914,277,559,556,633,509,603,671,676,754,796,1043,920,864,247,42,205
253,210000,fde95ea242abd896,1,1,431,201,457,514,445,435,473,472,553,433,460,600,530,498,140,27,113
139,500000,fde95ea242abd896,1,1,234,124,155,208,157,246,168,172,243,227,222,229,226,226,7,-5,12
140,610000,fde95ea242abd896,1,1,181,60,111,120,179,148,148,164,191,253,229,293,261,258,64,-24,88
111,230000,fde95ea242abd896,1,1,221,126,319,331,309,255,234,372,256,198,199,322,260,240,123,1,122
264,310000,97f15de12cfabbd5,1,1,359,113,123,139,212,242,279,368,455,354,457,516,486,442,59,103,-44
206,530000,97f15de12cfabbd5,1,1,154,94,88,54,90,69,134,137,168,236,233,253,243,241,20,-3,23
219,150000,97f15de12cfabbd5,1,1,249,91,148,111,161,112,170,148,180,212,200,238,219,217,38,-12,50
601,110000,97f15de12cfabbd5,1,1,1025,279,489,419,541,572,614,704,733,603,754,1094,924,817,340,151,189
391,510000,97f15de12cfabbd5,1,1,476,287,296,215,215,241,286,280,498,363,489,543,516,465,54,126,-72
495,340000,97f15de12cfabbd5,1,1,519,244,200,168,222,253,319,361,472,444,568,578,573,530,10,124,-114
1031,370000,97f15de12cfabbd5,1,1,1082,373,450,449,644,594,653,771,1001,1018,1094,1221,1158,1111,127,76,51
316,140000,97f15de12cfabbd5,1,1,596,250,187,190,307,319,310,398,381,370,395,605,500,457,210,25,185
2666,440000,97f15de12cfabbd5,1,1,3205,739,2169,1283,1775,1807,1926,2292,2762,3019,3563,3747,3655,3443,184,544,-360
193,450000,97f15de12cfabbd5,1,1,150,76,105,85,131,107,105,132,134,146,194,174,184,171,-20,48,-68
1070,320000,97f15de12cfabbd5,1,1,1333,669,776,574,791,789,884,1139,1155,1292,1491,1524,1508,1436,33,199,-166
346,360000,97f15de12cfabbd5,1,1,320,139,153,127,135,142,163,206,280,258,340,409,374,336,69,82,-13
789,130000,97f15de12cfabbd5,1,1,998,454,423,400,560,621,573,819,812,975,971,1119,1045,1022,148,-4,152
692,410000,97f15de12cfabbd5,1,1,744,364,326,261,356,378,472,519,592,609,805,866,836,760,61,196,-135
1138,330000,97f15de12cfabbd5,1,1,1482,629,657,569,729,797,1116,1100,1259,1371,1516,1515,1516,1467,-1,145,-146
749,420000,97f15de12cfabbd5,1,1,830,373,597,355,306,462,346,475,707,729,779,906,842,805,127,50,77
710,430000,97f15de12cfabbd5,1,1,903,356,437,344,400,350,381,419,626,645,767,839,803,750,72,122,-50
509,350000,97f15de12cfabbd5,1,1,611,185,292,182,309,251,400,389,434,571,612,638,625,607,26,41,-15
898,210000,97f15de12cfabbd5,1,1,1187,442,556,678,921,843,1057,1068,1256,1020,1269,1395,1332,1228,126,249,-123
159,500000,97f15de12cfabbd5,1,1,271,174,192,141,164,243,183,190,183,170,200,213,206,194,13,30,-17
227,610000,97f15de12cfabbd5,1,1,215,89,158,121,222,212,278,246,251,273,309,371,340,318,62,36,26
366,230000,97f15de12cfabbd5,1,1,618,230,238,301,459,440,381,659,536,422,639,783,711,615,144,217,-73
260,310000,f5d69960089c3614,1,1,327,94,200,200,179,143,213,231,263,186,304,291,298,260,-13,118,-131
78,530000,f5d69960089c3614,1,1,77,27,35,27,47,40,86,70,45,62,97,95,96,85,-2,35,-37
35,150000,f5d69960089c3614,1,1,50,18,65,39,59,30,34,48,53,57,54,64,59,58,10,-3,13
435,110000,f5d69960089c3614,1,1,533,209,530,530,580,328,387,431,542,458,551,739,645,583,188,93,95
270,510000,f5d69960089c3614,1,1,222,120,157,199,189,198,208,192,406,218,246,296,271,253,50,28,22
156,340000,f5d69960089c3614,1,1,118,55,65,66,77,68,83,102,108,119,125,125,125,123,0,6,-6
218,370000,f5d69960089c3614,1,1,211,101,152,215,226,189,211,236,259,209,228,356,292,264,128,19,109
47,140000,f5d69960089c3614,1,1,42,13,35,31,34,37,39,38,29,27,53,51,52,44,-2,26,-28
437,440000,f5d69960089c3614,1,1,308,85,279,264,290,315,201,283,319,341,442,572,507,452,130,101,29
44,450000,f5d69960089c3614,1,1,46,18,33,39,40,44,25,47,48,35,38,46,42,40,8,3,5
251,320000,f5d69960089c3614,1,1,206,120,177,166,199,160,179,202,235,218,248,301,274,256,53,30,23
84,360000,f5d69960089c3614,1,1,65,47,60,46,67,46,43,63,74,57,75,92,84,75,17,18,-1
106,130000,f5d69960089c3614,1,1,107,47,72,82,94,85,75,106,81,95,123,131,127,116,8,28,-20
131,410000,f5d69960089c3614,1,1,184,70,115,177,146,115,120,133,136,137,144,187,166,156,43,7,36
149,330000,f5d69960089c3614,1,1,134,40,101,105,120,103,117,123,127,129,149,230,190,169,81,20,61
148,420000,f5d69960089c3614,1,1,119,68,95,105,133,83,100,88,128,132,148,184,166,155,36,16,20
135,430000,f5d69960089c3614,1,1,176,67,111,119,132,99,113,129,125,121,157,211,184,163,54,36,18
108,350000,f5d69960089c3614,1,1,125,34,75,68,110,85,91,79,63,93,111,124,118,109,13,18,-5
69,210000,f5d69960089c3614,1,1,78,37,96,78,114,94,86,129,93,93,126,129,128,116,3,33,-30
125,500000,f5d69960089c3614,1,1,102,64,107,106,102,141,124,91,113,105,132,160,146,132,28,27,1
148,610000,f5d69960089c3614,1,1,176,50,104,117,132,93,101,114,118,176,150,182,166,169,32,-26,58
53,230000,f5d69960089c3614,1,1,50,27,72,66,58,77,51,83,64,44,71,77,74,64,6,27,-21
154,310000,5b1c11c3efed5312,1,1,309,83,137,166,137,100,120,182,195,186,244,388,316,273,144,58,86
194,530000,5b1c11c3efed5312,1,1,297,123,160,138,155,102,132,175,199,190,214,267,240,224,53,24,29
127,150000,5b1c11c3efed5312,1,1,216,72,109,113,123,90,86,129,117,180,167,259,213,202,92,-13,105
71,110000,5b1c11c3efed5312,1,1,414,84,168,157,135,132,124,189,195,143,181,370,276,231,189,38,151
448,510000,5b1c11c3efed5312,1,1,689,306,341,347,268,235,259,271,451,335,432,691,562,486,259,97,162
712,340000,5b1c11c3efed5312,1,1,951,409,428,406,511,409,457,615,665,719,699,1253,976,890,554,-20,574
549,370000,5b1c11c3efed5312,1,1,1052,368,553,712,759,542,525,598,799,850,792,1449,1120,1030,657,-58,715
153,140000,5b1c11c3efed5312,1,1,310,114,172,156,184,119,112,180,176,226,231,426,328,294,195,5,190
496,440000,5b1c11c3efed5312,1,1,940,146,505,439,656,557,570,682,810,953,1204,1628,1416,1262,424,251,173
121,450000,5b1c11c3efed5312,1,1,285,82,128,93,99,74,74,93,96,119,135,240,188,165,105,16,89
768,320000,5b1c11c3efed5312,1,1,1269,617,835,685,815,558,664,879,928,1050,1083,1908,1496,1347,825,33,792
453,360000,5b1c11c3efed5312,1,1,612,175,250,275,290,238,256,256,368,358,434,733,584,508,299,76,223
476,130000,5b1c11c3efed5312,1,1,825,345,481,442,541,372,433,513,576,665,667,1158,912,830,491,2,489
910,410000,5b1c11c3efed5312,1,1,1294,511,612,706,670,565,604,728,823,894,1006,1883,1444,1261,877,112,765
744,330000,5b1c11c3efed5312,1,1,1452,570,741,745,772,623,618,806,968,1022,1202,2202,1702,1475,1000,180,820
443,420000,5b1c11c3efed5312,1,1,552,200,249,254,222,214,224,236,278,353,409,749,579,504,340,56,284
378,430000,5b1c11c3efed5312,1,1,533,190,262,282,299,206,221,263,352,322,439,744,592,502,305,117,188
265,350000,5b1c11c3efed5312,1,1,373,106,251,186,224,163,185,197,242,345,391,594,492,443,203,46,157
75,210000,5b1c11c3efed5312,1,1,244,102,164,167,172,127,118,166,151,176,186,256,221,206,70,10,60
124,500000,5b1c11c3efed5312,1,1,132,69,103,86,60,103,92,81,101,86,92,172,132,117,80,6,74
144,610000,5b1c11c3efed5312,1,1,333,120,165,166,180,107,108,126,155,205,212,325,268,247,113,7,106
43,230000,5b1c11c3efed5312,1,1,158,68,172,142,116,90,66,138,116,107,126,152,139,128,26,19,7
65,310000,17363f08d683d52b,1,1,165,39,67,57,61,83,70,93,94,69,88,96,92,84,8,19,-11
216,530000,17363f08d683d52b,1,1,503,206,157,153,150,145,260,181,192,214,209,182,196,202,-27,-5,-22
132,150000,17363f08d683d52b,1,1,260,111,103,103,189,132,152,130,174,176,130,141,136,149,11,-46,57
124,110000,17363f08d683d52b,1,1,580,162,255,224,215,203,267,229,259,158,186,277,232,207,91,28,63
350,510000,17363f08d683d52b,1,1,787,379,249,251,265,277,338,249,374,267,205,292,248,255,87,-62,149
513,340000,17363f08d683d52b,1,1,964,370,259,261,334,403,369,409,407,332,341,384,362,352,43,9,34
555,370000,17363f08d683d52b,1,1,963,329,460,477,501,534,578,578,669,572,480,596,538,549,116,-92,208
66,140000,17363f08d683d52b,1,1,236,48,88,53,84,72,80,105,82,89,70,67,68,75,-3,-19,16
62,440000,17363f08d683d52b,1,1,560,58,174,189,205,161,153,130,99,91,101,84,92,92,-17,10,-27
45,450000,17363f08d683d52b,1,1,183,68,55,61,65,56,59,47,57,42,39,50,44,44,11,-3,14
538,320000,17363f08d683d52b,1,1,1022,474,501,391,511,498,540,652,534,502,474,569,522,515,95,-28,123
360,360000,17363f08d683d52b,1,1,675,234,206,222,322,296,334,361,423,281,274,309,292,288,35,-7,42
353,130000,17363f08d683d52b,1,1,777,302,326,300,423,331,415,474,378,372,326,383,354,360,57,-46,103
538,410000,17363f08d683d52b,1,1,1084,438,344,433,458,439,537,516,505,471,372,457,414,433,85,-99,184
388,330000,17363f08d683d52b,1,1,1315,474,480,439,481,523,527,619,525,437,429,453,441,440,24,-8,32
474,420000,17363f08d683d52b,1,1,824,291,253,287,274,347,357,348,470,379,317,421,369,372,104,-62,166
459,430000,17363f08d683d52b,1,1,770,263,271,267,285,332,369,394,455,353,348,428,388,376,80,-5,85
136,350000,17363f08d683d52b,1,1,349,89,110,105,117,97,156,140,150,148,127,159,143,145,32,-21,53
151,210000,17363f08d683d52b,1,1,309,139,206,190,224,186,211,236,239,216,174,238,206,209,64,-42,106
110,500000,17363f08d683d52b,1,1,363,173,118,113,119,207,154,160,119,108,151,126,138,128,-25,43,-68
180,610000,17363f08d683d52b,1,1,461,167,172,200,295,195,243,241,219,279,210,288,249,259,78,-69,147
75,230000,17363f08d683d52b,1,1,201,65,155,112,155,119,135,185,126,121,118,156,137,132,38,-3,41
208,310000,06880909932890ca,1,1,270,36,140,123,151,184,200,260,330,188,341,384,362,304,43,153,-110
142,530000,06880909932890ca,1,1,241,89,97,87,116,115,160,152,177,216,186,206,196,203,20,-30,50
74,150000,06880909932890ca,1,1,135,53,68,89,116,92,95,118,103,121,125,115,120,120,-10,4,-14
253,110000,06880909932890ca,1,1,872,197,494,429,502,404,587,598,646,461,553,771,662,595,218,92,126
673,510000,06880909932890ca,1,1,990,423,370,360,435,525,529,541,770,548,657,933,795,713,276,109,167
964,340000,06880909932890ca,1,1,1627,500,410,494,668,812,815,909,849,800,764,993,878,852,229,-36,265
1011,370000,06880909932890ca,1,1,1313,526,689,772,912,798,955,1028,1068,979,957,1332,1144,1089,375,-22,397
128,140000,06880909932890ca,1,1,297,89,124,155,182,158,166,260,200,213,203,275,239,230,72,-10,82
767,440000,06880909932890ca,1,1,1192,150,692,651,912,826,970,1165,1341,1182,1660,1546,1603,1463,-114,478,-592
186,450000,06880909932890ca,1,1,341,123,132,118,154,160,138,192,192,181,188,276,232,215,88,7,81
2094,320000,06880909932890ca,1,1,2572,1169,1437,1322,1690,1549,1784,2086,2054,2015,2022,2642,2332,2226,620,7,613
614,360000,06880909932890ca,1,1,744,225,275,317,446,403,446,466,481,368,453,691,572,504,238,85,153
530,130000,06880909932890ca,1,1,1088,433,527,489,571,550,679,797,728,665,667,773,720,702,106,2,104
1865,410000,06880909932890ca,1,1,2128,769,741,998,1156,1405,1588,1680,1676,1390,1577,2409,1993,1792,832,187,645
1022,330000,06880909932890ca,1,1,2117,826,1017,1000,1198,1267,1405,1649,1572,1696,1832,2222,2027,1917,390,136,254
605,420000,06880909932890ca,1,1,804,267,322,336,378,470,475,562,525,475,492,661,576,543,169,17,152
488,430000,06880909932890ca,1,1,768,259,348,380,383,445,414,541,561,481,547,698,622,575,151,66,85
361,350000,06880909932890ca,1,1,411,124,232,228,311,284,350,418,427,469,556,601,578,542,45,87,-42
161,210000,06880909932890ca,1,1,279,111,190,228,287,226,287,309,335,246,211,328,270,262,117,-35,152
326,500000,06880909932890ca,1,1,516,254,176,207,287,447,415,439,445,330,373,430,402,378,57,43,14
349,610000,06880909932890ca,1,1,542,170,252,248,336,278,349,407,350,449,347,562,454,453,215,-102,317
69,230000,06880909932890ca,1,1,154,58,136,101,109,89,128,149,133,82,97,100,98,93,3,15,-12
32,310000,9c1c7ee8ebdda299,1,1,53,12,45,21,27,22,13,27,10,4,41,46,44,30,5,37,-32
142,530000,9c1c7ee8ebdda299,1,1,388,230,170,165,176,148,181,200,159,126,119,169,144,138,50,-7,57
278,150000,9c1c7ee8ebdda299,1,1,995,264,295,260,348,233,350,323,327,297,353,430,392,360,77,56,21
52,110000,9c1c7ee8ebdda299,1,1,353,107,230,173,167,151,170,121,96,46,78,112,95,79,34,32,2
617,510000,9c1c7ee8ebdda299,1,1,1774,976,914,753,701,834,869,836,723,408,517,641,579,522,124,109,15
278,340000,9c1c7ee8ebdda299,1,1,663,352,281,292,330,322,293,261,211,71,198,190,194,153,-8,127,-135
1763,370000,9c1c7ee8ebdda299,1,1,4313,1881,1411,1514,1697,1542,1763,1885,1782,1445,1562,2281,1922,1763,719,117,602
691,140000,9c1c7ee8ebdda299,1,1,1841,559,695,566,798,670,854,973,842,579,768,886,827,744,118,189,-71
472,440000,9c1c7ee8ebdda299,1,1,1492,337,851,657,797,730,793,791,821,619,710,1008,859,779,298,91,207
251,450000,9c1c7ee8ebdda299,1,1,505,213,235,139,170,190,169,185,191,132,192,308,250,211,116,60,56
370,320000,9c1c7ee8ebdda299,1,1,753,409,368,309,295,297,299,267,195,95,307,309,308,237,2,212,-210
224,360000,9c1c7ee8ebdda299,1,1,678,297,223,225,303,258,215,138,145,60,177,182,180,140,5,117,-112
1468,130000,9c1c7ee8ebdda299,1,1,4384,2024,1679,1513,1845,1547,1898,2125,1949,1092,1644,1840,1742,1525,196,552,-356
1101,410000,9c1c7ee8ebdda299,1,1,2396,1096,746,823,772,817,797,693,546,306,774,911,842,664,137,468,-331
327,330000,9c1c7ee8ebdda299,1,1,520,250,257,215,232,213,216,202,149,42,380,352,366,258,-28,338,-366
211,420000,9c1c7ee8ebdda299,1,1,366,155,165,159,138,172,121,123,100,46,116,125,120,96,9,70,-61
230,430000,9c1c7ee8ebdda299,1,1,522,201,197,204,204,207,195,142,140,74,141,165,153,127,24,67,-43
204,350000,9c1c7ee8ebdda299,1,1,407,135,327,238,254,259,254,219,159,110,281,215,248,202,-66,171,-237
375,210000,9c1c7ee8ebdda299,1,1,1022,315,497,548,622,615,791,715,654,384,528,619,574,510,91,144,-53
116,500000,9c1c7ee8ebdda299,1,1,309,139,127,140,142,167,210,170,119,62,80,104,92,82,24,18,6
261,610000,9c1c7ee8ebdda299,1,1,814,279,325,347,415,360,504,331,168,145,214,250,232,203,36,69,-33
207,230000,9c1c7ee8ebdda299,1,1,645,228,325,312,349,289,307,328,302,291,350,342,346,328,-8,59,-67
174,310000,c6833cb891626c17,1,1,320,64,143,153,184,190,187,321,371,283,435,596,516,438,161,152,9
444,530000,c6833cb891626c17,1,1,310,120,243,214,293,278,391,368,477,514,538,699,618,584,161,24,137
221,150000,c6833cb891626c17,1,1,283,95,150,144,231,182,278,328,337,354,323,485,404,387,162,-31,193
309,110000,c6833cb891626c17,1,1,781,249,424,446,557,512,616,785,877,636,879,1517,1198,1011,638,243,395
743,510000,c6833cb891626c17,1,1,739,359,385,442,498,519,553,602,1020,712,770,1305,1038,929,535,58,477
855,340000,c6833cb891626c17,1,1,680,254,335,430,556,596,658,834,1066,894,964,1597,1280,1152,633,70,563
687,370000,c6833cb891626c17,1,1,983,380,583,765,851,801,793,998,1278,1160,1107,1740,1424,1336,633,-53,686
192,140000,c6833cb891626c17,1,1,314,106,151,162,214,187,206,301,280,282,301,514,408,366,213,19,194
542,440000,c6833cb891626c17,1,1,1227,149,614,549,687,668,710,890,1382,1240,1586,1899,1742,1575,313,346,-33
260,450000,c6833cb891626c17,1,1,327,107,187,136,186,226,201,232,277,266,309,514,412,363,205,43,162
939,320000,c6833cb891626c17,1,1,1339,523,808,744,993,872,955,1345,1406,1396,1446,2279,1862,1707,833,50,783
502,360000,c6833cb891626c17,1,1,463,121,209,241,288,279,356,409,638,519,571,900,736,663,329,52,277
708,130000,c6833cb891626c17,1,1,867,350,577,540,727,602,725,929,1066,990,1108,1749,1428,1282,641,118,523
1331,410000,c6833cb891626c17,1,1,1112,439,612,886,926,1021,1208,1438,1525,1493,1622,2735,2178,1950,1113,129,984
1119,330000,c6833cb891626c17,1,1,1942,598,832,846,1069,1144,1284,1635,1804,1911,2130,3255,2692,2432,1125,219,906
597,420000,c6833cb891626c17,1,1,472,187,282,287,324,375,419,485,678,560,634,1014,824,736,380,74,306
498,430000,c6833cb891626c17,1,1,548,169,301,351,355,332,374,473,712,546,606,978,792,710,372,60,312
311,350000,c6833cb891626c17,1,1,374,110,226,228,280,250,238,291,406,499,552,782,667,611,230,53,177
127,210000,c6833cb891626c17,1,1,354,117,255,208,243,206,229,283,315,299,258,424,341,327,166,-41,207
260,500000,c6833cb891626c17,1,1,314,131,137,183,177,223,193,277,336,267,309,532,420,369,223,42,181
315,610000,c6833cb891626c17,1,1,440,175,215,218,355,227,253,326,373,472,366,620,493,486,254,-106,360
80,230000,c6833cb891626c17,1,1,221,119,192,157,191,155,137,237,206,170,232,274,253,225,42,62,-20
369,310000,3e21824be728cbec,1,1,377,167,243,160,176,192,187,249,257,239,345,396,370,327,51,106,-55
203,530000,3e21824be728cbec,1,1,439,231,291,200,206,289,300,344,358,406,373,334,354,371,-39,-33,-6
51,150000,3e21824be728cbec,1,1,136,39,69,59,78,58,65,160,123,116,59,90,74,88,31,-57,88
93,110000,3e21824be728cbec,1,1,315,100,199,163,119,141,164,139,203,168,222,242,232,211,20,54,-34
288,510000,3e21824be728cbec,1,1,825,448,557,450,413,455,488,625,731,758,778,781,780,772,3,20,-17
309,340000,3e21824be728cbec,1,1,603,326,450,279,349,370,347,570,630,644,607,661,634,637,54,-37,91
540,370000,3e21824be728cbec,1,1,1125,460,731,616,559,584,576,690,772,807,782,994,888,861,212,-25,237
88,140000,3e21824be728cbec,1,1,255,97,151,126,140,127,162,287,240,200,132,201,166,178,69,-68,137
331,440000,3e21824be728cbec,1,1,789,198,606,453,438,526,486,516,619,721,938,1135,1036,931,197,217,-20
140,450000,3e21824be728cbec,1,1,413,155,278,158,185,230,205,301,268,247,370,403,386,340,33,123,-90
805,320000,3e21824be728cbec,1,1,1936,1070,1579,700,765,791,837,1017,1020,1227,1286,1781,1534,1431,495,59,436
157,360000,3e21824be728cbec,1,1,453,176,320,223,276,230,221,285,391,438,444,431,438,438,-13,6,-19
391,130000,3e21824be728cbec,1,1,1016,455,668,556,558,552,574,734,729,766,589,806,698,720,217,-177,394
363,410000,3e21824be728cbec,1,1,1137,475,738,578,632,668,840,854,777,834,729,896,812,820,167,-105,272
341,330000,3e21824be728cbec,1,1,990,595,865,493,406,443,507,510,573,616,797,1044,920,819,247,181,66
270,420000,3e21824be728cbec,1,1,594,248,391,284,238,303,280,357,375,452,413,461,437,442,48,-39,87
157,430000,3e21824be728cbec,1,1,559,210,341,224,235,250,255,292,394,414,458,478,468,450,20,44,-24
250,350000,3e21824be728cbec,1,1,791,270,489,293,325,290,310,328,339,397,455,593,524,482,138,58,80
45,210000,3e21824be728cbec,1,1,185,84,145,108,118,118,139,151,144,114,136,149,142,133,13,22,-9
136,500000,3e21824be728cbec,1,1,361,176,262,167,239,459,311,410,422,402,422,475,448,433,53,20,33
194,610000,3e21824be728cbec,1,1,511,231,280,319,382,320,375,494,446,595,355,464,410,471,109,-240,349
40,230000,3e21824be728cbec,1,1,172,107,198,154,180,125,146,202,237,176,82,87,84,115,5,-94,99
371,310000,f8a6975573af1b33,1,1,641,216,375,266,306,267,258,427,420,355,228,579,404,387,351,-127,478
215,530000,f8a6975573af1b33,1,1,375,183,225,152,177,118,180,214,200,244,165,338,252,249,173,-79,252
41,150000,f8a6975573af1b33,1,1,80,28,44,26,58,32,43,34,40,41,43,48,46,44,5,2,3
131,110000,f8a6975573af1b33,1,1,587,179,327,244,264,181,202,267,304,268,372,383,378,341,11,104,-93
550,510000,f8a6975573af1b33,1,1,832,424,488,398,410,336,352,370,632,431,484,820,652,578,336,53,283
508,340000,f8a6975573af1b33,1,1,855,330,403,387,411,362,305,443,521,495,362,758,560,538,396,-133,529
410,370000,f8a6975573af1b33,1,1,612,256,457,424,368,316,303,357,410,423,383,729,556,512,346,-40,386
74,140000,f8a6975573af1b33,1,1,139,52,102,63,71,48,59,51,78,61,91,136,114,96,45,30,15
1023,440000,f8a6975573af1b33,1,1,2156,403,1121,875,992,904,879,1153,1298,1305,1034,2232,1633,1524,1198,-271,1469
208,450000,f8a6975573af1b33,1,1,407,163,249,172,201,169,192,217,237,215,191,328,260,245,137,-24,161
1142,320000,f8a6975573af1b33,1,1,2028,1033,1427,1017,1202,877,845,1153,1190,1239,807,1846,1326,1297,1039,-432,1471
290,360000,f8a6975573af1b33,1,1,543,162,249,182,202,165,177,232,306,226,131,436,284,264,305,-95,400
287,130000,f8a6975573af1b33,1,1,538,224,327,290,285,257,243,316,360,308,272,475,374,352,203,-36,239
459,410000,f8a6975573af1b33,1,1,875,364,491,439,424,404,405,509,554,543,420,747,584,570,327,-123,450
752,330000,f8a6975573af1b33,1,1,1484,681,993,723,767,644,614,743,824,856,695,1454,1074,1002,759,-161,920
312,420000,f8a6975573af1b33,1,1,549,189,257,224,213,257,205,250,304,278,190,481,336,316,291,-88,379
324,430000,f8a6975573af1b33,1,1,592,187,320,299,303,226,226,283,329,289,235,425,330,316,190,-54,244
508,350000,f8a6975573af1b33,1,1,954,280,514,351,414,293,354,411,469,472,415,699,557,529,284,-57,341
66,210000,f8a6975573af1b33,1,1,186,95,156,120,126,118,94,128,154,125,64,125,94,105,61,-61,122
310,500000,f8a6975573af1b33,1,1,531,288,399,316,243,316,279,300,389,322,256,548,402,375,292,-66,358
170,610000,f8a6975573af1b33,1,1,321,118,154,172,180,121,162,175,188,226,181,259,220,222,78,-45,123
61,230000,f8a6975573af1b33,1,1,93,59,121,105,118,92,95,86,84,67,65,115,90,82,50,-2,52
415,310000,54fc07138d70374c,1,1,427,227,439,284,312,308,315,327,336,292,421,473,447,395,52,129,-77
500,530000,54fc07138d70374c,1,1,464,198,268,226,239,271,381,320,316,363,485,535,510,461,50,122,-72
273,150000,54fc07138d70374c,1,1,225,91,159,124,177,198,210,230,224,233,229,234,232,232,5,-4,9
534,110000,54fc07138d70374c,1,1,617,228,489,359,374,335,454,424,442,429,500,681,590,537,181,71,110
933,510000,54fc07138d70374c,1,1,850,346,509,498,454,508,557,495,659,704,743,849,796,765,106,39,67
404,340000,54fc07138d70374c,1,1,287,177,226,184,207,204,219,249,314,271,334,368,351,324,34,63,-29
911,370000,54fc07138d70374c,1,1,777,316,517,505,542,531,579,617,771,679,776,936,856,797,160,97,63
213,140000,54fc07138d70374c,1,1,182,97,155,129,125,128,113,131,135,142,208,244,226,198,36,66,-30
1526,440000,54fc07138d70374c,1,1,1965,437,1193,876,978,1056,1120,1145,1408,1392,1836,2078,1957,1769,242,444,-202
323,450000,54fc07138d70374c,1,1,379,160,248,190,185,216,203,212,207,208,246,317,282,257,71,38,33
821,320000,54fc07138d70374c,1,1,749,394,578,403,502,513,553,616,611,660,847,820,834,776,-27,187,-214
297,360000,54fc07138d70374c,1,1,289,116,232,156,222,179,206,215,215,187,249,262,256,233,13,62,-49
758,130000,54fc07138d70374c,1,1,549,298,398,396,448,411,475,528,576,625,746,750,748,707,4,121,-117
826,410000,54fc07138d70374c,1,1,754,347,596,488,554,520,548,623,596,604,752,820,786,725,68,148,-80
550,330000,54fc07138d70374c,1,1,679,333,435,299,309,330,357,379,387,524,623,684,654,610,61,99,-38
481,420000,54fc07138d70374c,1,1,373,179,291,252,255,280,268,311,346,310,385,425,405,373,40,75,-35
505,430000,54fc07138d70374c,1,1,471,214,378,270,349,338,350,384,424,364,460,493,476,439,33,96,-63
400,350000,54fc07138d70374c,1,1,456,167,290,209,200,169,259,222,223,268,329,338,334,312,9,61,-52
249,210000,54fc07138d70374c,1,1,333,154,305,230,303,292,281,324,364,303,369,450,410,374,81,66,15
576,500000,54fc07138d70374c,1,1,535,259,424,365,346,440,402,372,406,400,540,575,558,505,35,140,-105
376,610000,54fc07138d70374c,1,1,370,153,276,242,263,225,299,275,293,365,346,404,375,372,58,-19,77
324,230000,54fc07138d70374c,1,1,374,217,363,293,273,325,359,356,331,302,341,410,376,351,69,39,30
241,310000,212083a9246d2fd3,1,1,632,139,307,248,310,413,581,617,628,446,636,846,741,643,210,190,20
290,530000,212083a9246d2fd3,1,1,337,148,154,145,172,143,197,189,278,304,365,493,429,387,128,61,67
284,150000,212083a9246d2fd3,1,1,382,134,111,109,155,125,168,136,222,206,310,562,436,359,252,104,148
105,110000,212083a9246d2fd3,1,1,709,188,412,270,321,429,521,473,498,257,444,824,634,508,380,187,193
983,510000,212083a9246d2fd3,1,1,1265,770,584,606,603,636,717,777,1042,762,1080,1730,1405,1191,650,318,332
1186,340000,212083a9246d2fd3,1,1,1338,744,404,412,563,701,945,973,1078,1023,1260,2243,1752,1509,983,237,746
1261,370000,212083a9246d2fd3,1,1,1919,875,851,1042,1265,1160,1176,1294,1622,1536,1637,2998,2318,2057,1361,101,1260
313,140000,212083a9246d2fd3,1,1,381,136,144,177,203,154,257,272,308,299,372,645,508,439,273,73,200
905,440000,212083a9246d2fd3,1,1,1196,240,608,631,1027,923,1121,1670,1369,1274,1967,3191,2579,2144,1224,693,531
471,450000,212083a9246d2fd3,1,1,312,168,141,105,142,190,192,188,232,252,337,697,517,429,360,85,275
1631,320000,212083a9246d2fd3,1,1,2659,1526,1242,1231,1592,1724,1702,2067,2163,1918,2283,3836,3060,2679,1553,365,1188
658,360000,212083a9246d2fd3,1,1,1035,446,244,251,345,361,411,440,542,547,676,1270,973,831,594,129,465
950,130000,212083a9246d2fd3,1,1,1410,574,511,495,710,678,854,909,987,969,1064,2232,1648,1422,1168,95,1073
1894,410000,212083a9246d2fd3,1,1,2054,870,634,824,900,1091,1257,1337,1548,1431,1720,3243,2482,2131,1523,289,1234
574,330000,212083a9246d2fd3,1,1,1214,628,712,672,814,952,886,1003,1067,1140,1205,1850,1528,1398,645,65,580
755,420000,212083a9246d2fd3,1,1,1033,420,379,335,349,502,356,435,576,710,866,1354,1110,977,488,156,332
938,430000,212083a9246d2fd3,1,1,1096,420,360,426,538,599,590,709,844,687,982,1756,1369,1142,774,295,479
462,350000,212083a9246d2fd3,1,1,498,137,249,221,268,357,422,486,645,645,746,1041,894,811,295,101,194
181,210000,212083a9246d2fd3,1,1,298,143,177,163,241,231,300,418,415,275,422,561,492,419,139,147,-8
557,500000,212083a9246d2fd3,1,1,669,328,299,375,484,631,758,749,722,571,643,1136,890,783,493,72,421
639,610000,212083a9246d2fd3,1,1,771,225,254,261,399,506,811,726,652,682,805,1567,1186,1018,762,123,639
102,230000,212083a9246d2fd3,1,1,218,96,119,141,163,123,259,159,164,109,207,305,256,207,98,98,0
95,310000,4f79773e600518a6,1,1,374,59,117,95,90,87,88,90,112,64,139,159,149,121,20,75,-55
181,530000,4f79773e600518a6,1,1,312,150,132,81,108,54,102,103,88,129,116,195,156,147,79,-13,92
327,150000,4f79773e600518a6,1,1,400,166,183,174,223,139,192,148,178,215,227,336,282,259,109,12,97
99,110000,4f79773e600518a6,1,1,382,107,188,157,103,119,110,107,124,113,153,246,200,171,93,40,53
398,510000,4f79773e600518a6,1,1,651,300,263,231,201,164,169,165,260,194,267,387,327,283,120,73,47
484,340000,4f79773e600518a6,1,1,703,331,241,207,206,161,192,228,277,262,301,471,386,345,170,39,131
723,370000,4f79773e600518a6,1,1,1043,418,548,574,604,450,433,565,670,629,591,961,776,727,370,-38,408
149,140000,4f79773e600518a6,1,1,228,58,100,103,114,81,88,106,92,114,133,167,150,138,34,19,15
97,440000,4f79773e600518a6,1,1,480,62,174,156,103,107,99,112,111,142,134,176,155,151,42,-8,50
66,450000,4f79773e600518a6,1,1,169,79,90,53,59,61,36,46,27,44,52,62,57,53,10,8,2
333,320000,4f79773e600518a6,1,1,927,562,420,362,365,291,216,275,222,289,312,450,381,350,138,23,115
264,360000,4f79773e600518a6,1,1,344,157,142,129,162,110,96,123,158,141,164,252,208,186,88,23,65
362,130000,4f79773e600518a6,1,1,582,239,265,258,283,231,209,251,268,281,338,473,406,364,135,57,78
669,410000,4f79773e600518a6,1,1,955,386,456,508,440,420,458,438,436,457,535,679,607,557,144,78,66
131,330000,4f79773e600518a6,1,1,357,157,179,148,165,119,117,144,152,167,161,255,208,194,94,-6,100
450,420000,4f79773e600518a6,1,1,656,209,218,242,217,211,166,169,231,258,278,385,332,307,107,20,87
857,430000,4f79773e600518a6,1,1,943,399,388,395,357,324,322,320,453,378,533,776,654,562,243,155,88
41,350000,4f79773e600518a6,1,1,156,59,87,42,60,45,47,38,50,51,83,65,74,66,-18,32,-50
109,210000,4f79773e600518a6,1,1,207,85,129,125,118,82,101,115,152,128,129,166,148,141,37,1,36
256,500000,4f79773e600518a6,1,1,470,233,209,189,156,162,125,149,157,175,189,306,248,223,117,14,103
493,610000,4f79773e600518a6,1,1,733,248,335,296,319,224,270,298,329,421,381,634,508,479,253,-40,293
131,230000,4f79773e600518a6,1,1,247,155,190,188,152,109,132,165,141,126,204,277,240,202,73,78,-5
138,310000,fc32b1a017b34efe,1,1,289,99,199,164,165,139,164,176,188,167,211,361,286,246,150,44,106
406,530000,fc32b1a017b34efe,1,1,676,475,412,328,421,327,407,402,486,521,434,743,588,566,309,-87,396
304,150000,fc32b1a017b34efe,1,1,614,255,274,265,289,218,256,255,374,366,390,683,536,480,293,24,269
173,110000,fc32b1a017b34efe,1,1,823,214,434,345,391,298,365,388,458,302,357,675,516,445,318,55,263
1186,510000,fc32b1a017b34efe,1,1,1806,1086,1383,1313,1243,1067,1135,1222,1530,1137,1318,2057,1688,1504,739,181,558
574,340000,fc32b1a017b34efe,1,1,1055,371,408,413,407,292,363,463,479,476,493,865,679,611,372,17,355
723,370000,fc32b1a017b34efe,1,1,1659,712,778,983,935,718,720,875,922,870,894,1538,1216,1101,644,24,620
417,140000,fc32b1a017b34efe,1,1,671,240,339,383,469,311,358,454,470,495,510,974,742,660,464,15,449
569,440000,fc32b1a017b34efe,1,1,1131,292,692,629,703,576,557,610,730,702,768,1105,936,858,337,66,271
260,450000,fc32b1a017b34efe,1,1,418,208,209,154,242,164,182,175,217,208,212,406,309,275,194,4,190
698,320000,fc32b1a017b34efe,1,1,1289,648,745,631,724,557,652,768,765,828,786,1332,1059,982,546,-42,588
420,360000,fc32b1a017b34efe,1,1,663,215,235,288,311,262,276,281,350,363,356,774,565,498,418,-7,425
891,130000,fc32b1a017b34efe,1,1,1473,676,744,724,862,614,693,937,936,974,964,2069,1516,1336,1105,-10,1115
1026,410000,fc32b1a017b34efe,1,1,1851,610,715,892,850,682,796,900,924,913,934,1916,1425,1254,982,21,961
370,330000,fc32b1a017b34efe,1,1,979,395,572,541,581,492,491,561,604,663,556,982,769,734,426,-107,533
401,420000,fc32b1a017b34efe,1,1,716,193,265,278,276,303,276,301,385,300,389,721,555,470,332,89,243
631,430000,fc32b1a017b34efe,1,1,1172,586,514,623,562,511,551,548,722,567,687,1290,988,848,603,120,483
180,350000,fc32b1a017b34efe,1,1,341,96,218,190,170,135,152,178,217,240,253,385,319,293,132,13,119
135,210000,fc32b1a017b34efe,1,1,323,115,237,238,223,208,212,251,209,211,226,330,278,256,104,15,89
661,500000,fc32b1a017b34efe,1,1,1880,977,800,797,796,935,790,970,909,844,751,1420,1086,1005,669,-93,762
604,610000,fc32b1a017b34efe,1,1,1164,452,501,575,671,425,496,540,574,623,639,1234,936,832,595,16,579
76,230000,fc32b1a017b34efe,1,1,184,100,176,124,152,127,131,146,126,126,150,236,193,171,86,24,62
357,310000,feabbf46658382b9,1,1,511,104,239,247,291,237,275,484,500,412,620,805,712,612,185,208,-23
829,530000,feabbf46658382b9,1,1,905,502,481,450,444,342,521,806,851,856,921,1249,1085,1009,328,65,263
601,150000,feabbf46658382b9,1,1,646,262,315,336,322,265,347,507,500,528,675,925,800,709,250,147,103
437,110000,feabbf46658382b9,1,1,1119,300,478,446,455,384,534,743,672,532,779,1421,1100,911,642,247,395
2183,510000,feabbf46658382b9,1,1,2331,1283,1148,1182,899,922,1077,1757,2178,1620,1861,2915,2388,2132,1054,241,813
1141,340000,feabbf46658382b9,1,1,1188,607,365,405,383,373,395,690,798,757,934,1307,1120,999,373,177,196
1006,370000,feabbf46658382b9,1,1,1240,594,611,792,689,593,668,1173,1160,1214,1192,1610,1401,1339,418,-22,440
406,140000,feabbf46658382b9,1,1,527,200,325,308,304,235,316,582,505,511,601,970,786,694,369,90,279
1203,440000,feabbf46658382b9,1,1,1642,304,689,958,928,799,758,1347,1576,1507,1902,2685,2294,2031,783,395,388
433,450000,feabbf46658382b9,1,1,521,257,267,191,230,206,193,394,347,352,440,665,552,486,225,88,137
1481,320000,feabbf46658382b9,1,1,1894,917,887,1007,951,861,1014,1794,1646,1598,1955,2752,2354,2102,797,357,440
624,360000,feabbf46658382b9,1,1,713,304,214,275,281,260,281,443,510,475,511,802,656,596,291,36,255
970,130000,feabbf46658382b9,1,1,1091,551,562,650,653,522,624,985,1009,905,1021,1551,1286,1159,530,116,414
1928,410000,feabbf46658382b9,1,1,1873,946,628,786,747,679,846,1361,1342,1399,1530,2696,2113,1875,1166,131,1035
704,330000,feabbf46658382b9,1,1,1342,458,535,675,710,572,720,1247,1320,1351,1499,2124,1812,1658,625,148,477
837,420000,feabbf46658382b9,1,1,998,363,307,317,322,323,347,614,653,620,794,1252,1023,889,458,174,284
1657,430000,feabbf46658382b9,1,1,1709,749,596,697,623,625,741,1241,1383,1339,1478,2360,1919,1726,882,139,743
428,350000,feabbf46658382b9,1,1,563,132,235,287,264,213,231,425,414,399,601,698,650,566,97,202,-105
235,210000,feabbf46658382b9,1,1,351,130,230,240,206,200,191,375,331,306,361,459,410,375,98,55,43
1846,500000,feabbf46658382b9,1,1,2161,1368,1012,1031,877,1159,994,1592,1671,1487,1581,2727,2154,1932,1146,94,1052
905,610000,feabbf46658382b9,1,1,1023,517,513,636,634,391,538,758,764,827,896,1319,1108,1014,423,69,354
173,230000,feabbf46658382b9,1,1,209,93,173,167,152,156,136,271,219,256,312,397,354,322,85,56,29
19,310000,f270f6a489c6a9d7,1,1,63,42,81,54,48,33,25,37,28,27,30,34,32,30,4,3,1
1680,530000,f270f6a489c6a9d7,1,1,2334,1982,1751,1315,1335,1170,1342,1395,1639,1736,1547,1939,1743,1741,392,-189,581
54,150000,f270f6a489c6a9d7,1,1,78,56,83,96,80,81,79,74,107,93,105,108,106,102,3,12,-9
106,110000,f270f6a489c6a9d7,1,1,409,156,229,233,214,173,229,238,282,198,305,504,404,336,199,107,92
603,510000,f270f6a489c6a9d7,1,1,1034,976,1205,892,875,682,620,742,717,655,773,955,864,794,182,118,64
216,340000,f270f6a489c6a9d7,1,1,378,440,323,285,216,207,172,194,197,214,225,272,248,237,47,11,36
629,370000,f270f6a489c6a9d7,1,1,1070,767,721,695,659,545,644,631,622,551,636,1105,870,764,469,85,384
166,140000,f270f6a489c6a9d7,1,1,194,162,270,155,157,114,131,103,137,118,161,233,197,171,72,43,29
346,440000,f270f6a489c6a9d7,1,1,1381,617,1291,948,890,830,568,627,644,624,713,866,790,734,153,89,64
92,450000,f270f6a489c6a9d7,1,1,156,161,173,97,104,62,69,50,93,63,75,97,86,78,22,12,10
610,320000,f270f6a489c6a9d7,1,1,1028,952,992,724,727,654,653,752,766,763,871,1150,1010,928,279,108,171
132,360000,f270f6a489c6a9d7,1,1,214,205,183,155,161,110,121,107,134,92,117,148,132,119,31,25,6
537,130000,f270f6a489c6a9d7,1,1,874,789,811,606,636,506,529,574,561,554,769,983,876,769,214,215,-1
922,410000,f270f6a489c6a9d7,1,1,2101,1478,1260,1027,934,847,759,825,703,746,952,1314,1133,1004,362,206,156
312,330000,f270f6a489c6a9d7,1,1,867,670,934,557,549,457,405,385,451,456,466,653,560,525,187,10,177
514,420000,f270f6a489c6a9d7,1,1,1027,697,859,536,538,476,513,518,582,592,590,903,746,695,313,-2,315
405,430000,f270f6a489c6a9d7,1,1,727,503,656,598,440,429,353,375,366,327,426,575,500,443,149,99,50
85,350000,f270f6a489c6a9d7,1,1,229,137,270,206,172,148,152,164,156,179,175,195,185,183,20,-4,24
158,210000,f270f6a489c6a9d7,1,1,244,206,331,272,228,230,212,192,216,260,281,370,326,304,89,21,68
636,500000,f270f6a489c6a9d7,1,1,1781,1641,1037,781,700,668,554,592,643,645,706,955,830,769,249,61,188
195,610000,f270f6a489c6a9d7,1,1,474,316,321,306,283,187,180,190,227,209,280,324,302,271,44,71,-27
35,230000,f270f6a489c6a9d7,1,1,99,95,134,124,103,81,47,88,70,59,76,90,83,75,14,17,-3
60,310000,d0f245b8781e3631,1,1,314,76,116,114,110,134,139,176,218,159,193,281,237,211,88,34,54
181,530000,d0f245b8781e3631,1,1,296,168,124,127,149,132,201,192,241,224,227,356,292,269,129,3,126
117,150000,d0f245b8781e3631,1,1,210,74,100,61,89,103,103,63,86,129,183,244,214,185,61,54,7
105,110000,d0f245b8781e3631,1,1,935,202,520,398,466,501,463,464,472,326,417,805,611,516,388,91,297
816,510000,d0f245b8781e3631,1,1,1096,755,939,830,726,715,739,855,1133,824,910,1456,1183,1063,546,86,460
251,340000,d0f245b8781e3631,1,1,562,244,164,160,209,240,323,314,310,267,287,463,375,339,176,20,156
600,370000,d0f245b8781e3631,1,1,1235,559,501,593,571,548,646,773,797,679,738,1182,960,866,444,59,385
192,140000,d0f245b8781e3631,1,1,399,161,200,167,199,121,199,221,226,243,264,497,380,335,233,21,212
297,440000,d0f245b8781e3631,1,1,698,169,374,342,351,384,378,429,596,574,615,869,742,686,254,41,213
254,450000,d0f245b8781e3631,1,1,313,160,162,108,140,126,161,139,167,205,233,425,329,288,192,28,164
461,320000,d0f245b8781e3631,1,1,1080,492,606,574,521,545,683,706,761,731,749,1017,883,832,268,18,250
211,360000,d0f245b8781e3631,1,1,345,142,127,126,110,128,145,145,229,198,198,315,256,237,117,0,117
754,130000,d0f245b8781e3631,1,1,1018,635,446,455,480,501,551,690,771,682,755,1430,1092,956,675,73,602
892,410000,d0f245b8781e3631,1,1,1880,899,500,524,534,645,779,871,851,876,865,1601,1233,1114,736,-11,747
174,330000,d0f245b8781e3631,1,1,520,192,280,246,271,509,410,370,1437,406,420,845,632,557,425,14,411
134,420000,d0f245b8781e3631,1,1,324,117,139,112,83,118,124,88,110,128,133,246,190,169,113,5,108
439,430000,d0f245b8781e3631,1,1,698,304,398,280,324,325,335,319,439,335,447,756,602,513,309,112,197
102,350000,d0f245b8781e3631,1,1,194,47,105,96,92,93,116,102,142,175,166,247,206,196,81,-9,90
47,210000,d0f245b8781e3631,1,1,64,41,64,60,48,65,77,81,68,54,102,113,108,90,11,48,-37
630,500000,d0f245b8781e3631,1,1,1130,1292,570,694,1791,780,781,1602,764,548,596,1578,1087,907,982,48,934
498,610000,d0f245b8781e3631,1,1,678,273,384,352,349,347,435,453,455,455,558,938,748,650,380,103,277
7,230000,d0f245b8781e3631,1,1,31,15,20,14,19,35,25,28,17,16,45,45,45,35,0,29,-29
228,310000,c6cd4e0e073f5ac2,1,1,1323,384,766,615,1911,902,547,590,1049,393,448,746,597,529,298,55,243
105,530000,c6cd4e0e073f5ac2,1,1,587,278,301,236,299,183,317,301,410,266,224,235,230,242,11,-42,53
208,150000,c6cd4e0e073f5ac2,1,1,529,177,210,170,205,129,178,248,263,289,273,340,306,301,67,-16,83
72,110000,c6cd4e0e073f5ac2,1,1,488,156,210,198,2153,193,216,265,2528,156,179,362,270,232,183,23,160
542,510000,c6cd4e0e073f5ac2,1,1,1979,1198,978,987,918,779,942,1243,1666,730,631,1027,829,796,396,-99,495
792,340000,c6cd4e0e073f5ac2,1,1,1526,817,521,577,609,647,742,968,961,755,678,1434,1056,956,756,-77,833
823,370000,c6cd4e0e073f5ac2,1,1,3685,1658,1597,1972,2081,1738,2176,2848,2646,1380,1053,1685,1369,1373,632,-327,959
321,140000,c6cd4e0e073f5ac2,1,1,805,317,332,357,466,412,468,657,660,386,479,604,542,490,125,93,32
451,440000,c6cd4e0e073f5ac2,1,1,1424,279,1067,835,808,584,546,819,1623,936,1038,1493,1266,1156,455,102,353
250,450000,c6cd4e0e073f5ac2,1,1,464,190,289,222,206,200,234,316,360,349,312,543,428,401,231,-37,268
1205,320000,c6cd4e0e073f5ac2,1,1,3597,2058,2036,1793,2058,1654,1827,2527,2388,1650,1467,2828,2148,1982,1361,-183,1544
549,360000,c6cd4e0e073f5ac2,1,1,1108,420,401,428,462,351,450,511,752,626,577,1241,909,815,664,-49,713
602,130000,c6cd4e0e073f5ac2,1,1,1899,890,745,818,940,856,987,1387,1606,840,561,1020,790,807,459,-279,738
992,410000,c6cd4e0e073f5ac2,1,1,2861,1366,1036,1237,1242,1377,1416,1736,1669,959,1021,1584,1302,1188,563,62,501
386,330000,c6cd4e0e073f5ac2,1,1,1696,584,854,706,739,693,717,1019,1203,828,859,1272,1066,986,413,31,382
523,420000,c6cd4e0e073f5ac2,1,1,1580,683,611,623,602,550,430,713,769,691,751,1208,980,883,457,60,397
508,430000,c6cd4e0e073f5ac2,1,1,1213,489,532,566,595,580,641,816,847,522,619,891,755,677,272,97,175
173,350000,c6cd4e0e073f5ac2,1,1,379,107,172,152,204,142,221,243,304,268,291,431,361,330,140,23,117
91,210000,c6cd4e0e073f5ac2,1,1,305,124,182,229,277,157,228,366,291,139,186,225,206,183,39,47,-8
128,500000,c6cd4e0e073f5ac2,1,1,391,221,210,204,174,226,215,324,310,182,148,242,195,191,94,-34,128
182,610000,c6cd4e0e073f5ac2,1,1,853,306,391,524,533,558,687,656,661,278,275,432,354,328,157,-3,160
53,230000,c6cd4e0e073f5ac2,1,1,197,92,110,100,111,89,97,146,137,83,61,140,100,95,79,-22,101
142,310000,a9a43d1a7ecbe75d,1,1,204,87,149,133,134,134,141,138,161,113,162,163,162,146,1,49,-48
146,530000,a9a43d1a7ecbe75d,1,1,121,54,107,85,86,94,141,123,111,95,152,131,142,126,-21,57,-78
83,150000,a9a43d1a7ecbe75d,1,1,81,40,55,64,107,75,84,71,81,97,81,90,86,89,9,-16,25
88,110000,a9a43d1a7ecbe75d,1,1,130,34,85,87,95,97,119,87,131,79,100,123,112,101,23,21,2
341,510000,a9a43d1a7ecbe75d,1,1,340,197,228,225,215,255,232,227,447,284,279,330,304,298,51,-5,56
254,340000,a9a43d1a7ecbe75d,1,1,208,99,134,119,161,145,138,167,182,170,183,198,190,184,15,13,2
159,370000,a9a43d1a7ecbe75d,1,1,228,84,124,180,157,181,138,136,198,152,160,191,176,168,31,8,23
41,140000,a9a43d1a7ecbe75d,1,1,57,20,17,25,37,27,30,36,34,32,31,28,30,30,-3,-1,-2
568,440000,a9a43d1a7ecbe75d,1,1,570,146,429,345,479,470,487,435,593,541,658,638,648,612,-20,117,-137
297,450000,a9a43d1a7ecbe75d,1,1,262,89,156,161,164,160,151,154,208,163,172,213,192,183,41,9,32
430,320000,a9a43d1a7ecbe75d,1,1,454,205,341,313,360,325,317,361,402,385,402,439,420,409,37,17,20
103,360000,a9a43d1a7ecbe75d,1,1,82,37,64,44,75,70,82,64,94,87,76,120,98,94,44,-11,55
109,130000,a9a43d1a7ecbe75d,1,1,115,39,90,92,88,94,88,102,92,82,85,95,90,87,10,3,7
130,410000,a9a43d1a7ecbe75d,1,1,151,72,107,141,117,126,120,123,153,141,134,164,149,146,30,-7,37
466,330000,a9a43d1a7ecbe75d,1,1,433,156,242,287,301,272,322,299,308,339,364,397,380,367,33,25,8
270,420000,a9a43d1a7ecbe75d,1,1,278,86,162,187,145,190,155,179,232,184,244,236,240,221,-8,60,-68
519,430000,a9a43d1a7ecbe75d,1,1,375,173,254,290,293,279,299,298,395,308,355,445,400,369,90,47,43
145,350000,a9a43d1a7ecbe75d,1,1,131,45,88,69,99,64,92,91,93,87,125,99,112,104,-26,38,-64
89,210000,a9a43d1a7ecbe75d,1,1,141,60,120,97,133,116,136,158,194,115,126,155,140,132,29,11,18
160,500000,a9a43d1a7ecbe75d,1,1,178,103,110,159,135,304,146,146,203,173,179,214,196,189,35,6,29
274,610000,a9a43d1a7ecbe75d,1,1,221,88,179,190,260,217,273,229,256,263,252,263,258,259,11,-11,22
65,230000,a9a43d1a7ecbe75d,1,1,79,36,89,80,70,81,75,75,68,54,66,57,62,59,-9,12,-21
193,310000,3c974920a76ac9c1,2,0,134,323,266,271,235,260,162,265,228,369,374,305,340,349,-69,5,-74
194,530000,3c974920a76ac9c1,2,0,227,260,216,308,279,419,246,217,310,402,456,434,445,431,-22,54,-76
128,150000,3c974920a76ac9c1,2,0,123,206,149,236,164,187,153,157,178,204,219,180,200,201,-39,15,-54
432,110000,3c974920a76ac9c1,2,0,160,362,404,445,351,322,244,337,371,460,563,468,516,497,-95,103,-198
253,510000,3c974920a76ac9c1,2,0,311,358,373,360,329,335,345,623,350,453,570,500,535,508,-70,117,-187
76,340000,3c974920a76ac9c1,2,0,125,152,155,154,138,108,127,159,136,179,226,198,212,201,-28,47,-75
290,370000,3c974920a76ac9c1,2,0,254,418,482,482,353,339,259,422,394,483,601,468,534,517,-133,118,-251
146,140000,3c974920a76ac9c1,2,0,126,197,211,250,166,178,189,194,233,215,260,248,254,241,-12,45,-57
1680,440000,3c974920a76ac9c1,2,0,932,2407,2080,2897,2187,2183,1804,2265,2711,3532,3800,2692,3246,3341,-1108,268,-1376
248,450000,3c974920a76ac9c1,2,0,224,347,259,363,291,276,249,267,349,472,505,425,465,467,-80,33,-113
486,320000,3c974920a76ac9c1,2,0,540,791,629,780,561,554,569,631,764,871,1010,800,905,894,-210,139,-349
78,360000,3c974920a76ac9c1,2,0,86,138,143,167,149,136,95,156,166,204,262,236,249,234,-26,58,-84
190,130000,3c974920a76ac9c1,2,0,138,237,254,280,252,227,235,225,228,291,305,260,282,285,-45,14,-59
250,410000,3c974920a76ac9c1,2,0,225,304,394,313,330,384,256,301,351,521,505,405,455,477,-100,-16,-84
409,330000,3c974920a76ac9c1,2,0,342,504,483,638,453,457,422,545,702,660,865,633,749,719,-232,205,-437
228,420000,3c974920a76ac9c1,2,0,275,418,368,357,440,329,325,381,447,480,474,497,486,484,23,-6,29
174,430000,3c974920a76ac9c1,2,0,157,288,266,308,275,250,286,299,327,364,474,347,410,395,-127,110,-237
181,350000,3c974920a76ac9c1,2,0,150,315,287,307,223,276,226,258,368,331,404,292,348,342,-112,73,-185
566,210000,3c974920a76ac9c1,2,0,433,807,807,900,645,700,556,721,769,941,997,650,824,863,-347,56,-403
72,500000,3c974920a76ac9c1,2,0,141,127,106,114,181,131,111,101,120,155,199,115,157,156,-84,44,-128
219,610000,3c974920a76ac9c1,2,0,116,246,259,414,206,262,204,187,324,393,440,305,372,379,-135,47,-182
234,230000,3c974920a76ac9c1,2,0,148,482,356,398,288,194,351,302,310,458,461,292,376,404,-169,3,-172
263,310000,3d7554f1f56dd664,2,0,262,484,342,349,376,356,410,417,271,639,518,268,393,475,-250,-121,-129
264,530000,3d7554f1f56dd664,2,0,222,275,246,290,259,337,266,368,334,609,519,292,406,473,-227,-90,-137
149,150000,3d7554f1f56dd664,2,0,125,189,191,270,175,231,216,208,216,370,337,175,256,294,-162,-33,-129
359,110000,3d7554f1f56dd664,2,0,209,527,412,406,405,459,464,449,231,675,811,368,590,618,-443,136,-579
560,510000,3d7554f1f56dd664,2,0,504,885,758,701,656,684,758,1227,469,1053,1125,657,891,945,-468,72,-540
225,340000,3d7554f1f56dd664,2,0,169,202,232,224,252,293,358,325,253,574,507,301,404,461,-206,-67,-139
729,370000,3d7554f1f56dd664,2,0,445,807,1100,977,862,990,917,1222,876,1567,1574,775,1174,1305,-799,7,-806
239,140000,3d7554f1f56dd664,2,0,164,299,314,339,253,284,382,372,320,590,571,290,430,484,-281,-19,-262
4688,440000,3d7554f1f56dd664,2,0,2585,8611,7234,9327,8266,8709,10596,10140,6925,13598,11515,5136,8326,10083,-6379,-2083,-4296
559,450000,3d7554f1f56dd664,2,0,411,855,658,835,723,792,866,969,642,1386,1258,750,1004,1131,-508,-128,-380
1635,320000,3d7554f1f56dd664,2,0,1328,2057,1655,2026,1678,1827,2216,2075,1763,3112,2877,1445,2161,2478,-1432,-235,-1197
311,360000,3d7554f1f56dd664,2,0,167,359,359,396,344,400,420,535,356,595,741,435,588,590,-306,146,-452
486,130000,3d7554f1f56dd664,2,0,354,516,591,633,520,604,569,722,520,1137,974,498,736,870,-476,-163,-313
486,410000,3d7554f1f56dd664,2,0,396,544,698,673,695,718,785,808,565,1273,1234,645,940,1051,-589,-39,-550
1205,330000,3d7554f1f56dd664,2,0,1026,1659,1539,1625,1420,1737,1785,1658,1293,2709,2467,1135,1801,2104,-1332,-242,-1090
508,420000,3d7554f1f56dd664,2,0,375,804,713,668,835,675,883,908,742,1001,1050,703,876,918,-347,49,-396
445,430000,3d7554f1f56dd664,2,0,402,678,683,657,625,567,721,958,582,1112,1192,689,940,998,-503,80,-583
899,350000,3d7554f1f56dd664,2,0,577,1254,1127,1467,1202,1533,1388,1310,817,2205,1578,856,1217,1546,-722,-627,-95
1306,210000,3d7554f1f56dd664,2,0,783,1838,1870,2279,1544,2253,2301,1915,1064,2892,2161,1110,1636,2054,-1051,-731,-320
215,500000,3d7554f1f56dd664,2,0,130,218,213,199,327,300,319,331,173,470,398,244,321,371,-154,-72,-82
260,610000,3d7554f1f56dd664,2,0,138,255,320,486,412,553,492,462,375,582,607,340,474,510,-267,25,-292
521,230000,3d7554f1f56dd664,2,0,291,946,626,765,687,670,1107,843,480,1076,1018,447,732,847,-571,-58,-513
101,310000,2d0d2c3403909fdb,2,0,77,213,184,219,211,160,159,169,112,163,167,157,162,162,-10,4,-14
213,530000,2d0d2c3403909fdb,2,0,206,253,260,265,254,351,309,270,218,354,350,290,320,331,-60,-4,-56
174,150000,2d0d2c3403909fdb,2,0,91,210,228,261,237,261,246,234,155,184,233,279,256,232,46,49,-3
387,110000,2d0d2c3403909fdb,2,0,257,551,670,627,552,633,554,583,457,611,677,549,613,612,-128,66,-194
235,510000,2d0d2c3403909fdb,2,0,187,348,327,372,413,373,319,387,300,411,434,516,475,454,82,23,59
83,340000,2d0d2c3403909fdb,2,0,64,119,116,119,126,118,108,157,129,128,138,176,157,147,38,10,28
235,370000,2d0d2c3403909fdb,2,0,152,316,317,345,393,358,328,376,327,415,400,420,410,412,20,-15,35
103,140000,2d0d2c3403909fdb,2,0,63,160,161,165,161,170,152,135,111,141,197,179,188,172,-18,56,-74
1159,440000,2d0d2c3403909fdb,2,0,549,1579,1472,1652,1649,1691,1490,1683,1421,1989,1829,1713,1771,1844,-116,-160,44
121,450000,2d0d2c3403909fdb,2,0,109,184,157,187,179,178,141,192,165,181,173,211,192,188,38,-8,46
296,320000,2d0d2c3403909fdb,2,0,218,361,393,413,417,373,340,401,333,437,427,470,448,445,43,-10,53
55,360000,2d0d2c3403909fdb,2,0,40,75,95,119,89,94,84,108,90,107,109,126,118,114,17,2,15
251,130000,2d0d2c3403909fdb,2,0,139,233,302,305,302,324,321,309,274,302,328,389,358,340,61,26,35
202,410000,2d0d2c3403909fdb,2,0,172,259,323,298,340,309,300,327,262,352,337,377,357,355,40,-15,55
264,330000,2d0d2c3403909fdb,2,0,174,327,357,357,351,316,352,336,342,428,424,401,412,418,-23,-4,-19
189,420000,2d0d2c3403909fdb,2,0,130,210,242,242,268,203,201,303,211,267,280,321,300,289,41,13,28
146,430000,2d0d2c3403909fdb,2,0,118,212,237,248,277,255,193,250,211,244,275,284,280,268,9,31,-22
81,350000,2d0d2c3403909fdb,2,0,66,105,124,113,128,123,95,124,106,151,157,167,162,158,10,6,4
316,210000,2d0d2c3403909fdb,2,0,246,417,495,542,501,506,466,488,346,464,567,506,536,512,-61,103,-164
116,500000,2d0d2c3403909fdb,2,0,105,176,130,156,186,166,134,169,138,184,155,213,184,184,58,-29,87
206,610000,2d0d2c3403909fdb,2,0,114,253,239,271,255,273,253,271,195,252,267,297,282,272,30,15,15
155,230000,2d0d2c3403909fdb,2,0,187,216,276,357,324,293,304,239,208,258,336,315,326,303,-21,78,-99
96,310000,a28bb927b6fcb33c,2,0,118,232,238,251,282,229,249,216,166,212,210,117,164,180,-93,-2,-91
110,530000,a28bb927b6fcb33c,2,0,105,163,123,154,116,231,232,256,209,270,308,173,240,250,-135,38,-173
72,150000,a28bb927b6fcb33c,2,0,69,114,106,123,97,118,134,193,128,165,176,89,132,143,-87,11,-98
109,110000,a28bb927b6fcb33c,2,0,190,324,305,237,267,308,309,286,179,246,342,136,239,241,-206,96,-302
212,510000,a28bb927b6fcb33c,2,0,292,452,413,430,414,426,492,712,401,438,436,351,394,408,-85,-2,-83
151,340000,a28bb927b6fcb33c,2,0,191,244,230,261,218,300,368,358,250,325,348,264,306,312,-84,23,-107
175,370000,a28bb927b6fcb33c,2,0,173,389,484,405,407,399,489,606,454,468,556,225,390,416,-331,88,-419
70,140000,a28bb927b6fcb33c,2,0,74,128,130,124,127,123,233,187,181,144,181,92,136,139,-89,37,-126
1639,440000,a28bb927b6fcb33c,2,0,1368,3766,3317,3840,3624,4020,4618,5211,4012,4216,4195,2391,3293,3601,-1804,-21,-1783
166,450000,a28bb927b6fcb33c,2,0,192,344,277,350,329,360,409,444,331,432,386,248,317,355,-138,-46,-92
651,320000,a28bb927b6fcb33c,2,0,507,940,829,888,876,892,1148,1130,943,1033,1154,680,917,956,-474,121,-595
96,360000,a28bb927b6fcb33c,2,0,140,184,170,221,210,194,288,380,260,302,351,208,280,287,-143,49,-192
284,130000,a28bb927b6fcb33c,2,0,191,358,362,423,480,475,550,584,385,397,419,248,334,355,-171,22,-193
242,410000,a28bb927b6fcb33c,2,0,244,376,449,371,468,562,658,673,556,567,651,338,494,519,-313,84,-397
739,330000,a28bb927b6fcb33c,2,0,511,990,1039,1012,1006,1138,1244,1296,1228,1343,1310,747,1028,1133,-563,-33,-530
226,420000,a28bb927b6fcb33c,2,0,282,547,533,457,595,544,655,744,726,677,787,450,618,638,-337,110,-447
223,430000,a28bb927b6fcb33c,2,0,238,482,529,476,494,503,610,619,436,474,674,394,534,514,-280,200,-480
173,350000,a28bb927b6fcb33c,2,0,152,423,426,506,417,546,535,615,563,615,519,231,375,455,-288,-96,-192
233,210000,a28bb927b6fcb33c,2,0,305,554,649,665,803,867,1031,840,522,652,848,213,530,571,-635,196,-831
85,500000,a28bb927b6fcb33c,2,0,100,193,183,200,348,324,316,208,150,157,208,123,166,163,-85,51,-136
105,610000,a28bb927b6fcb33c,2,0,112,192,194,239,237,272,274,262,219,225,317,148,232,230,-169,92,-261
85,230000,a28bb927b6fcb33c,2,0,125,253,261,255,248,232,335,334,222,288,303,90,196,227,-213,15,-228
177,310000,17bc272c93f19d56,2,0,138,302,182,202,234,212,256,234,168,249,477,199,338,308,-278,228,-506
3067,530000,17bc272c93f19d56,2,0,2559,2705,2130,2397,2353,2868,2565,3307,3096,3216,4503,4785,4644,4168,282,1287,-1005
451,150000,17bc272c93f19d56,2,0,257,434,313,361,329,346,368,502,360,520,675,504,590,566,-171,155,-326
92,110000,17bc272c93f19d56,2,0,125,304,246,278,163,179,202,242,199,305,514,151,332,323,-363,209,-572
1537,510000,17bc272c93f19d56,2,0,1289,1498,1056,1064,1118,1183,1230,1449,1007,1411,1954,1724,1839,1696,-230,543,-773
1881,340000,17bc272c93f19d56,2,0,1946,1532,1224,1396,1210,1260,1418,1458,1238,1535,2328,2152,2240,2005,-176,793,-969
3060,370000,17bc272c93f19d56,2,0,3478,2813,2653,3587,2963,3398,3600,3519,3268,3907,6576,4483,5530,4989,-2093,2669,-4762
1361,140000,17bc272c93f19d56,2,0,1096,1300,1076,1493,1193,1334,1452,1749,1354,1585,2844,2093,2468,2174,-751,1259,-2010
1579,440000,17bc272c93f19d56,2,0,794,1712,1309,1820,1577,1457,1550,1999,1555,2007,3029,1611,2320,2216,-1418,1022,-2440
1836,450000,17bc272c93f19d56,2,0,2843,2715,1831,2371,1991,2051,2291,2515,2293,2687,4443,3084,3764,3405,-1359,1756,-3115
2419,320000,17bc272c93f19d56,2,0,1736,2075,1392,1679,1539,1776,1799,1764,1493,1942,3067,2165,2616,2391,-902,1125,-2027
922,360000,17bc272c93f19d56,2,0,1085,1047,877,1066,892,885,890,1111,824,980,1510,1290,1400,1260,-220,530,-750
3403,130000,17bc272c93f19d56,2,0,2579,2548,2351,2960,2437,2748,3368,3303,2808,3641,6231,3870,5050,4581,-2361,2590,-4951
3564,410000,17bc272c93f19d56,2,0,4158,3545,2891,3967,3302,3413,3591,3584,3821,4668,7650,5825,6738,6048,-1825,2982,-4807
1629,330000,17bc272c93f19d56,2,0,1111,1340,943,1216,1213,1206,1016,1295,1112,1294,2062,1260,1661,1539,-802,768,-1570
1140,420000,17bc272c93f19d56,2,0,1058,1238,1013,1221,954,900,992,1202,958,1353,2198,1919,2058,1823,-279,845,-1124
1506,430000,17bc272c93f19d56,2,0,1476,1924,1609,1715,1491,1500,1678,1773,1354,1770,2693,2364,2528,2276,-329,923,-1252
650,350000,17bc272c93f19d56,2,0,399,702,458,576,545,512,565,573,523,688,892,592,742,724,-300,204,-504
939,210000,17bc272c93f19d56,2,0,557,1124,894,1170,1034,1023,1010,1135,824,1154,1710,924,1317,1263,-786,556,-1342
248,500000,17bc272c93f19d56,2,0,194,204,191,258,225,203,204,284,201,250,357,250,304,286,-107,107,-214
1105,610000,17bc272c93f19d56,2,0,1145,1221,1008,1213,1083,1173,1245,1658,1590,1877,3217,2072,2644,2389,-1145,1340,-2485
518,230000,17bc272c93f19d56,2,0,458,819,646,736,776,785,835,795,518,816,982,506,744,768,-476,166,-642
114,310000,2a2ab41f8f6ff1cb,2,0,80,202,198,232,330,331,445,555,272,582,623,382,502,529,-241,41,-282
300,530000,2a2ab41f8f6ff1cb,2,0,178,199,246,327,333,428,409,543,553,546,680,484,582,570,-196,134,-330
317,150000,2a2ab41f8f6ff1cb,2,0,321,444,472,638,517,552,645,831,715,836,832,551,692,740,-281,-4,-277
102,110000,2a2ab41f8f6ff1cb,2,0,72,162,260,324,331,345,369,502,362,440,598,212,405,417,-386,158,-544
671,510000,2a2ab41f8f6ff1cb,2,0,607,864,847,961,1004,1032,1165,1460,1050,1385,1850,1223,1536,1486,-627,465,-1092
717,340000,2a2ab41f8f6ff1cb,2,0,758,744,849,934,1047,1058,1409,1565,1256,1491,1666,1515,1590,1557,-151,175,-326
842,370000,2a2ab41f8f6ff1cb,2,0,614,897,1413,1635,1575,1773,2139,2580,2061,2146,2737,1706,2222,2196,-1031,591,-1622
312,140000,2a2ab41f8f6ff1cb,2,0,250,365,433,477,430,532,655,690,724,762,993,533,763,763,-460,231,-691
2647,440000,2a2ab41f8f6ff1cb,2,0,1441,3854,3887,5187,5010,5237,6544,8215,6582,6734,6492,5607,6050,6278,-885,-242,-643
409,450000,2a2ab41f8f6ff1cb,2,0,385,570,472,589,632,639,680,913,743,853,894,799,846,849,-95,41,-136
1016,320000,2a2ab41f8f6ff1cb,2,0,799,1459,1467,1717,1679,1859,2252,2410,2283,2584,2672,1728,2200,2328,-944,88,-1032
356,360000,2a2ab41f8f6ff1cb,2,0,496,549,619,761,704,848,964,1340,1065,1086,1291,1027,1159,1135,-264,205,-469
1271,130000,2a2ab41f8f6ff1cb,2,0,770,1146,1445,1808,1966,2293,2864,3253,2277,2327,2703,2119,2411,2383,-584,376,-960
1308,410000,2a2ab41f8f6ff1cb,2,0,1247,1386,1910,2169,2264,2690,3318,3446,2827,2797,3447,2952,3200,3065,-495,650,-1145
459,330000,2a2ab41f8f6ff1cb,2,0,264,593,721,949,928,974,1151,1369,1262,1632,1972,795,1384,1466,-1177,340,-1517
597,420000,2a2ab41f8f6ff1cb,2,0,799,1011,1012,1027,1207,1181,1412,1938,1686,1663,2151,1566,1858,1793,-585,488,-1073
844,430000,2a2ab41f8f6ff1cb,2,0,832,1249,1396,1570,1605,1889,1918,2573,2247,1966,2770,1651,2210,2129,-1119,804,-1923
148,350000,2a2ab41f8f6ff1cb,2,0,83,172,208,292,259,301,348,390,371,447,476,264,370,396,-212,29,-241
211,210000,2a2ab41f8f6ff1cb,2,0,109,187,283,311,261,323,369,397,317,403,513,241,377,386,-272,110,-382
328,500000,2a2ab41f8f6ff1cb,2,0,312,479,530,585,806,750,810,888,646,803,1149,803,976,918,-346,346,-692
247,610000,2a2ab41f8f6ff1cb,2,0,176,306,358,387,403,502,566,687,665,655,845,620,732,707,-225,190,-415
306,230000,2a2ab41f8f6ff1cb,2,0,218,468,492,550,570,602,652,669,544,740,1032,399,716,724,-633,292,-925
890,310000,c06a2a387c0ee510,2,0,527,1063,994,1124,945,1154,1068,958,710,977,1212,1265,1238,1151,53,235,-182
63,530000,c06a2a387c0ee510,2,0,43,70,57,124,99,83,62,79,45,66,119,104,112,96,-15,53,-68
64,150000,c06a2a387c0ee510,2,0,19,65,50,51,85,56,51,54,43,56,75,86,80,72,11,19,-8
1114,110000,c06a2a387c0ee510,2,0,361,867,872,926,824,1014,976,1027,677,793,1627,1352,1490,1257,-275,834,-1109
187,510000,c06a2a387c0ee510,2,0,82,223,166,175,144,210,234,199,102,145,321,208,264,225,-113,176,-289
175,340000,c06a2a387c0ee510,2,0,96,149,190,155,149,157,167,182,145,176,251,253,252,227,2,75,-73
649,370000,c06a2a387c0ee510,2,0,335,562,729,614,644,701,698,710,494,739,1047,878,962,888,-169,308,-477
123,140000,c06a2a387c0ee510,2,0,53,106,96,90,115,93,101,121,83,105,184,165,174,151,-19,79,-98
448,440000,c06a2a387c0ee510,2,0,183,472,491,557,511,479,453,514,463,571,819,762,790,717,-57,248,-305
54,450000,c06a2a387c0ee510,2,0,32,56,38,32,27,46,65,36,87,45,96,92,94,78,-4,51,-55
650,320000,c06a2a387c0ee510,2,0,394,680,808,786,664,704,653,923,563,731,1002,974,988,902,-28,271,-299
85,360000,c06a2a387c0ee510,2,0,42,55,107,79,54,83,56,89,43,74,97,118,108,96,21,23,-2
361,130000,c06a2a387c0ee510,2,0,130,229,240,232,241,288,302,284,232,288,493,470,482,417,-23,205,-228
345,410000,c06a2a387c0ee510,2,0,182,314,390,376,374,353,356,387,282,366,596,517,556,493,-79,230,-309
424,330000,c06a2a387c0ee510,2,0,262,365,466,382,390,895,578,350,278,533,736,534,635,601,-202,203,-405
103,420000,c06a2a387c0ee510,2,0,47,93,139,123,130,108,119,115,66,94,173,151,162,139,-22,79,-101
59,430000,c06a2a387c0ee510,2,0,46,72,140,72,59,68,91,68,60,83,119,101,110,101,-18,36,-54
106,350000,c06a2a387c0ee510,2,0,35,128,219,92,103,107,123,99,106,97,170,123,146,130,-47,73,-120
154,210000,c06a2a387c0ee510,2,0,72,139,266,153,169,211,178,184,111,151,300,181,240,211,-119,149,-268
71,500000,c06a2a387c0ee510,2,0,39,102,106,65,63,75,66,120,43,58,100,60,80,73,-40,42,-82
179,610000,c06a2a387c0ee510,2,0,81,169,185,153,156,195,228,164,136,164,313,234,274,237,-79,149,-228
74,230000,c06a2a387c0ee510,2,0,54,90,127,69,65,102,113,130,76,95,177,129,153,134,-48,82,-130
168,310000,7023efdab9cedc03,2,0,253,606,561,484,494,547,504,605,431,543,697,325,511,522,-372,154,-526
25,530000,7023efdab9cedc03,2,0,100,83,82,70,56,86,60,80,64,106,112,40,76,86,-72,6,-78
18,150000,7023efdab9cedc03,2,0,48,55,66,70,55,54,65,50,48,60,75,31,53,55,-44,15,-59
51,110000,7023efdab9cedc03,2,0,76,141,177,131,96,96,105,107,59,86,132,40,86,86,-92,46,-138
117,510000,7023efdab9cedc03,2,0,195,188,226,211,185,192,194,379,187,278,408,216,312,301,-192,130,-322
148,340000,7023efdab9cedc03,2,0,275,330,375,352,304,284,383,452,363,447,587,357,472,464,-230,140,-370
180,370000,7023efdab9cedc03,2,0,281,405,655,512,403,384,434,524,437,477,555,320,438,451,-235,78,-313
23,140000,7023efdab9cedc03,2,0,28,50,77,84,53,53,40,61,59,55,64,30,47,50,-34,9,-43
39,440000,7023efdab9cedc03,2,0,57,219,282,274,225,205,191,284,225,342,408,121,264,290,-287,66,-353
34,450000,7023efdab9cedc03,2,0,66,75,77,81,56,48,72,86,66,86,129,68,98,94,-61,43,-104
628,320000,7023efdab9cedc03,2,0,974,1119,1203,1261,881,934,1240,1311,1156,1271,1767,893,1330,1310,-874,496,-1370
92,360000,7023efdab9cedc03,2,0,118,149,241,252,167,187,201,205,175,224,302,169,236,232,-133,78,-211
56,130000,7023efdab9cedc03,2,0,88,169,204,145,156,130,129,149,129,127,215,80,148,141,-135,88,-223
97,410000,7023efdab9cedc03,2,0,189,277,347,264,222,222,264,300,257,320,368,183,276,290,-185,48,-233
309,330000,7023efdab9cedc03,2,0,633,762,810,793,638,611,791,867,742,941,1163,445,804,850,-718,222,-940
94,420000,7023efdab9cedc03,2,0,152,191,266,209,221,204,189,253,233,287,401,211,306,300,-190,114,-304
83,430000,7023efdab9cedc03,2,0,160,191,256,228,177,169,202,213,182,259,315,201,258,258,-114,56,-170
20,350000,7023efdab9cedc03,2,0,56,96,99,97,66,59,77,86,70,117,145,54,100,105,-91,28,-119
21,210000,7023efdab9cedc03,2,0,40,89,169,79,56,94,56,78,81,68,104,28,66,67,-76,36,-112
20,500000,7023efdab9cedc03,2,0,39,57,50,37,61,45,63,77,40,57,62,28,45,49,-34,5,-39
51,610000,7023efdab9cedc03,2,0,100,108,169,156,96,102,126,137,141,113,177,107,142,132,-70,64,-134
11,230000,7023efdab9cedc03,2,0,20,36,50,45,25,30,29,39,29,28,30,11,20,23,-19,2,-21
540,310000,af6f4f548684e14d,2,0,511,1006,969,925,835,829,878,839,851,1537,1734,940,1337,1404,-794,197,-991
288,530000,af6f4f548684e14d,2,0,360,410,333,370,297,444,406,375,464,639,732,400,566,590,-332,93,-425
195,150000,af6f4f548684e14d,2,0,213,302,350,427,288,345,346,426,433,493,573,322,448,463,-251,80,-331
394,110000,af6f4f548684e14d,2,0,307,553,585,621,593,551,572,648,532,915,1057,659,858,877,-398,142,-540
611,510000,af6f4f548684e14d,2,0,680,747,869,835,754,816,821,1394,1020,1293,1876,1072,1474,1414,-804,583,-1387
457,340000,af6f4f548684e14d,2,0,528,678,800,749,648,689,782,938,1018,1287,1597,1015,1306,1300,-582,310,-892
522,370000,af6f4f548684e14d,2,0,744,1062,1662,1314,1119,1240,1232,1497,1547,1722,2394,1077,1736,1731,-1317,672,-1989
248,140000,af6f4f548684e14d,2,0,222,358,423,462,359,317,365,407,489,581,742,375,558,566,-367,161,-528
463,440000,af6f4f548684e14d,2,0,484,919,955,1092,904,1023,986,1197,1508,2163,2594,949,1772,1902,-1645,431,-2076
210,450000,af6f4f548684e14d,2,0,202,368,262,320,307,308,261,338,373,502,713,341,527,519,-372,211,-583
939,320000,af6f4f548684e14d,2,0,1018,1351,1369,1459,1195,1141,1497,1413,1635,2059,2647,1466,2056,2057,-1181,588,-1769
397,360000,af6f4f548684e14d,2,0,383,549,710,757,635,717,687,798,900,1083,1527,753,1140,1121,-774,444,-1218
404,130000,af6f4f548684e14d,2,0,449,745,695,817,660,609,745,771,828,1012,1235,691,963,979,-544,223,-767
589,410000,af6f4f548684e14d,2,0,672,938,1124,951,899,929,998,1228,1191,1470,2122,1000,1561,1531,-1122,652,-1774
537,330000,af6f4f548684e14d,2,0,604,799,913,926,862,813,942,1042,1090,1626,2068,1003,1536,1566,-1065,442,-1507
485,420000,af6f4f548684e14d,2,0,552,799,894,947,966,785,977,1135,1284,1519,1632,1025,1328,1392,-607,113,-720
467,430000,af6f4f548684e14d,2,0,634,928,1065,1061,902,924,1034,1175,1168,1619,2178,1217,1698,1671,-961,559,-1520
257,350000,af6f4f548684e14d,2,0,264,347,323,473,273,417,426,426,568,767,913,522,718,734,-391,146,-537
172,210000,af6f4f548684e14d,2,0,195,288,386,363,316,315,365,365,407,443,594,254,424,430,-340,151,-491
252,500000,af6f4f548684e14d,2,0,203,303,331,291,407,357,329,386,354,500,762,420,591,561,-342,262,-604
184,610000,af6f4f548684e14d,2,0,267,401,396,383,263,316,283,360,444,478,651,365,508,498,-286,173,-459
121,230000,af6f4f548684e14d,2,0,123,274,347,288,202,213,233,201,203,289,372,142,257,268,-230,83,-313
513,310000,7cf283430b3b5e38,2,0,545,1276,1391,1398,1353,1616,1715,1560,1261,1546,1428,635,1032,1203,-793,-118,-675
167,530000,7cf283430b3b5e38,2,0,240,300,304,335,298,451,462,412,350,412,626,249,438,429,-377,214,-591
178,150000,7cf283430b3b5e38,2,0,212,323,304,432,328,313,335,434,451,516,701,285,493,501,-416,185,-601
74,110000,7cf283430b3b5e38,2,0,101,202,284,280,232,247,248,278,174,264,913,106,510,428,-807,649,-1456
763,510000,7cf283430b3b5e38,2,0,1083,1323,1763,1713,1549,1800,1833,2351,1555,1783,2691,1134,1912,1869,-1557,908,-2465
968,340000,7cf283430b3b5e38,2,0,1182,1314,1838,2005,1957,2071,2572,2578,2110,2138,2356,1607,1982,2034,-749,218,-967
1323,370000,7cf283430b3b5e38,2,0,1428,1837,3584,3723,2665,3185,3623,4079,3911,3787,4830,2048,3439,3555,-2782,1043,-3825
283,140000,7cf283430b3b5e38,2,0,264,390,562,695,612,635,770,774,678,852,1073,317,695,747,-756,221,-977
488,440000,7cf283430b3b5e38,2,0,393,1288,1748,2151,1841,2105,2230,2219,1912,2435,2500,695,1598,1877,-1805,65,-1870
293,450000,7cf283430b3b5e38,2,0,309,481,401,605,509,467,597,723,646,783,869,475,672,709,-394,86,-480
2401,320000,7cf283430b3b5e38,2,0,2924,3351,4265,5237,4119,4343,5439,5089,5170,5016,5865,2657,4261,4513,-3208,849,-4057
549,360000,7cf283430b3b5e38,2,0,548,685,1136,1339,997,1282,1228,1446,1175,1376,1737,923,1330,1345,-814,361,-1175
720,130000,7cf283430b3b5e38,2,0,954,1178,1462,1915,1717,1730,2030,2166,1672,1926,2621,900,1760,1816,-1721,695,-2416
1042,410000,7cf283430b3b5e38,2,0,1210,1347,2464,2148,2124,2569,3033,2794,2644,2874,3243,1683,2463,2600,-1560,369,-1929
1038,330000,7cf283430b3b5e38,2,0,1398,2016,2464,3027,2635,2644,3079,3258,3003,3295,3490,1289,2390,2691,-2201,195,-2396
480,420000,7cf283430b3b5e38,2,0,664,796,1212,1354,1346,1388,1694,1779,1500,1547,1624,929,1276,1367,-695,77,-772
516,430000,7cf283430b3b5e38,2,0,733,970,1484,1556,1388,1464,1556,1793,1457,1585,1952,989,1470,1509,-963,367,-1330
402,350000,7cf283430b3b5e38,2,0,228,546,695,1147,600,1040,913,859,836,1130,958,546,752,878,-412,-172,-240
149,210000,7cf283430b3b5e38,2,0,209,435,639,553,466,570,710,667,540,619,821,205,513,548,-616,202,-818
163,500000,7cf283430b3b5e38,2,0,225,233,248,344,487,446,463,501,422,419,597,296,446,437,-301,178,-479
242,610000,7cf283430b3b5e38,2,0,258,403,620,717,590,762,830,880,891,912,1151,413,782,825,-738,239,-977
130,230000,7cf283430b3b5e38,2,0,175,240,355,391,233,247,332,298,250,347,415,118,266,293,-297,68,-365
27,310000,d4efbebb087fd03f,2,0,38,145,116,132,121,130,170,225,144,225,270,79,174,191,-191,45,-236
172,530000,d4efbebb087fd03f,2,0,103,104,130,150,124,141,193,215,192,267,384,296,340,316,-88,117,-205
124,150000,d4efbebb087fd03f,2,0,174,191,134,180,155,165,211,257,237,359,450,248,349,352,-202,91,-293
74,110000,d4efbebb087fd03f,2,0,72,213,666,671,764,635,596,755,684,938,1287,118,702,781,-1169,349,-1518
797,510000,d4efbebb087fd03f,2,0,807,671,665,754,743,840,1135,1134,707,1002,2805,1326,2066,1711,-1479,1803,-3282
436,340000,d4efbebb087fd03f,2,0,626,432,458,431,427,626,807,752,716,977,1443,903,1173,1108,-540,466,-1006
1009,370000,d4efbebb087fd03f,2,0,1342,1025,1289,1432,1325,1510,2013,2253,1752,2198,3785,1878,2832,2620,-1907,1587,-3494
248,140000,d4efbebb087fd03f,2,0,270,276,293,383,273,396,591,635,370,1993,2925,603,1764,1840,-2322,932,-3254
399,440000,d4efbebb087fd03f,2,0,289,994,1031,1203,1183,1216,1851,1526,1065,2044,2419,914,1666,1792,-1505,375,-1880
303,450000,d4efbebb087fd03f,2,0,276,260,250,385,389,373,565,452,368,493,935,666,800,698,-269,442,-711
648,320000,d4efbebb087fd03f,2,0,779,828,897,1057,971,1038,1263,1231,1184,1531,2308,910,1609,1583,-1398,777,-2175
364,360000,d4efbebb087fd03f,2,0,652,459,469,546,479,591,657,831,701,917,1377,999,1188,1098,-378,460,-838
641,130000,d4efbebb087fd03f,2,0,741,471,479,696,616,754,991,941,754,1144,2067,1110,1588,1440,-957,923,-1880
888,410000,d4efbebb087fd03f,2,0,1382,887,1161,1258,1321,1528,1922,1491,1090,1965,3560,2272,2916,2599,-1288,1595,-2883
639,330000,d4efbebb087fd03f,2,0,823,1584,1570,1718,1900,1877,2534,1978,2287,3147,4324,1028,2676,2833,-3296,1177,-4473
347,420000,d4efbebb087fd03f,2,0,443,424,420,420,475,487,636,528,521,941,1534,1004,1269,1160,-530,593,-1123
438,430000,d4efbebb087fd03f,2,0,937,896,945,1034,885,1014,1148,1102,762,1142,1719,1133,1426,1331,-586,577,-1163
268,350000,d4efbebb087fd03f,2,0,190,590,596,665,596,710,861,605,468,762,1967,434,1200,1054,-1533,1205,-2738
149,210000,d4efbebb087fd03f,2,0,132,202,209,189,242,328,373,319,239,291,520,199,360,337,-321,229,-550
291,500000,d4efbebb087fd03f,2,0,271,206,305,265,352,383,500,317,253,326,532,432,482,430,-100,206,-306
422,610000,d4efbebb087fd03f,2,0,421,382,511,669,670,984,1191,1013,830,1010,1651,919,1285,1193,-732,641,-1373
104,230000,d4efbebb087fd03f,2,0,79,88,79,102,96,114,179,154,114,204,257,135,196,199,-122,53,-175
40,310000,7245e0ee27b195cd,2,0,23,47,54,61,91,84,82,78,75,125,158,63,110,115,-95,33,-128
246,530000,7245e0ee27b195cd,2,0,217,206,208,229,212,242,297,409,425,375,535,421,478,444,-114,160,-274
164,150000,7245e0ee27b195cd,2,0,150,198,157,157,141,155,186,321,287,448,676,363,520,496,-313,228,-541
74,110000,7245e0ee27b195cd,2,0,72,142,158,142,166,192,229,328,289,360,496,86,291,314,-410,136,-546
451,510000,7245e0ee27b195cd,2,0,453,466,458,502,542,612,740,894,870,831,1260,724,992,938,-536,429,-965
272,340000,7245e0ee27b195cd,2,0,266,304,266,327,272,360,423,570,478,510,806,576,691,631,-230,296,-526
762,370000,7245e0ee27b195cd,2,0,1114,946,977,950,814,1067,1385,1544,1660,1778,2915,1529,2222,2074,-1386,1137,-2523
366,140000,7245e0ee27b195cd,2,0,225,305,328,438,304,387,526,657,689,668,1092,615,854,792,-477,424,-901
363,440000,7245e0ee27b195cd,2,0,221,467,644,800,706,726,1003,987,1170,1384,1437,718,1078,1180,-719,53,-772
233,450000,7245e0ee27b195cd,2,0,206,238,200,244,215,205,275,336,321,463,659,452,556,525,-207,196,-403
405,320000,7245e0ee27b195cd,2,0,284,374,406,417,417,424,503,619,691,743,1008,543,776,765,-465,265,-730
247,360000,7245e0ee27b195cd,2,0,325,271,316,324,321,323,384,576,518,577,816,634,725,676,-182,239,-421
951,130000,7245e0ee27b195cd,2,0,883,734,754,897,796,976,1190,1442,1308,1432,2365,1304,1834,1700,-1061,933,-1994
717,410000,7245e0ee27b195cd,2,0,751,731,764,796,796,921,1180,1362,1148,1406,2228,1526,1877,1720,-702,822,-1524
306,330000,7245e0ee27b195cd,2,0,256,491,555,599,497,546,656,656,660,874,1121,438,780,811,-683,247,-930
255,420000,7245e0ee27b195cd,2,0,284,280,340,316,308,353,445,594,534,655,903,635,769,731,-268,248,-516
321,430000,7245e0ee27b195cd,2,0,477,571,590,590,570,561,665,852,609,763,1216,773,994,917,-443,453,-896
153,350000,7245e0ee27b195cd,2,0,95,214,227,185,203,218,279,280,218,239,420,249,334,303,-171,181,-352
222,210000,7245e0ee27b195cd,2,0,149,240,267,276,253,308,361,450,328,514,641,287,464,481,-354,127,-481
142,500000,7245e0ee27b195cd,2,0,155,141,187,187,221,263,289,325,272,292,402,296,349,330,-106,110,-216
410,610000,7245e0ee27b195cd,2,0,388,397,433,446,383,562,667,705,729,755,1158,815,986,909,-343,403,-746
145,230000,7245e0ee27b195cd,2,0,131,179,118,155,141,189,179,249,176,328,336,166,251,277,-170,8,-178
102,310000,8c915fe4632fb9fa,2,0,130,160,94,156,130,143,149,181,158,314,461,180,320,318,-281,147,-428
575,530000,8c915fe4632fb9fa,2,0,338,404,239,336,248,387,336,447,627,757,1396,1059,1228,1071,-337,639,-976
270,150000,8c915fe4632fb9fa,2,0,137,199,117,165,174,186,216,287,324,527,720,520,620,589,-200,193,-393
86,110000,8c915fe4632fb9fa,2,0,109,157,85,99,100,137,177,237,199,242,487,101,294,277,-386,245,-631
1194,510000,8c915fe4632fb9fa,2,0,901,983,554,759,618,741,845,1263,1243,1605,2433,1860,2146,1966,-573,828,-1401
720,340000,8c915fe4632fb9fa,2,0,660,594,483,561,546,651,840,1069,1269,1370,2298,1440,1869,1703,-858,928,-1786
1109,370000,8c915fe4632fb9fa,2,0,621,625,585,723,768,927,999,1485,1686,2126,3804,2217,3010,2716,-1587,1678,-3265
404,140000,8c915fe4632fb9fa,2,0,232,272,166,255,224,271,379,496,642,748,1215,772,994,912,-443,467,-910
446,440000,8c915fe4632fb9fa,2,0,298,728,449,600,502,550,650,835,848,1467,2021,1040,1530,1509,-981,554,-1535
330,450000,8c915fe4632fb9fa,2,0,174,351,170,257,240,225,284,342,388,511,880,738,809,710,-142,369,-511
1130,320000,8c915fe4632fb9fa,2,0,861,985,648,883,678,762,1001,1116,1451,1816,2525,1540,2032,1960,-985,709,-1694
377,360000,8c915fe4632fb9fa,2,0,504,443,270,410,377,409,440,725,733,889,1320,1015,1168,1075,-305,431,-736
1126,130000,8c915fe4632fb9fa,2,0,623,634,487,781,785,958,1014,1437,1548,2026,3281,1882,2582,2396,-1399,1255,-2654
1002,410000,8c915fe4632fb9fa,2,0,786,582,542,634,719,857,953,1313,1473,1843,2975,2324,2650,2381,-651,1132,-1783
565,330000,8c915fe4632fb9fa,2,0,640,897,591,746,723,731,805,1089,1175,1502,2235,958,1596,1565,-1277,733,-2010
463,420000,8c915fe4632fb9fa,2,0,492,599,444,503,489,505,669,868,924,1339,1557,1148,1352,1348,-409,218,-627
439,430000,8c915fe4632fb9fa,2,0,399,488,309,371,399,407,438,633,772,835,1281,1235,1258,1117,-46,446,-492
365,350000,8c915fe4632fb9fa,2,0,190,303,174,227,178,234,282,307,414,622,877,518,698,672,-359,255,-614
224,210000,8c915fe4632fb9fa,2,0,155,236,155,177,191,236,231,291,296,396,542,311,426,416,-231,146,-377
274,500000,8c915fe4632fb9fa,2,0,252,295,169,207,227,218,259,311,316,419,666,489,578,525,-177,247,-424
394,610000,8c915fe4632fb9fa,2,0,331,283,202,287,271,303,362,519,627,715,1549,1036,1292,1100,-513,834,-1347
372,230000,8c915fe4632fb9fa,2,0,248,377,252,344,319,336,422,442,411,616,998,401,700,672,-597,382,-979
192,310000,6155b214590c66e6,2,0,360,517,534,459,422,464,522,661,472,781,1047,423,735,750,-624,266,-890
680,530000,6155b214590c66e6,2,0,825,894,856,985,706,939,877,1084,1148,1159,1879,1354,1616,1464,-525,720,-1245
347,150000,6155b214590c66e6,2,0,297,457,492,583,433,551,578,725,701,941,1442,814,1128,1066,-628,501,-1129
176,110000,6155b214590c66e6,2,0,297,397,406,411,391,454,496,664,474,569,1295,274,784,713,-1021,726,-1747
1081,510000,6155b214590c66e6,2,0,1779,1779,1892,1614,1306,1417,1488,2289,1556,2162,4188,2540,3364,2963,-1648,2026,-3674
863,340000,6155b214590c66e6,2,0,1365,1104,1361,1443,1295,1412,1803,1996,1889,2073,3650,2495,3072,2739,-1155,1577,-2732
1356,370000,6155b214590c66e6,2,0,1514,1781,2492,2580,2168,2583,2886,3461,3252,3594,6275,3467,4871,4445,-2808,2681,-5489
357,140000,6155b214590c66e6,2,0,293,482,602,630,509,619,652,805,800,914,1576,743,1160,1078,-833,662,-1495
653,440000,6155b214590c66e6,2,0,552,1659,1766,2201,1866,1837,2246,2808,2902,3269,4342,1784,3063,3132,-2558,1073,-3631
381,450000,6155b214590c66e6,2,0,312,603,500,655,477,518,574,670,621,739,1316,892,1104,982,-424,577,-1001
1760,320000,6155b214590c66e6,2,0,2048,2831,2838,3224,2468,2600,3230,3453,3560,3776,5864,3032,4448,4224,-2832,2088,-4920
453,360000,6155b214590c66e6,2,0,796,783,897,980,839,839,860,1325,1195,1285,2160,1579,1870,1675,-581,875,-1456
1231,130000,6155b214590c66e6,2,0,1405,1287,1778,2039,1774,2024,2258,2481,2298,2594,4551,2375,3463,3173,-2176,1957,-4133
1586,410000,6155b214590c66e6,2,0,2208,2034,2494,2508,2539,3103,3396,3571,3427,4047,8018,5309,6664,5791,-2709,3971,-6680
826,330000,6155b214590c66e6,2,0,1317,1705,1980,2136,1905,1897,2229,2579,2724,3014,4336,1679,3008,3010,-2657,1322,-3979
551,420000,6155b214590c66e6,2,0,1019,1237,1346,1186,1236,1304,1341,1747,1512,1848,3179,2049,2614,2359,-1130,1331,-2461
732,430000,6155b214590c66e6,2,0,944,1417,1610,1468,1450,1536,1679,2187,1872,2355,3747,2461,3104,2854,-1286,1392,-2678
364,350000,6155b214590c66e6,2,0,377,549,639,683,519,626,618,738,859,1140,1306,596,951,1014,-710,166,-876
415,210000,6155b214590c66e6,2,0,439,737,900,949,846,1022,1132,1218,970,1188,1784,769,1276,1247,-1015,596,-1611
373,500000,6155b214590c66e6,2,0,523,596,660,656,695,635,655,770,622,761,1417,877,1147,1018,-540,656,-1196
303,610000,6155b214590c66e6,2,0,455,425,548,688,468,587,654,727,899,841,1546,1008,1277,1132,-538,705,-1243
365,230000,6155b214590c66e6,2,0,417,638,624,692,573,663,777,675,517,944,1290,579,934,938,-711,346,-1057
433,310000,28e29f2c03dcd84c,2,0,406,900,712,656,680,680,720,820,623,807,1293,851,1072,984,-442,486,-928
300,530000,28e29f2c03dcd84c,2,0,255,271,184,252,242,468,405,456,394,535,639,509,574,561,-130,104,-234
276,150000,28e29f2c03dcd84c,2,0,266,342,266,364,340,407,480,482,477,451,580,494,537,508,-86,129,-215
923,110000,28e29f2c03dcd84c,2,0,612,1376,1000,1124,1019,1062,1143,1276,969,1288,2146,1327,1736,1587,-819,858,-1677
454,510000,28e29f2c03dcd84c,2,0,548,541,447,452,487,585,715,1123,634,781,1105,856,980,914,-249,324,-573
364,340000,28e29f2c03dcd84c,2,0,475,554,507,478,422,472,667,840,774,803,1070,953,1012,942,-117,267,-384
778,370000,28e29f2c03dcd84c,2,0,957,1035,932,915,988,988,1162,1315,1224,1513,1837,1329,1583,1560,-508,324,-832
474,140000,28e29f2c03dcd84c,2,0,558,679,602,669,598,604,750,729,770,798,1203,945,1074,982,-258,405,-663
180,440000,28e29f2c03dcd84c,2,0,134,313,221,266,335,313,351,438,425,536,825,423,624,595,-402,289,-691
71,450000,28e29f2c03dcd84c,2,0,128,156,79,110,114,93,121,141,135,160,243,179,211,194,-64,83,-147
1058,320000,28e29f2c03dcd84c,2,0,1242,1350,1122,1198,1215,1276,1793,1838,1848,1951,2643,1820,2232,2138,-823,692,-1515
151,360000,28e29f2c03dcd84c,2,0,233,355,293,295,274,321,334,419,377,424,571,408,490,468,-163,147,-310
884,130000,28e29f2c03dcd84c,2,0,842,1063,923,1024,961,977,1321,1377,1264,1433,1923,1604,1764,1653,-319,490,-809
548,410000,28e29f2c03dcd84c,2,0,731,827,723,780,738,834,1010,1081,952,1113,1482,1178,1330,1258,-304,369,-673
352,330000,28e29f2c03dcd84c,2,0,584,577,432,444,464,536,601,733,722,894,1112,767,940,924,-345,218,-563
164,420000,28e29f2c03dcd84c,2,0,233,258,236,284,317,260,295,373,329,377,483,446,464,435,-37,106,-143
262,430000,28e29f2c03dcd84c,2,0,340,403,317,301,333,339,383,464,438,477,783,487,635,582,-296,306,-602
140,350000,28e29f2c03dcd84c,2,0,162,321,213,189,158,212,189,235,212,345,456,397,426,399,-59,111,-170
165,210000,28e29f2c03dcd84c,2,0,160,216,236,253,279,277,296,261,247,251,310,270,290,277,-40,59,-99
263,500000,28e29f2c03dcd84c,2,0,413,369,328,342,482,408,414,486,426,491,644,555,600,563,-89,153,-242
361,610000,28e29f2c03dcd84c,2,0,424,439,293,395,348,388,413,568,617,622,758,719,738,700,-39,136,-175
79,230000,28e29f2c03dcd84c,2,0,116,156,121,150,115,124,187,159,142,152,169,104,136,142,-65,17,-82
37,310000,37aa9169b575ef79,2,0,35,64,37,32,39,46,46,41,395,67,117,63,90,82,-54,50,-104
692,530000,37aa9169b575ef79,2,0,757,1431,1186,1072,971,1395,1426,1254,988,1142,1590,946,1268,1226,-644,448,-1092
413,150000,37aa9169b575ef79,2,0,514,769,698,895,690,744,864,895,802,945,982,602,792,843,-380,37,-417
271,110000,37aa9169b575ef79,2,0,466,982,803,698,717,716,794,737,477,625,985,300,642,637,-685,360,-1045
1639,510000,37aa9169b575ef79,2,0,1370,2758,2537,2734,2651,2620,2791,2955,1733,2221,3340,1470,2405,2344,-1870,1119,-2989
260,340000,37aa9169b575ef79,2,0,352,581,410,402,479,502,552,488,424,410,575,248,412,411,-327,165,-492
1708,370000,37aa9169b575ef79,2,0,2068,3709,3356,3511,2812,3126,3130,3837,3617,3662,4024,1903,2964,3196,-2121,362,-2483
442,140000,37aa9169b575ef79,2,0,571,1176,933,1057,828,993,1217,1561,1243,1188,1616,679,1148,1161,-937,428,-1365
1075,440000,37aa9169b575ef79,2,0,627,1889,1775,1785,1654,1766,1963,2010,1906,2111,2398,1196,1797,1902,-1202,287,-1489
301,450000,37aa9169b575ef79,2,0,278,462,403,353,331,405,319,409,384,459,435,440,438,445,5,-24,29
626,320000,37aa9169b575ef79,2,0,541,942,753,875,786,701,745,840,781,777,930,527,728,745,-403,153,-556
189,360000,37aa9169b575ef79,2,0,261,379,339,330,292,330,358,538,488,482,540,354,447,459,-186,58,-244
1780,130000,37aa9169b575ef79,2,0,2309,3367,3025,3349,3221,3102,3388,3910,3483,3233,4206,2068,3137,3169,-2138,973,-3111
1050,410000,37aa9169b575ef79,2,0,1238,2093,1984,2022,1974,2200,2100,2323,1931,2018,2962,1570,2266,2183,-1392,944,-2336
422,330000,37aa9169b575ef79,2,0,384,837,836,827,820,769,777,723,606,634,886,424,655,648,-462,252,-714
270,420000,37aa9169b575ef79,2,0,389,867,611,610,623,595,715,725,585,544,920,483,702,649,-437,376,-813
653,430000,37aa9169b575ef79,2,0,1115,2020,1616,1475,1358,1456,1533,1680,1444,1489,2336,1714,2025,1846,-622,847,-1469
292,350000,37aa9169b575ef79,2,0,302,657,579,484,487,627,773,710,690,597,622,308,465,509,-314,25,-339
691,210000,37aa9169b575ef79,2,0,854,1439,1484,1508,1498,1804,1815,1871,1308,1478,1878,681,1280,1346,-1197,400,-1597
105,500000,37aa9169b575ef79,2,0,167,284,211,204,370,530,502,347,184,172,247,131,189,183,-116,75,-191
384,610000,37aa9169b575ef79,2,0,499,771,729,604,479,874,1106,695,580,634,1051,558,804,748,-493,417,-910
952,230000,37aa9169b575ef79,2,0,1179,1914,1499,1291,1253,1193,1427,1562,1308,1636,1781,730,1256,1382,-1051,145,-1196
501,310000,63065128401bb3ff,2,0,573,2243,2672,2922,2462,1180,1500,2397,1674,2362,3060,1909,2484,2444,-1151,698,-1849
504,530000,63065128401bb3ff,2,0,563,707,630,647,551,884,974,1076,1038,1033,1402,656,1029,1030,-746,369,-1115
214,150000,63065128401bb3ff,2,0,335,525,430,507,344,410,446,541,468,630,827,268,548,575,-559,197,-756
200,110000,63065128401bb3ff,2,0,353,2808,1941,2551,971,995,1118,835,516,1494,2145,217,1181,1285,-1928,651,-2579
937,510000,63065128401bb3ff,2,0,1405,2143,1834,1543,1533,1662,1864,2707,1708,2119,2450,1355,1902,1975,-1095,331,-1426
775,340000,63065128401bb3ff,2,0,1494,1764,1722,1828,1799,2028,2809,2863,2529,2927,3132,1460,2296,2506,-1672,205,-1877
1225,370000,63065128401bb3ff,2,0,2478,3115,3589,3471,2715,3147,4018,4409,4129,4087,5401,1885,3643,3791,-3516,1314,-4830
491,140000,63065128401bb3ff,2,0,779,1146,1022,1337,977,1223,1490,1510,1452,1547,2066,692,1379,1435,-1374,519,-1893
462,440000,63065128401bb3ff,2,0,535,2905,1816,1983,1796,1715,2112,2192,2036,2188,2519,625,1572,1777,-1894,331,-2225
176,450000,63065128401bb3ff,2,0,397,549,377,518,379,413,503,589,568,596,616,308,462,507,-308,20,-328
1862,320000,63065128401bb3ff,2,0,3297,3990,3393,3757,3219,3369,4854,5016,4475,5007,5643,2143,3893,4264,-3500,636,-4136
442,360000,63065128401bb3ff,2,0,1077,1305,1276,1370,1233,1308,1681,2044,1627,1981,2357,973,1665,1770,-1384,376,-1760
1261,130000,63065128401bb3ff,2,0,1882,2484,2675,3198,2587,2964,3829,3951,3277,3711,5424,1723,3574,3619,-3701,1713,-5414
1238,410000,63065128401bb3ff,2,0,1915,2442,2757,2736,2702,3421,4398,4500,3793,4237,5119,2463,3791,3940,-2656,882,-3538
768,330000,63065128401bb3ff,2,0,1321,2050,1853,2092,1953,2021,2513,2777,2324,2401,2755,895,1825,2017,-1860,354,-2214
357,420000,63065128401bb3ff,2,0,916,1381,1205,1158,1213,1120,1591,1818,1296,1466,1985,1002,1494,1484,-983,519,-1502
531,430000,63065128401bb3ff,2,0,1083,1689,1645,1561,1517,1583,1906,2187,1670,2078,2533,1085,1809,1899,-1448,455,-1903
400,350000,63065128401bb3ff,2,0,446,1142,977,1082,843,1055,1347,1279,1170,1218,1549,440,994,1069,-1109,331,-1440
212,210000,63065128401bb3ff,2,0,394,781,766,859,586,702,806,897,700,869,1098,268,683,745,-830,229,-1059
359,500000,63065128401bb3ff,2,0,586,936,946,870,1013,987,1230,1171,824,938,1120,617,868,892,-503,182,-685
397,610000,63065128401bb3ff,2,0,688,869,1036,1284,861,1113,1278,1300,1165,1199,1748,631,1190,1193,-1117,549,-1666
156,230000,63065128401bb3ff,2,0,210,484,451,421,327,303,404,404,286,466,480,162,321,369,-318,14,-332
362,310000,ea489c253676aafc,2,0,300,906,709,759,629,425,535,502,314,574,754,315,534,548,-439,180,-619
295,530000,ea489c253676aafc,2,0,389,500,421,595,461,551,450,435,635,692,866,452,659,670,-414,174,-588
254,150000,ea489c253676aafc,2,0,383,577,507,561,440,380,452,427,495,612,941,427,684,660,-514,329,-843
89,110000,ea489c253676aafc,2,0,209,482,498,353,301,382,397,346,199,341,546,125,336,337,-421,205,-626
704,510000,ea489c253676aafc,2,0,991,1444,1326,1270,1055,1379,1197,903,838,1187,1812,1017,1414,1339,-795,625,-1420
475,340000,ea489c253676aafc,2,0,887,1184,1065,1021,869,1109,958,734,813,952,1669,741,1205,1121,-928,717,-1645
1515,370000,ea489c253676aafc,2,0,2475,3780,3634,3404,2787,3450,3299,2451,2995,3812,5496,2330,3913,3879,-3166,1684,-4850
641,140000,ea489c253676aafc,2,0,1042,1482,1678,1725,1270,1462,1588,1052,1126,1234,2626,1165,1896,1675,-1461,1392,-2853
255,440000,ea489c253676aafc,2,0,178,510,397,473,460,457,448,529,384,525,1055,368,712,649,-687,530,-1217
155,450000,ea489c253676aafc,2,0,173,461,182,302,352,363,291,255,362,355,448,365,406,389,-83,93,-176
1028,320000,ea489c253676aafc,2,0,941,1639,1304,1178,1368,1353,1085,864,1310,1728,2261,1167,1714,1719,-1094,533,-1627
223,360000,ea489c253676aafc,2,0,332,492,421,412,315,365,335,301,356,946,847,641,744,811,-206,-99,-107
1551,130000,ea489c253676aafc,2,0,2876,2946,3004,3190,2715,3210,3609,2265,2586,3058,5478,1932,3705,3489,-3546,2420,-5966
893,410000,ea489c253676aafc,2,0,1336,1920,1867,1905,1469,1701,1452,1141,1472,1941,3092,1731,2412,2255,-1361,1151,-2512
467,330000,ea489c253676aafc,2,0,560,1342,916,1100,1016,1000,913,659,638,706,1205,504,854,805,-701,499,-1200
154,420000,ea489c253676aafc,2,0,332,433,470,347,353,277,263,202,272,348,657,298,478,434,-359,309,-668
253,430000,ea489c253676aafc,2,0,599,989,827,849,769,962,701,698,568,587,1351,576,964,838,-775,764,-1539
148,350000,ea489c253676aafc,2,0,127,369,321,335,225,356,355,342,307,452,617,215,416,428,-402,165,-567
408,210000,ea489c253676aafc,2,0,461,979,733,783,589,621,716,684,572,853,1026,394,710,758,-632,173,-805
248,500000,ea489c253676aafc,2,0,370,549,493,497,413,558,474,304,408,379,694,353,524,475,-341,315,-656
418,610000,ea489c253676aafc,2,0,406,608,683,599,723,667,832,623,693,804,1400,754,1077,986,-646,596,-1242
266,230000,ea489c253676aafc,2,0,551,532,645,383,283,369,508,307,324,496,710,280,495,495,-430,214,-644
177,310000,cd5841d44fd7625e,2,0,162,289,246,249,228,201,232,150,148,312,359,339,349,337,-20,47,-67
248,530000,cd5841d44fd7625e,2,0,215,264,283,346,330,388,290,304,344,442,485,409,447,445,-76,43,-119
319,150000,cd5841d44fd7625e,2,0,173,236,276,395,262,398,348,325,432,401,434,519,476,451,85,33,52
877,110000,cd5841d44fd7625e,2,0,607,1252,1112,1156,1039,990,1183,1150,795,1121,1802,1263,1532,1395,-539,681,-1220
565,510000,cd5841d44fd7625e,2,0,485,639,702,679,596,623,519,741,610,732,1083,1390,1236,1068,307,351,-44
315,340000,cd5841d44fd7625e,2,0,265,335,339,414,403,381,360,323,440,519,629,667,648,605,38,110,-72
878,370000,cd5841d44fd7625e,2,0,694,1162,1362,1499,1162,1256,1311,1391,1370,1666,1642,1861,1752,1723,219,-24,243
317,140000,cd5841d44fd7625e,2,0,225,381,342,380,264,316,332,330,480,421,414,426,420,420,12,-7,19
322,440000,cd5841d44fd7625e,2,0,132,499,400,553,537,509,516,523,704,995,1243,727,985,988,-516,248,-764
119,450000,cd5841d44fd7625e,2,0,72,100,87,113,102,97,101,156,159,192,214,225,220,210,11,22,-11
868,320000,cd5841d44fd7625e,2,0,733,1051,1024,1236,925,785,871,1280,881,1099,1374,1336,1355,1270,-38,275,-313
141,360000,cd5841d44fd7625e,2,0,114,198,208,246,191,199,169,178,237,276,329,364,346,323,35,53,-18
1165,130000,cd5841d44fd7625e,2,0,874,1322,1150,1563,1391,1238,1360,1115,1052,1461,1615,1768,1692,1615,153,154,-1
856,410000,cd5841d44fd7625e,2,0,536,792,984,996,913,957,1047,1104,1357,1223,1443,1429,1436,1365,-14,220,-234
356,330000,cd5841d44fd7625e,2,0,311,485,482,592,492,475,404,404,512,747,863,742,802,784,-121,116,-237
262,420000,cd5841d44fd7625e,2,0,217,350,350,345,337,298,379,393,374,473,566,558,562,532,-8,93,-101
230,430000,cd5841d44fd7625e,2,0,193,301,261,307,277,273,291,253,248,418,494,519,506,477,25,76,-51
188,350000,cd5841d44fd7625e,2,0,162,288,229,307,216,229,183,186,285,325,402,404,403,377,2,77,-75
546,210000,cd5841d44fd7625e,2,0,324,566,616,593,769,652,721,569,738,644,1082,704,893,810,-378,438,-816
202,500000,cd5841d44fd7625e,2,0,158,224,260,274,314,254,213,262,251,282,391,433,412,369,42,109,-67
257,610000,cd5841d44fd7625e,2,0,184,273,411,522,312,356,360,419,276,346,497,487,492,443,-10,151,-161
666,230000,cd5841d44fd7625e,2,0,427,986,775,794,828,639,929,731,657,664,964,785,874,804,-179,300,-479
447,310000,b25c4e2e3856af22,2,0,568,1144,987,982,1141,897,946,1150,1010,1563,1504,815,1160,1294,-689,-59,-630
277,530000,b25c4e2e3856af22,2,0,407,491,429,522,373,681,595,570,759,692,785,585,685,687,-200,93,-293
110,150000,b25c4e2e3856af22,2,0,174,204,243,365,254,296,333,327,407,342,430,303,366,358,-127,88,-215
284,110000,b25c4e2e3856af22,2,0,395,672,745,768,998,675,772,925,740,925,1127,376,752,809,-751,202,-953
562,510000,b25c4e2e3856af22,2,0,779,913,980,978,903,990,1085,1885,1100,1320,1775,1096,1436,1397,-679,455,-1134
364,340000,b25c4e2e3856af22,2,0,600,798,764,823,725,769,980,1023,1001,1064,1490,952,1221,1169,-538,426,-964
501,370000,b25c4e2e3856af22,2,0,681,940,1108,1210,1082,1134,1323,1432,1303,1408,1739,940,1340,1362,-799,331,-1130
113,140000,b25c4e2e3856af22,2,0,235,312,291,326,221,257,295,289,333,332,371,229,300,311,-142,39,-181
451,440000,b25c4e2e3856af22,2,0,423,1174,995,1269,1114,1097,1195,1320,1463,1644,2216,854,1535,1571,-1362,572,-1934
114,450000,b25c4e2e3856af22,2,0,211,246,212,277,223,187,218,240,280,255,372,218,295,282,-154,117,-271
987,320000,b25c4e2e3856af22,2,0,1323,1686,1487,1639,1433,1571,1947,1897,1872,2263,3132,1586,2359,2327,-1546,869,-2415
284,360000,b25c4e2e3856af22,2,0,454,671,722,759,661,681,684,855,798,870,1144,754,949,923,-390,274,-664
442,130000,b25c4e2e3856af22,2,0,517,776,716,788,622,676,985,861,883,944,1218,652,935,938,-566,274,-840
471,410000,b25c4e2e3856af22,2,0,652,810,959,936,866,965,1056,1067,1021,1121,1578,856,1217,1185,-722,457,-1179
893,330000,b25c4e2e3856af22,2,0,1395,1880,1823,1961,1826,1921,2037,2367,2323,2703,3371,1749,2560,2608,-1622,668,-2290
363,420000,b25c4e2e3856af22,2,0,532,746,751,751,798,730,829,920,1033,988,1333,941,1137,1087,-392,345,-737
386,430000,b25c4e2e3856af22,2,0,612,798,869,852,770,811,908,1056,973,1081,1561,1003,1282,1215,-558,480,-1038
370,350000,b25c4e2e3856af22,2,0,407,744,580,799,587,681,684,714,853,905,1102,667,884,891,-435,197,-632
188,210000,b25c4e2e3856af22,2,0,172,302,339,376,332,444,478,491,437,403,555,253,404,404,-302,152,-454
184,500000,b25c4e2e3856af22,2,0,350,388,450,403,448,421,422,477,428,496,740,452,596,563,-288,244,-532
223,610000,b25c4e2e3856af22,2,0,275,327,347,397,335,338,351,433,450,479,533,395,464,469,-138,54,-192
219,230000,b25c4e2e3856af22,2,0,146,415,369,422,399,362,461,359,320,352,428,213,320,331,-215,76,-291
231,310000,4a103c30d593fbbe,2,0,184,494,480,438,464,464,563,552,450,685,688,275,482,549,-413,3,-416
321,530000,4a103c30d593fbbe,2,0,407,551,494,611,509,837,743,640,687,714,1001,409,705,708,-592,287,-879
239,150000,4a103c30d593fbbe,2,0,281,409,555,665,393,509,544,557,650,671,789,370,580,610,-419,118,-537
360,110000,4a103c30d593fbbe,2,0,555,1236,1175,1102,1018,1021,1288,1431,1045,1332,1807,402,1104,1180,-1405,475,-1880
1106,510000,4a103c30d593fbbe,2,0,1439,1972,2107,1866,1748,1887,2009,2921,2017,2913,3590,1589,2590,2697,-2001,677,-2678
593,340000,4a103c30d593fbbe,2,0,517,1041,1182,1170,1110,1307,1431,1596,1491,1717,1968,921,1444,1535,-1047,251,-1298
945,370000,4a103c30d593fbbe,2,0,1121,2092,2449,2486,1895,2003,2387,2615,2547,2776,3299,1329,2314,2468,-1970,523,-2493
261,140000,4a103c30d593fbbe,2,0,373,673,634,789,589,641,800,787,813,782,1130,401,766,771,-729,348,-1077
354,440000,4a103c30d593fbbe,2,0,323,1264,996,1286,1093,1029,1303,1438,1702,2171,2397,475,1436,1681,-1922,226,-2148
179,450000,4a103c30d593fbbe,2,0,161,369,263,323,295,287,282,358,395,493,595,225,410,438,-370,102,-472
1477,320000,4a103c30d593fbbe,2,0,1522,2786,2473,3080,2334,2394,3107,2962,3228,3579,4302,1623,2962,3168,-2679,723,-3402
230,360000,4a103c30d593fbbe,2,0,252,491,598,657,503,672,641,755,781,885,1016,398,707,766,-618,131,-749
1311,130000,4a103c30d593fbbe,2,0,1404,2330,2475,2921,2392,2559,2979,2860,2877,2989,3954,1565,2760,2836,-2389,965,-3354
872,410000,4a103c30d593fbbe,2,0,955,1587,2122,1817,1841,2115,2398,2493,2358,2638,3291,1489,2390,2473,-1802,653,-2455
793,330000,4a103c30d593fbbe,2,0,893,1688,1755,1827,1550,1572,1914,1992,2163,2458,2897,961,1929,2105,-1936,439,-2375
357,420000,4a103c30d593fbbe,2,0,473,870,703,828,848,789,996,1142,948,1247,1304,805,1054,1119,-499,57,-556
264,430000,4a103c30d593fbbe,2,0,394,710,632,689,696,720,817,950,757,948,1222,427,824,866,-795,274,-1069
327,350000,4a103c30d593fbbe,2,0,280,669,569,777,495,680,640,694,837,946,924,385,654,752,-539,-22,-517
423,210000,4a103c30d593fbbe,2,0,487,985,1021,1093,717,904,1088,1057,1007,1160,1513,414,964,1029,-1099,353,-1452
209,500000,4a103c30d593fbbe,2,0,214,312,317,246,378,375,374,365,407,493,612,296,454,467,-316,119,-435
239,610000,4a103c30d593fbbe,2,0,352,582,607,926,472,701,761,801,945,946,1143,404,774,831,-739,197,-936
436,230000,4a103c30d593fbbe,2,0,475,987,974,825,774,757,1154,914,753,1190,1198,462,830,950,-736,8,-744
455,310000,7a7885e2d7c00bcf,2,0,350,778,523,603,553,600,670,690,633,790,925,325,625,680,-600,135,-735
218,530000,7a7885e2d7c00bcf,2,0,244,415,322,387,317,493,447,408,431,527,546,194,370,422,-352,19,-371
163,150000,7a7885e2d7c00bcf,2,0,150,300,265,350,301,313,341,355,371,359,418,168,293,315,-250,59,-309
523,110000,7a7885e2d7c00bcf,2,0,426,1017,846,916,826,879,911,1074,915,1162,1615,471,1043,1083,-1144,453,-1597
516,510000,7a7885e2d7c00bcf,2,0,562,879,706,738,715,745,722,1155,772,961,1167,445,806,858,-722,206,-928
418,340000,7a7885e2d7c00bcf,2,0,357,675,647,692,656,677,767,841,878,933,1003,374,688,770,-629,70,-699
984,370000,7a7885e2d7c00bcf,2,0,860,1928,1822,1978,1685,1638,1852,2308,2307,2370,2766,875,1820,2004,-1891,396,-2287
184,140000,7a7885e2d7c00bcf,2,0,166,314,241,352,275,285,300,313,320,355,484,139,312,326,-345,129,-474
402,440000,7a7885e2d7c00bcf,2,0,342,1042,810,979,912,937,951,992,1092,1209,1464,402,933,1025,-1062,255,-1317
109,450000,7a7885e2d7c00bcf,2,0,125,288,186,265,233,260,262,246,259,290,384,118,251,264,-266,94,-360
1612,320000,7a7885e2d7c00bcf,2,0,1512,2488,1949,2522,2016,2112,2209,2679,2595,2801,3241,1057,2149,2366,-2184,440,-2624
176,360000,7a7885e2d7c00bcf,2,0,200,434,361,405,347,434,393,442,498,481,511,213,362,402,-298,30,-328
885,130000,7a7885e2d7c00bcf,2,0,764,1561,1277,1469,1298,1298,1461,1525,1603,1929,2115,754,1434,1599,-1361,186,-1547
724,410000,7a7885e2d7c00bcf,2,0,578,1090,1137,1026,959,1096,1283,1383,1309,1461,1740,591,1166,1264,-1149,279,-1428
1237,330000,7a7885e2d7c00bcf,2,0,1062,1999,1632,1956,1671,1999,1697,1991,2033,2127,2662,818,1740,1869,-1844,535,-2379
279,420000,7a7885e2d7c00bcf,2,0,314,537,473,508,574,499,596,611,603,616,685,305,495,535,-380,69,-449
278,430000,7a7885e2d7c00bcf,2,0,263,575,412,494,442,503,514,645,501,559,768,256,512,528,-512,209,-721
257,350000,7a7885e2d7c00bcf,2,0,236,512,409,530,373,503,451,397,473,480,608,216,412,435,-392,128,-520
217,210000,7a7885e2d7c00bcf,2,0,246,558,476,514,420,483,505,553,489,516,595,169,382,427,-426,79,-505
99,500000,7a7885e2d7c00bcf,2,0,94,156,120,135,198,189,145,189,159,216,258,69,164,181,-189,42,-231
238,610000,7a7885e2d7c00bcf,2,0,259,468,393,540,321,402,487,425,510,487,657,185,421,443,-472,170,-642
228,230000,7a7885e2d7c00bcf,2,0,242,628,493,470,454,420,611,511,443,413,533,157,345,368,-376,120,-496
41,310000,346393c2c6305fb1,2,0,80,117,123,63,113,83,134,126,104,114,215,76,146,135,-139,101,-240
41,530000,346393c2c6305fb1,2,0,186,114,92,106,89,141,121,133,139,121,182,95,138,133,-87,61,-148
66,150000,346393c2c6305fb1,2,0,114,123,107,124,111,114,92,121,108,174,205,99,152,159,-106,31,-137
40,110000,346393c2c6305fb1,2,0,148,234,172,132,149,201,202,250,161,243,439,74,256,252,-365,196,-561
153,510000,346393c2c6305fb1,2,0,509,328,331,262,301,284,317,459,291,297,513,309,411,373,-204,216,-420
273,340000,346393c2c6305fb1,2,0,870,680,514,529,526,633,733,655,600,692,1047,578,812,772,-469,355,-824
381,370000,346393c2c6305fb1,2,0,1101,802,922,771,855,1000,1063,1138,1097,1099,1844,902,1373,1282,-942,745,-1687
158,140000,346393c2c6305fb1,2,0,211,155,211,195,143,212,261,250,277,308,545,238,392,364,-307,237,-544
71,440000,346393c2c6305fb1,2,0,89,154,162,145,223,291,295,282,277,289,373,126,250,263,-247,84,-331
53,450000,346393c2c6305fb1,2,0,104,97,54,71,100,108,107,108,100,115,162,93,128,123,-69,47,-116
168,320000,346393c2c6305fb1,2,0,502,454,332,411,403,402,461,370,406,397,621,300,460,439,-321,224,-545
36,360000,346393c2c6305fb1,2,0,200,101,96,91,121,141,112,150,164,143,266,151,208,187,-115,123,-238
389,130000,346393c2c6305fb1,2,0,753,620,514,537,455,575,645,742,699,808,1460,748,1104,1005,-712,652,-1364
174,410000,346393c2c6305fb1,2,0,528,298,313,364,453,477,544,566,471,617,1100,524,812,747,-576,483,-1059
55,330000,346393c2c6305fb1,2,0,143,158,153,145,161,194,181,198,211,191,260,101,180,184,-159,69,-228
79,420000,346393c2c6305fb1,2,0,242,211,178,180,285,274,266,326,324,313,534,275,404,374,-259,221,-480
119,430000,346393c2c6305fb1,2,0,234,247,217,180,205,282,273,347,286,335,535,308,422,393,-227,200,-427
25,350000,346393c2c6305fb1,2,0,45,82,56,58,88,101,114,102,89,87,129,60,94,92,-69,42,-111
91,210000,346393c2c6305fb1,2,0,232,279,252,262,234,252,331,280,278,265,371,149,260,262,-222,106,-328
84,500000,346393c2c6305fb1,2,0,271,178,190,138,222,247,251,250,189,199,335,168,252,234,-167,136,-303
62,610000,346393c2c6305fb1,2,0,166,118,112,151,113,180,161,167,197,186,360,209,284,252,-151,174,-325
95,230000,346393c2c6305fb1,2,0,152,215,165,177,206,165,264,248,169,223,312,126,219,220,-186,89,-275
494,310000,02aab221aabc03b9,2,0,279,554,507,485,527,653,687,651,489,558,362,679,520,533,317,-196,513
130,530000,02aab221aabc03b9,2,0,87,174,151,202,185,247,209,201,174,160,155,229,192,181,74,-5,79
63,150000,02aab221aabc03b9,2,0,51,90,76,95,106,108,130,97,99,82,59,106,82,82,47,-23,70
532,110000,02aab221aabc03b9,2,0,424,733,545,566,646,748,847,831,642,654,521,798,660,658,277,-133,410
394,510000,02aab221aabc03b9,2,0,325,439,421,431,486,460,559,615,471,430,474,703,588,536,229,44,185
203,340000,02aab221aabc03b9,2,0,144,198,252,223,244,244,344,348,248,228,187,338,262,251,151,-41,192
362,370000,02aab221aabc03b9,2,0,240,412,457,437,443,584,549,525,474,421,353,610,482,461,257,-68,325
94,140000,02aab221aabc03b9,2,0,58,112,93,114,101,121,154,121,105,117,105,129,117,117,24,-12,36
847,440000,02aab221aabc03b9,2,0,384,1124,891,1008,1160,1083,1238,1180,1049,976,1007,1207,1107,1063,200,31,169
102,450000,02aab221aabc03b9,2,0,68,133,79,114,129,142,161,151,126,138,119,159,139,139,40,-19,59
1066,320000,02aab221aabc03b9,2,0,960,1400,1291,1323,1469,1509,1821,1585,1270,1186,1077,1735,1406,1333,658,-109,767
146,360000,02aab221aabc03b9,2,0,93,153,158,177,165,198,224,232,164,154,152,242,197,183,90,-2,92
242,130000,02aab221aabc03b9,2,0,118,239,297,312,337,350,330,362,307,254,182,340,261,259,158,-72,230
199,410000,02aab221aabc03b9,2,0,161,301,358,277,291,353,389,339,239,284,223,320,272,276,97,-61,158
973,330000,02aab221aabc03b9,2,0,745,1150,1124,1121,1210,1486,1568,1439,1239,1136,1024,1529,1276,1230,505,-112,617
238,420000,02aab221aabc03b9,2,0,166,276,286,265,300,346,383,407,272,273,274,370,322,306,96,1,95
186,430000,02aab221aabc03b9,2,0,113,209,229,207,229,257,270,285,213,205,215,305,260,242,90,10,80
242,350000,02aab221aabc03b9,2,0,187,331,340,375,354,394,437,448,353,321,324,518,421,388,194,3,191
205,210000,02aab221aabc03b9,2,0,150,206,234,226,254,291,346,299,229,207,174,292,233,224,118,-33,151
199,500000,02aab221aabc03b9,2,0,140,226,204,204,232,259,222,255,197,217,217,267,242,234,50,0,50
151,610000,02aab221aabc03b9,2,0,145,192,213,288,241,238,319,283,263,205,197,285,241,229,88,-8,96
68,230000,02aab221aabc03b9,2,0,46,74,80,87,80,75,119,71,81,63,53,93,73,70,40,-10,50
160,310000,5d7fb682edd0f937,2,0,164,397,283,308,272,297,303,281,281,247,225,315,270,262,90,-22,112
108,530000,5d7fb682edd0f937,2,0,89,159,143,175,143,190,187,165,167,133,176,164,170,158,-12,43,-55
62,150000,5d7fb682edd0f937,2,0,51,91,82,115,109,112,117,120,96,85,86,86,86,86,0,1,-1
190,110000,5d7fb682edd0f937,2,0,232,428,353,385,362,331,427,429,308,324,417,323,370,355,-94,93,-187
166,510000,5d7fb682edd0f937,2,0,224,376,344,382,380,359,376,389,305,301,337,483,410,374,146,36,110
119,340000,5d7fb682edd0f937,2,0,119,169,162,175,187,156,227,205,162,169,174,188,181,177,14,5,9
160,370000,5d7fb682edd0f937,2,0,185,290,276,307,309,263,302,292,265,227,253,339,296,273,86,26,60
56,140000,5d7fb682edd0f937,2,0,50,77,59,95,91,82,103,99,83,81,91,111,101,94,20,10,10
314,440000,5d7fb682edd0f937,2,0,212,629,501,543,522,480,565,575,462,510,512,581,546,534,69,2,67
57,450000,5d7fb682edd0f937,2,0,67,86,103,113,124,96,117,108,102,103,109,128,118,113,19,6,13
456,320000,5d7fb682edd0f937,2,0,478,831,673,752,698,733,823,757,642,661,734,807,770,734,73,73,0
79,360000,5d7fb682edd0f937,2,0,65,143,134,157,139,120,153,155,115,129,138,165,152,144,27,9,18
126,130000,5d7fb682edd0f937,2,0,109,201,188,230,197,195,219,226,184,180,178,203,190,187,25,-2,27
103,410000,5d7fb682edd0f937,2,0,105,163,205,180,189,189,186,187,161,189,173,186,180,183,13,-16,29
382,330000,5d7fb682edd0f937,2,0,473,696,636,660,565,645,709,620,587,599,595,656,626,617,61,-4,65
142,420000,5d7fb682edd0f937,2,0,151,282,230,266,292,242,319,331,219,258,266,270,268,265,4,8,-4
114,430000,5d7fb682edd0f937,2,0,96,191,206,200,169,164,219,179,160,168,191,210,200,190,19,23,-4
127,350000,5d7fb682edd0f937,2,0,129,246,219,230,256,240,260,259,202,201,205,241,223,216,36,4,32
90,210000,5d7fb682edd0f937,2,0,84,157,166,150,154,152,161,165,130,138,128,140,134,135,12,-10,22
54,500000,5d7fb682edd0f937,2,0,74,152,134,144,142,148,158,109,123,106,134,131,132,124,-3,28,-31
85,610000,5d7fb682edd0f937,2,0,115,156,163,199,168,161,205,192,172,135,145,159,152,146,14,10,4
34,230000,5d7fb682edd0f937,2,0,45,84,72,91,70,67,99,74,50,53,61,68,64,61,7,8,-1
424,310000,a207df29ec9583f0,2,0,276,461,355,455,551,438,559,478,428,493,474,835,654,601,361,-19,380
178,530000,a207df29ec9583f0,2,0,96,197,123,203,222,190,240,237,204,210,215,310,262,245,95,5,90
87,150000,a207df29ec9583f0,2,0,55,85,62,91,81,74,115,91,72,82,74,139,106,98,65,-8,73
648,110000,a207df29ec9583f0,2,0,419,597,509,573,717,674,824,853,604,747,817,1033,925,866,216,70,146
383,510000,a207df29ec9583f0,2,0,265,377,334,442,494,344,458,388,382,361,382,695,538,479,313,21,292
152,340000,a207df29ec9583f0,2,0,113,164,138,167,188,148,226,228,183,176,177,354,266,236,177,1,176
328,370000,a207df29ec9583f0,2,0,221,286,259,291,346,365,453,344,338,348,336,608,472,431,272,-12,284
96,140000,a207df29ec9583f0,2,0,51,78,95,88,102,105,108,108,84,93,100,165,132,119,65,7,58
690,440000,a207df29ec9583f0,2,0,299,866,560,678,769,689,886,875,627,766,825,1178,1002,923,353,59,294
106,450000,a207df29ec9583f0,2,0,44,91,57,97,100,90,105,124,72,100,114,160,137,125,46,14,32
766,320000,a207df29ec9583f0,2,0,575,787,801,890,962,857,1124,918,791,915,1007,1591,1299,1171,584,92,492
115,360000,a207df29ec9583f0,2,0,57,129,99,112,125,115,140,155,101,129,108,227,168,155,119,-21,140
209,130000,a207df29ec9583f0,2,0,131,173,183,199,229,221,266,200,202,203,219,376,298,266,157,16,141
201,410000,a207df29ec9583f0,2,0,145,193,185,185,207,254,276,252,194,283,262,357,310,301,95,-21,116
623,330000,a207df29ec9583f0,2,0,438,716,641,723,810,824,880,834,733,849,908,1436,1172,1064,528,59,469
202,420000,a207df29ec9583f0,2,0,130,265,212,243,260,260,327,326,230,315,356,436,396,369,80,41,39
179,430000,a207df29ec9583f0,2,0,71,152,121,164,200,157,190,184,143,174,192,302,247,223,110,18,92
212,350000,a207df29ec9583f0,2,0,119,238,208,225,265,234,296,266,197,227,256,500,378,328,244,29,215
176,210000,a207df29ec9583f0,2,0,145,170,172,190,254,215,281,225,176,194,227,304,266,242,77,33,44
152,500000,a207df29ec9583f0,2,0,113,138,114,168,164,192,184,176,151,174,194,265,230,211,71,20,51
140,610000,a207df29ec9583f0,2,0,141,184,186,174,206,235,213,228,210,194,216,307,262,239,91,22,69
84,230000,a207df29ec9583f0,2,0,52,69,62,72,97,59,106,77,74,83,85,102,94,90,17,2,15
97,310000,b4be3a4917289c82,2,0,90,185,166,151,149,152,203,190,188,201,262,80,171,181,-182,61,-243
35,530000,b4be3a4917289c82,2,0,23,65,81,86,43,35,60,52,76,100,59,26,42,62,-33,-41,8
17,150000,b4be3a4917289c82,2,0,20,44,34,38,23,35,33,31,42,40,37,22,30,33,-15,-3,-12
117,110000,b4be3a4917289c82,2,0,106,251,267,259,192,172,203,232,200,230,226,93,160,183,-133,-4,-129
76,510000,b4be3a4917289c82,2,0,100,155,124,131,94,121,152,216,166,240,223,57,140,173,-166,-17,-149
59,340000,b4be3a4917289c82,2,0,58,93,91,91,85,90,104,106,110,130,121,57,89,103,-64,-9,-55
137,370000,b4be3a4917289c82,2,0,97,238,273,264,203,199,232,258,215,231,199,113,156,181,-86,-32,-54
10,140000,b4be3a4917289c82,2,0,17,30,23,35,28,32,37,31,31,28,33,16,24,26,-17,5,-22
115,440000,b4be3a4917289c82,2,0,83,239,207,253,209,182,223,290,309,396,384,120,252,300,-264,-12,-252
18,450000,b4be3a4917289c82,2,0,18,29,21,31,23,25,29,35,34,41,40,20,30,34,-20,-1,-19
325,320000,b4be3a4917289c82,2,0,314,442,327,438,345,389,471,447,420,635,591,225,408,484,-366,-44,-322
18,360000,b4be3a4917289c82,2,0,29,37,44,50,31,41,43,50,52,66,85,10,48,54,-75,19,-94
99,130000,b4be3a4917289c82,2,0,87,128,105,161,119,127,130,145,141,166,161,78,120,135,-83,-5,-78
77,410000,b4be3a4917289c82,2,0,59,126,107,118,88,93,86,118,117,128,163,57,110,116,-106,35,-141
290,330000,b4be3a4917289c82,2,0,270,423,431,415,297,361,382,415,422,523,567,168,368,419,-399,44,-443
54,420000,b4be3a4917289c82,2,0,58,96,72,86,72,79,106,110,92,120,142,48,95,103,-94,22,-116
43,430000,b4be3a4917289c82,2,0,38,74,84,62,48,45,64,96,79,112,124,41,82,92,-83,12,-95
28,350000,b4be3a4917289c82,2,0,35,60,68,83,59,50,84,61,85,108,127,23,75,86,-104,19,-123
38,210000,b4be3a4917289c82,2,0,51,101,79,77,61,82,88,87,77,106,83,28,56,72,-55,-23,-32
20,500000,b4be3a4917289c82,2,0,28,40,35,34,28,26,35,47,43,77,67,17,42,54,-50,-10,-40
52,610000,b4be3a4917289c82,2,0,35,72,77,99,52,57,82,79,83,68,82,41,62,64,-41,14,-55
18,230000,b4be3a4917289c82,2,0,36,71,63,68,50,44,61,42,40,48,45,18,32,37,-27,-3,-24
283,310000,ef76a85c4b39f693,2,0,285,625,493,512,736,581,360,145,129,306,492,378,435,392,-114,186,-300
101,530000,ef76a85c4b39f693,2,0,144,215,224,243,237,221,153,83,75,142,154,140,147,145,-14,12,-26
79,150000,ef76a85c4b39f693,2,0,85,133,133,164,131,165,105,47,48,67,109,121,115,99,12,42,-30
299,110000,ef76a85c4b39f693,2,0,303,713,701,789,881,663,502,321,175,311,576,511,544,466,-65,265,-330
291,510000,ef76a85c4b39f693,2,0,397,598,495,600,609,554,488,356,206,340,526,495,510,454,-31,186,-217
148,340000,ef76a85c4b39f693,2,0,181,295,315,306,319,309,208,104,111,219,307,304,306,277,-3,88,-91
284,370000,ef76a85c4b39f693,2,0,326,543,643,668,672,573,446,246,241,312,378,406,392,365,28,66,-38
61,140000,ef76a85c4b39f693,2,0,91,129,126,145,145,138,80,47,46,58,83,94,88,78,11,25,-14
355,440000,ef76a85c4b39f693,2,0,191,803,692,927,973,869,740,398,282,593,912,598,755,701,-314,319,-633
33,450000,ef76a85c4b39f693,2,0,51,92,69,104,120,85,95,39,30,50,68,74,71,64,6,18,-12
652,320000,ef76a85c4b39f693,2,0,705,1330,1133,1369,1500,1116,610,270,351,609,1028,993,1010,877,-35,419,-454
69,360000,ef76a85c4b39f693,2,0,111,177,180,188,194,175,130,47,59,107,208,200,204,172,-8,101,-109
250,130000,ef76a85c4b39f693,2,0,274,446,396,489,506,429,351,172,141,298,340,342,341,327,2,42,-40
184,410000,ef76a85c4b39f693,2,0,194,359,443,350,442,406,206,143,136,170,239,290,264,233,51,69,-18
708,330000,ef76a85c4b39f693,2,0,893,1531,1481,1596,1826,1257,815,643,498,965,1300,996,1148,1087,-304,335,-639
134,420000,ef76a85c4b39f693,2,0,186,290,320,331,346,286,253,116,101,212,331,334,332,292,3,119,-116
146,430000,ef76a85c4b39f693,2,0,183,302,305,370,344,325,229,78,92,180,310,284,297,258,-26,130,-156
97,350000,ef76a85c4b39f693,2,0,100,249,210,345,285,288,200,69,95,138,176,229,202,181,53,38,15
190,210000,ef76a85c4b39f693,2,0,174,359,364,390,459,433,291,193,157,189,261,256,258,235,-5,72,-77
82,500000,ef76a85c4b39f693,2,0,111,157,161,172,225,158,135,51,35,76,157,115,136,116,-42,81,-123
136,610000,ef76a85c4b39f693,2,0,163,253,275,312,315,249,241,115,96,127,205,223,214,185,18,78,-60
92,230000,ef76a85c4b39f693,2,0,153,325,234,241,211,111,123,58,56,108,145,104,124,119,-41,37,-78
214,310000,bb9fbec9a2833839,2,0,161,390,364,320,327,408,528,494,298,341,507,266,386,371,-241,166,-407
99,530000,bb9fbec9a2833839,2,0,126,173,191,127,108,198,213,197,180,169,225,142,184,179,-83,56,-139
74,150000,bb9fbec9a2833839,2,0,83,156,132,135,136,178,178,174,157,121,169,76,122,122,-93,48,-141
170,110000,bb9fbec9a2833839,2,0,187,418,394,364,332,388,450,529,355,417,450,177,314,348,-273,33,-306
224,510000,bb9fbec9a2833839,2,0,292,385,337,371,406,440,533,641,403,433,394,242,318,356,-152,-39,-113
139,340000,bb9fbec9a2833839,2,0,133,230,208,185,223,244,297,328,172,256,310,160,235,242,-150,54,-204
251,370000,bb9fbec9a2833839,2,0,238,402,377,302,378,352,487,582,453,469,507,305,406,427,-202,38,-240
43,140000,bb9fbec9a2833839,2,0,77,141,107,116,114,132,168,143,117,124,97,55,76,92,-42,-27,-15
271,440000,bb9fbec9a2833839,2,0,200,616,587,591,684,704,813,867,710,821,895,435,665,717,-460,74,-534
66,450000,bb9fbec9a2833839,2,0,77,129,95,81,120,108,129,137,85,114,124,79,102,106,-45,10,-55
589,320000,bb9fbec9a2833839,2,0,510,885,789,826,854,952,1272,1166,688,937,1154,552,853,881,-602,217,-819
91,360000,bb9fbec9a2833839,2,0,99,172,121,144,151,183,202,193,186,189,178,106,142,158,-72,-11,-61
188,130000,bb9fbec9a2833839,2,0,170,325,291,244,275,310,427,423,324,327,378,179,278,295,-199,51,-250
143,410000,bb9fbec9a2833839,2,0,161,241,351,217,257,301,336,420,237,276,308,156,232,247,-152,32,-184
543,330000,bb9fbec9a2833839,2,0,537,1058,811,816,971,1162,1196,1045,917,1072,1169,550,860,930,-619,97,-716
177,420000,bb9fbec9a2833839,2,0,173,366,272,236,352,315,395,429,270,308,378,261,320,316,-117,70,-187
129,430000,bb9fbec9a2833839,2,0,132,288,231,235,286,268,360,359,193,226,309,145,227,227,-164,83,-247
110,350000,bb9fbec9a2833839,2,0,107,228,247,214,238,244,281,263,253,214,293,168,230,225,-125,79,-204
85,210000,bb9fbec9a2833839,2,0,110,199,192,184,149,191,241,242,174,177,213,86,150,159,-127,36,-163
59,500000,bb9fbec9a2833839,2,0,62,91,84,83,135,121,146,128,96,89,130,65,98,95,-65,41,-106
81,610000,bb9fbec9a2833839,2,0,76,153,141,143,148,200,229,215,165,164,174,112,143,150,-62,10,-72
40,230000,bb9fbec9a2833839,2,0,83,190,96,96,121,92,130,140,82,95,85,44,64,75,-41,-10,-31
251,310000,da457d15788fe8ee,2,0,224,524,428,462,576,421,521,504,402,593,748,538,643,626,-210,155,-365
166,530000,da457d15788fe8ee,2,0,173,285,234,259,204,306,266,231,316,323,344,263,304,310,-81,21,-102
109,150000,da457d15788fe8ee,2,0,106,139,167,203,169,162,217,201,207,206,200,197,198,201,-3,-6,3
424,110000,da457d15788fe8ee,2,0,395,929,887,986,1008,845,898,731,715,939,1050,755,902,915,-295,111,-406
348,510000,da457d15788fe8ee,2,0,418,657,632,753,748,554,658,1072,583,560,641,624,632,608,-17,81,-98
200,340000,da457d15788fe8ee,2,0,151,261,270,316,300,257,346,329,282,331,409,330,370,357,-79,78,-157
309,370000,da457d15788fe8ee,2,0,383,514,607,578,623,481,543,678,438,630,646,659,652,645,13,16,-3
44,140000,da457d15788fe8ee,2,0,83,103,127,142,127,114,155,143,139,142,103,120,112,122,17,-39,56
499,440000,da457d15788fe8ee,2,0,325,1013,985,1219,1303,1074,1237,1342,1295,1408,1829,1269,1549,1502,-560,421,-981
82,450000,da457d15788fe8ee,2,0,70,170,96,158,161,124,125,189,162,142,255,213,234,203,-42,113,-155
649,320000,da457d15788fe8ee,2,0,635,1034,965,1031,1078,842,1106,1255,1040,1108,1430,1304,1367,1281,-126,322,-448
85,360000,da457d15788fe8ee,2,0,105,194,206,264,228,177,230,275,218,275,247,282,264,268,35,-28,63
254,130000,da457d15788fe8ee,2,0,205,365,330,420,442,396,476,471,407,417,527,425,476,456,-102,110,-212
251,410000,da457d15788fe8ee,2,0,240,352,404,359,472,400,422,469,405,382,502,442,472,442,-60,120,-180
567,330000,da457d15788fe8ee,2,0,585,1059,1028,1051,1251,1000,1181,1241,932,1214,1500,938,1219,1217,-562,286,-848
259,420000,da457d15788fe8ee,2,0,243,406,406,395,467,358,427,529,447,473,526,572,549,524,46,53,-7
207,430000,da457d15788fe8ee,2,0,204,413,420,443,451,322,451,476,369,391,505,374,440,423,-131,114,-245
144,350000,da457d15788fe8ee,2,0,140,232,234,345,272,282,266,282,298,320,358,335,346,338,-23,38,-61
156,210000,da457d15788fe8ee,2,0,232,362,315,405,340,365,459,418,357,335,454,281,368,357,-173,119,-292
108,500000,da457d15788fe8ee,2,0,121,206,221,225,291,189,230,259,188,209,244,199,222,217,-45,35,-80
174,610000,da457d15788fe8ee,2,0,168,242,253,346,302,281,312,352,366,242,346,325,336,304,-21,104,-125
94,230000,da457d15788fe8ee,2,0,130,276,201,264,224,175,240,219,123,190,198,139,168,176,-59,8,-67
384,310000,6858d6dfe680bdf7,2,0,306,722,679,634,547,444,607,438,357,513,576,543,560,544,-33,63,-96
199,530000,6858d6dfe680bdf7,2,0,151,279,225,250,183,177,213,139,117,236,257,243,250,245,-14,21,-35
43,150000,6858d6dfe680bdf7,2,0,26,82,69,87,52,46,43,47,37,60,80,54,67,65,-26,20,-46
311,110000,6858d6dfe680bdf7,2,0,262,673,614,681,595,494,449,410,328,585,816,536,676,646,-280,231,-511
337,510000,6858d6dfe680bdf7,2,0,275,561,619,591,569,444,445,455,290,447,593,591,592,544,-2,146,-148
230,340000,6858d6dfe680bdf7,2,0,174,315,300,376,284,251,265,236,233,275,385,322,354,327,-63,110,-173
289,370000,6858d6dfe680bdf7,2,0,202,484,554,521,386,382,358,297,285,401,440,468,454,436,28,39,-11
64,140000,6858d6dfe680bdf7,2,0,35,81,62,68,61,45,60,31,30,61,103,57,80,74,-46,42,-88
618,440000,6858d6dfe680bdf7,2,0,316,1135,1224,1221,1023,972,1033,800,773,983,1319,1274,1296,1192,-45,336,-381
84,450000,6858d6dfe680bdf7,2,0,61,151,132,140,110,112,99,93,94,126,167,115,141,136,-52,41,-93
919,320000,6858d6dfe680bdf7,2,0,611,1328,1233,1314,879,894,893,729,862,988,1160,1203,1182,1117,43,172,-129
89,360000,6858d6dfe680bdf7,2,0,72,178,202,203,160,175,134,144,96,129,200,185,192,171,-15,71,-86
232,130000,6858d6dfe680bdf7,2,0,131,280,289,334,287,249,266,194,192,281,283,417,350,327,134,2,132
224,410000,6858d6dfe680bdf7,2,0,144,309,370,322,315,276,272,209,174,237,350,258,304,282,-92,113,-205
1004,330000,6858d6dfe680bdf7,2,0,930,1725,1897,1719,1389,1189,1547,1208,929,1465,1724,1540,1632,1576,-184,259,-443
143,420000,6858d6dfe680bdf7,2,0,118,290,306,263,266,203,235,199,144,218,283,271,277,257,-12,65,-77
195,430000,6858d6dfe680bdf7,2,0,181,345,396,354,336,258,251,209,203,255,374,375,374,335,1,119,-118
161,350000,6858d6dfe680bdf7,2,0,139,298,266,319,252,323,276,236,214,251,346,352,349,316,6,95,-89
146,210000,6858d6dfe680bdf7,2,0,138,306,327,247,205,195,187,133,91,159,186,215,200,187,29,27,2
131,500000,6858d6dfe680bdf7,2,0,140,246,273,262,227,183,189,132,105,200,253,198,226,217,-55,53,-108
135,610000,6858d6dfe680bdf7,2,0,116,215,204,258,182,135,163,159,132,134,174,188,181,165,14,40,-26
44,230000,6858d6dfe680bdf7,2,0,38,108,94,88,66,52,57,23,28,58,76,70,73,68,-6,18,-24
136,310000,79de4e4b24c35b04,2,0,130,248,205,249,256,328,379,426,299,501,825,333,579,553,-492,324,-816
634,530000,79de4e4b24c35b04,2,0,715,584,517,594,552,695,707,913,926,928,1393,1050,1222,1124,-343,465,-808
132,150000,79de4e4b24c35b04,2,0,80,151,118,129,99,134,132,200,230,272,405,185,295,287,-220,133,-353
127,110000,79de4e4b24c35b04,2,0,174,284,352,376,194,240,313,370,330,446,852,178,515,492,-674,406,-1080
565,510000,79de4e4b24c35b04,2,0,971,753,633,599,569,778,755,971,792,934,1509,1063,1286,1169,-446,575,-1021
1072,340000,79de4e4b24c35b04,2,0,1583,836,765,835,790,1052,1349,1421,1263,1461,2601,1965,2283,2009,-636,1140,-1776
1598,370000,79de4e4b24c35b04,2,0,2065,1669,1567,2055,1628,2244,2677,2814,2975,3077,5360,2858,4109,3765,-2502,2283,-4785
396,140000,79de4e4b24c35b04,2,0,273,351,377,360,353,542,640,778,791,803,1442,701,1072,982,-741,639,-1380
1872,440000,79de4e4b24c35b04,2,0,1524,3366,2719,3307,2768,3295,4086,5098,5032,5800,8421,3465,5943,5895,-4956,2621,-7577
1510,450000,79de4e4b24c35b04,2,0,2862,2406,1619,1976,1690,1981,2497,3110,3025,3479,6171,2981,4576,4210,-3190,2692,-5882
1542,320000,79de4e4b24c35b04,2,0,1515,1369,1121,1352,1272,1577,1829,2045,1978,2153,3757,2028,2892,2646,-1729,1604,-3333
443,360000,79de4e4b24c35b04,2,0,578,516,412,417,410,598,635,806,703,736,1319,827,1073,961,-492,583,-1075
1047,130000,79de4e4b24c35b04,2,0,921,863,830,1060,888,1184,1505,1631,1500,1789,2863,1366,2114,2006,-1497,1074,-2571
2842,410000,79de4e4b24c35b04,2,0,3619,2609,2474,2930,3020,3796,4302,4617,4700,5194,9539,6024,7782,6919,-3515,4345,-7860
580,330000,79de4e4b24c35b04,2,0,626,867,616,852,799,1096,1291,1435,1528,1653,2646,934,1790,1744,-1712,993,-2705
521,420000,79de4e4b24c35b04,2,0,792,578,459,481,488,678,753,891,696,982,1629,1137,1383,1249,-492,647,-1139
771,430000,79de4e4b24c35b04,2,0,846,806,812,802,747,984,1113,1544,1234,1513,2352,1658,2005,1841,-694,839,-1533
316,350000,79de4e4b24c35b04,2,0,279,474,380,411,360,626,548,706,724,738,1086,453,770,759,-633,348,-981
313,210000,79de4e4b24c35b04,2,0,214,377,398,383,376,528,616,644,644,694,1039,408,724,714,-631,345,-976
210,500000,79de4e4b24c35b04,2,0,422,371,270,261,287,297,277,359,279,304,514,324,419,381,-190,210,-400
403,610000,79de4e4b24c35b04,2,0,433,412,456,460,358,538,648,785,855,1045,1704,937,1320,1229,-767,659,-1426
365,230000,79de4e4b24c35b04,2,0,292,439,350,475,475,643,791,839,638,832,1045,394,720,757,-651,213,-864
338,310000,12f8b7e14947c34d,2,0,432,848,740,785,835,1350,1065,2065,1032,1283,1483,389,936,1052,-1094,200,-1294
160,530000,12f8b7e14947c34d,2,0,240,292,229,244,208,404,346,402,396,360,567,208,388,378,-359,207,-566
215,150000,12f8b7e14947c34d,2,0,289,446,450,527,415,569,575,712,648,698,789,413,601,633,-376,91,-467
102,110000,12f8b7e14947c34d,2,0,219,346,342,374,346,429,397,451,276,389,488,143,316,340,-345,99,-444
374,510000,12f8b7e14947c34d,2,0,594,746,756,677,695,682,820,1286,786,820,1117,531,824,823,-586,297,-883
198,340000,12f8b7e14947c34d,2,0,322,351,363,414,357,477,644,726,594,615,705,385,545,568,-320,90,-410
424,370000,12f8b7e14947c34d,2,0,844,1400,1356,1271,1075,1292,1454,1777,1435,1352,1707,803,1255,1287,-904,355,-1259
87,140000,12f8b7e14947c34d,2,0,139,326,295,376,259,310,346,391,347,352,464,131,298,316,-333,112,-445
117,440000,12f8b7e14947c34d,2,0,70,223,205,277,296,248,286,326,342,407,475,130,302,337,-345,68,-413
43,450000,12f8b7e14947c34d,2,0,114,135,110,154,153,106,135,181,167,158,231,93,162,161,-138,73,-211
782,320000,12f8b7e14947c34d,2,0,1375,2036,1589,1718,1504,1598,2024,2099,1880,1868,2181,991,1586,1680,-1190,313,-1503
128,360000,12f8b7e14947c34d,2,0,227,332,338,384,268,290,349,532,430,438,495,251,373,395,-244,57,-301
360,130000,12f8b7e14947c34d,2,0,526,697,668,745,713,769,1026,1153,782,978,1229,546,888,918,-683,251,-934
259,410000,12f8b7e14947c34d,2,0,432,507,691,656,595,849,951,954,750,835,1053,508,780,799,-545,218,-763
291,330000,12f8b7e14947c34d,2,0,476,727,703,696,655,723,773,920,884,1063,1213,348,780,875,-865,150,-1015
80,420000,12f8b7e14947c34d,2,0,168,248,264,212,303,273,340,406,336,358,440,200,320,333,-240,82,-322
150,430000,12f8b7e14947c34d,2,0,271,375,384,428,388,473,550,688,528,670,749,385,567,601,-364,79,-443
136,350000,12f8b7e14947c34d,2,0,170,319,281,308,207,297,275,314,302,385,408,188,298,327,-220,23,-243
54,210000,12f8b7e14947c34d,2,0,103,162,132,162,151,156,254,246,156,195,210,53,132,153,-157,15,-172
85,500000,12f8b7e14947c34d,2,0,110,142,161,182,218,192,205,240,178,181,295,131,213,202,-164,114,-278
280,610000,12f8b7e14947c34d,2,0,510,777,772,950,666,1062,1276,1109,958,1012,1286,412,849,903,-874,274,-1148
80,230000,12f8b7e14947c34d,2,0,157,262,257,265,200,199,236,256,202,210,228,66,147,168,-162,18,-180
175,310000,04e66e578f653ab9,2,0,191,341,301,229,293,265,342,422,337,524,679,950,814,718,271,155,116
118,530000,04e66e578f653ab9,2,0,23,57,93,77,88,123,129,142,173,215,293,131,212,213,-162,78,-240
38,150000,04e66e578f653ab9,2,0,20,43,68,68,57,63,80,87,94,102,118,60,89,93,-58,16,-74
87,110000,04e66e578f653ab9,2,0,57,160,141,144,157,165,158,241,166,231,280,180,230,230,-100,49,-149
140,510000,04e66e578f653ab9,2,0,80,119,165,176,134,135,208,419,226,291,404,151,278,282,-253,113,-366
64,340000,04e66e578f653ab9,2,0,32,69,84,82,105,84,146,172,127,176,201,116,158,164,-85,25,-110
146,370000,04e66e578f653ab9,2,0,87,288,336,249,208,207,253,405,274,383,451,230,340,355,-221,68,-289
23,140000,04e66e578f653ab9,2,0,21,25,37,54,47,58,68,104,75,85,95,42,68,74,-53,10,-63
54,440000,04e66e578f653ab9,2,0,21,94,95,114,119,105,149,140,175,225,268,104,186,199,-164,43,-207
28,450000,04e66e578f653ab9,2,0,19,28,27,26,35,28,43,42,39,42,71,30,50,48,-41,29,-70
279,320000,04e66e578f653ab9,2,0,167,319,322,305,326,286,477,566,501,644,669,334,502,549,-335,25,-360
32,360000,04e66e578f653ab9,2,0,25,53,46,68,55,61,72,97,83,104,86,64,75,85,-22,-18,-4
97,130000,04e66e578f653ab9,2,0,50,125,133,124,117,113,185,186,192,206,272,140,206,206,-132,66,-198
90,410000,04e66e578f653ab9,2,0,57,78,115,86,115,109,191,156,169,219,319,144,232,227,-175,100,-275
120,330000,04e66e578f653ab9,2,0,62,153,241,174,199,216,262,293,289,400,452,190,321,347,-262,52,-314
33,420000,04e66e578f653ab9,2,0,17,36,44,55,47,45,58,71,47,81,82,146,114,103,64,1,63
59,430000,04e66e578f653ab9,2,0,44,96,96,123,93,121,118,158,115,135,228,105,166,156,-123,93,-216
43,350000,04e66e578f653ab9,2,0,32,69,44,77,80,72,82,93,107,132,139,77,108,116,-62,7,-69
40,210000,04e66e578f653ab9,2,0,14,35,39,48,22,42,64,69,52,62,81,42,62,62,-39,19,-58
31,500000,04e66e578f653ab9,2,0,14,28,31,19,68,61,42,66,46,77,87,44,66,69,-43,10,-53
83,610000,04e66e578f653ab9,2,0,45,125,134,132,92,109,169,208,170,201,238,124,181,188,-114,37,-151
17,230000,04e66e578f653ab9,2,0,14,33,46,45,30,38,60,45,45,56,48,22,35,42,-26,-8,-18
124,310000,dff803b4024d261d,2,0,119,239,228,169,138,110,96,130,129,206,317,238,278,254,-79,111,-190
55,530000,dff803b4024d261d,2,0,51,78,75,180,62,53,48,150,68,61,94,64,79,73,-30,33,-63
58,150000,dff803b4024d261d,2,0,54,113,86,107,104,115,80,59,69,77,114,119,116,103,5,37,-32
303,110000,dff803b4024d261d,2,0,190,502,679,1478,362,522,549,341,411,466,954,488,721,636,-466,488,-954
212,510000,dff803b4024d261d,2,0,362,298,337,329,313,287,213,226,219,270,560,493,526,441,-67,290,-357
108,340000,dff803b4024d261d,2,0,151,173,287,132,112,137,105,226,131,164,192,238,215,198,46,28,18
352,370000,dff803b4024d261d,2,0,229,452,634,622,583,483,376,451,391,462,714,609,662,595,-105,252,-357
75,140000,dff803b4024d261d,2,0,106,160,138,173,121,88,87,81,104,152,230,168,199,183,-62,78,-140
554,440000,dff803b4024d261d,2,0,446,1134,1049,1151,1204,796,688,783,887,1988,1893,1283,1588,1721,-610,-95,-515
132,450000,dff803b4024d261d,2,0,172,287,232,292,302,238,333,211,167,204,333,316,324,284,-17,129,-146
520,320000,dff803b4024d261d,2,0,528,715,817,757,633,614,701,409,489,602,865,785,825,751,-80,263,-343
100,360000,dff803b4024d261d,2,0,130,160,214,361,199,120,104,272,168,194,280,264,272,246,-16,86,-102
248,130000,dff803b4024d261d,2,0,156,276,257,299,271,278,358,279,275,250,454,387,420,364,-67,204,-271
141,410000,dff803b4024d261d,2,0,134,161,254,201,225,287,201,184,168,191,300,319,310,270,19,109,-90
391,330000,dff803b4024d261d,2,0,387,571,611,676,536,359,406,355,572,795,787,577,682,720,-210,-8,-202
193,420000,dff803b4024d261d,2,0,280,556,499,394,422,178,222,287,394,374,566,545,556,495,-21,192,-213
410,430000,dff803b4024d261d,2,0,189,281,349,524,267,270,181,332,203,423,412,412,412,416,0,-11,11
242,350000,dff803b4024d261d,2,0,172,320,297,502,255,324,353,331,397,363,562,555,558,493,-7,199,-206
163,210000,dff803b4024d261d,2,0,169,322,331,310,263,240,234,219,239,228,340,230,285,266,-110,112,-222
203,500000,dff803b4024d261d,2,0,201,377,423,567,467,292,184,281,158,348,846,378,612,524,-468,498,-966
68,610000,dff803b4024d261d,2,0,51,99,165,127,82,202,64,63,62,99,126,138,132,121,12,27,-15
72,230000,dff803b4024d261d,2,0,67,124,102,107,81,71,56,91,46,89,107,57,82,84,-50,18,-68
140,310000,61e73e32ad101892,2,0,172,381,276,268,259,263,265,263,222,276,374,264,319,305,-110,98,-208
246,530000,61e73e32ad101892,2,0,233,291,288,287,259,444,328,322,420,444,423,403,413,423,-20,-21,1
251,150000,61e73e32ad101892,2,0,191,345,439,598,415,527,467,541,608,505,619,534,576,553,-85,114,-199
459,110000,61e73e32ad101892,2,0,334,863,864,925,776,823,803,1019,845,1016,1441,741,1091,1066,-700,425,-1125
507,510000,61e73e32ad101892,2,0,708,697,804,780,668,723,668,1080,712,743,1078,940,1009,920,-138,335,-473
107,340000,61e73e32ad101892,2,0,148,191,191,212,209,143,177,210,217,212,273,247,260,244,-26,61,-87
350,370000,61e73e32ad101892,2,0,229,560,823,816,666,592,643,866,764,681,1011,688,850,793,-323,330,-653
115,140000,61e73e32ad101892,2,0,110,206,261,279,232,228,276,283,280,288,348,274,311,303,-74,60,-134
777,440000,61e73e32ad101892,2,0,557,1603,1334,1757,1676,1516,1456,1686,2097,2144,2562,1849,2206,2185,-713,418,-1131
194,450000,61e73e32ad101892,2,0,173,357,308,368,312,289,221,333,376,342,443,364,404,383,-79,101,-180
425,320000,61e73e32ad101892,2,0,397,732,642,720,594,521,656,670,713,682,857,658,758,732,-199,175,-374
121,360000,61e73e32ad101892,2,0,183,215,284,272,228,226,207,304,324,277,382,334,358,331,-48,105,-153
407,130000,61e73e32ad101892,2,0,350,512,623,789,655,636,756,829,875,790,1042,804,923,879,-238,252,-490
303,410000,61e73e32ad101892,2,0,314,442,561,418,478,457,520,525,514,567,656,654,655,626,-2,89,-91
338,330000,61e73e32ad101892,2,0,397,692,688,672,696,609,628,658,707,687,970,632,801,763,-338,283,-621
526,420000,61e73e32ad101892,2,0,607,1019,976,969,1189,812,879,1194,1234,1296,1458,1429,1444,1394,-29,162,-191
262,430000,61e73e32ad101892,2,0,324,451,527,529,432,433,504,586,532,579,879,712,796,723,-167,300,-467
223,350000,61e73e32ad101892,2,0,200,378,320,437,254,309,324,331,423,388,523,387,455,433,-136,135,-271
424,210000,61e73e32ad101892,2,0,379,785,855,952,717,778,859,919,871,786,1105,571,838,821,-534,319,-853
327,500000,61e73e32ad101892,2,0,319,482,469,390,863,400,378,452,406,568,732,616,674,639,-116,164,-280
288,610000,61e73e32ad101892,2,0,204,415,526,586,401,428,429,480,618,464,618,561,590,548,-57,154,-211
165,230000,61e73e32ad101892,2,0,172,403,364,391,379,393,463,364,346,348,497,267,382,371,-230,149,-379
37,310000,a432c483b5beb856,2,0,74,148,107,138,95,119,125,135,111,242,237,68,152,182,-169,-5,-164
100,530000,a432c483b5beb856,2,0,101,116,126,123,110,141,143,170,165,182,271,140,206,198,-131,89,-220
54,150000,a432c483b5beb856,2,0,94,127,130,150,140,118,135,135,144,149,195,78,136,141,-117,46,-163
44,110000,a432c483b5beb856,2,0,94,161,133,142,156,136,151,163,97,128,205,34,120,122,-171,77,-248
186,510000,a432c483b5beb856,2,0,440,394,366,331,297,273,290,355,284,276,560,275,418,370,-285,284,-569
109,340000,a432c483b5beb856,2,0,185,162,134,155,164,187,210,258,234,289,496,209,352,331,-287,207,-494
156,370000,a432c483b5beb856,2,0,264,365,376,429,398,297,370,455,430,397,599,241,420,412,-358,202,-560
52,140000,a432c483b5beb856,2,0,124,155,134,191,136,138,154,165,187,192,226,67,146,162,-159,34,-193
290,440000,a432c483b5beb856,2,0,467,1001,803,902,957,908,969,966,1096,1273,1753,510,1132,1179,-1243,480,-1723
76,450000,a432c483b5beb856,2,0,158,173,112,150,145,121,133,163,183,209,314,161,238,228,-153,105,-258
399,320000,a432c483b5beb856,2,0,533,542,500,626,524,494,659,663,720,808,1176,484,830,823,-692,368,-1060
99,360000,a432c483b5beb856,2,0,227,159,167,200,179,156,182,243,282,281,556,258,407,365,-298,275,-573
126,130000,a432c483b5beb856,2,0,201,227,222,334,278,240,275,311,284,290,435,164,300,296,-271,145,-416
130,410000,a432c483b5beb856,2,0,268,207,216,293,353,273,313,316,283,364,562,252,407,393,-310,198,-508
255,330000,a432c483b5beb856,2,0,426,580,534,604,578,536,581,660,738,799,1102,332,717,744,-770,303,-1073
110,420000,a432c483b5beb856,2,0,248,298,272,226,274,204,230,271,257,362,526,267,396,385,-259,164,-423
115,430000,a432c483b5beb856,2,0,212,198,189,225,184,208,271,292,260,313,627,286,456,409,-341,314,-655
128,350000,a432c483b5beb856,2,0,191,273,232,272,218,246,274,282,315,340,500,185,342,342,-315,160,-475
86,210000,a432c483b5beb856,2,0,252,378,382,339,300,311,310,311,260,209,299,101,200,203,-198,90,-288
87,500000,a432c483b5beb856,2,0,182,208,200,174,215,160,199,165,151,159,317,179,248,218,-138,158,-296
58,610000,a432c483b5beb856,2,0,74,107,132,119,143,116,126,114,163,141,242,89,166,157,-153,101,-254
44,230000,a432c483b5beb856,2,0,91,139,139,154,146,135,155,139,103,121,126,60,93,102,-66,5,-71
135,310000,0797526c057dcf5b,2,0,125,152,176,401,401,321,346,427,336,1289,571,175,373,678,-396,-718,322
154,530000,0797526c057dcf5b,2,0,106,125,149,202,186,247,218,226,257,285,393,160,276,279,-233,108,-341
164,150000,0797526c057dcf5b,2,0,102,151,182,235,185,198,218,291,326,339,631,236,434,402,-395,292,-687
253,110000,0797526c057dcf5b,2,0,106,458,579,619,663,697,743,797,664,656,980,232,606,623,-748,324,-1072
478,510000,0797526c057dcf5b,2,0,517,383,511,577,808,786,904,1230,923,1016,1536,609,1072,1054,-927,520,-1447
257,340000,0797526c057dcf5b,2,0,168,141,183,258,304,319,476,565,666,550,750,358,554,553,-392,200,-592
1203,370000,0797526c057dcf5b,2,0,846,1159,1838,2095,1935,1835,2200,2915,3148,3502,5481,1788,3634,3590,-3693,1979,-5672
371,140000,0797526c057dcf5b,2,0,276,388,385,544,496,521,585,792,899,919,1474,502,988,965,-972,555,-1527
3718,440000,0797526c057dcf5b,2,0,2322,6681,6500,8617,8587,8085,9999,11167,12710,12394,15317,5306,10312,11006,-10011,2923,-12934
777,450000,0797526c057dcf5b,2,0,509,777,650,933,1046,1010,1186,1639,1709,1789,2693,1195,1944,1892,-1498,904,-2402
1529,320000,0797526c057dcf5b,2,0,775,917,1039,1356,1362,1273,1726,2274,2226,2622,3296,1247,2272,2388,-2049,674,-2723
484,360000,0797526c057dcf5b,2,0,298,301,380,537,595,606,715,1083,1277,1265,1764,857,1310,1295,-907,499,-1406
995,130000,0797526c057dcf5b,2,0,607,575,834,1174,1117,1091,1516,1988,2221,2449,3796,1214,2505,2486,-2582,1347,-3929
848,410000,0797526c057dcf5b,2,0,766,966,1035,851,918,1151,1553,1783,1739,1951,3130,1278,2204,2120,-1852,1179,-3031
801,330000,0797526c057dcf5b,2,0,268,670,888,1084,1050,1140,1443,1709,2001,2019,2088,700,1394,1602,-1388,69,-1457
376,420000,0797526c057dcf5b,2,0,283,464,568,585,851,689,870,1071,1120,1425,1562,736,1149,1241,-826,137,-963
677,430000,0797526c057dcf5b,2,0,826,1099,1123,1343,1265,1384,1668,1721,1444,1769,3168,1244,2206,2060,-1924,1399,-3323
598,350000,0797526c057dcf5b,2,0,324,743,748,1047,978,991,1227,1477,1846,1591,1981,769,1375,1447,-1212,390,-1602
1132,210000,0797526c057dcf5b,2,0,1130,2185,2416,2738,2351,2715,3298,3035,2443,2622,3705,1059,2382,2462,-2646,1083,-3729
235,500000,0797526c057dcf5b,2,0,134,130,208,307,592,510,660,624,494,548,828,333,580,570,-495,280,-775
175,610000,0797526c057dcf5b,2,0,91,148,246,335,408,480,451,462,457,402,722,289,506,471,-433,320,-753
347,230000,0797526c057dcf5b,2,0,195,290,315,472,426,421,630,651,605,913,1064,350,707,776,-714,151,-865
161,310000,936168bd4850913d,2,0,124,267,256,231,232,275,253,330,234,241,272,250,261,254,-22,31,-53
162,530000,936168bd4850913d,2,0,150,218,222,273,237,317,281,288,285,282,383,494,438,386,111,101,10
213,150000,936168bd4850913d,2,0,145,261,297,409,278,346,325,397,353,331,374,412,393,372,38,43,-5
255,110000,936168bd4850913d,2,0,169,385,428,423,454,541,459,651,432,527,798,336,567,554,-462,271,-733
198,510000,936168bd4850913d,2,0,255,328,404,345,365,374,356,560,353,364,502,560,531,475,58,138,-80
228,340000,936168bd4850913d,2,0,224,248,311,364,321,347,370,464,369,339,449,378,414,389,-71,110,-181
648,370000,936168bd4850913d,2,0,436,794,1159,1092,1036,1063,896,1347,1014,1020,1083,1132,1108,1078,49,63,-14
276,140000,936168bd4850913d,2,0,163,407,327,404,319,311,334,462,394,347,454,373,414,391,-81,107,-188
1337,440000,936168bd4850913d,2,0,894,2297,2056,2432,2474,2478,2391,3040,2810,2842,3119,2859,2989,2940,-260,277,-537
154,450000,936168bd4850913d,2,0,114,277,228,279,260,273,237,346,287,279,316,376,346,324,60,37,23
579,320000,936168bd4850913d,2,0,503,864,875,944,898,914,919,1153,908,905,1057,1012,1034,991,-45,152,-197
195,360000,936168bd4850913d,2,0,183,259,334,387,321,370,350,407,325,334,414,397,406,382,-17,80,-97
602,130000,936168bd4850913d,2,0,304,529,645,721,619,623,691,837,696,646,778,797,788,740,19,132,-113
596,410000,936168bd4850913d,2,0,524,743,938,870,860,976,801,1165,786,979,1154,954,1054,1029,-200,175,-375
388,330000,936168bd4850913d,2,0,336,591,647,679,619,746,631,767,611,709,819,752,786,760,-67,110,-177
549,420000,936168bd4850913d,2,0,713,1120,1091,1131,1321,1289,1127,1463,1111,1292,1497,1405,1451,1398,-92,205,-297
341,430000,936168bd4850913d,2,0,371,605,681,762,693,656,726,776,563,649,953,623,788,742,-330,304,-634
347,350000,936168bd4850913d,2,0,264,561,623,627,554,655,558,641,586,610,611,627,619,616,16,1,15
485,210000,936168bd4850913d,2,0,348,596,668,714,579,727,667,816,696,727,851,758,804,779,-93,124,-217
87,500000,936168bd4850913d,2,0,106,151,162,139,215,222,181,222,152,145,208,248,228,200,40,63,-23
229,610000,936168bd4850913d,2,0,150,307,362,418,335,362,360,429,415,400,482,463,472,448,-19,82,-101
346,230000,936168bd4850913d,2,0,233,643,636,673,545,503,567,621,450,630,549,617,583,599,68,-81,149
153,310000,cc21c7e91a3b5a0c,2,0,193,307,268,271,242,256,281,287,238,345,456,114,285,305,-342,111,-453
203,530000,cc21c7e91a3b5a0c,2,0,184,287,277,288,270,381,345,327,285,338,442,406,424,395,-36,104,-140
193,150000,cc21c7e91a3b5a0c,2,0,130,221,205,287,238,235,267,246,282,331,382,195,288,303,-187,51,-238
115,110000,cc21c7e91a3b5a0c,2,0,124,239,243,275,251,253,208,303,262,356,580,121,350,352,-459,224,-683
234,510000,cc21c7e91a3b5a0c,2,0,303,495,459,461,461,453,451,636,487,569,804,459,632,611,-345,235,-580
244,340000,cc21c7e91a3b5a0c,2,0,276,362,355,346,364,377,400,439,428,489,503,403,453,465,-100,14,-114
505,370000,cc21c7e91a3b5a0c,2,0,424,741,891,877,768,778,692,815,855,912,1164,554,859,877,-610,252,-862
193,140000,cc21c7e91a3b5a0c,2,0,131,274,256,316,230,226,277,310,284,316,428,223,326,322,-205,112,-317
1262,440000,cc21c7e91a3b5a0c,2,0,1092,2312,2006,2367,2317,2288,2219,2478,2450,3345,3730,1930,2830,3002,-1800,385,-2185
187,450000,cc21c7e91a3b5a0c,2,0,164,296,226,316,262,277,270,290,313,377,417,266,342,353,-151,40,-191
754,320000,cc21c7e91a3b5a0c,2,0,663,1174,1098,1171,1053,1035,1139,1193,1114,1454,1527,877,1202,1286,-650,73,-723
161,360000,cc21c7e91a3b5a0c,2,0,179,286,283,344,324,354,314,340,317,350,507,305,406,387,-202,157,-359
434,130000,cc21c7e91a3b5a0c,2,0,276,466,466,575,563,517,521,590,551,574,797,453,625,608,-344,223,-567
391,410000,cc21c7e91a3b5a0c,2,0,387,631,701,609,620,657,647,687,548,872,1036,630,833,846,-406,164,-570
529,330000,cc21c7e91a3b5a0c,2,0,560,868,916,952,851,928,863,800,942,1151,1258,739,998,1049,-519,107,-626
454,420000,cc21c7e91a3b5a0c,2,0,649,859,860,857,1022,954,876,1065,918,1189,1511,963,1237,1221,-548,322,-870
189,430000,cc21c7e91a3b5a0c,2,0,265,432,418,440,412,436,456,456,452,506,737,420,578,554,-317,231,-548
353,350000,cc21c7e91a3b5a0c,2,0,320,585,524,634,509,574,525,556,643,734,779,473,626,662,-306,45,-351
241,210000,cc21c7e91a3b5a0c,2,0,229,394,433,415,359,423,434,437,390,480,602,285,444,456,-317,122,-439
95,500000,cc21c7e91a3b5a0c,2,0,111,154,208,153,256,232,218,203,186,200,305,185,245,230,-120,105,-225
157,610000,cc21c7e91a3b5a0c,2,0,159,255,282,291,238,303,301,293,309,345,496,293,394,378,-203,151,-354
206,230000,cc21c7e91a3b5a0c,2,0,238,410,348,422,361,360,329,347,306,404,422,214,318,347,-208,18,-226
140,310000,7aab7fca2470987e,2,0,127,288,255,249,227,228,228,248,166,277,348,224,286,283,-124,71,-195
19,530000,7aab7fca2470987e,2,0,18,26,19,19,13,29,23,22,12,22,33,19,26,25,-14,11,-25
19,150000,7aab7fca2470987e,2,0,9,22,31,32,22,34,26,20,16,19,22,21,22,21,-1,3,-4
244,110000,7aab7fca2470987e,2,0,155,342,385,371,412,397,450,433,353,372,511,424,468,436,-87,139,-226
42,510000,7aab7fca2470987e,2,0,28,61,40,41,50,45,33,53,34,42,64,69,66,58,5,22,-17
59,340000,7aab7fca2470987e,2,0,58,96,94,77,54,58,60,65,52,74,75,83,79,77,8,1,7
189,370000,7aab7fca2470987e,2,0,131,279,291,321,323,323,300,349,309,286,341,430,386,352,89,55,34
64,140000,7aab7fca2470987e,2,0,47,101,97,85,61,83,86,76,58,62,78,105,92,82,27,16,11
443,440000,7aab7fca2470987e,2,0,320,938,782,929,824,845,827,959,887,972,1235,1009,1122,1072,-226,263,-489
17,450000,7aab7fca2470987e,2,0,19,27,25,33,22,15,35,23,23,13,26,34,30,24,8,13,-5
258,320000,7aab7fca2470987e,2,0,239,397,361,372,366,390,384,352,323,380,481,397,439,419,-84,101,-185
16,360000,7aab7fca2470987e,2,0,21,43,45,28,35,34,41,44,29,35,37,61,49,44,24,2,22
172,130000,7aab7fca2470987e,2,0,115,209,215,221,251,231,259,229,234,231,316,308,312,285,-8,85,-93
134,410000,7aab7fca2470987e,2,0,117,183,203,189,186,204,209,192,150,188,209,242,226,213,33,21,12
222,330000,7aab7fca2470987e,2,0,167,351,324,279,263,302,300,252,293,323,375,353,364,350,-22,52,-74
47,420000,7aab7fca2470987e,2,0,33,64,65,48,56,41,58,58,26,64,62,54,58,60,-8,-2,-6
26,430000,7aab7fca2470987e,2,0,26,45,53,33,37,54,26,47,25,31,44,54,49,43,10,13,-3
41,350000,7aab7fca2470987e,2,0,36,100,71,65,63,56,64,42,57,83,105,92,98,93,-13,22,-35
103,210000,7aab7fca2470987e,2,0,88,143,201,173,177,170,176,181,127,153,187,158,172,166,-29,34,-63
12,500000,7aab7fca2470987e,2,0,15,27,25,16,43,25,22,19,17,12,27,22,24,20,-5,15,-20
16,610000,7aab7fca2470987e,2,0,15,29,33,50,39,32,34,19,25,29,46,61,54,45,15,17,-2
41,230000,7aab7fca2470987e,2,0,40,94,92,117,107,90,78,77,62,61,65,66,66,64,1,4,-3
142,310000,fde95ea242abd896,2,0,143,279,297,244,231,222,233,237,260,331,369,161,265,287,-208,38,-246
202,530000,fde95ea242abd896,2,0,236,312,304,293,280,397,351,388,519,521,651,386,518,519,-265,130,-395
90,150000,fde95ea242abd896,2,0,96,126,103,173,112,115,149,181,185,190,234,146,190,190,-88,44,-132
141,110000,fde95ea242abd896,2,0,149,302,248,267,240,223,271,313,223,301,382,210,296,298,-172,81,-253
240,510000,fde95ea242abd896,2,0,310,417,389,401,386,408,384,645,492,617,839,509,674,655,-330,222,-552
163,340000,fde95ea242abd896,2,0,255,336,313,328,323,371,429,508,453,504,690,387,538,527,-303,186,-489
303,370000,fde95ea242abd896,2,0,296,546,625,677,569,603,642,825,774,709,964,444,704,706,-520,255,-775
132,140000,fde95ea242abd896,2,0,136,255,277,268,247,194,300,278,277,302,443,175,309,307,-268,141,-409
1517,440000,fde95ea242abd896,2,0,1286,3265,2736,3407,3034,2769,3466,3967,4449,4901,5547,3229,4388,4559,-2318,646,-2964
181,450000,fde95ea242abd896,2,0,241,394,300,323,305,295,375,362,434,458,665,381,523,501,-284,207,-491
508,320000,fde95ea242abd896,2,0,551,920,905,886,740,767,910,875,888,974,1139,690,914,934,-449,165,-614
184,360000,fde95ea242abd896,2,0,221,252,298,296,306,326,283,440,408,499,625,381,503,502,-244,126,-370
320,130000,fde95ea242abd896,2,0,281,454,470,518,437,434,560,591,602,602,830,407,618,613,-423,228,-651
247,410000,fde95ea242abd896,2,0,307,448,487,451,445,414,574,666,620,614,920,507,714,680,-413,306,-719
558,330000,fde95ea242abd896,2,0,648,939,1038,954,959,917,968,1148,998,1169,1424,732,1078,1108,-692,255,-947
270,420000,fde95ea242abd896,2,0,481,744,646,667,730,629,764,987,818,1066,1347,698,1022,1037,-649,281,-930
203,430000,fde95ea242abd896,2,0,381,522,540,567,522,526,503,752,630,700,988,570,779,753,-418,288,-706
368,350000,fde95ea242abd896,2,0,277,559,556,633,509,603,671,676,754,796,1043,605,824,815,-438,247,-685
193,210000,fde95ea242abd896,2,0,201,457,514,445,435,473,472,553,433,460,600,253,426,438,-347,140,-487
105,500000,fde95ea242abd896,2,0,124,155,208,157,246,168,172,243,227,222,229,139,184,197,-90,7,-97
96,610000,fde95ea242abd896,2,0,60,111,120,179,148,148,164,191,253,229,293,140,216,221,-153,64,-217
123,230000,fde95ea242abd896,2,0,126,319,331,309,255,234,372,256,198,199,322,111,216,211,-211,123,-334
193,310000,97f15de12cfabbd5,2,0,113,123,139,212,242,279,368,455,354,457,516,264,390,412,-252,59,-311
111,530000,97f15de12cfabbd5,2,0,94,88,54,90,69,134,137,168,236,233,253,206,230,231,-47,20,-67
114,150000,97f15de12cfabbd5,2,0,91,148,111,161,112,170,148,180,212,200,238,219,228,219,-19,38,-57
390,110000,97f15de12cfabbd5,2,0,279,489,419,541,572,614,704,733,603,754,1094,601,848,816,-493,340,-833
237,510000,97f15de12cfabbd5,2,0,287,296,215,215,241,286,280,498,363,489,543,391,467,474,-152,54,-206
153,340000,97f15de12cfabbd5,2,0,244,200,168,222,253,319,361,472,444,568,578,495,536,547,-83,10,-93
476,370000,97f15de12cfabbd5,2,0,373,450,449,644,594,653,771,1001,1018,1094,1221,1031,1126,1115,-190,127,-317
221,140000,97f15de12cfabbd5,2,0,250,187,190,307,319,310,398,381,370,395,605,316,460,439,-289,210,-499
1125,440000,97f15de12cfabbd5,2,0,739,2169,1283,1775,1807,1926,2292,2762,3019,3563,3747,2666,3206,3325,-1081,184,-1265
92,450000,97f15de12cfabbd5,2,0,76,105,85,131,107,105,132,134,146,194,174,193,184,187,19,-20,39
552,320000,97f15de12cfabbd5,2,0,669,776,574,791,789,884,1139,1155,1292,1491,1524,1070,1297,1362,-454,33,-487
81,360000,97f15de12cfabbd5,2,0,139,153,127,135,142,163,206,280,258,340,409,346,378,365,-63,69,-132
422,130000,97f15de12cfabbd5,2,0,454,423,400,560,621,573,819,812,975,971,1119,789,954,960,-330,148,-478
326,410000,97f15de12cfabbd5,2,0,364,326,261,356,378,472,519,592,609,805,866,692,779,788,-174,61,-235
549,330000,97f15de12cfabbd5,2,0,629,657,569,729,797,1116,1100,1259,1371,1516,1515,1138,1326,1390,-377,-1,-376
253,420000,97f15de12cfabbd5,2,0,373,597,355,306,462,346,475,707,729,779,906,749,828,811,-157,127,-284
238,430000,97f15de12cfabbd5,2,0,356,437,344,400,350,381,419,626,645,767,839,710,774,772,-129,72,-201
288,350000,97f15de12cfabbd5,2,0,185,292,182,309,251,400,389,434,571,612,638,509,574,586,-129,26,-155
506,210000,97f15de12cfabbd5,2,0,442,556,678,921,843,1057,1068,1256,1020,1269,1395,898,1146,1187,-497,126,-623
106,500000,97f15de12cfabbd5,2,0,174,192,141,164,243,183,190,183,170,200,213,159,186,191,-54,13,-67
159,610000,97f15de12cfabbd5,2,0,89,158,121,222,212,278,246,251,273,309,371,227,299,302,-144,62,-206
217,230000,97f15de12cfabbd5,2,0,230,238,301,459,440,381,659,536,422,639,783,366,574,596,-417,144,-561
125,310000,f5d69960089c3614,2,0,94,200,200,179,143,213,231,263,186,304,291,260,276,285,-31,-13,-18
48,530000,f5d69960089c3614,2,0,27,35,27,47,40,86,70,45,62,97,95,78,86,90,-17,-2,-15
18,150000,f5d69960089c3614,2,0,18,65,39,59,30,34,48,53,57,54,64,35,50,51,-29,10,-39
233,110000,f5d69960089c3614,2,0,209,530,530,580,328,387,431,542,458,551,739,435,587,575,-304,188,-492
133,510000,f5d69960089c3614,2,0,120,157,199,189,198,208,192,406,218,246,296,270,283,271,-26,50,-76
59,340000,f5d69960089c3614,2,0,55,65,66,77,68,83,102,108,119,125,125,156,140,135,31,0,31
112,370000,f5d69960089c3614,2,0,101,152,215,226,189,211,236,259,209,228,356,218,287,267,-138,128,-266
21,140000,f5d69960089c3614,2,0,13,35,31,34,37,39,38,29,27,53,51,47,49,50,-4,-2,-2
152,440000,f5d69960089c3614,2,0,85,279,264,290,315,201,283,319,341,442,572,437,504,484,-135,130,-265
34,450000,f5d69960089c3614,2,0,18,33,39,40,44,25,47,48,35,38,46,44,45,43,-2,8,-10
138,320000,f5d69960089c3614,2,0,120,177,166,199,160,179,202,235,218,248,301,251,276,267,-50,53,-103
32,360000,f5d69960089c3614,2,0,47,60,46,67,46,43,63,74,57,75,92,84,88,84,-8,17,-25
79,130000,f5d69960089c3614,2,0,47,72,82,94,85,75,106,81,95,123,131,106,118,120,-25,8,-33
57,410000,f5d69960089c3614,2,0,70,115,177,146,115,120,133,136,137,144,187,131,159,154,-56,43,-99
78,330000,f5d69960089c3614,2,0,40,101,105,120,103,117,123,127,129,149,230,149,190,176,-81,81,-162
61,420000,f5d69960089c3614,2,0,68,95,105,133,83,100,88,128,132,148,184,148,166,160,-36,36,-72
74,430000,f5d69960089c3614,2,0,67,111,119,132,99,113,129,125,121,157,211,135,173,168,-76,54,-130
57,350000,f5d69960089c3614,2,0,34,75,68,110,85,91,79,63,93,111,124,108,116,114,-16,13,-29
51,210000,f5d69960089c3614,2,0,37,96,78,114,94,86,129,93,93,126,129,69,99,108,-60,3,-63
77,500000,f5d69960089c3614,2,0,64,107,106,102,141,124,91,113,105,132,160,125,142,139,-35,28,-63
77,610000,f5d69960089c3614,2,0,50,104,117,132,93,101,114,118,176,150,182,148,165,160,-34,32,-66
34,230000,f5d69960089c3614,2,0,27,72,66,58,77,51,83,64,44,71,77,53,65,67,-24,6,-30
85,310000,5b1c11c3efed5312,2,0,83,137,166,137,100,120,182,195,186,244,388,154,271,262,-234,144,-378
91,530000,5b1c11c3efed5312,2,0,123,160,138,155,102,132,175,199,190,214,267,194,230,225,-73,53,-126
62,150000,5b1c11c3efed5312,2,0,72,109,113,123,90,86,129,117,180,167,259,127,193,184,-132,92,-224
41,110000,5b1c11c3efed5312,2,0,84,168,157,135,132,124,189,195,143,181,370,71,220,207,-299,189,-488
194,510000,5b1c11c3efed5312,2,0,306,341,347,268,235,259,271,451,335,432,691,448,570,524,-243,259,-502
250,340000,5b1c11c3efed5312,2,0,409,428,406,511,409,457,615,665,719,699,1253,712,982,888,-541,554,-1095
320,370000,5b1c11c3efed5312,2,0,368,553,712,759,542,525,598,799,850,792,1449,549,999,930,-900,657,-1557
81,140000,5b1c11c3efed5312,2,0,114,172,156,184,119,112,180,176,226,231,426,153,290,270,-273,195,-468
168,440000,5b1c11c3efed5312,2,0,146,505,439,656,557,570,682,810,953,1204,1628,496,1062,1109,-1132,424,-1556
56,450000,5b1c11c3efed5312,2,0,82,128,93,99,74,74,93,96,119,135,240,121,180,165,-119,105,-224
543,320000,5b1c11c3efed5312,2,0,617,835,685,815,558,664,879,928,1050,1083,1908,768,1338,1253,-1140,825,-1965
153,360000,5b1c11c3efed5312,2,0,175,250,275,290,238,256,256,368,358,434,733,453,593,540,-280,299,-579
272,130000,5b1c11c3efed5312,2,0,345,481,442,541,372,433,513,576,665,667,1158,476,817,767,-682,491,-1173
372,410000,5b1c11c3efed5312,2,0,511,612,706,670,565,604,728,823,894,1006,1883,910,1396,1266,-973,877,-1850
430,330000,5b1c11c3efed5312,2,0,570,741,745,772,623,618,806,968,1022,1202,2202,744,1473,1383,-1458,1000,-2458
143,420000,5b1c11c3efed5312,2,0,200,249,254,222,214,224,236,278,353,409,749,443,596,534,-306,340,-646
131,430000,5b1c11c3efed5312,2,0,190,262,282,299,206,221,263,352,322,439,744,378,561,520,-366,305,-671
149,350000,5b1c11c3efed5312,2,0,106,251,186,224,163,185,197,242,345,391,594,265,430,417,-329,203,-532
62,210000,5b1c11c3efed5312,2,0,102,164,167,172,127,118,166,151,176,186,256,75,166,172,-181,70,-251
38,500000,5b1c11c3efed5312,2,0,69,103,86,60,103,92,81,101,86,92,172,124,148,129,-48,80,-128
79,610000,5b1c11c3efed5312,2,0,120,165,166,180,107,108,126,155,205,212,325,144,234,227,-181,113,-294
36,230000,5b1c11c3efed5312,2,0,68,172,142,116,90,66,138,116,107,126,152,43,98,107,-109,26,-135
19,310000,17363f08d683d52b,2,0,39,67,57,61,83,70,93,94,69,88,96,65,80,83,-31,8,-39
75,530000,17363f08d683d52b,2,0,206,157,153,150,145,260,181,192,214,209,182,216,199,202,34,-27,61
46,150000,17363f08d683d52b,2,0,111,103,103,189,132,152,130,174,176,130,141,132,136,134,-9,11,-20
81,110000,17363f08d683d52b,2,0,162,255,224,215,203,267,229,259,158,186,277,124,200,196,-153,91,-244
117,510000,17363f08d683d52b,2,0,379,249,251,265,277,338,249,374,267,205,292,350,321,282,58,87,-29
121,340000,17363f08d683d52b,2,0,370,259,261,334,403,369,409,407,332,341,384,513,448,413,129,43,86
214,370000,17363f08d683d52b,2,0,329,460,477,501,534,578,578,669,572,480,596,555,576,544,-41,116,-157
26,140000,17363f08d683d52b,2,0,48,88,53,84,72,80,105,82,89,70,67,66,66,68,-1,-3,2
19,440000,17363f08d683d52b,2,0,58,174,189,205,161,153,130,99,91,101,84,62,73,82,-22,-17,-5
14,450000,17363f08d683d52b,2,0,68,55,61,65,56,59,47,57,42,39,50,45,48,45,-5,11,-16
214,320000,17363f08d683d52b,2,0,474,501,391,511,498,540,652,534,502,474,569,538,554,527,-31,95,-126
94,360000,17363f08d683d52b,2,0,234,206,222,322,296,334,361,423,281,274,309,360,334,314,51,35,16
154,130000,17363f08d683d52b,2,0,302,326,300,423,331,415,474,378,372,326,383,353,368,354,-30,57,-87
139,410000,17363f08d683d52b,2,0,438,344,433,458,439,537,516,505,471,372,457,538,498,456,81,85,-4
129,330000,17363f08d683d52b,2,0,474,480,439,481,523,527,619,525,437,429,453,388,420,423,-65,24,-89
120,420000,17363f08d683d52b,2,0,291,253,287,274,347,357,348,470,379,317,421,474,448,404,53,104,-51
95,430000,17363f08d683d52b,2,0,263,271,267,285,332,369,394,455,353,348,428,459,444,412,31,80,-49
38,350000,17363f08d683d52b,2,0,89,110,105,117,97,156,140,150,148,127,159,136,148,141,-23,32,-55
59,210000,17363f08d683d52b,2,0,139,206,190,224,186,211,236,239,216,174,238,151,194,188,-87,64,-151
41,500000,17363f08d683d52b,2,0,173,118,113,119,207,154,160,119,108,151,126,110,118,129,-16,-25,9
80,610000,17363f08d683d52b,2,0,167,172,200,295,195,243,241,219,279,210,288,180,234,226,-108,78,-186
46,230000,17363f08d683d52b,2,0,65,155,112,155,119,135,185,126,121,118,156,75,116,116,-81,38,-119
78,310000,06880909932890ca,2,0,36,140,123,151,184,200,260,330,188,341,384,208,296,311,-176,43,-219
56,530000,06880909932890ca,2,0,89,97,87,116,115,160,152,177,216,186,206,142,174,178,-64,20,-84
44,150000,06880909932890ca,2,0,53,68,89,116,92,95,118,103,121,125,115,74,94,105,-41,-10,-31
139,110000,06880909932890ca,2,0,197,494,429,502,404,587,598,646,461,553,771,253,512,526,-518,218,-736
263,510000,06880909932890ca,2,0,423,370,360,435,525,529,541,770,548,657,933,673,803,754,-260,276,-536
338,340000,06880909932890ca,2,0,500,410,494,668,812,815,909,849,800,764,993,964,978,907,-29,229,-258
383,370000,06880909932890ca,2,0,526,689,772,912,798,955,1028,1068,979,957,1332,1011,1172,1100,-321,375,-696
67,140000,06880909932890ca,2,0,89,124,155,182,158,166,260,200,213,203,275,128,202,202,-147,72,-219
278,440000,06880909932890ca,2,0,150,692,651,912,826,970,1165,1341,1182,1660,1546,767,1156,1324,-779,-114,-665
86,450000,06880909932890ca,2,0,123,132,118,154,160,138,192,192,181,188,276,186,231,217,-90,88,-178
991,320000,06880909932890ca,2,0,1169,1437,1322,1690,1549,1784,2086,2054,2015,2022,2642,2094,2368,2253,-548,620,-1168
157,360000,06880909932890ca,2,0,225,275,317,446,403,446,466,481,368,453,691,614,652,586,-77,238,-315
290,130000,06880909932890ca,2,0,433,527,489,571,550,679,797,728,665,667,773,530,652,657,-243,106,-349
640,410000,06880909932890ca,2,0,769,741,998,1156,1405,1588,1680,1676,1390,1577,2409,1865,2137,1950,-544,832,-1376
501,330000,06880909932890ca,2,0,826,1017,1000,1198,1267,1405,1649,1572,1696,1832,2222,1022,1622,1692,-1200,390,-1590
178,420000,06880909932890ca,2,0,267,322,336,378,470,475,562,525,475,492,661,605,633,586,-56,169,-225
170,430000,06880909932890ca,2,0,259,348,380,383,445,414,541,561,481,547,698,488,593,578,-210,151,-361
197,350000,06880909932890ca,2,0,124,232,228,311,284,350,418,427,469,556,601,361,481,506,-240,45,-285
100,210000,06880909932890ca,2,0,111,190,228,287,226,287,309,335,246,211,328,161,244,233,-167,117,-284
140,500000,06880909932890ca,2,0,254,176,207,287,447,415,439,445,330,373,430,326,378,376,-104,57,-161
119,610000,06880909932890ca,2,0,170,252,248,336,278,349,407,350,449,347,562,349,456,419,-213,215,-428
37,230000,06880909932890ca,2,0,58,136,101,109,89,128,149,133,82,97,100,69,84,89,-31,3,-34
19,310000,9c1c7ee8ebdda299,2,0,12,45,21,27,22,13,27,10,4,41,46,32,39,40,-14,5,-19
104,530000,9c1c7ee8ebdda299,2,0,230,170,165,176,148,181,200,159,126,119,169,142,156,143,-27,50,-77
168,150000,9c1c7ee8ebdda299,2,0,264,295,260,348,233,350,323,327,297,353,430,278,354,354,-152,77,-229
38,110000,9c1c7ee8ebdda299,2,0,107,230,173,167,151,170,121,96,46,78,112,52,82,81,-60,34,-94
336,510000,9c1c7ee8ebdda299,2,0,976,914,753,701,834,869,836,723,408,517,641,617,629,592,-24,124,-148
146,340000,9c1c7ee8ebdda299,2,0,352,281,292,330,322,293,261,211,71,198,190,278,234,222,88,-8,96
885,370000,9c1c7ee8ebdda299,2,0,1881,1411,1514,1697,1542,1763,1885,1782,1445,1562,2281,1763,2022,1869,-518,719,-1237
295,140000,9c1c7ee8ebdda299,2,0,559,695,566,798,670,854,973,842,579,768,886,691,788,782,-195,118,-313
229,440000,9c1c7ee8ebdda299,2,0,337,851,657,797,730,793,791,821,619,710,1008,472,740,730,-536,298,-834
110,450000,9c1c7ee8ebdda299,2,0,213,235,139,170,190,169,185,191,132,192,308,251,280,250,-57,116,-173
299,320000,9c1c7ee8ebdda299,2,0,409,368,309,295,297,299,267,195,95,307,309,370,340,329,61,2,59
84,360000,9c1c7ee8ebdda299,2,0,297,223,225,303,258,215,138,145,60,177,182,224,203,194,42,5,37
940,130000,9c1c7ee8ebdda299,2,0,2024,1679,1513,1845,1547,1898,2125,1949,1092,1644,1840,1468,1654,1651,-372,196,-568
433,410000,9c1c7ee8ebdda299,2,0,1096,746,823,772,817,797,693,546,306,774,911,1101,1006,929,190,137,53
197,330000,9c1c7ee8ebdda299,2,0,250,257,215,232,213,216,202,149,42,380,352,327,340,353,-25,-28,3
58,420000,9c1c7ee8ebdda299,2,0,155,165,159,138,172,121,123,100,46,116,125,211,168,151,86,9,77
105,430000,9c1c7ee8ebdda299,2,0,201,197,204,204,207,195,142,140,74,141,165,230,198,179,65,24,41
105,350000,9c1c7ee8ebdda299,2,0,135,327,238,254,259,254,219,159,110,281,215,204,210,233,-11,-66,55
317,210000,9c1c7ee8ebdda299,2,0,315,497,548,622,615,791,715,654,384,528,619,375,497,507,-244,91,-335
61,500000,9c1c7ee8ebdda299,2,0,139,127,140,142,167,210,170,119,62,80,104,116,110,100,12,24,-12
108,610000,9c1c7ee8ebdda299,2,0,279,325,347,415,360,504,331,168,145,214,250,261,256,242,11,36,-25
144,230000,9c1c7ee8ebdda299,2,0,228,325,312,349,289,307,328,302,291,350,342,207,274,300,-135,-8,-127
80,310000,c6833cb891626c17,2,0,64,143,153,184,190,187,321,371,283,435,596,174,385,402,-422,161,-583
236,530000,c6833cb891626c17,2,0,120,243,214,293,278,391,368,477,514,538,699,444,572,560,-255,161,-416
94,150000,c6833cb891626c17,2,0,95,150,144,231,182,278,328,337,354,323,485,221,353,343,-264,162,-426
174,110000,c6833cb891626c17,2,0,249,424,446,557,512,616,785,877,636,879,1517,309,913,902,-1208,638,-1846
339,510000,c6833cb891626c17,2,0,359,385,442,498,519,553,602,1020,712,770,1305,743,1024,939,-562,535,-1097
344,340000,c6833cb891626c17,2,0,254,335,430,556,596,658,834,1066,894,964,1597,855,1226,1139,-742,633,-1375
383,370000,c6833cb891626c17,2,0,380,583,765,851,801,793,998,1278,1160,1107,1740,687,1214,1178,-1053,633,-1686
100,140000,c6833cb891626c17,2,0,106,151,162,214,187,206,301,280,282,301,514,192,353,336,-322,213,-535
186,440000,c6833cb891626c17,2,0,149,614,549,687,668,710,890,1382,1240,1586,1899,542,1220,1342,-1357,313,-1670
96,450000,c6833cb891626c17,2,0,107,187,136,186,226,201,232,277,266,309,514,260,387,361,-254,205,-459
574,320000,c6833cb891626c17,2,0,523,808,744,993,872,955,1345,1406,1396,1446,2279,939,1609,1555,-1340,833,-2173
180,360000,c6833cb891626c17,2,0,121,209,241,288,279,356,409,638,519,571,900,502,701,658,-398,329,-727
414,130000,c6833cb891626c17,2,0,350,577,540,727,602,725,929,1066,990,1108,1749,708,1228,1188,-1041,641,-1682
509,410000,c6833cb891626c17,2,0,439,612,886,926,1021,1208,1438,1525,1493,1622,2735,1331,2033,1896,-1404,1113,-2517
581,330000,c6833cb891626c17,2,0,598,832,846,1069,1144,1284,1635,1804,1911,2130,3255,1119,2187,2168,-2136,1125,-3261
202,420000,c6833cb891626c17,2,0,187,282,287,324,375,419,485,678,560,634,1014,597,806,748,-417,380,-797
212,430000,c6833cb891626c17,2,0,169,301,351,355,332,374,473,712,546,606,978,498,738,694,-480,372,-852
141,350000,c6833cb891626c17,2,0,110,226,228,280,250,238,291,406,499,552,782,311,546,548,-471,230,-701
80,210000,c6833cb891626c17,2,0,117,255,208,243,206,229,283,315,299,258,424,127,276,270,-297,166,-463
104,500000,c6833cb891626c17,2,0,131,137,183,177,223,193,277,336,267,309,532,260,396,367,-272,223,-495
130,610000,c6833cb891626c17,2,0,175,215,218,355,227,253,326,373,472,366,620,315,468,434,-305,254,-559
52,230000,c6833cb891626c17,2,0,119,192,157,191,155,137,237,206,170,232,274,80,177,195,-194,42,-236
177,310000,3e21824be728cbec,2,0,167,243,160,176,192,187,249,257,239,345,396,369,382,370,-27,51,-78
134,530000,3e21824be728cbec,2,0,231,291,200,206,289,300,344,358,406,373,334,203,268,303,-131,-39,-92
29,150000,3e21824be728cbec,2,0,39,69,59,78,58,65,160,123,116,59,90,51,70,67,-39,31,-70
60,110000,3e21824be728cbec,2,0,100,199,163,119,141,164,139,203,168,222,242,93,168,186,-149,20,-169
239,510000,3e21824be728cbec,2,0,448,557,450,413,455,488,625,731,758,778,781,288,534,616,-493,3,-496
266,340000,3e21824be728cbec,2,0,326,450,279,349,370,347,570,630,644,607,661,309,485,526,-352,54,-406
419,370000,3e21824be728cbec,2,0,460,731,616,559,584,576,690,772,807,782,994,540,767,772,-454,212,-666
44,140000,3e21824be728cbec,2,0,97,151,126,140,127,162,287,240,200,132,201,88,144,140,-113,69,-182
231,440000,3e21824be728cbec,2,0,198,606,453,438,526,486,516,619,721,938,1135,331,733,801,-804,197,-1001
92,450000,3e21824be728cbec,2,0,155,278,158,185,230,205,301,268,247,370,403,140,272,304,-263,33,-296
710,320000,3e21824be728cbec,2,0,1070,1579,700,765,791,837,1017,1020,1227,1286,1781,805,1293,1291,-976,495,-1471
97,360000,3e21824be728cbec,2,0,176,320,223,276,230,221,285,391,438,444,431,157,294,344,-274,-13,-261
375,130000,3e21824be728cbec,2,0,455,668,556,558,552,574,734,729,766,589,806,391,598,595,-415,217,-632
334,410000,3e21824be728cbec,2,0,475,738,578,632,668,840,854,777,834,729,896,363,630,663,-533,167,-700
386,330000,3e21824be728cbec,2,0,595,865,493,406,443,507,510,573,616,797,1044,341,692,727,-703,247,-950
123,420000,3e21824be728cbec,2,0,248,391,284,238,303,280,357,375,452,413,461,270,366,381,-191,48,-239
99,430000,3e21824be728cbec,2,0,210,341,224,235,250,255,292,394,414,458,478,157,318,364,-321,20,-341
154,350000,3e21824be728cbec,2,0,270,489,293,325,290,310,328,339,397,455,593,250,422,433,-343,138,-481
36,210000,3e21824be728cbec,2,0,84,145,108,118,118,139,151,144,114,136,149,45,97,110,-104,13,-117
124,500000,3e21824be728cbec,2,0,176,262,167,239,459,311,410,422,402,422,475,136,306,344,-339,53,-392
145,610000,3e21824be728cbec,2,0,231,280,319,382,320,375,494,446,595,355,464,194,329,338,-270,109,-379
47,230000,3e21824be728cbec,2,0,107,198,154,180,125,146,202,237,176,82,87,40,64,70,-47,5,-52
131,310000,f8a6975573af1b33,2,0,216,375,266,306,267,258,427,420,355,228,579,371,475,393,-208,351,-559
134,530000,f8a6975573af1b33,2,0,183,225,152,177,118,180,214,200,244,165,338,215,276,239,-123,173,-296
28,150000,f8a6975573af1b33,2,0,28,44,26,58,32,43,34,40,41,43,48,41,44,44,-7,5,-12
61,110000,f8a6975573af1b33,2,0,179,327,244,264,181,202,267,304,268,372,383,131,257,295,-252,11,-263
286,510000,f8a6975573af1b33,2,0,424,488,398,410,336,352,370,632,431,484,820,550,685,618,-270,336,-606
322,340000,f8a6975573af1b33,2,0,330,403,387,411,362,305,443,521,495,362,758,508,633,543,-250,396,-646
227,370000,f8a6975573af1b33,2,0,256,457,424,368,316,303,357,410,423,383,729,410,570,507,-319,346,-665
57,140000,f8a6975573af1b33,2,0,52,102,63,71,48,59,51,78,61,91,136,74,105,100,-62,45,-107
444,440000,f8a6975573af1b33,2,0,403,1121,875,992,904,879,1153,1298,1305,1034,2232,1023,1628,1430,-1209,1198,-2407
107,450000,f8a6975573af1b33,2,0,163,249,172,201,169,192,217,237,215,191,328,208,268,242,-120,137,-257
747,320000,f8a6975573af1b33,2,0,1033,1427,1017,1202,877,845,1153,1190,1239,807,1846,1142,1494,1265,-704,1039,-1743
111,360000,f8a6975573af1b33,2,0,162,249,182,202,165,177,232,306,226,131,436,290,363,286,-146,305,-451
194,130000,f8a6975573af1b33,2,0,224,327,290,285,257,243,316,360,308,272,475,287,381,345,-188,203,-391
249,410000,f8a6975573af1b33,2,0,364,491,439,424,404,405,509,554,543,420,747,459,603,542,-288,327,-615
503,330000,f8a6975573af1b33,2,0,681,993,723,767,644,614,743,824,856,695,1454,752,1103,967,-702,759,-1461
158,420000,f8a6975573af1b33,2,0,189,257,224,213,257,205,250,304,278,190,481,312,396,328,-169,291,-460
139,430000,f8a6975573af1b33,2,0,187,320,299,303,226,226,283,329,289,235,425,324,374,328,-101,190,-291
260,350000,f8a6975573af1b33,2,0,280,514,351,414,293,354,411,469,472,415,699,508,604,541,-191,284,-475
52,210000,f8a6975573af1b33,2,0,95,156,120,126,118,94,128,154,125,64,125,66,96,85,-59,61,-120
185,500000,f8a6975573af1b33,2,0,288,399,316,243,316,279,300,389,322,256,548,310,429,371,-238,292,-530
96,610000,f8a6975573af1b33,2,0,118,154,172,180,121,162,175,188,226,181,259,170,214,203,-89,78,-167
52,230000,f8a6975573af1b33,2,0,59,121,105,118,92,95,86,84,67,65,115,61,88,80,-54,50,-104
199,310000,54fc07138d70374c,2,0,227,439,284,312,308,315,327,336,292,421,473,415,444,436,-58,52,-110
259,530000,54fc07138d70374c,2,0,198,268,226,239,271,381,320,316,363,485,535,500,518,507,-35,50,-85
129,150000,54fc07138d70374c,2,0,91,159,124,177,198,210,230,224,233,229,234,273,254,245,39,5,34
295,110000,54fc07138d70374c,2,0,228,489,359,374,335,454,424,442,429,500,681,534,608,572,-147,181,-328
442,510000,54fc07138d70374c,2,0,346,509,498,454,508,557,495,659,704,743,849,933,891,842,84,106,-22
198,340000,54fc07138d70374c,2,0,177,226,184,207,204,219,249,314,271,334,368,404,386,369,36,34,2
376,370000,54fc07138d70374c,2,0,316,517,505,542,531,579,617,771,679,776,936,911,924,874,-25,160,-185
113,140000,54fc07138d70374c,2,0,97,155,129,125,128,113,131,135,142,208,244,213,228,222,-31,36,-67
521,440000,54fc07138d70374c,2,0,437,1193,876,978,1056,1120,1145,1408,1392,1836,2078,1526,1802,1813,-552,242,-794
145,450000,54fc07138d70374c,2,0,160,248,190,185,216,203,212,207,208,246,317,323,320,295,6,71,-65
461,320000,54fc07138d70374c,2,0,394,578,403,502,513,553,616,611,660,847,820,821,820,829,1,-27,28
113,360000,54fc07138d70374c,2,0,116,232,156,222,179,206,215,215,187,249,262,297,280,269,35,13,22
431,130000,54fc07138d70374c,2,0,298,398,396,448,411,475,528,576,625,746,750,758,754,751,8,4,4
447,410000,54fc07138d70374c,2,0,347,596,488,554,520,548,623,596,604,752,820,826,823,799,6,68,-62
252,330000,54fc07138d70374c,2,0,333,435,299,309,330,357,379,387,524,623,684,550,617,619,-134,61,-195
197,420000,54fc07138d70374c,2,0,179,291,252,255,280,268,311,346,310,385,425,481,453,430,56,40,16
239,430000,54fc07138d70374c,2,0,214,378,270,349,338,350,384,424,364,460,493,505,499,486,12,33,-21
163,350000,54fc07138d70374c,2,0,167,290,209,200,169,259,222,223,268,329,338,400,369,356,62,9,53
117,210000,54fc07138d70374c,2,0,154,305,230,303,292,281,324,364,303,369,450,249,350,356,-201,81,-282
284,500000,54fc07138d70374c,2,0,259,424,365,346,440,402,372,406,400,540,575,576,576,564,1,35,-34
178,610000,54fc07138d70374c,2,0,153,276,242,263,225,299,275,293,365,346,404,376,390,375,-28,58,-86
206,230000,54fc07138d70374c,2,0,217,363,293,273,325,359,356,331,302,341,410,324,367,358,-86,69,-155
179,310000,212083a9246d2fd3,2,0,139,307,248,310,413,581,617,628,446,636,846,241,544,574,-605,210,-815
145,530000,212083a9246d2fd3,2,0,148,154,145,172,143,197,189,278,304,365,493,290,392,383,-203,128,-331
123,150000,212083a9246d2fd3,2,0,134,111,109,155,125,168,136,222,206,310,562,284,423,385,-278,252,-530
71,110000,212083a9246d2fd3,2,0,188,412,270,321,429,521,473,498,257,444,824,105,464,458,-719,380,-1099
504,510000,212083a9246d2fd3,2,0,770,584,606,603,636,717,777,1042,762,1080,1730,983,1356,1264,-747,650,-1397
528,340000,212083a9246d2fd3,2,0,744,404,412,563,701,945,973,1078,1023,1260,2243,1186,1714,1563,-1057,983,-2040
553,370000,212083a9246d2fd3,2,0,875,851,1042,1265,1160,1176,1294,1622,1536,1637,2998,1261,2130,1965,-1737,1361,-3098
178,140000,212083a9246d2fd3,2,0,136,144,177,203,154,257,272,308,299,372,645,313,479,443,-332,273,-605
337,440000,212083a9246d2fd3,2,0,240,608,631,1027,923,1121,1670,1369,1274,1967,3191,905,2048,2021,-2286,1224,-3510
179,450000,212083a9246d2fd3,2,0,168,141,105,142,190,192,188,232,252,337,697,471,584,502,-226,360,-586
972,320000,212083a9246d2fd3,2,0,1526,1242,1231,1592,1724,1702,2067,2163,1918,2283,3836,1631,2734,2583,-2205,1553,-3758
229,360000,212083a9246d2fd3,2,0,446,244,251,345,361,411,440,542,547,676,1270,658,964,868,-612,594,-1206
551,130000,212083a9246d2fd3,2,0,574,511,495,710,678,854,909,987,969,1064,2232,950,1591,1415,-1282,1168,-2450
828,410000,212083a9246d2fd3,2,0,870,634,824,900,1091,1257,1337,1548,1431,1720,3243,1894,2568,2286,-1349,1523,-2872
328,330000,212083a9246d2fd3,2,0,628,712,672,814,952,886,1003,1067,1140,1205,1850,574,1212,1210,-1276,645,-1921
244,420000,212083a9246d2fd3,2,0,420,379,335,349,502,356,435,576,710,866,1354,755,1054,992,-599,488,-1087
322,430000,212083a9246d2fd3,2,0,420,360,426,538,599,590,709,844,687,982,1756,938,1347,1225,-818,774,-1592
182,350000,212083a9246d2fd3,2,0,137,249,221,268,357,422,486,645,645,746,1041,462,752,750,-579,295,-874
92,210000,212083a9246d2fd3,2,0,143,177,163,241,231,300,418,415,275,422,561,181,371,388,-380,139,-519
231,500000,212083a9246d2fd3,2,0,328,299,375,484,631,758,749,722,571,643,1136,557,846,779,-579,493,-1072
298,610000,212083a9246d2fd3,2,0,225,254,261,399,506,811,726,652,682,805,1567,639,1103,1004,-928,762,-1690
62,230000,212083a9246d2fd3,2,0,96,119,141,163,123,259,159,164,109,207,305,102,204,205,-203,98,-301
31,310000,4f79773e600518a6,2,0,59,117,95,90,87,88,90,112,64,139,159,95,127,131,-64,20,-84
91,530000,4f79773e600518a6,2,0,150,132,81,108,54,102,103,88,129,116,195,181,188,164,-14,79,-93
113,150000,4f79773e600518a6,2,0,166,183,174,223,139,192,148,178,215,227,336,327,332,297,-9,109,-118
35,110000,4f79773e600518a6,2,0,107,188,157,103,119,110,107,124,113,153,246,99,172,166,-147,93,-240
155,510000,4f79773e600518a6,2,0,300,263,231,201,164,169,165,260,194,267,387,398,392,351,11,120,-109
121,340000,4f79773e600518a6,2,0,331,241,207,206,161,192,228,277,262,301,471,484,478,419,13,170,-157
263,370000,4f79773e600518a6,2,0,418,548,574,604,450,433,565,670,629,591,961,723,842,758,-238,370,-608
66,140000,4f79773e600518a6,2,0,58,100,103,114,81,88,106,92,114,133,167,149,158,150,-18,34,-52
19,440000,4f79773e600518a6,2,0,62,174,156,103,107,99,112,111,142,134,176,97,136,136,-79,42,-121
20,450000,4f79773e600518a6,2,0,79,90,53,59,61,36,46,27,44,52,62,66,64,60,4,10,-6
168,320000,4f79773e600518a6,2,0,562,420,362,365,291,216,275,222,289,312,450,333,392,365,-117,138,-255
69,360000,4f79773e600518a6,2,0,157,142,129,162,110,96,123,158,141,164,252,264,258,227,12,88,-76
182,130000,4f79773e600518a6,2,0,239,265,258,283,231,209,251,268,281,338,473,362,418,391,-111,135,-246
213,410000,4f79773e600518a6,2,0,386,456,508,440,420,458,438,436,457,535,679,669,674,628,-10,144,-154
59,330000,4f79773e600518a6,2,0,157,179,148,165,119,117,144,152,167,161,255,131,193,182,-124,94,-218
105,420000,4f79773e600518a6,2,0,209,218,242,217,211,166,169,231,258,278,385,450,418,371,65,107,-42
222,430000,4f79773e600518a6,2,0,399,388,395,357,324,322,320,453,378,533,776,857,816,722,81,243,-162
21,350000,4f79773e600518a6,2,0,59,87,42,60,45,47,38,50,51,83,65,41,53,63,-24,-18,-6
50,210000,4f79773e600518a6,2,0,85,129,125,118,82,101,115,152,128,129,166,109,138,135,-57,37,-94
58,500000,4f79773e600518a6,2,0,233,209,189,156,162,125,149,157,175,189,306,256,281,250,-50,117,-167
193,610000,4f79773e600518a6,2,0,248,335,296,319,224,270,298,329,421,381,634,493,564,503,-141,253,-394
70,230000,4f79773e600518a6,2,0,155,190,188,152,109,132,165,141,126,204,277,131,204,204,-146,73,-219
71,310000,fc32b1a017b34efe,2,0,99,199,164,165,139,164,176,188,167,211,361,138,250,237,-223,150,-373
299,530000,fc32b1a017b34efe,2,0,475,412,328,421,327,407,402,486,521,434,743,406,574,528,-337,309,-646
135,150000,fc32b1a017b34efe,2,0,255,274,265,289,218,256,255,374,366,390,683,304,494,459,-379,293,-672
56,110000,fc32b1a017b34efe,2,0,214,434,345,391,298,365,388,458,302,357,675,173,424,402,-502,318,-820
681,510000,fc32b1a017b34efe,2,0,1086,1383,1313,1243,1067,1135,1222,1530,1137,1318,2057,1186,1622,1520,-871,739,-1610
194,340000,fc32b1a017b34efe,2,0,371,408,413,407,292,363,463,479,476,493,865,574,720,644,-291,372,-663
282,370000,fc32b1a017b34efe,2,0,712,778,983,935,718,720,875,922,870,894,1538,723,1130,1052,-815,644,-1459
214,140000,fc32b1a017b34efe,2,0,240,339,383,469,311,358,454,470,495,510,974,417,696,634,-557,464,-1021
259,440000,fc32b1a017b34efe,2,0,292,692,629,703,576,557,610,730,702,768,1105,569,837,814,-536,337,-873
101,450000,fc32b1a017b34efe,2,0,208,209,154,242,164,182,175,217,208,212,406,260,333,293,-146,194,-340
402,320000,fc32b1a017b34efe,2,0,648,745,631,724,557,652,768,765,828,786,1332,698,1015,939,-634,546,-1180
110,360000,fc32b1a017b34efe,2,0,215,235,288,311,262,276,281,350,363,356,774,420,597,517,-354,418,-772
397,130000,fc32b1a017b34efe,2,0,676,744,724,862,614,693,937,936,974,964,2069,891,1480,1308,-1178,1105,-2283
330,410000,fc32b1a017b34efe,2,0,610,715,892,850,682,796,900,924,913,934,1916,1026,1471,1292,-890,982,-1872
195,330000,fc32b1a017b34efe,2,0,395,572,541,581,492,491,561,604,663,556,982,370,676,636,-612,426,-1038
105,420000,fc32b1a017b34efe,2,0,193,265,278,276,303,276,301,385,300,389,721,401,561,504,-320,332,-652
205,430000,fc32b1a017b34efe,2,0,586,514,623,562,511,551,548,722,567,687,1290,631,960,869,-659,603,-1262
95,350000,fc32b1a017b34efe,2,0,96,218,190,170,135,152,178,217,240,253,385,180,282,273,-205,132,-337
104,210000,fc32b1a017b34efe,2,0,115,237,238,223,208,212,251,209,211,226,330,135,232,230,-195,104,-299
420,500000,fc32b1a017b34efe,2,0,977,800,797,796,935,790,970,909,844,751,1420,661,1040,944,-759,669,-1428
184,610000,fc32b1a017b34efe,2,0,452,501,575,671,425,496,540,574,623,639,1234,604,919,826,-630,595,-1225
111,230000,fc32b1a017b34efe,2,0,100,176,124,152,127,131,146,126,126,150,236,76,156,154,-160,86,-246
95,310000,feabbf46658382b9,2,0,104,239,247,291,237,275,484,500,412,620,805,357,581,594,-448,185,-633
418,530000,feabbf46658382b9,2,0,502,481,450,444,342,521,806,851,856,921,1249,829,1039,1000,-420,328,-748
288,150000,feabbf46658382b9,2,0,262,315,336,322,265,347,507,500,528,675,925,601,763,734,-324,250,-574
212,110000,feabbf46658382b9,2,0,300,478,446,455,384,534,743,672,532,779,1421,437,929,879,-984,642,-1626
903,510000,feabbf46658382b9,2,0,1283,1148,1182,899,922,1077,1757,2178,1620,1861,2915,2183,2549,2320,-732,1054,-1786
304,340000,feabbf46658382b9,2,0,607,365,405,383,373,395,690,798,757,934,1307,1141,1224,1127,-166,373,-539
389,370000,feabbf46658382b9,2,0,594,611,792,689,593,668,1173,1160,1214,1192,1610,1006,1308,1269,-604,418,-1022
198,140000,feabbf46658382b9,2,0,200,325,308,304,235,316,582,505,511,601,970,406,688,659,-564,369,-933
341,440000,feabbf46658382b9,2,0,304,689,958,928,799,758,1347,1576,1507,1902,2685,1203,1944,1930,-1482,783,-2265
149,450000,feabbf46658382b9,2,0,257,267,191,230,206,193,394,347,352,440,665,433,549,513,-232,225,-457
650,320000,feabbf46658382b9,2,0,917,887,1007,951,861,1014,1794,1646,1598,1955,2752,1481,2116,2063,-1271,797,-2068
159,360000,feabbf46658382b9,2,0,304,214,275,281,260,281,443,510,475,511,802,624,713,646,-178,291,-469
478,130000,feabbf46658382b9,2,0,551,562,650,653,522,624,985,1009,905,1021,1551,970,1260,1181,-581,530,-1111
502,410000,feabbf46658382b9,2,0,946,628,786,747,679,846,1361,1342,1399,1530,2696,1928,2312,2051,-768,1166,-1934
292,330000,feabbf46658382b9,2,0,458,535,675,710,572,720,1247,1320,1351,1499,2124,704,1414,1442,-1420,625,-2045
201,420000,feabbf46658382b9,2,0,363,307,317,322,323,347,614,653,620,794,1252,837,1044,961,-415,458,-873
503,430000,feabbf46658382b9,2,0,749,596,697,623,625,741,1241,1383,1339,1478,2360,1657,2008,1832,-703,882,-1585
129,350000,feabbf46658382b9,2,0,132,235,287,264,213,231,425,414,399,601,698,428,563,576,-270,97,-367
125,210000,feabbf46658382b9,2,0,130,230,240,206,200,191,375,331,306,361,459,235,347,352,-224,98,-322
758,500000,feabbf46658382b9,2,0,1368,1012,1031,877,1159,994,1592,1671,1487,1581,2727,1846,2286,2051,-881,1146,-2027
333,610000,feabbf46658382b9,2,0,517,513,636,634,391,538,758,764,827,896,1319,905,1112,1040,-414,423,-837
117,230000,feabbf46658382b9,2,0,93,173,167,152,156,136,271,219,256,312,397,173,285,294,-224,85,-309
29,310000,f270f6a489c6a9d7,2,0,42,81,54,48,33,25,37,28,27,30,34,19,26,28,-15,4,-19
1190,530000,f270f6a489c6a9d7,2,0,1982,1751,1315,1335,1170,1342,1395,1639,1736,1547,1939,1680,1810,1722,-259,392,-651
78,150000,f270f6a489c6a9d7,2,0,56,83,96,80,81,79,74,107,93,105,108,54,81,89,-54,3,-57
118,110000,f270f6a489c6a9d7,2,0,156,229,233,214,173,229,238,282,198,305,504,106,305,305,-398,199,-597
645,510000,f270f6a489c6a9d7,2,0,976,1205,892,875,682,620,742,717,655,773,955,603,779,777,-352,182,-534
223,340000,f270f6a489c6a9d7,2,0,440,323,285,216,207,172,194,197,214,225,272,216,244,238,-56,47,-103
541,370000,f270f6a489c6a9d7,2,0,767,721,695,659,545,644,631,622,551,636,1105,629,867,790,-476,469,-945
115,140000,f270f6a489c6a9d7,2,0,162,270,155,157,114,131,103,137,118,161,233,166,200,187,-67,72,-139
505,440000,f270f6a489c6a9d7,2,0,617,1291,948,890,830,568,627,644,624,713,866,346,606,642,-520,153,-673
50,450000,f270f6a489c6a9d7,2,0,161,173,97,104,62,69,50,93,63,75,97,92,94,88,-5,22,-27
843,320000,f270f6a489c6a9d7,2,0,952,992,724,727,654,653,752,766,763,871,1150,610,880,877,-540,279,-819
89,360000,f270f6a489c6a9d7,2,0,205,183,155,161,110,121,107,134,92,117,148,132,140,132,-16,31,-47
616,130000,f270f6a489c6a9d7,2,0,789,811,606,636,506,529,574,561,554,769,983,537,760,763,-446,214,-660
778,410000,f270f6a489c6a9d7,2,0,1478,1260,1027,934,847,759,825,703,746,952,1314,922,1118,1063,-392,362,-754
498,330000,f270f6a489c6a9d7,2,0,670,934,557,549,457,405,385,451,456,466,653,312,482,477,-341,187,-528
438,420000,f270f6a489c6a9d7,2,0,697,859,536,538,476,513,518,582,592,590,903,514,708,669,-389,313,-702
314,430000,f270f6a489c6a9d7,2,0,503,656,598,440,429,353,375,366,327,426,575,405,490,469,-170,149,-319
140,350000,f270f6a489c6a9d7,2,0,137,270,206,172,148,152,164,156,179,175,195,85,140,152,-110,20,-130
187,210000,f270f6a489c6a9d7,2,0,206,331,272,228,230,212,192,216,260,281,370,158,264,270,-212,89,-301
643,500000,f270f6a489c6a9d7,2,0,1641,1037,781,700,668,554,592,643,645,706,955,636,796,766,-319,249,-568
155,610000,f270f6a489c6a9d7,2,0,316,321,306,283,187,180,190,227,209,280,324,195,260,266,-129,44,-173
48,230000,f270f6a489c6a9d7,2,0,95,134,124,103,81,47,88,70,59,76,90,35,62,67,-55,14,-69
52,310000,d0f245b8781e3631,2,0,76,116,114,110,134,139,176,218,159,193,281,60,170,178,-221,88,-309
119,530000,d0f245b8781e3631,2,0,168,124,127,149,132,201,192,241,224,227,356,181,268,255,-175,129,-304
67,150000,d0f245b8781e3631,2,0,74,100,61,89,103,103,63,86,129,183,244,117,180,181,-127,61,-188
52,110000,d0f245b8781e3631,2,0,202,520,398,466,501,463,464,472,326,417,805,105,455,442,-700,388,-1088
454,510000,d0f245b8781e3631,2,0,755,939,830,726,715,739,855,1133,824,910,1456,816,1136,1061,-640,546,-1186
96,340000,d0f245b8781e3631,2,0,244,164,160,209,240,323,314,310,267,287,463,251,357,334,-212,176,-388
283,370000,d0f245b8781e3631,2,0,559,501,593,571,548,646,773,797,679,738,1182,600,891,840,-582,444,-1026
96,140000,d0f245b8781e3631,2,0,161,200,167,199,121,199,221,226,243,264,497,192,344,318,-305,233,-538
127,440000,d0f245b8781e3631,2,0,169,374,342,351,384,378,429,596,574,615,869,297,583,594,-572,254,-826
71,450000,d0f245b8781e3631,2,0,160,162,108,140,126,161,139,167,205,233,425,254,340,304,-171,192,-363
270,320000,d0f245b8781e3631,2,0,492,606,574,521,545,683,706,761,731,749,1017,461,739,742,-556,268,-824
60,360000,d0f245b8781e3631,2,0,142,127,126,110,128,145,145,229,198,198,315,211,263,241,-104,117,-221
390,130000,d0f245b8781e3631,2,0,635,446,455,480,501,551,690,771,682,755,1430,754,1092,980,-676,675,-1351
268,410000,d0f245b8781e3631,2,0,899,500,524,534,645,779,871,851,876,865,1601,892,1246,1119,-709,736,-1445
81,330000,d0f245b8781e3631,2,0,192,280,246,271,509,410,370,1437,406,420,845,174,510,480,-671,425,-1096
39,420000,d0f245b8781e3631,2,0,117,139,112,83,118,124,88,110,128,133,246,134,190,171,-112,113,-225
130,430000,d0f245b8781e3631,2,0,304,398,280,324,325,335,319,439,335,447,756,439,598,547,-317,309,-626
51,350000,d0f245b8781e3631,2,0,47,105,96,92,93,116,102,142,175,166,247,102,174,172,-145,81,-226
21,210000,d0f245b8781e3631,2,0,41,64,60,48,65,77,81,68,54,102,113,47,80,87,-66,11,-77
283,500000,d0f245b8781e3631,2,0,1292,570,694,1791,780,781,1602,764,548,596,1578,630,1104,935,-948,982,-1930
189,610000,d0f245b8781e3631,2,0,273,384,352,349,347,435,453,455,455,558,938,498,718,665,-440,380,-820
10,230000,d0f245b8781e3631,2,0,15,20,14,19,35,25,28,17,16,45,45,7,26,32,-38,0,-38
125,310000,c6cd4e0e073f5ac2,2,0,384,766,615,1911,902,547,590,1049,393,448,746,228,487,474,-518,298,-816
67,530000,c6cd4e0e073f5ac2,2,0,278,301,236,299,183,317,301,410,266,224,235,105,170,188,-130,11,-141
63,150000,c6cd4e0e073f5ac2,2,0,177,210,170,205,129,178,248,263,289,273,340,208,274,274,-132,67,-199
29,110000,c6cd4e0e073f5ac2,2,0,156,210,198,2153,193,216,265,2528,156,179,362,72,217,204,-290,183,-473
251,510000,c6cd4e0e073f5ac2,2,0,1198,978,987,918,779,942,1243,1666,730,631,1027,542,784,733,-485,396,-881
244,340000,c6cd4e0e073f5ac2,2,0,817,521,577,609,647,742,968,961,755,678,1434,792,1113,968,-642,756,-1398
326,370000,c6cd4e0e073f5ac2,2,0,1658,1597,1972,2081,1738,2176,2848,2646,1380,1053,1685,823,1254,1187,-862,632,-1494
126,140000,c6cd4e0e073f5ac2,2,0,317,332,357,466,412,468,657,660,386,479,604,321,462,468,-283,125,-408
130,440000,c6cd4e0e073f5ac2,2,0,279,1067,835,808,584,546,819,1623,936,1038,1493,451,972,994,-1042,455,-1497
76,450000,c6cd4e0e073f5ac2,2,0,190,289,222,206,200,234,316,360,349,312,543,250,396,368,-293,231,-524
656,320000,c6cd4e0e073f5ac2,2,0,2058,2036,1793,2058,1654,1827,2527,2388,1650,1467,2828,1205,2016,1833,-1623,1361,-2984
138,360000,c6cd4e0e073f5ac2,2,0,420,401,428,462,351,450,511,752,626,577,1241,549,895,789,-692,664,-1356
249,130000,c6cd4e0e073f5ac2,2,0,890,745,818,940,856,987,1387,1606,840,561,1020,602,811,728,-418,459,-877
320,410000,c6cd4e0e073f5ac2,2,0,1366,1036,1237,1242,1377,1416,1736,1669,959,1021,1584,992,1288,1199,-592,563,-1155
193,330000,c6cd4e0e073f5ac2,2,0,584,854,706,739,693,717,1019,1203,828,859,1272,386,829,839,-886,413,-1299
161,420000,c6cd4e0e073f5ac2,2,0,683,611,623,602,550,430,713,769,691,751,1208,523,866,827,-685,457,-1142
132,430000,c6cd4e0e073f5ac2,2,0,489,532,566,595,580,641,816,847,522,619,891,508,700,673,-383,272,-655
74,350000,c6cd4e0e073f5ac2,2,0,107,172,152,204,142,221,243,304,268,291,431,173,302,298,-258,140,-398
51,210000,c6cd4e0e073f5ac2,2,0,124,182,229,277,157,228,366,291,139,186,225,91,158,167,-134,39,-173
33,500000,c6cd4e0e073f5ac2,2,0,221,210,204,174,226,215,324,310,182,148,242,128,185,173,-114,94,-208
64,610000,c6cd4e0e073f5ac2,2,0,306,391,524,533,558,687,656,661,278,275,432,182,307,296,-250,157,-407
29,230000,c6cd4e0e073f5ac2,2,0,92,110,100,111,89,97,146,137,83,61,140,53,96,85,-87,79,-166
84,310000,a9a43d1a7ecbe75d,2,0,87,149,133,134,134,141,138,161,113,162,163,142,152,156,-21,1,-22
84,530000,a9a43d1a7ecbe75d,2,0,54,107,85,86,94,141,123,111,95,152,131,146,138,143,15,-21,36
41,150000,a9a43d1a7ecbe75d,2,0,40,55,64,107,75,84,71,81,97,81,90,83,86,85,-7,9,-16
65,110000,a9a43d1a7ecbe75d,2,0,34,85,87,95,97,119,87,131,79,100,123,88,106,104,-35,23,-58
184,510000,a9a43d1a7ecbe75d,2,0,197,228,225,215,255,232,227,447,284,279,330,341,336,317,11,51,-40
107,340000,a9a43d1a7ecbe75d,2,0,99,134,119,161,145,138,167,182,170,183,198,254,226,212,56,15,41
74,370000,a9a43d1a7ecbe75d,2,0,84,124,180,157,181,138,136,198,152,160,191,159,175,170,-32,31,-63
25,140000,a9a43d1a7ecbe75d,2,0,20,17,25,37,27,30,36,34,32,31,28,41,34,33,13,-3,16
264,440000,a9a43d1a7ecbe75d,2,0,146,429,345,479,470,487,435,593,541,658,638,568,603,621,-70,-20,-50
121,450000,a9a43d1a7ecbe75d,2,0,89,156,161,164,160,151,154,208,163,172,213,297,255,227,84,41,43
213,320000,a9a43d1a7ecbe75d,2,0,205,341,313,360,325,317,361,402,385,402,439,430,434,424,-9,37,-46
50,360000,a9a43d1a7ecbe75d,2,0,37,64,44,75,70,82,64,94,87,76,120,103,112,100,-17,44,-61
50,130000,a9a43d1a7ecbe75d,2,0,39,90,92,88,94,88,102,92,82,85,95,109,102,96,14,10,4
78,410000,a9a43d1a7ecbe75d,2,0,72,107,141,117,126,120,123,153,141,134,164,130,147,143,-34,30,-64
185,330000,a9a43d1a7ecbe75d,2,0,156,242,287,301,272,322,299,308,339,364,397,466,432,409,69,33,36
129,420000,a9a43d1a7ecbe75d,2,0,86,162,187,145,190,155,179,232,184,244,236,270,253,250,34,-8,42
215,430000,a9a43d1a7ecbe75d,2,0,173,254,290,293,279,299,298,395,308,355,445,519,482,440,74,90,-16
57,350000,a9a43d1a7ecbe75d,2,0,45,88,69,99,64,92,91,93,87,125,99,145,122,123,46,-26,72
59,210000,a9a43d1a7ecbe75d,2,0,60,120,97,133,116,136,158,194,115,126,155,89,122,123,-66,29,-95
89,500000,a9a43d1a7ecbe75d,2,0,103,110,159,135,304,146,146,203,173,179,214,160,187,184,-54,35,-89
154,610000,a9a43d1a7ecbe75d,2,0,88,179,190,260,217,273,229,256,263,252,263,274,268,263,11,11,0
35,230000,a9a43d1a7ecbe75d,2,0,36,89,80,70,81,75,75,68,54,66,57,65,61,63,8,-9,17
309,310000,3c974920a76ac9c1,3,0,323,266,271,235,260,162,265,228,369,374,305,193,249,291,-112,-69,-43
302,530000,3c974920a76ac9c1,3,0,260,216,308,279,419,246,217,310,402,456,434,194,314,361,-240,-22,-218
201,150000,3c974920a76ac9c1,3,0,206,149,236,164,187,153,157,178,204,219,180,128,154,176,-52,-39,-13
472,110000,3c974920a76ac9c1,3,0,362,404,445,351,322,244,337,371,460,563,468,432,450,488,-36,-95,59
378,510000,3c974920a76ac9c1,3,0,358,373,360,329,335,345,623,350,453,570,500,253,376,441,-247,-70,-177
132,340000,3c974920a76ac9c1,3,0,152,155,154,138,108,127,159,136,179,226,198,76,137,167,-122,-28,-94
412,370000,3c974920a76ac9c1,3,0,418,482,482,353,339,259,422,394,483,601,468,290,379,453,-178,-133,-45
249,140000,3c974920a76ac9c1,3,0,197,211,250,166,178,189,194,233,215,260,248,146,197,218,-102,-12,-90
2958,440000,3c974920a76ac9c1,3,0,2407,2080,2897,2187,2183,1804,2265,2711,3532,3800,2692,1680,2186,2724,-1012,-1108,96
383,450000,3c974920a76ac9c1,3,0,347,259,363,291,276,249,267,349,472,505,425,248,336,393,-177,-80,-97
817,320000,3c974920a76ac9c1,3,0,791,629,780,561,554,569,631,764,871,1010,800,486,643,765,-314,-210,-104
191,360000,3c974920a76ac9c1,3,0,138,143,167,149,136,95,156,166,204,262,236,78,157,192,-158,-26,-132
297,130000,3c974920a76ac9c1,3,0,237,254,280,252,227,235,225,228,291,305,260,190,225,252,-70,-45,-25
355,410000,3c974920a76ac9c1,3,0,304,394,313,330,384,256,301,351,521,505,405,250,328,387,-155,-100,-55
621,330000,3c974920a76ac9c1,3,0,504,483,638,453,457,422,545,702,660,865,633,409,521,636,-224,-232,8
445,420000,3c974920a76ac9c1,3,0,418,368,357,440,329,325,381,447,480,474,497,228,362,400,-269,23,-292
297,430000,3c974920a76ac9c1,3,0,288,266,308,275,250,286,299,327,364,474,347,174,260,332,-173,-127,-46
307,350000,3c974920a76ac9c1,3,0,315,287,307,223,276,226,258,368,331,404,292,181,236,292,-111,-112,1
775,210000,3c974920a76ac9c1,3,0,807,807,900,645,700,556,721,769,941,997,650,566,608,738,-84,-347,263
126,500000,3c974920a76ac9c1,3,0,127,106,114,181,131,111,101,120,155,199,115,72,94,129,-43,-84,41
295,610000,3c974920a76ac9c1,3,0,246,259,414,206,262,204,187,324,393,440,305,219,262,321,-86,-135,49
401,230000,3c974920a76ac9c1,3,0,482,356,398,288,194,351,302,310,458,461,292,234,263,329,-58,-169,111
442,310000,3d7554f1f56dd664,3,0,484,342,349,376,356,410,417,271,639,518,268,263,266,350,-5,-250,245
403,530000,3d7554f1f56dd664,3,0,275,246,290,259,337,266,368,334,609,519,292,264,278,358,-28,-227,199
316,150000,3d7554f1f56dd664,3,0,189,191,270,175,231,216,208,216,370,337,175,149,162,220,-26,-162,136
470,110000,3d7554f1f56dd664,3,0,527,412,406,405,459,464,449,231,675,811,368,359,364,513,-9,-443,434
806,510000,3d7554f1f56dd664,3,0,885,758,701,656,684,758,1227,469,1053,1125,657,560,608,781,-97,-468,371
317,340000,3d7554f1f56dd664,3,0,202,232,224,252,293,358,325,253,574,507,301,225,263,344,-76,-206,130
1060,370000,3d7554f1f56dd664,3,0,807,1100,977,862,990,917,1222,876,1567,1574,775,729,752,1026,-46,-799,753
407,140000,3d7554f1f56dd664,3,0,299,314,339,253,284,382,372,320,590,571,290,239,264,367,-51,-281,230
10371,440000,3d7554f1f56dd664,3,0,8611,7234,9327,8266,8709,10596,10140,6925,13598,11515,5136,4688,4912,7113,-448,-6379,5931
1074,450000,3d7554f1f56dd664,3,0,855,658,835,723,792,866,969,642,1386,1258,750,559,654,856,-191,-508,317
2184,320000,3d7554f1f56dd664,3,0,2057,1655,2026,1678,1827,2216,2075,1763,3112,2877,1445,1635,1540,1986,190,-1432,1622
545,360000,3d7554f1f56dd664,3,0,359,359,396,344,400,420,535,356,595,741,435,311,373,496,-124,-306,182
847,130000,3d7554f1f56dd664,3,0,516,591,633,520,604,569,722,520,1137,974,498,486,492,653,-12,-476,464
968,410000,3d7554f1f56dd664,3,0,544,698,673,695,718,785,808,565,1273,1234,645,486,566,788,-159,-589,430
1969,330000,3d7554f1f56dd664,3,0,1659,1539,1625,1420,1737,1785,1658,1293,2709,2467,1135,1205,1170,1602,70,-1332,1402
734,420000,3d7554f1f56dd664,3,0,804,713,668,835,675,883,908,742,1001,1050,703,508,606,754,-195,-347,152
769,430000,3d7554f1f56dd664,3,0,678,683,657,625,567,721,958,582,1112,1192,689,445,567,775,-244,-503,259
1607,350000,3d7554f1f56dd664,3,0,1254,1127,1467,1202,1533,1388,1310,817,2205,1578,856,899,878,1111,43,-722,765
1905,210000,3d7554f1f56dd664,3,0,1838,1870,2279,1544,2253,2301,1915,1064,2892,2161,1110,1306,1208,1526,196,-1051,1247
285,500000,3d7554f1f56dd664,3,0,218,213,199,327,300,319,331,173,470,398,244,215,230,286,-29,-154,125
369,610000,3d7554f1f56dd664,3,0,255,320,486,412,553,492,462,375,582,607,340,260,300,402,-80,-267,187
1186,230000,3d7554f1f56dd664,3,0,946,626,765,687,670,1107,843,480,1076,1018,447,521,484,662,74,-571,645
187,310000,2d0d2c3403909fdb,3,0,213,184,219,211,160,159,169,112,163,167,157,101,129,142,-56,-10,-46
293,530000,2d0d2c3403909fdb,3,0,253,260,265,254,351,309,270,218,354,350,290,213,252,284,-77,-60,-17
228,150000,2d0d2c3403909fdb,3,0,210,228,261,237,261,246,234,155,184,233,279,174,226,229,-105,46,-151
627,110000,2d0d2c3403909fdb,3,0,551,670,627,552,633,554,583,457,611,677,549,387,468,538,-162,-128,-34
377,510000,2d0d2c3403909fdb,3,0,348,327,372,413,373,319,387,300,411,434,516,235,376,395,-281,82,-363
127,340000,2d0d2c3403909fdb,3,0,119,116,119,126,118,108,157,129,128,138,176,83,130,132,-93,38,-131
353,370000,2d0d2c3403909fdb,3,0,316,317,345,393,358,328,376,327,415,400,420,235,328,352,-185,20,-205
189,140000,2d0d2c3403909fdb,3,0,160,161,165,161,170,152,135,111,141,197,179,103,141,160,-76,-18,-58
1738,440000,2d0d2c3403909fdb,3,0,1579,1472,1652,1649,1691,1490,1683,1421,1989,1829,1713,1159,1436,1567,-554,-116,-438
197,450000,2d0d2c3403909fdb,3,0,184,157,187,179,178,141,192,165,181,173,211,121,166,168,-90,38,-128
446,320000,2d0d2c3403909fdb,3,0,361,393,413,417,373,340,401,333,437,427,470,296,383,398,-174,43,-217
113,360000,2d0d2c3403909fdb,3,0,75,95,119,89,94,84,108,90,107,109,126,55,90,97,-71,17,-88
371,130000,2d0d2c3403909fdb,3,0,233,302,305,302,324,321,309,274,302,328,389,251,320,323,-138,61,-199
331,410000,2d0d2c3403909fdb,3,0,259,323,298,340,309,300,327,262,352,337,377,202,290,305,-175,40,-215
349,330000,2d0d2c3403909fdb,3,0,327,357,357,351,316,352,336,342,428,424,401,264,332,363,-137,-23,-114
271,420000,2d0d2c3403909fdb,3,0,210,242,242,268,203,201,303,211,267,280,321,189,255,263,-132,41,-173
275,430000,2d0d2c3403909fdb,3,0,212,237,248,277,255,193,250,211,244,275,284,146,215,235,-138,9,-147
107,350000,2d0d2c3403909fdb,3,0,105,124,113,128,123,95,124,106,151,157,167,81,124,135,-86,10,-96
529,210000,2d0d2c3403909fdb,3,0,417,495,542,501,506,466,488,346,464,567,506,316,411,463,-190,-61,-129
188,500000,2d0d2c3403909fdb,3,0,176,130,156,186,166,134,169,138,184,155,213,116,164,161,-97,58,-155
288,610000,2d0d2c3403909fdb,3,0,253,239,271,255,273,253,271,195,252,267,297,206,252,257,-91,30,-121
306,230000,2d0d2c3403909fdb,3,0,216,276,357,324,293,304,239,208,258,336,315,155,235,269,-160,-21,-139
135,310000,a28bb927b6fcb33c,3,0,232,238,251,282,229,249,216,166,212,210,117,96,106,141,-21,-93,72
159,530000,a28bb927b6fcb33c,3,0,163,123,154,116,231,232,256,209,270,308,173,110,142,197,-63,-135,72
136,150000,a28bb927b6fcb33c,3,0,114,106,123,97,118,134,193,128,165,176,89,72,80,112,-17,-87,70
179,110000,a28bb927b6fcb33c,3,0,324,305,237,267,308,309,286,179,246,342,136,109,122,196,-27,-206,179
361,510000,a28bb927b6fcb33c,3,0,452,413,430,414,426,492,712,401,438,436,351,212,282,333,-139,-85,-54
204,340000,a28bb927b6fcb33c,3,0,244,230,261,218,300,368,358,250,325,348,264,151,208,254,-113,-84,-29
357,370000,a28bb927b6fcb33c,3,0,389,484,405,407,399,489,606,454,468,556,225,175,200,319,-50,-331,281
148,140000,a28bb927b6fcb33c,3,0,128,130,124,127,123,233,187,181,144,181,92,70,81,114,-22,-89,67
3992,440000,a28bb927b6fcb33c,3,0,3766,3317,3840,3624,4020,4618,5211,4012,4216,4195,2391,1639,2015,2742,-752,-1804,1052
443,450000,a28bb927b6fcb33c,3,0,344,277,350,329,360,409,444,331,432,386,248,166,207,267,-82,-138,56
982,320000,a28bb927b6fcb33c,3,0,940,829,888,876,892,1148,1130,943,1033,1154,680,651,666,828,-29,-474,445
254,360000,a28bb927b6fcb33c,3,0,184,170,221,210,194,288,380,260,302,351,208,96,152,218,-112,-143,31
584,130000,a28bb927b6fcb33c,3,0,358,362,423,480,475,550,584,385,397,419,248,284,266,317,36,-171,207
578,410000,a28bb927b6fcb33c,3,0,376,449,371,468,562,658,673,556,567,651,338,242,290,410,-96,-313,217
1438,330000,a28bb927b6fcb33c,3,0,990,1039,1012,1006,1138,1244,1296,1228,1343,1310,747,739,743,932,-8,-563,555
461,420000,a28bb927b6fcb33c,3,0,547,533,457,595,544,655,744,726,677,787,450,226,338,488,-224,-337,113
436,430000,a28bb927b6fcb33c,3,0,482,529,476,494,503,610,619,436,474,674,394,223,308,430,-171,-280,109
535,350000,a28bb927b6fcb33c,3,0,423,426,506,417,546,535,615,563,615,519,231,173,202,308,-58,-288,230
610,210000,a28bb927b6fcb33c,3,0,554,649,665,803,867,1031,840,522,652,848,213,233,223,431,20,-635,655
166,500000,a28bb927b6fcb33c,3,0,193,183,200,348,324,316,208,150,157,208,123,85,104,139,-38,-85,47
202,610000,a28bb927b6fcb33c,3,0,192,194,239,237,272,274,262,219,225,317,148,105,126,190,-43,-169,126
233,230000,a28bb927b6fcb33c,3,0,253,261,255,248,232,335,334,222,288,303,90,85,88,159,-5,-213,208
267,310000,17bc272c93f19d56,3,0,302,182,202,234,212,256,234,168,249,477,199,177,188,284,-22,-278,256
2754,530000,17bc272c93f19d56,3,0,2705,2130,2397,2353,2868,2565,3307,3096,3216,4503,4785,3067,3926,4118,-1718,282,-2000
680,150000,17bc272c93f19d56,3,0,434,313,361,329,346,368,502,360,520,675,504,451,478,543,-53,-171,118
197,110000,17bc272c93f19d56,3,0,304,246,278,163,179,202,242,199,305,514,151,92,122,252,-59,-363,304
1481,510000,17bc272c93f19d56,3,0,1498,1056,1064,1118,1183,1230,1449,1007,1411,1954,1724,1537,1630,1738,-187,-230,43
1518,340000,17bc272c93f19d56,3,0,1532,1224,1396,1210,1260,1418,1458,1238,1535,2328,2152,1881,2016,2120,-271,-176,-95
2839,370000,17bc272c93f19d56,3,0,2813,2653,3587,2963,3398,3600,3519,3268,3907,6576,4483,3060,3772,4706,-1423,-2093,670
1353,140000,17bc272c93f19d56,3,0,1300,1076,1493,1193,1334,1452,1749,1354,1585,2844,2093,1361,1727,2099,-732,-751,19
2180,440000,17bc272c93f19d56,3,0,1712,1309,1820,1577,1457,1550,1999,1555,2007,3029,1611,1579,1595,2073,-32,-1418,1386
2310,450000,17bc272c93f19d56,3,0,2715,1831,2371,1991,2051,2291,2515,2293,2687,4443,3084,1836,2460,3121,-1248,-1359,111
2029,320000,17bc272c93f19d56,3,0,2075,1392,1679,1539,1776,1799,1764,1493,1942,3067,2165,2419,2292,2550,254,-902,1156
875,360000,17bc272c93f19d56,3,0,1047,877,1066,892,885,890,1111,824,980,1510,1290,922,1106,1241,-368,-220,-148
2945,130000,17bc272c93f19d56,3,0,2548,2351,2960,2437,2748,3368,3303,2808,3641,6231,3870,3403,3636,4501,-467,-2361,1894
3197,410000,17bc272c93f19d56,3,0,3545,2891,3967,3302,3413,3591,3584,3821,4668,7650,5825,3564,4694,5680,-2261,-1825,-436
1592,330000,17bc272c93f19d56,3,0,1340,943,1216,1213,1206,1016,1295,1112,1294,2062,1260,1629,1444,1650,369,-802,1171
1262,420000,17bc272c93f19d56,3,0,1238,1013,1221,954,900,992,1202,958,1353,2198,1919,1140,1530,1752,-779,-279,-500
1541,430000,17bc272c93f19d56,3,0,1924,1609,1715,1491,1500,1678,1773,1354,1770,2693,2364,1506,1935,2188,-858,-329,-529
741,350000,17bc272c93f19d56,3,0,702,458,576,545,512,565,573,523,688,892,592,650,621,711,58,-300,358
1322,210000,17bc272c93f19d56,3,0,1124,894,1170,1034,1023,1010,1135,824,1154,1710,924,939,932,1191,15,-786,801
235,500000,17bc272c93f19d56,3,0,204,191,258,225,203,204,284,201,250,357,250,248,249,285,-2,-107,105
1314,610000,17bc272c93f19d56,3,0,1221,1008,1213,1083,1173,1245,1658,1590,1877,3217,2072,1105,1588,2131,-967,-1145,178
806,230000,17bc272c93f19d56,3,0,819,646,736,776,785,835,795,518,816,982,506,518,512,669,12,-476,488
351,310000,2a2ab41f8f6ff1cb,3,0,202,198,232,330,331,445,555,272,582,623,382,114,248,373,-268,-241,-27
452,530000,2a2ab41f8f6ff1cb,3,0,199,246,327,333,428,409,543,553,546,680,484,300,392,488,-184,-196,12
489,150000,2a2ab41f8f6ff1cb,3,0,444,472,638,517,552,645,831,715,836,832,551,317,434,567,-234,-281,47
180,110000,2a2ab41f8f6ff1cb,3,0,162,260,324,331,345,369,502,362,440,598,212,102,157,304,-110,-386,276
850,510000,2a2ab41f8f6ff1cb,3,0,864,847,961,1004,1032,1165,1460,1050,1385,1850,1223,671,947,1248,-552,-627,75
1018,340000,2a2ab41f8f6ff1cb,3,0,744,849,934,1047,1058,1409,1565,1256,1491,1666,1515,717,1116,1299,-798,-151,-647
1734,370000,2a2ab41f8f6ff1cb,3,0,897,1413,1635,1575,1773,2139,2580,2061,2146,2737,1706,842,1274,1762,-864,-1031,167
595,140000,2a2ab41f8f6ff1cb,3,0,365,433,477,430,532,655,690,724,762,993,533,312,422,613,-221,-460,239
5713,440000,2a2ab41f8f6ff1cb,3,0,3854,3887,5187,5010,5237,6544,8215,6582,6734,6492,5607,2647,4127,4915,-2960,-885,-2075
719,450000,2a2ab41f8f6ff1cb,3,0,570,472,589,632,639,680,913,743,853,894,799,409,604,701,-390,-95,-295
1729,320000,2a2ab41f8f6ff1cb,3,0,1459,1467,1717,1679,1859,2252,2410,2283,2584,2672,1728,1016,1372,1805,-712,-944,232
690,360000,2a2ab41f8f6ff1cb,3,0,549,619,761,704,848,964,1340,1065,1086,1291,1027,356,692,891,-671,-264,-407
2126,130000,2a2ab41f8f6ff1cb,3,0,1146,1445,1808,1966,2293,2864,3253,2277,2327,2703,2119,1271,1695,2031,-848,-584,-264
2514,410000,2a2ab41f8f6ff1cb,3,0,1386,1910,2169,2264,2690,3318,3446,2827,2797,3447,2952,1308,2130,2569,-1644,-495,-1149
876,330000,2a2ab41f8f6ff1cb,3,0,593,721,949,928,974,1151,1369,1262,1632,1972,795,459,627,1075,-336,-1177,841
1095,420000,2a2ab41f8f6ff1cb,3,0,1011,1012,1027,1207,1181,1412,1938,1686,1663,2151,1566,597,1082,1438,-969,-585,-384
1487,430000,2a2ab41f8f6ff1cb,3,0,1249,1396,1570,1605,1889,1918,2573,2247,1966,2770,1651,844,1248,1755,-807,-1119,312
314,350000,2a2ab41f8f6ff1cb,3,0,172,208,292,259,301,348,390,371,447,476,264,148,206,296,-116,-212,96
360,210000,2a2ab41f8f6ff1cb,3,0,187,283,311,261,323,369,397,317,403,513,241,211,226,322,-30,-272,242
472,500000,2a2ab41f8f6ff1cb,3,0,479,530,585,806,750,810,888,646,803,1149,803,328,566,760,-475,-346,-129
468,610000,2a2ab41f8f6ff1cb,3,0,306,358,387,403,502,566,687,665,655,845,620,247,434,571,-373,-225,-148
506,230000,2a2ab41f8f6ff1cb,3,0,468,492,550,570,602,652,669,544,740,1032,399,306,352,579,-93,-633,540
1247,310000,c06a2a387c0ee510,3,0,1063,994,1124,945,1154,1068,958,710,977,1212,1265,890,1078,1122,-375,53,-428
214,530000,c06a2a387c0ee510,3,0,70,57,124,99,83,62,79,45,66,119,104,63,84,95,-41,-15,-26
154,150000,c06a2a387c0ee510,3,0,65,50,51,85,56,51,54,43,56,75,86,64,75,75,-22,11,-33
1508,110000,c06a2a387c0ee510,3,0,867,872,926,824,1014,976,1027,677,793,1627,1352,1114,1233,1364,-238,-275,37
254,510000,c06a2a387c0ee510,3,0,223,166,175,144,210,234,199,102,145,321,208,187,198,239,-21,-113,92
322,340000,c06a2a387c0ee510,3,0,149,190,155,149,157,167,182,145,176,251,253,175,214,226,-78,2,-80
1303,370000,c06a2a387c0ee510,3,0,562,729,614,644,701,698,710,494,739,1047,878,649,764,858,-229,-169,-60
244,140000,c06a2a387c0ee510,3,0,106,96,90,115,93,101,121,83,105,184,165,123,144,157,-42,-19,-23
944,440000,c06a2a387c0ee510,3,0,472,491,557,511,479,453,514,463,571,819,762,448,605,676,-314,-57,-257
103,450000,c06a2a387c0ee510,3,0,56,38,32,27,46,65,36,87,45,96,92,54,73,81,-38,-4,-34
1188,320000,c06a2a387c0ee510,3,0,680,808,786,664,704,653,923,563,731,1002,974,650,812,875,-324,-28,-296
164,360000,c06a2a387c0ee510,3,0,55,107,79,54,83,56,89,43,74,97,118,85,102,100,-33,21,-54
599,130000,c06a2a387c0ee510,3,0,229,240,232,241,288,302,284,232,288,493,470,361,416,441,-109,-23,-86
763,410000,c06a2a387c0ee510,3,0,314,390,376,374,353,356,387,282,366,596,517,345,431,486,-172,-79,-93
754,330000,c06a2a387c0ee510,3,0,365,466,382,390,895,578,350,278,533,736,534,424,479,565,-110,-202,92
240,420000,c06a2a387c0ee510,3,0,93,139,123,130,108,119,115,66,94,173,151,103,127,142,-48,-22,-26
203,430000,c06a2a387c0ee510,3,0,72,140,72,59,68,91,68,60,83,119,101,59,80,93,-42,-18,-24
206,350000,c06a2a387c0ee510,3,0,128,219,92,103,107,123,99,106,97,170,123,106,114,133,-17,-47,30
357,210000,c06a2a387c0ee510,3,0,139,266,153,169,211,178,184,111,151,300,181,154,168,212,-27,-119,92
130,500000,c06a2a387c0ee510,3,0,102,106,65,63,75,66,120,43,58,100,60,71,66,77,11,-40,51
320,610000,c06a2a387c0ee510,3,0,169,185,153,156,195,228,164,136,164,313,234,179,206,242,-55,-79,24
323,230000,c06a2a387c0ee510,3,0,90,127,69,65,102,113,130,76,95,177,129,74,102,127,-55,-48,-7
288,310000,7023efdab9cedc03,3,0,606,561,484,494,547,504,605,431,543,697,325,168,246,397,-157,-372,215
38,530000,7023efdab9cedc03,3,0,83,82,70,56,86,60,80,64,106,112,40,25,32,59,-15,-72,57
29,150000,7023efdab9cedc03,3,0,55,66,70,55,54,65,50,48,60,75,31,18,24,41,-13,-44,31
59,110000,7023efdab9cedc03,3,0,141,177,131,96,96,105,107,59,86,132,40,51,46,74,11,-92,103
192,510000,7023efdab9cedc03,3,0,188,226,211,185,192,194,379,187,278,408,216,117,166,247,-99,-192,93
207,340000,7023efdab9cedc03,3,0,330,375,352,304,284,383,452,363,447,587,357,148,252,364,-209,-230,21
373,370000,7023efdab9cedc03,3,0,405,655,512,403,384,434,524,437,477,555,320,180,250,352,-140,-235,95
28,140000,7023efdab9cedc03,3,0,50,77,84,53,53,40,61,59,55,64,30,23,26,39,-7,-34,27
166,440000,7023efdab9cedc03,3,0,219,282,274,225,205,191,284,225,342,408,121,39,80,189,-82,-287,205
47,450000,7023efdab9cedc03,3,0,75,77,81,56,48,72,86,66,86,129,68,34,51,77,-34,-61,27
788,320000,7023efdab9cedc03,3,0,1119,1203,1261,881,934,1240,1311,1156,1271,1767,893,628,760,1096,-265,-874,609
161,360000,7023efdab9cedc03,3,0,149,241,252,167,187,201,205,175,224,302,169,92,130,188,-77,-133,56
93,130000,7023efdab9cedc03,3,0,169,204,145,156,130,129,149,129,127,215,80,56,68,117,-24,-135,111
185,410000,7023efdab9cedc03,3,0,277,347,264,222,222,264,300,257,320,368,183,97,140,216,-86,-185,99
478,330000,7023efdab9cedc03,3,0,762,810,793,638,611,791,867,742,941,1163,445,309,377,639,-136,-718,582
172,420000,7023efdab9cedc03,3,0,191,266,209,221,204,189,253,233,287,401,211,94,152,235,-117,-190,73
173,430000,7023efdab9cedc03,3,0,191,256,228,177,169,202,213,182,259,315,201,83,142,200,-118,-114,-4
51,350000,7023efdab9cedc03,3,0,96,99,97,66,59,77,86,70,117,145,54,20,37,73,-34,-91,57
52,210000,7023efdab9cedc03,3,0,89,169,79,56,94,56,78,81,68,104,28,21,24,51,-7,-76,69
37,500000,7023efdab9cedc03,3,0,57,50,37,61,45,63,77,40,57,62,28,20,24,37,-8,-34,26
78,610000,7023efdab9cedc03,3,0,108,169,156,96,102,126,137,141,113,177,107,51,79,112,-56,-70,14
8,230000,7023efdab9cedc03,3,0,36,50,45,25,30,29,39,29,28,30,11,11,11,17,0,-19,19
957,310000,af6f4f548684e14d,3,0,1006,969,925,835,829,878,839,851,1537,1734,940,540,740,1071,-400,-794,394
346,530000,af6f4f548684e14d,3,0,410,333,370,297,444,406,375,464,639,732,400,288,344,473,-112,-332,220
323,150000,af6f4f548684e14d,3,0,302,350,427,288,345,346,426,433,493,573,322,195,258,363,-127,-251,124
601,110000,af6f4f548684e14d,3,0,553,585,621,593,551,572,648,532,915,1057,659,394,526,703,-265,-398,133
873,510000,af6f4f548684e14d,3,0,747,869,835,754,816,821,1394,1020,1293,1876,1072,611,842,1186,-461,-804,343
773,340000,af6f4f548684e14d,3,0,678,800,749,648,689,782,938,1018,1287,1597,1015,457,736,1023,-558,-582,24
1253,370000,af6f4f548684e14d,3,0,1062,1662,1314,1119,1240,1232,1497,1547,1722,2394,1077,522,800,1331,-555,-1317,762
450,140000,af6f4f548684e14d,3,0,358,423,462,359,317,365,407,489,581,742,375,248,312,455,-127,-367,240
1024,440000,af6f4f548684e14d,3,0,919,955,1092,904,1023,986,1197,1508,2163,2594,949,463,706,1335,-486,-1645,1159
322,450000,af6f4f548684e14d,3,0,368,262,320,307,308,261,338,373,502,713,341,210,276,421,-131,-372,241
1519,320000,af6f4f548684e14d,3,0,1351,1369,1459,1195,1141,1497,1413,1635,2059,2647,1466,939,1202,1684,-527,-1181,654
757,360000,af6f4f548684e14d,3,0,549,710,757,635,717,687,798,900,1083,1527,753,397,575,892,-356,-774,418
655,130000,af6f4f548684e14d,3,0,745,695,817,660,609,745,771,828,1012,1235,691,404,548,777,-287,-544,257
1119,410000,af6f4f548684e14d,3,0,938,1124,951,899,929,998,1228,1191,1470,2122,1000,589,794,1237,-411,-1122,711
978,330000,af6f4f548684e14d,3,0,799,913,926,862,813,942,1042,1090,1626,2068,1003,537,770,1203,-466,-1065,599
1058,420000,af6f4f548684e14d,3,0,799,894,947,966,785,977,1135,1284,1519,1632,1025,485,755,1047,-540,-607,67
1068,430000,af6f4f548684e14d,3,0,928,1065,1061,902,924,1034,1175,1168,1619,2178,1217,467,842,1287,-750,-961,211
433,350000,af6f4f548684e14d,3,0,347,323,473,273,417,426,426,568,767,913,522,257,390,564,-265,-391,126
277,210000,af6f4f548684e14d,3,0,288,386,363,316,315,365,365,407,443,594,254,172,213,340,-82,-340,258
342,500000,af6f4f548684e14d,3,0,303,331,291,407,357,329,386,354,500,762,420,252,336,478,-168,-342,174
306,610000,af6f4f548684e14d,3,0,401,396,383,263,316,283,360,444,478,651,365,184,274,400,-181,-286,105
207,230000,af6f4f548684e14d,3,0,274,347,288,202,213,233,201,203,289,372,142,121,132,212,-21,-230,209
975,310000,7cf283430b3b5e38,3,0,1276,1391,1398,1353,1616,1715,1560,1261,1546,1428,635,513,574,859,-122,-793,671
333,530000,7cf283430b3b5e38,3,0,300,304,335,298,451,462,412,350,412,626,249,167,208,347,-82,-377,295
320,150000,7cf283430b3b5e38,3,0,323,304,432,328,313,335,434,451,516,701,285,178,232,388,-107,-416,309
113,110000,7cf283430b3b5e38,3,0,202,284,280,232,247,248,278,174,264,913,106,74,90,364,-32,-807,775
1522,510000,7cf283430b3b5e38,3,0,1323,1763,1713,1549,1800,1833,2351,1555,1783,2691,1134,763,948,1529,-371,-1557,1186
1908,340000,7cf283430b3b5e38,3,0,1314,1838,2005,1957,2071,2572,2578,2110,2138,2356,1607,968,1288,1644,-639,-749,110
3138,370000,7cf283430b3b5e38,3,0,1837,3584,3723,2665,3185,3623,4079,3911,3787,4830,2048,1323,1686,2734,-725,-2782,2057
629,140000,7cf283430b3b5e38,3,0,390,562,695,612,635,770,774,678,852,1073,317,283,300,558,-34,-756,722
1495,440000,7cf283430b3b5e38,3,0,1288,1748,2151,1841,2105,2230,2219,1912,2435,2500,695,488,592,1228,-207,-1805,1598
738,450000,7cf283430b3b5e38,3,0,481,401,605,509,467,597,723,646,783,869,475,293,384,546,-182,-394,212
4119,320000,7cf283430b3b5e38,3,0,3351,4265,5237,4119,4343,5439,5089,5170,5016,5865,2657,2401,2529,3641,-256,-3208,2952
1502,360000,7cf283430b3b5e38,3,0,685,1136,1339,997,1282,1228,1446,1175,1376,1737,923,549,736,1070,-374,-814,440
1379,130000,7cf283430b3b5e38,3,0,1178,1462,1915,1717,1730,2030,2166,1672,1926,2621,900,720,810,1414,-180,-1721,1541
2558,410000,7cf283430b3b5e38,3,0,1347,2464,2148,2124,2569,3033,2794,2644,2874,3243,1683,1042,1362,1989,-641,-1560,919
1965,330000,7cf283430b3b5e38,3,0,2016,2464,3027,2635,2644,3079,3258,3003,3295,3490,1289,1038,1164,1939,-251,-2201,1950
1234,420000,7cf283430b3b5e38,3,0,796,1212,1354,1346,1388,1694,1779,1500,1547,1624,929,480,704,1011,-449,-695,246
1513,430000,7cf283430b3b5e38,3,0,970,1484,1556,1388,1464,1556,1793,1457,1585,1952,989,516,752,1152,-473,-963,490
859,350000,7cf283430b3b5e38,3,0,546,695,1147,600,1040,913,859,836,1130,958,546,402,474,635,-144,-412,268
446,210000,7cf283430b3b5e38,3,0,435,639,553,466,570,710,667,540,619,821,205,149,177,392,-56,-616,560
296,500000,7cf283430b3b5e38,3,0,233,248,344,487,446,463,501,422,419,597,296,163,230,352,-133,-301,168
475,610000,7cf283430b3b5e38,3,0,403,620,717,590,762,830,880,891,912,1151,413,242,328,602,-171,-738,567
301,230000,7cf283430b3b5e38,3,0,240,355,391,233,247,332,298,250,347,415,118,130,124,221,12,-297,309
45,310000,d4efbebb087fd03f,3,0,145,116,132,121,130,170,225,144,225,270,79,27,53,125,-52,-191,139
285,530000,d4efbebb087fd03f,3,0,104,130,150,124,141,193,215,192,267,384,296,172,234,284,-124,-88,-36
211,150000,d4efbebb087fd03f,3,0,191,134,180,155,165,211,257,237,359,450,248,124,186,274,-124,-202,78
556,110000,d4efbebb087fd03f,3,0,213,666,671,764,635,596,755,684,938,1287,118,74,96,493,-44,-1169,1125
891,510000,d4efbebb087fd03f,3,0,671,665,754,743,840,1135,1134,707,1002,2805,1326,797,1062,1643,-529,-1479,950
535,340000,d4efbebb087fd03f,3,0,432,458,431,427,626,807,752,716,977,1443,903,436,670,927,-467,-540,73
1343,370000,d4efbebb087fd03f,3,0,1025,1289,1432,1325,1510,2013,2253,1752,2198,3785,1878,1009,1444,2224,-869,-1907,1038
417,140000,d4efbebb087fd03f,3,0,276,293,383,273,396,591,635,370,1993,2925,603,248,426,1259,-355,-2322,1967
1078,440000,d4efbebb087fd03f,3,0,994,1031,1203,1183,1216,1851,1526,1065,2044,2419,914,399,656,1244,-515,-1505,990
492,450000,d4efbebb087fd03f,3,0,260,250,385,389,373,565,452,368,493,935,666,303,484,635,-363,-269,-94
752,320000,d4efbebb087fd03f,3,0,828,897,1057,971,1038,1263,1231,1184,1531,2308,910,648,779,1289,-262,-1398,1136
509,360000,d4efbebb087fd03f,3,0,459,469,546,479,591,657,831,701,917,1377,999,364,682,913,-635,-378,-257
741,130000,d4efbebb087fd03f,3,0,471,479,696,616,754,991,941,754,1144,2067,1110,641,876,1273,-469,-957,488
1199,410000,d4efbebb087fd03f,3,0,887,1161,1258,1321,1528,1922,1491,1090,1965,3560,2272,888,1580,2240,-1384,-1288,-96
1114,330000,d4efbebb087fd03f,3,0,1584,1570,1718,1900,1877,2534,1978,2287,3147,4324,1028,639,834,1997,-389,-3296,2907
476,420000,d4efbebb087fd03f,3,0,424,420,420,475,487,636,528,521,941,1534,1004,347,676,962,-657,-530,-127
685,430000,d4efbebb087fd03f,3,0,896,945,1034,885,1014,1148,1102,762,1142,1719,1133,438,786,1097,-695,-586,-109
656,350000,d4efbebb087fd03f,3,0,590,596,665,596,710,861,605,468,762,1967,434,268,351,890,-166,-1533,1367
205,210000,d4efbebb087fd03f,3,0,202,209,189,242,328,373,319,239,291,520,199,149,174,289,-50,-321,271
409,500000,d4efbebb087fd03f,3,0,206,305,265,352,383,500,317,253,326,532,432,291,362,418,-141,-100,-41
609,610000,d4efbebb087fd03f,3,0,382,511,669,670,984,1191,1013,830,1010,1651,919,422,670,997,-497,-732,235
114,230000,d4efbebb087fd03f,3,0,88,79,102,96,114,179,154,114,204,257,135,104,120,165,-31,-122,91
60,310000,7245e0ee27b195cd,3,0,47,54,61,91,84,82,78,75,125,158,63,40,52,87,-23,-95,72
288,530000,7245e0ee27b195cd,3,0,206,208,229,212,242,297,409,425,375,535,421,246,334,401,-175,-114,-61
250,150000,7245e0ee27b195cd,3,0,198,157,157,141,155,186,321,287,448,676,363,164,264,401,-199,-313,114
109,110000,7245e0ee27b195cd,3,0,142,158,142,166,192,229,328,289,360,496,86,74,80,219,-12,-410,398
621,510000,7245e0ee27b195cd,3,0,466,458,502,542,612,740,894,870,831,1260,724,451,588,812,-273,-536,263
358,340000,7245e0ee27b195cd,3,0,304,266,327,272,360,423,570,478,510,806,576,272,424,551,-304,-230,-74
977,370000,7245e0ee27b195cd,3,0,946,977,950,814,1067,1385,1544,1660,1778,2915,1529,762,1146,1735,-767,-1386,619
578,140000,7245e0ee27b195cd,3,0,305,328,438,304,387,526,657,689,668,1092,615,366,490,691,-249,-477,228
821,440000,7245e0ee27b195cd,3,0,467,644,800,706,726,1003,987,1170,1384,1437,718,363,540,839,-355,-719,364
370,450000,7245e0ee27b195cd,3,0,238,200,244,215,205,275,336,321,463,659,452,233,342,448,-219,-207,-12
518,320000,7245e0ee27b195cd,3,0,374,406,417,417,424,503,619,691,743,1008,543,405,474,652,-138,-465,327
323,360000,7245e0ee27b195cd,3,0,271,316,324,321,323,384,576,518,577,816,634,247,440,566,-387,-182,-205
1023,130000,7245e0ee27b195cd,3,0,734,754,897,796,976,1190,1442,1308,1432,2365,1304,951,1128,1540,-353,-1061,708
888,410000,7245e0ee27b195cd,3,0,731,764,796,796,921,1180,1362,1148,1406,2228,1526,717,1122,1490,-809,-702,-107
511,330000,7245e0ee27b195cd,3,0,491,555,599,497,546,656,656,660,874,1121,438,306,372,622,-132,-683,551
364,420000,7245e0ee27b195cd,3,0,280,340,316,308,353,445,594,534,655,903,635,255,445,598,-380,-268,-112
479,430000,7245e0ee27b195cd,3,0,571,590,590,570,561,665,852,609,763,1216,773,321,547,770,-452,-443,-9
274,350000,7245e0ee27b195cd,3,0,214,227,185,203,218,279,280,218,239,420,249,153,201,274,-96,-171,75
321,210000,7245e0ee27b195cd,3,0,240,267,276,253,308,361,450,328,514,641,287,222,254,383,-65,-354,289
238,500000,7245e0ee27b195cd,3,0,141,187,187,221,263,289,325,272,292,402,296,142,219,280,-154,-106,-48
484,610000,7245e0ee27b195cd,3,0,397,433,446,383,562,667,705,729,755,1158,815,410,612,794,-405,-343,-62
205,230000,7245e0ee27b195cd,3,0,179,118,155,141,189,179,249,176,328,336,166,145,156,216,-21,-170,149
190,310000,8c915fe4632fb9fa,3,0,160,94,156,130,143,149,181,158,314,461,180,102,141,248,-78,-281,203
778,530000,8c915fe4632fb9fa,3,0,404,239,336,248,387,336,447,627,757,1396,1059,575,817,1010,-484,-337,-147
473,150000,8c915fe4632fb9fa,3,0,199,117,165,174,186,216,287,324,527,720,520,270,395,503,-250,-200,-50
162,110000,8c915fe4632fb9fa,3,0,157,85,99,100,137,177,237,199,242,487,101,86,94,225,-15,-386,371
1302,510000,8c915fe4632fb9fa,3,0,983,554,759,618,741,845,1263,1243,1605,2433,1860,1194,1527,1829,-666,-573,-93
878,340000,8c915fe4632fb9fa,3,0,594,483,561,546,651,840,1069,1269,1370,2298,1440,720,1080,1486,-720,-858,138
1504,370000,8c915fe4632fb9fa,3,0,625,585,723,768,927,999,1485,1686,2126,3804,2217,1109,1663,2377,-1108,-1587,479
591,140000,8c915fe4632fb9fa,3,0,272,166,255,224,271,379,496,642,748,1215,772,404,588,797,-368,-443,75
977,440000,8c915fe4632fb9fa,3,0,728,449,600,502,550,650,835,848,1467,2021,1040,446,743,1169,-594,-981,387
660,450000,8c915fe4632fb9fa,3,0,351,170,257,240,225,284,342,388,511,880,738,330,534,649,-408,-142,-266
1441,320000,8c915fe4632fb9fa,3,0,985,648,883,678,762,1001,1116,1451,1816,2525,1540,1130,1335,1732,-410,-985,575
598,360000,8c915fe4632fb9fa,3,0,443,270,410,377,409,440,725,733,889,1320,1015,377,696,904,-638,-305,-333
1456,130000,8c915fe4632fb9fa,3,0,634,487,781,785,958,1014,1437,1548,2026,3281,1882,1126,1504,2096,-756,-1399,643
1413,410000,8c915fe4632fb9fa,3,0,582,542,634,719,857,953,1313,1473,1843,2975,2324,1002,1663,2100,-1322,-651,-671
880,330000,8c915fe4632fb9fa,3,0,897,591,746,723,731,805,1089,1175,1502,2235,958,565,762,1253,-393,-1277,884
782,420000,8c915fe4632fb9fa,3,0,599,444,503,489,505,669,868,924,1339,1557,1148,463,806,1056,-685,-409,-276
733,430000,8c915fe4632fb9fa,3,0,488,309,371,399,407,438,633,772,835,1281,1235,439,837,985,-796,-46,-750
529,350000,8c915fe4632fb9fa,3,0,303,174,227,178,234,282,307,414,622,877,518,365,442,587,-153,-359,206
349,210000,8c915fe4632fb9fa,3,0,236,155,177,191,236,231,291,296,396,542,311,224,268,359,-87,-231,144
346,500000,8c915fe4632fb9fa,3,0,295,169,207,227,218,259,311,316,419,666,489,274,382,476,-215,-177,-38
463,610000,8c915fe4632fb9fa,3,0,283,202,287,271,303,362,519,627,715,1549,1036,394,715,993,-642,-513,-129
684,230000,8c915fe4632fb9fa,3,0,377,252,344,319,336,422,442,411,616,998,401,372,386,590,-29,-597,568
279,310000,6155b214590c66e6,3,0,517,534,459,422,464,522,661,472,781,1047,423,192,308,554,-231,-624,393
631,530000,6155b214590c66e6,3,0,894,856,985,706,939,877,1084,1148,1159,1879,1354,680,1017,1304,-674,-525,-149
566,150000,6155b214590c66e6,3,0,457,492,583,433,551,578,725,701,941,1442,814,347,580,868,-467,-628,161
281,110000,6155b214590c66e6,3,0,397,406,411,391,454,496,664,474,569,1295,274,176,225,582,-98,-1021,923
1111,510000,6155b214590c66e6,3,0,1779,1892,1614,1306,1417,1488,2289,1556,2162,4188,2540,1081,1810,2603,-1459,-1648,189
893,340000,6155b214590c66e6,3,0,1104,1361,1443,1295,1412,1803,1996,1889,2073,3650,2495,863,1679,2336,-1632,-1155,-477
2002,370000,6155b214590c66e6,3,0,1781,2492,2580,2168,2583,2886,3461,3252,3594,6275,3467,1356,2412,3699,-2111,-2808,697
500,140000,6155b214590c66e6,3,0,482,602,630,509,619,652,805,800,914,1576,743,357,550,892,-386,-833,447
1364,440000,6155b214590c66e6,3,0,1659,1766,2201,1866,1837,2246,2808,2902,3269,4342,1784,653,1218,2260,-1131,-2558,1427
556,450000,6155b214590c66e6,3,0,603,500,655,477,518,574,670,621,739,1316,892,381,636,863,-511,-424,-87
2316,320000,6155b214590c66e6,3,0,2831,2838,3224,2468,2600,3230,3453,3560,3776,5864,3032,1760,2396,3552,-1272,-2832,1560
603,360000,6155b214590c66e6,3,0,783,897,980,839,839,860,1325,1195,1285,2160,1579,453,1016,1397,-1126,-581,-545
1427,130000,6155b214590c66e6,3,0,1287,1778,2039,1774,2024,2258,2481,2298,2594,4551,2375,1231,1803,2719,-1144,-2176,1032
1915,410000,6155b214590c66e6,3,0,2034,2494,2508,2539,3103,3396,3571,3427,4047,8018,5309,1586,3448,4971,-3723,-2709,-1014
1161,330000,6155b214590c66e6,3,0,1705,1980,2136,1905,1897,2229,2579,2724,3014,4336,1679,826,1252,2280,-853,-2657,1804
906,420000,6155b214590c66e6,3,0,1237,1346,1186,1236,1304,1341,1747,1512,1848,3179,2049,551,1300,1926,-1498,-1130,-368
1157,430000,6155b214590c66e6,3,0,1417,1610,1468,1450,1536,1679,2187,1872,2355,3747,2461,732,1596,2313,-1729,-1286,-443
463,350000,6155b214590c66e6,3,0,549,639,683,519,626,618,738,859,1140,1306,596,364,480,755,-232,-710,478
765,210000,6155b214590c66e6,3,0,737,900,949,846,1022,1132,1218,970,1188,1784,769,415,592,989,-354,-1015,661
399,500000,6155b214590c66e6,3,0,596,660,656,695,635,655,770,622,761,1417,877,373,625,889,-504,-540,36
361,610000,6155b214590c66e6,3,0,425,548,688,468,587,654,727,899,841,1546,1008,303,656,952,-705,-538,-167
604,230000,6155b214590c66e6,3,0,638,624,692,573,663,777,675,517,944,1290,579,365,472,745,-214,-711,497
764,310000,28e29f2c03dcd84c,3,0,900,712,656,680,680,720,820,623,807,1293,851,433,642,859,-418,-442,24
415,530000,28e29f2c03dcd84c,3,0,271,184,252,242,468,405,456,394,535,639,509,300,404,483,-209,-130,-79
556,150000,28e29f2c03dcd84c,3,0,342,266,364,340,407,480,482,477,451,580,494,276,385,450,-218,-86,-132
1308,110000,28e29f2c03dcd84c,3,0,1376,1000,1124,1019,1062,1143,1276,969,1288,2146,1327,923,1125,1465,-404,-819,415
680,510000,28e29f2c03dcd84c,3,0,541,447,452,487,585,715,1123,634,781,1105,856,454,655,805,-402,-249,-153
644,340000,28e29f2c03dcd84c,3,0,554,507,478,422,472,667,840,774,803,1070,953,364,658,796,-589,-117,-472
1244,370000,28e29f2c03dcd84c,3,0,1035,932,915,988,988,1162,1315,1224,1513,1837,1329,778,1054,1315,-551,-508,-43
746,140000,28e29f2c03dcd84c,3,0,679,602,669,598,604,750,729,770,798,1203,945,474,710,874,-471,-258,-213
427,440000,28e29f2c03dcd84c,3,0,313,221,266,335,313,351,438,425,536,825,423,180,302,476,-243,-402,159
140,450000,28e29f2c03dcd84c,3,0,156,79,110,114,93,121,141,135,160,243,179,71,125,164,-108,-64,-44
1565,320000,28e29f2c03dcd84c,3,0,1350,1122,1198,1215,1276,1793,1838,1848,1951,2643,1820,1058,1439,1840,-762,-823,61
325,360000,28e29f2c03dcd84c,3,0,355,293,295,274,321,334,419,377,424,571,408,151,280,377,-257,-163,-94
1377,130000,28e29f2c03dcd84c,3,0,1063,923,1024,961,977,1321,1377,1264,1433,1923,1604,884,1244,1470,-720,-319,-401
1003,410000,28e29f2c03dcd84c,3,0,827,723,780,738,834,1010,1081,952,1113,1482,1178,548,863,1069,-630,-304,-326
679,330000,28e29f2c03dcd84c,3,0,577,432,444,464,536,601,733,722,894,1112,767,352,560,744,-415,-345,-70
271,420000,28e29f2c03dcd84c,3,0,258,236,284,317,260,295,373,329,377,483,446,164,305,364,-282,-37,-245
452,430000,28e29f2c03dcd84c,3,0,403,317,301,333,339,383,464,438,477,783,487,262,374,511,-225,-296,71
227,350000,28e29f2c03dcd84c,3,0,321,213,189,158,212,189,235,212,345,456,397,140,268,331,-257,-59,-198
356,210000,28e29f2c03dcd84c,3,0,216,236,253,279,277,296,261,247,251,310,270,165,218,248,-105,-40,-65
408,500000,28e29f2c03dcd84c,3,0,369,328,342,482,408,414,486,426,491,644,555,263,409,487,-292,-89,-203
603,610000,28e29f2c03dcd84c,3,0,439,293,395,348,388,413,568,617,622,758,719,361,540,613,-358,-39,-319
149,230000,28e29f2c03dcd84c,3,0,156,121,150,115,124,187,159,142,152,169,104,79,92,117,-25,-65,40
86,310000,37aa9169b575ef79,3,0,64,37,32,39,46,46,41,395,67,117,63,37,50,72,-26,-54,28
1035,530000,37aa9169b575ef79,3,0,1431,1186,1072,971,1395,1426,1254,988,1142,1590,946,692,819,1076,-254,-644,390
714,150000,37aa9169b575ef79,3,0,769,698,895,690,744,864,895,802,945,982,602,413,508,666,-189,-380,191
404,110000,37aa9169b575ef79,3,0,982,803,698,717,716,794,737,477,625,985,300,271,286,519,-29,-685,656
3175,510000,37aa9169b575ef79,3,0,2758,2537,2734,2651,2620,2791,2955,1733,2221,3340,1470,1639,1554,2150,169,-1870,2039
384,340000,37aa9169b575ef79,3,0,581,410,402,479,502,552,488,424,410,575,248,260,254,361,12,-327,339
2748,370000,37aa9169b575ef79,3,0,3709,3356,3511,2812,3126,3130,3837,3617,3662,4024,1903,1708,1806,2545,-195,-2121,1926
672,140000,37aa9169b575ef79,3,0,1176,933,1057,828,993,1217,1561,1243,1188,1616,679,442,560,912,-237,-937,700
2249,440000,37aa9169b575ef79,3,0,1889,1775,1785,1654,1766,1963,2010,1906,2111,2398,1196,1075,1136,1556,-121,-1202,1081
449,450000,37aa9169b575ef79,3,0,462,403,353,331,405,319,409,384,459,435,440,301,370,392,-139,5,-144
655,320000,37aa9169b575ef79,3,0,942,753,875,786,701,745,840,781,777,930,527,626,576,694,99,-403,502
356,360000,37aa9169b575ef79,3,0,379,339,330,292,330,358,538,488,482,540,354,189,272,361,-165,-186,21
2633,130000,37aa9169b575ef79,3,0,3367,3025,3349,3221,3102,3388,3910,3483,3233,4206,2068,1780,1924,2685,-288,-2138,1850
1823,410000,37aa9169b575ef79,3,0,2093,1984,2022,1974,2200,2100,2323,1931,2018,2962,1570,1050,1310,1861,-520,-1392,872
628,330000,37aa9169b575ef79,3,0,837,836,827,820,769,777,723,606,634,886,424,422,423,577,-2,-462,460
442,420000,37aa9169b575ef79,3,0,867,611,610,623,595,715,725,585,544,920,483,270,376,558,-213,-437,224
1232,430000,37aa9169b575ef79,3,0,2020,1616,1475,1358,1456,1533,1680,1444,1489,2336,1714,653,1184,1568,-1061,-622,-439
460,350000,37aa9169b575ef79,3,0,657,579,484,487,627,773,710,690,597,622,308,292,300,407,-16,-314,298
1319,210000,37aa9169b575ef79,3,0,1439,1484,1508,1498,1804,1815,1871,1308,1478,1878,681,691,686,1083,10,-1197,1207
125,500000,37aa9169b575ef79,3,0,284,211,204,370,530,502,347,184,172,247,131,105,118,161,-26,-116,90
605,610000,37aa9169b575ef79,3,0,771,729,604,479,874,1106,695,580,634,1051,558,384,471,664,-174,-493,319
1556,230000,37aa9169b575ef79,3,0,1914,1499,1291,1253,1193,1427,1562,1308,1636,1781,730,952,841,1154,222,-1051,1273
2672,310000,63065128401bb3ff,3,0,2243,2672,2922,2462,1180,1500,2397,1674,2362,3060,1909,501,1205,1823,-1408,-1151,-257
651,530000,63065128401bb3ff,3,0,707,630,647,551,884,974,1076,1038,1033,1402,656,504,580,854,-152,-746,594
376,150000,63065128401bb3ff,3,0,525,430,507,344,410,446,541,468,630,827,268,214,241,436,-54,-559,505
2331,110000,63065128401bb3ff,3,0,2808,1941,2551,971,995,1118,835,516,1494,2145,217,200,208,854,-17,-1928,1911
1478,510000,63065128401bb3ff,3,0,2143,1834,1543,1533,1662,1864,2707,1708,2119,2450,1355,937,1146,1581,-418,-1095,677
1436,340000,63065128401bb3ff,3,0,1764,1722,1828,1799,2028,2809,2863,2529,2927,3132,1460,775,1118,1789,-685,-1672,987
2010,370000,63065128401bb3ff,3,0,3115,3589,3471,2715,3147,4018,4409,4129,4087,5401,1885,1225,1555,2837,-660,-3516,2856
877,140000,63065128401bb3ff,3,0,1146,1022,1337,977,1223,1490,1510,1452,1547,2066,692,491,592,1083,-201,-1374,1173
1475,440000,63065128401bb3ff,3,0,2905,1816,1983,1796,1715,2112,2192,2036,2188,2519,625,462,544,1202,-163,-1894,1731
366,450000,63065128401bb3ff,3,0,549,377,518,379,413,503,589,568,596,616,308,176,242,367,-132,-308,176
2644,320000,63065128401bb3ff,3,0,3990,3393,3757,3219,3369,4854,5016,4475,5007,5643,2143,1862,2002,3216,-281,-3500,3219
916,360000,63065128401bb3ff,3,0,1305,1276,1370,1233,1308,1681,2044,1627,1981,2357,973,442,708,1257,-531,-1384,853
2043,130000,63065128401bb3ff,3,0,2484,2675,3198,2587,2964,3829,3951,3277,3711,5424,1723,1261,1492,2803,-462,-3701,3239
2429,410000,63065128401bb3ff,3,0,2442,2757,2736,2702,3421,4398,4500,3793,4237,5119,2463,1238,1850,2940,-1225,-2656,1431
1359,330000,63065128401bb3ff,3,0,2050,1853,2092,1953,2021,2513,2777,2324,2401,2755,895,768,832,1473,-127,-1860,1733
841,420000,63065128401bb3ff,3,0,1381,1205,1158,1213,1120,1591,1818,1296,1466,1985,1002,357,680,1115,-645,-983,338
1104,430000,63065128401bb3ff,3,0,1689,1645,1561,1517,1583,1906,2187,1670,2078,2533,1085,531,808,1383,-554,-1448,894
775,350000,63065128401bb3ff,3,0,1142,977,1082,843,1055,1347,1279,1170,1218,1549,440,400,420,796,-40,-1109,1069
386,210000,63065128401bb3ff,3,0,781,766,859,586,702,806,897,700,869,1098,268,212,240,526,-56,-830,774
603,500000,63065128401bb3ff,3,0,936,946,870,1013,987,1230,1171,824,938,1120,617,359,488,699,-258,-503,245
661,610000,63065128401bb3ff,3,0,869,1036,1284,861,1113,1278,1300,1165,1199,1748,631,397,514,925,-234,-1117,883
276,230000,63065128401bb3ff,3,0,484,451,421,327,303,404,404,286,466,480,162,156,159,266,-6,-318,312
767,310000,ea489c253676aafc,3,0,906,709,759,629,425,535,502,314,574,754,315,362,338,477,47,-439,486
448,530000,ea489c253676aafc,3,0,500,421,595,461,551,450,435,635,692,866,452,295,374,538,-157,-414,257
591,150000,ea489c253676aafc,3,0,577,507,561,440,380,452,427,495,612,941,427,254,340,541,-173,-514,341
159,110000,ea489c253676aafc,3,0,482,498,353,301,382,397,346,199,341,546,125,89,107,253,-36,-421,385
1344,510000,ea489c253676aafc,3,0,1444,1326,1270,1055,1379,1197,903,838,1187,1812,1017,704,860,1178,-313,-795,482
869,340000,ea489c253676aafc,3,0,1184,1065,1021,869,1109,958,734,813,952,1669,741,475,608,962,-266,-928,662
2865,370000,ea489c253676aafc,3,0,3780,3634,3404,2787,3450,3299,2451,2995,3812,5496,2330,1515,1922,3114,-815,-3166,2351
1247,140000,ea489c253676aafc,3,0,1482,1678,1725,1270,1462,1588,1052,1126,1234,2626,1165,641,903,1477,-524,-1461,937
433,440000,ea489c253676aafc,3,0,510,397,473,460,457,448,529,384,525,1055,368,255,312,559,-113,-687,574
240,450000,ea489c253676aafc,3,0,461,182,302,352,363,291,255,362,355,448,365,155,260,323,-210,-83,-127
1507,320000,ea489c253676aafc,3,0,1639,1304,1178,1368,1353,1085,864,1310,1728,2261,1167,1028,1098,1485,-139,-1094,955
316,360000,ea489c253676aafc,3,0,492,421,412,315,365,335,301,356,946,847,641,223,432,570,-418,-206,-212
2981,130000,ea489c253676aafc,3,0,2946,3004,3190,2715,3210,3609,2265,2586,3058,5478,1932,1551,1742,2987,-381,-3546,3165
1695,410000,ea489c253676aafc,3,0,1920,1867,1905,1469,1701,1452,1141,1472,1941,3092,1731,893,1312,1905,-838,-1361,523
741,330000,ea489c253676aafc,3,0,1342,916,1100,1016,1000,913,659,638,706,1205,504,467,486,725,-37,-701,664
273,420000,ea489c253676aafc,3,0,433,470,347,353,277,263,202,272,348,657,298,154,226,370,-144,-359,215
448,430000,ea489c253676aafc,3,0,989,827,849,769,962,701,698,568,587,1351,576,253,414,727,-323,-775,452
255,350000,ea489c253676aafc,3,0,369,321,335,225,356,355,342,307,452,617,215,148,182,327,-67,-402,335
768,210000,ea489c253676aafc,3,0,979,733,783,589,621,716,684,572,853,1026,394,408,401,609,14,-632,646
346,500000,ea489c253676aafc,3,0,549,493,497,413,558,474,304,408,379,694,353,248,300,432,-105,-341,236
791,610000,ea489c253676aafc,3,0,608,683,599,723,667,832,623,693,804,1400,754,418,586,857,-336,-646,310
503,230000,ea489c253676aafc,3,0,532,645,383,283,369,508,307,324,496,710,280,266,273,419,-14,-430,416
321,310000,cd5841d44fd7625e,3,0,289,246,249,228,201,232,150,148,312,359,339,177,258,292,-162,-20,-142
357,530000,cd5841d44fd7625e,3,0,264,283,346,330,388,290,304,344,442,485,409,248,328,381,-161,-76,-85
522,150000,cd5841d44fd7625e,3,0,236,276,395,262,398,348,325,432,401,434,519,319,419,424,-200,85,-285
1267,110000,cd5841d44fd7625e,3,0,1252,1112,1156,1039,990,1183,1150,795,1121,1802,1263,877,1070,1314,-386,-539,153
951,510000,cd5841d44fd7625e,3,0,639,702,679,596,623,519,741,610,732,1083,1390,565,978,1013,-825,307,-1132
471,340000,cd5841d44fd7625e,3,0,335,339,414,403,381,360,323,440,519,629,667,315,491,537,-352,38,-390
1578,370000,cd5841d44fd7625e,3,0,1162,1362,1499,1162,1256,1311,1391,1370,1666,1642,1861,878,1370,1460,-983,219,-1202
451,140000,cd5841d44fd7625e,3,0,381,342,380,264,316,332,330,480,421,414,426,317,372,386,-109,12,-121
827,440000,cd5841d44fd7625e,3,0,499,400,553,537,509,516,523,704,995,1243,727,322,524,764,-405,-516,111
204,450000,cd5841d44fd7625e,3,0,100,87,113,102,97,101,156,159,192,214,225,119,172,186,-106,11,-117
1301,320000,cd5841d44fd7625e,3,0,1051,1024,1236,925,785,871,1280,881,1099,1374,1336,868,1102,1193,-468,-38,-430
291,360000,cd5841d44fd7625e,3,0,198,208,246,191,199,169,178,237,276,329,364,141,252,278,-223,35,-258
1697,130000,cd5841d44fd7625e,3,0,1322,1150,1563,1391,1238,1360,1115,1052,1461,1615,1768,1165,1466,1516,-603,153,-756
1325,410000,cd5841d44fd7625e,3,0,792,984,996,913,957,1047,1104,1357,1223,1443,1429,856,1142,1243,-573,-14,-559
707,330000,cd5841d44fd7625e,3,0,485,482,592,492,475,404,404,512,747,863,742,356,549,654,-386,-121,-265
443,420000,cd5841d44fd7625e,3,0,350,350,345,337,298,379,393,374,473,566,558,262,410,462,-296,-8,-288
424,430000,cd5841d44fd7625e,3,0,301,261,307,277,273,291,253,248,418,494,519,230,374,414,-289,25,-314
330,350000,cd5841d44fd7625e,3,0,288,229,307,216,229,183,186,285,325,402,404,188,296,331,-216,2,-218
870,210000,cd5841d44fd7625e,3,0,566,616,593,769,652,721,569,738,644,1082,704,546,625,777,-158,-378,220
335,500000,cd5841d44fd7625e,3,0,224,260,274,314,254,213,262,251,282,391,433,202,318,342,-231,42,-273
378,610000,cd5841d44fd7625e,3,0,273,411,522,312,356,360,419,276,346,497,487,257,372,414,-230,-10,-220
1198,230000,cd5841d44fd7625e,3,0,986,775,794,828,639,929,731,657,664,964,785,666,726,805,-119,-179,60
731,310000,b25c4e2e3856af22,3,0,1144,987,982,1141,897,946,1150,1010,1563,1504,815,447,631,922,-368,-689,321
403,530000,b25c4e2e3856af22,3,0,491,429,522,373,681,595,570,759,692,785,585,277,431,549,-308,-200,-108
229,150000,b25c4e2e3856af22,3,0,204,243,365,254,296,333,327,407,342,430,303,110,206,281,-193,-127,-66
427,110000,b25c4e2e3856af22,3,0,672,745,768,998,675,772,925,740,925,1127,376,284,330,596,-92,-751,659
764,510000,b25c4e2e3856af22,3,0,913,980,978,903,990,1085,1885,1100,1320,1775,1096,562,829,1144,-534,-679,145
600,340000,b25c4e2e3856af22,3,0,798,764,823,725,769,980,1023,1001,1064,1490,952,364,658,935,-588,-538,-50
805,370000,b25c4e2e3856af22,3,0,940,1108,1210,1082,1134,1323,1432,1303,1408,1739,940,501,720,1060,-439,-799,360
151,140000,b25c4e2e3856af22,3,0,312,291,326,221,257,295,289,333,332,371,229,113,171,238,-116,-142,26
986,440000,b25c4e2e3856af22,3,0,1174,995,1269,1114,1097,1195,1320,1463,1644,2216,854,451,652,1174,-403,-1362,959
237,450000,b25c4e2e3856af22,3,0,246,212,277,223,187,218,240,280,255,372,218,114,166,235,-104,-154,50
1345,320000,b25c4e2e3856af22,3,0,1686,1487,1639,1433,1571,1947,1897,1872,2263,3132,1586,987,1286,1902,-599,-1546,947
498,360000,b25c4e2e3856af22,3,0,671,722,759,661,681,684,855,798,870,1144,754,284,519,727,-470,-390,-80
599,130000,b25c4e2e3856af22,3,0,776,716,788,622,676,985,861,883,944,1218,652,442,547,771,-210,-566,356
700,410000,b25c4e2e3856af22,3,0,810,959,936,866,965,1056,1067,1021,1121,1578,856,471,664,968,-385,-722,337
1369,330000,b25c4e2e3856af22,3,0,1880,1823,1961,1826,1921,2037,2367,2323,2703,3371,1749,893,1321,2004,-856,-1622,766
579,420000,b25c4e2e3856af22,3,0,746,751,751,798,730,829,920,1033,988,1333,941,363,652,879,-578,-392,-186
716,430000,b25c4e2e3856af22,3,0,798,869,852,770,811,908,1056,973,1081,1561,1003,386,694,983,-617,-558,-59
551,350000,b25c4e2e3856af22,3,0,744,580,799,587,681,684,714,853,905,1102,667,370,518,713,-297,-435,138
258,210000,b25c4e2e3856af22,3,0,302,339,376,332,444,478,491,437,403,555,253,188,220,332,-65,-302,237
293,500000,b25c4e2e3856af22,3,0,388,450,403,448,421,422,477,428,496,740,452,184,318,459,-268,-288,20
292,610000,b25c4e2e3856af22,3,0,327,347,397,335,338,351,433,450,479,533,395,223,309,384,-172,-138,-34
281,230000,b25c4e2e3856af22,3,0,415,369,422,399,362,461,359,320,352,428,213,219,216,287,6,-215,221
396,310000,4a103c30d593fbbe,3,0,494,480,438,464,464,563,552,450,685,688,275,231,253,398,-44,-413,369
443,530000,4a103c30d593fbbe,3,0,551,494,611,509,837,743,640,687,714,1001,409,321,365,577,-88,-592,504
440,150000,4a103c30d593fbbe,3,0,409,555,665,393,509,544,557,650,671,789,370,239,304,466,-131,-419,288
619,110000,4a103c30d593fbbe,3,0,1236,1175,1102,1018,1021,1288,1431,1045,1332,1807,402,360,381,856,-42,-1405,1363
1523,510000,4a103c30d593fbbe,3,0,1972,2107,1866,1748,1887,2009,2921,2017,2913,3590,1589,1106,1348,2095,-483,-2001,1518
995,340000,4a103c30d593fbbe,3,0,1041,1182,1170,1110,1307,1431,1596,1491,1717,1968,921,593,757,1161,-328,-1047,719
1856,370000,4a103c30d593fbbe,3,0,2092,2449,2486,1895,2003,2387,2615,2547,2776,3299,1329,945,1137,1858,-384,-1970,1586
510,140000,4a103c30d593fbbe,3,0,673,634,789,589,641,800,787,813,782,1130,401,261,331,597,-140,-729,589
1081,440000,4a103c30d593fbbe,3,0,1264,996,1286,1093,1029,1303,1438,1702,2171,2397,475,354,414,1075,-121,-1922,1801
348,450000,4a103c30d593fbbe,3,0,369,263,323,295,287,282,358,395,493,595,225,179,202,333,-46,-370,324
2234,320000,4a103c30d593fbbe,3,0,2786,2473,3080,2334,2394,3107,2962,3228,3579,4302,1623,1477,1550,2467,-146,-2679,2533
537,360000,4a103c30d593fbbe,3,0,491,598,657,503,672,641,755,781,885,1016,398,230,314,548,-168,-618,450
2239,130000,4a103c30d593fbbe,3,0,2330,2475,2921,2392,2559,2979,2860,2877,2989,3954,1565,1311,1438,2277,-254,-2389,2135
1684,410000,4a103c30d593fbbe,3,0,1587,2122,1817,1841,2115,2398,2493,2358,2638,3291,1489,872,1180,1884,-617,-1802,1185
1491,330000,4a103c30d593fbbe,3,0,1688,1755,1827,1550,1572,1914,1992,2163,2458,2897,961,793,877,1550,-168,-1936,1768
634,420000,4a103c30d593fbbe,3,0,870,703,828,848,789,996,1142,948,1247,1304,805,357,581,822,-448,-499,51
565,430000,4a103c30d593fbbe,3,0,710,632,689,696,720,817,950,757,948,1222,427,264,346,638,-163,-795,632
518,350000,4a103c30d593fbbe,3,0,669,569,777,495,680,640,694,837,946,924,385,327,356,545,-58,-539,481
828,210000,4a103c30d593fbbe,3,0,985,1021,1093,717,904,1088,1057,1007,1160,1513,414,423,418,783,9,-1099,1108
288,500000,4a103c30d593fbbe,3,0,312,317,246,378,375,374,365,407,493,612,296,209,252,372,-87,-316,229
410,610000,4a103c30d593fbbe,3,0,582,607,926,472,701,761,801,945,946,1143,404,239,322,595,-165,-739,574
1058,230000,4a103c30d593fbbe,3,0,987,974,825,774,757,1154,914,753,1190,1198,462,436,449,699,-26,-736,710
653,310000,7a7885e2d7c00bcf,3,0,778,523,603,553,600,670,690,633,790,925,325,455,390,568,130,-600,730
317,530000,7a7885e2d7c00bcf,3,0,415,322,387,317,493,447,408,431,527,546,194,218,206,319,24,-352,376
287,150000,7a7885e2d7c00bcf,3,0,300,265,350,301,313,341,355,371,359,418,168,163,166,250,-5,-250,245
831,110000,7a7885e2d7c00bcf,3,0,1017,846,916,826,879,911,1074,915,1162,1615,471,523,497,870,52,-1144,1196
738,510000,7a7885e2d7c00bcf,3,0,879,706,738,715,745,722,1155,772,961,1167,445,516,480,709,71,-722,793
658,340000,7a7885e2d7c00bcf,3,0,675,647,692,656,677,767,841,878,933,1003,374,418,396,598,44,-629,673
1739,370000,7a7885e2d7c00bcf,3,0,1928,1822,1978,1685,1638,1852,2308,2307,2370,2766,875,984,930,1542,109,-1891,2000
247,140000,7a7885e2d7c00bcf,3,0,314,241,352,275,285,300,313,320,355,484,139,184,162,269,45,-345,390
896,440000,7a7885e2d7c00bcf,3,0,1042,810,979,912,937,951,992,1092,1209,1464,402,402,402,756,0,-1062,1062
224,450000,7a7885e2d7c00bcf,3,0,288,186,265,233,260,262,246,259,290,384,118,109,114,204,-9,-266,257
2234,320000,7a7885e2d7c00bcf,3,0,2488,1949,2522,2016,2112,2209,2679,2595,2801,3241,1057,1612,1334,1970,555,-2184,2739
385,360000,7a7885e2d7c00bcf,3,0,434,361,405,347,434,393,442,498,481,511,213,176,194,300,-37,-298,261
1533,130000,7a7885e2d7c00bcf,3,0,1561,1277,1469,1298,1298,1461,1525,1603,1929,2115,754,885,820,1251,131,-1361,1492
1200,410000,7a7885e2d7c00bcf,3,0,1090,1137,1026,959,1096,1283,1383,1309,1461,1740,591,724,658,1018,133,-1149,1282
1764,330000,7a7885e2d7c00bcf,3,0,1999,1632,1956,1671,1999,1697,1991,2033,2127,2662,818,1237,1028,1572,419,-1844,2263
470,420000,7a7885e2d7c00bcf,3,0,537,473,508,574,499,596,611,603,616,685,305,279,292,423,-26,-380,354
497,430000,7a7885e2d7c00bcf,3,0,575,412,494,442,503,514,645,501,559,768,256,278,267,434,22,-512,534
389,350000,7a7885e2d7c00bcf,3,0,512,409,530,373,503,451,397,473,480,608,216,257,236,360,41,-392,433
412,210000,7a7885e2d7c00bcf,3,0,558,476,514,420,483,505,553,489,516,595,169,217,193,327,48,-426,474
133,500000,7a7885e2d7c00bcf,3,0,156,120,135,198,189,145,189,159,216,258,69,99,84,142,30,-189,219
361,610000,7a7885e2d7c00bcf,3,0,468,393,540,321,402,487,425,510,487,657,185,238,212,360,53,-472,525
535,230000,7a7885e2d7c00bcf,3,0,628,493,470,454,420,611,511,443,413,533,157,228,192,306,71,-376,447
45,310000,346393c2c6305fb1,3,0,117,123,63,113,83,134,126,104,114,215,76,41,58,111,-35,-139,104
34,530000,346393c2c6305fb1,3,0,114,92,106,89,141,121,133,139,121,182,95,41,68,106,-54,-87,33
95,150000,346393c2c6305fb1,3,0,123,107,124,111,114,92,121,108,174,205,99,66,82,123,-33,-106,73
54,110000,346393c2c6305fb1,3,0,234,172,132,149,201,202,250,161,243,439,74,40,57,184,-34,-365,331
136,510000,346393c2c6305fb1,3,0,328,331,262,301,284,317,459,291,297,513,309,153,231,325,-156,-204,48
312,340000,346393c2c6305fb1,3,0,680,514,529,526,633,733,655,600,692,1047,578,273,426,633,-305,-469,164
538,370000,346393c2c6305fb1,3,0,802,922,771,855,1000,1063,1138,1097,1099,1844,902,381,642,1042,-521,-942,421
237,140000,346393c2c6305fb1,3,0,155,211,195,143,212,261,250,277,308,545,238,158,198,314,-80,-307,227
118,440000,346393c2c6305fb1,3,0,154,162,145,223,291,295,282,277,289,373,126,71,98,190,-55,-247,192
69,450000,346393c2c6305fb1,3,0,97,54,71,100,108,107,108,100,115,162,93,53,73,103,-40,-69,29
197,320000,346393c2c6305fb1,3,0,454,332,411,403,402,461,370,406,397,621,300,168,234,363,-132,-321,189
61,360000,346393c2c6305fb1,3,0,101,96,91,121,141,112,150,164,143,266,151,36,94,151,-115,-115,0
430,130000,346393c2c6305fb1,3,0,620,514,537,455,575,645,742,699,808,1460,748,389,568,866,-359,-712,353
251,410000,346393c2c6305fb1,3,0,298,313,364,453,477,544,566,471,617,1100,524,174,349,599,-350,-576,226
63,330000,346393c2c6305fb1,3,0,158,153,145,161,194,181,198,211,191,260,101,55,78,139,-46,-159,113
103,420000,346393c2c6305fb1,3,0,211,178,180,285,274,266,326,324,313,534,275,79,177,296,-196,-259,63
163,430000,346393c2c6305fb1,3,0,247,217,180,205,282,273,347,286,335,535,308,119,214,321,-189,-227,38
51,350000,346393c2c6305fb1,3,0,82,56,58,88,101,114,102,89,87,129,60,25,42,71,-35,-69,34
133,210000,346393c2c6305fb1,3,0,279,252,262,234,252,331,280,278,265,371,149,91,120,204,-58,-222,164
69,500000,346393c2c6305fb1,3,0,178,190,138,222,247,251,250,189,199,335,168,84,126,196,-84,-167,83
83,610000,346393c2c6305fb1,3,0,118,112,151,113,180,161,167,197,186,360,209,62,136,210,-147,-151,4
154,230000,346393c2c6305fb1,3,0,215,165,177,206,165,264,248,169,223,312,126,95,110,178,-31,-186,155
731,310000,02aab221aabc03b9,3,0,554,507,485,527,653,687,651,489,558,362,679,494,586,512,-185,317,-502
223,530000,02aab221aabc03b9,3,0,174,151,202,185,247,209,201,174,160,155,229,130,180,171,-99,74,-173
136,150000,02aab221aabc03b9,3,0,90,76,95,106,108,130,97,99,82,59,106,63,84,76,-43,47,-90
838,110000,02aab221aabc03b9,3,0,733,545,566,646,748,847,831,642,654,521,798,532,665,617,-266,277,-543
653,510000,02aab221aabc03b9,3,0,439,421,431,486,460,559,615,471,430,474,703,394,548,524,-309,229,-538
372,340000,02aab221aabc03b9,3,0,198,252,223,244,244,344,348,248,228,187,338,203,270,243,-135,151,-286
607,370000,02aab221aabc03b9,3,0,412,457,437,443,584,549,525,474,421,353,610,362,486,442,-248,257,-505
160,140000,02aab221aabc03b9,3,0,112,93,114,101,121,154,121,105,117,105,129,94,112,109,-35,24,-59
1361,440000,02aab221aabc03b9,3,0,1124,891,1008,1160,1083,1238,1180,1049,976,1007,1207,847,1027,1020,-360,200,-560
172,450000,02aab221aabc03b9,3,0,133,79,114,129,142,161,151,126,138,119,159,102,130,127,-57,40,-97
1713,320000,02aab221aabc03b9,3,0,1400,1291,1323,1469,1509,1821,1585,1270,1186,1077,1735,1066,1400,1293,-669,658,-1327
291,360000,02aab221aabc03b9,3,0,153,158,177,165,198,224,232,164,154,152,242,146,194,180,-96,90,-186
360,130000,02aab221aabc03b9,3,0,239,297,312,337,350,330,362,307,254,182,340,242,291,255,-98,158,-256
311,410000,02aab221aabc03b9,3,0,301,358,277,291,353,389,339,239,284,223,320,199,260,247,-121,97,-218
1602,330000,02aab221aabc03b9,3,0,1150,1124,1121,1210,1486,1568,1439,1239,1136,1024,1529,973,1251,1175,-556,505,-1061
369,420000,02aab221aabc03b9,3,0,276,286,265,300,346,383,407,272,273,274,370,238,304,294,-132,96,-228
346,430000,02aab221aabc03b9,3,0,209,229,207,229,257,270,285,213,205,215,305,186,246,235,-119,90,-209
572,350000,02aab221aabc03b9,3,0,331,340,375,354,394,437,448,353,321,324,518,242,380,361,-276,194,-470
321,210000,02aab221aabc03b9,3,0,206,234,226,254,291,346,299,229,207,174,292,205,248,224,-87,118,-205
277,500000,02aab221aabc03b9,3,0,226,204,204,232,259,222,255,197,217,217,267,199,233,228,-68,50,-118
281,610000,02aab221aabc03b9,3,0,192,213,288,241,238,319,283,263,205,197,285,151,218,211,-134,88,-222
133,230000,02aab221aabc03b9,3,0,74,80,87,80,75,119,71,81,63,53,93,68,80,71,-25,40,-65
297,310000,5d7fb682edd0f937,3,0,397,283,308,272,297,303,281,281,247,225,315,160,238,233,-155,90,-245
164,530000,5d7fb682edd0f937,3,0,159,143,175,143,190,187,165,167,133,176,164,108,136,149,-56,-12,-44
103,150000,5d7fb682edd0f937,3,0,91,82,115,109,112,117,120,96,85,86,86,62,74,78,-24,0,-24
356,110000,5d7fb682edd0f937,3,0,428,353,385,362,331,427,429,308,324,417,323,190,256,310,-133,-94,-39
411,510000,5d7fb682edd0f937,3,0,376,344,382,380,359,376,389,305,301,337,483,166,324,329,-317,146,-463
173,340000,5d7fb682edd0f937,3,0,169,162,175,187,156,227,205,162,169,174,188,119,154,160,-69,14,-83
306,370000,5d7fb682edd0f937,3,0,290,276,307,309,263,302,292,265,227,253,339,160,250,251,-179,86,-265
97,140000,5d7fb682edd0f937,3,0,77,59,95,91,82,103,99,83,81,91,111,56,84,86,-55,20,-75
531,440000,5d7fb682edd0f937,3,0,629,501,543,522,480,565,575,462,510,512,581,314,448,469,-267,69,-336
103,450000,5d7fb682edd0f937,3,0,86,103,113,124,96,117,108,102,103,109,128,57,92,98,-71,19,-90
741,320000,5d7fb682edd0f937,3,0,831,673,752,698,733,823,757,642,661,734,807,456,632,666,-351,73,-424
158,360000,5d7fb682edd0f937,3,0,143,134,157,139,120,153,155,115,129,138,165,79,122,127,-86,27,-113
201,130000,5d7fb682edd0f937,3,0,201,188,230,197,195,219,226,184,180,178,203,126,164,169,-77,25,-102
191,410000,5d7fb682edd0f937,3,0,163,205,180,189,189,186,187,161,189,173,186,103,144,154,-83,13,-96
738,330000,5d7fb682edd0f937,3,0,696,636,660,565,645,709,620,587,599,595,656,382,519,544,-274,61,-335
257,420000,5d7fb682edd0f937,3,0,282,230,266,292,242,319,331,219,258,266,270,142,206,226,-128,4,-132
205,430000,5d7fb682edd0f937,3,0,191,206,200,169,164,219,179,160,168,191,210,114,162,172,-96,19,-115
267,350000,5d7fb682edd0f937,3,0,246,219,230,256,240,260,259,202,201,205,241,127,184,191,-114,36,-150
113,210000,5d7fb682edd0f937,3,0,157,166,150,154,152,161,165,130,138,128,140,90,115,119,-50,12,-62
117,500000,5d7fb682edd0f937,3,0,152,134,144,142,148,158,109,123,106,134,131,54,92,106,-77,-3,-74
142,610000,5d7fb682edd0f937,3,0,156,163,199,168,161,205,192,172,135,145,159,85,122,130,-74,14,-88
78,230000,5d7fb682edd0f937,3,0,84,72,91,70,67,99,74,50,53,61,68,34,51,54,-34,7,-41
592,310000,a207df29ec9583f0,3,0,461,355,455,551,438,559,478,428,493,474,835,424,630,578,-411,361,-772
234,530000,a207df29ec9583f0,3,0,197,123,203,222,190,240,237,204,210,215,310,178,244,234,-132,95,-227
116,150000,a207df29ec9583f0,3,0,85,62,91,81,74,115,91,72,82,74,139,87,113,100,-52,65,-117
841,110000,a207df29ec9583f0,3,0,597,509,573,717,674,824,853,604,747,817,1033,648,840,833,-385,216,-601
524,510000,a207df29ec9583f0,3,0,377,334,442,494,344,458,388,382,361,382,695,383,539,487,-312,313,-625
225,340000,a207df29ec9583f0,3,0,164,138,167,188,148,226,228,183,176,177,354,152,253,228,-202,177,-379
530,370000,a207df29ec9583f0,3,0,286,259,291,346,365,453,344,338,348,336,608,328,468,424,-280,272,-552
130,140000,a207df29ec9583f0,3,0,78,95,88,102,105,108,108,84,93,100,165,96,130,120,-69,65,-134
1101,440000,a207df29ec9583f0,3,0,866,560,678,769,689,886,875,627,766,825,1178,690,934,898,-488,353,-841
163,450000,a207df29ec9583f0,3,0,91,57,97,100,90,105,124,72,100,114,160,106,133,127,-54,46,-100
1115,320000,a207df29ec9583f0,3,0,787,801,890,962,857,1124,918,791,915,1007,1591,766,1178,1121,-825,584,-1409
167,360000,a207df29ec9583f0,3,0,129,99,112,125,115,140,155,101,129,108,227,115,171,150,-112,119,-231
316,130000,a207df29ec9583f0,3,0,173,183,199,229,221,266,200,202,203,219,376,209,292,268,-167,157,-324
287,410000,a207df29ec9583f0,3,0,193,185,185,207,254,276,252,194,283,262,357,201,279,273,-156,95,-251
970,330000,a207df29ec9583f0,3,0,716,641,723,810,824,880,834,733,849,908,1436,623,1030,989,-813,528,-1341
366,420000,a207df29ec9583f0,3,0,265,212,243,260,260,327,326,230,315,356,436,202,319,331,-234,80,-314
246,430000,a207df29ec9583f0,3,0,152,121,164,200,157,190,184,143,174,192,302,179,240,224,-123,110,-233
338,350000,a207df29ec9583f0,3,0,238,208,225,265,234,296,266,197,227,256,500,212,356,323,-288,244,-532
286,210000,a207df29ec9583f0,3,0,170,172,190,254,215,281,225,176,194,227,304,176,240,236,-128,77,-205
205,500000,a207df29ec9583f0,3,0,138,114,168,164,192,184,176,151,174,194,265,152,208,204,-113,71,-184
222,610000,a207df29ec9583f0,3,0,184,186,174,206,235,213,228,210,194,216,307,140,224,221,-167,91,-258
125,230000,a207df29ec9583f0,3,0,69,62,72,97,59,106,77,74,83,85,102,84,93,90,-18,17,-35
160,310000,b4be3a4917289c82,3,0,185,166,151,149,152,203,190,188,201,262,80,97,88,146,17,-182,199
34,530000,b4be3a4917289c82,3,0,65,81,86,43,35,60,52,76,100,59,26,35,30,40,9,-33,42
26,150000,b4be3a4917289c82,3,0,44,34,38,23,35,33,31,42,40,37,22,17,20,25,-5,-15,10
153,110000,b4be3a4917289c82,3,0,251,267,259,192,172,203,232,200,230,226,93,117,105,145,24,-133,157
90,510000,b4be3a4917289c82,3,0,155,124,131,94,121,152,216,166,240,223,57,76,66,119,19,-166,185
72,340000,b4be3a4917289c82,3,0,93,91,91,85,90,104,106,110,130,121,57,59,58,79,2,-64,66
218,370000,b4be3a4917289c82,3,0,238,273,264,203,199,232,258,215,231,199,113,137,125,150,24,-86,110
28,140000,b4be3a4917289c82,3,0,30,23,35,28,32,37,31,31,28,33,16,10,13,20,-6,-17,11
231,440000,b4be3a4917289c82,3,0,239,207,253,209,182,223,290,309,396,384,120,115,118,206,-5,-264,259
18,450000,b4be3a4917289c82,3,0,29,21,31,23,25,29,35,34,41,40,20,18,19,26,-2,-20,18
414,320000,b4be3a4917289c82,3,0,442,327,438,345,389,471,447,420,635,591,225,325,275,380,100,-366,466
37,360000,b4be3a4917289c82,3,0,37,44,50,31,41,43,50,52,66,85,10,18,14,38,8,-75,83
131,130000,b4be3a4917289c82,3,0,128,105,161,119,127,130,145,141,166,161,78,99,88,113,21,-83,104
90,410000,b4be3a4917289c82,3,0,126,107,118,88,93,86,118,117,128,163,57,77,67,99,20,-106,126
344,330000,b4be3a4917289c82,3,0,423,431,415,297,361,382,415,422,523,567,168,290,229,342,122,-399,521
76,420000,b4be3a4917289c82,3,0,96,72,86,72,79,106,110,92,120,142,48,54,51,81,6,-94,100
61,430000,b4be3a4917289c82,3,0,74,84,62,48,45,64,96,79,112,124,41,43,42,69,2,-83,85
50,350000,b4be3a4917289c82,3,0,60,68,83,59,50,84,61,85,108,127,23,28,26,59,5,-104,109
67,210000,b4be3a4917289c82,3,0,101,79,77,61,82,88,87,77,106,83,28,38,33,50,10,-55,65
19,500000,b4be3a4917289c82,3,0,40,35,34,28,26,35,47,43,77,67,17,20,18,35,3,-50,53
48,610000,b4be3a4917289c82,3,0,72,77,99,52,57,82,79,83,68,82,41,52,46,58,11,-41,52
48,230000,b4be3a4917289c82,3,0,71,63,68,50,44,61,42,40,48,45,18,18,18,27,0,-27,27
374,310000,ef76a85c4b39f693,3,0,625,493,512,736,581,360,145,129,306,492,378,283,330,384,-95,-114,19
145,530000,ef76a85c4b39f693,3,0,215,224,243,237,221,153,83,75,142,154,140,101,120,132,-39,-14,-25
109,150000,ef76a85c4b39f693,3,0,133,133,164,131,165,105,47,48,67,109,121,79,100,103,-42,12,-54
438,110000,ef76a85c4b39f693,3,0,713,701,789,881,663,502,321,175,311,576,511,299,405,462,-212,-65,-147
361,510000,ef76a85c4b39f693,3,0,598,495,600,609,554,488,356,206,340,526,495,291,393,437,-204,-31,-173
259,340000,ef76a85c4b39f693,3,0,295,315,306,319,309,208,104,111,219,307,304,148,226,253,-156,-3,-153
400,370000,ef76a85c4b39f693,3,0,543,643,668,672,573,446,246,241,312,378,406,284,345,356,-122,28,-150
99,140000,ef76a85c4b39f693,3,0,129,126,145,145,138,80,47,46,58,83,94,61,78,79,-33,11,-44
607,440000,ef76a85c4b39f693,3,0,803,692,927,973,869,740,398,282,593,912,598,355,476,622,-243,-314,71
77,450000,ef76a85c4b39f693,3,0,92,69,104,120,85,95,39,30,50,68,74,33,54,58,-41,6,-47
891,320000,ef76a85c4b39f693,3,0,1330,1133,1369,1500,1116,610,270,351,609,1028,993,652,822,891,-341,-35,-306
151,360000,ef76a85c4b39f693,3,0,177,180,188,194,175,130,47,59,107,208,200,69,134,159,-131,-8,-123
323,130000,ef76a85c4b39f693,3,0,446,396,489,506,429,351,172,141,298,340,342,250,296,311,-92,2,-94
293,410000,ef76a85c4b39f693,3,0,359,443,350,442,406,206,143,136,170,239,290,184,237,238,-106,51,-157
969,330000,ef76a85c4b39f693,3,0,1531,1481,1596,1826,1257,815,643,498,965,1300,996,708,852,1001,-288,-304,16
250,420000,ef76a85c4b39f693,3,0,290,320,331,346,286,253,116,101,212,331,334,134,234,266,-200,3,-203
251,430000,ef76a85c4b39f693,3,0,302,305,370,344,325,229,78,92,180,310,284,146,215,247,-138,-26,-112
153,350000,ef76a85c4b39f693,3,0,249,210,345,285,288,200,69,95,138,176,229,97,163,167,-132,53,-185
274,210000,ef76a85c4b39f693,3,0,359,364,390,459,433,291,193,157,189,261,256,190,223,236,-66,-5,-61
120,500000,ef76a85c4b39f693,3,0,157,161,172,225,158,135,51,35,76,157,115,82,98,118,-33,-42,9
166,610000,ef76a85c4b39f693,3,0,253,275,312,315,249,241,115,96,127,205,223,136,180,188,-87,18,-105
153,230000,ef76a85c4b39f693,3,0,325,234,241,211,111,123,58,56,108,145,104,92,98,114,-12,-41,29
347,310000,bb9fbec9a2833839,3,0,390,364,320,327,408,528,494,298,341,507,266,214,240,329,-52,-241,189
142,530000,bb9fbec9a2833839,3,0,173,191,127,108,198,213,197,180,169,225,142,99,120,155,-43,-83,40
105,150000,bb9fbec9a2833839,3,0,156,132,135,136,178,178,174,157,121,169,76,74,75,106,-2,-93,91
259,110000,bb9fbec9a2833839,3,0,418,394,364,332,388,450,529,355,417,450,177,170,174,266,-7,-273,266
324,510000,bb9fbec9a2833839,3,0,385,337,371,406,440,533,641,403,433,394,242,224,233,287,-18,-152,134
211,340000,bb9fbec9a2833839,3,0,230,208,185,223,244,297,328,172,256,310,160,139,150,203,-21,-150,129
332,370000,bb9fbec9a2833839,3,0,402,377,302,378,352,487,582,453,469,507,305,251,278,354,-54,-202,148
101,140000,bb9fbec9a2833839,3,0,141,107,116,114,132,168,143,117,124,97,55,43,49,65,-12,-42,30
630,440000,bb9fbec9a2833839,3,0,616,587,591,684,704,813,867,710,821,895,435,271,353,534,-164,-460,296
108,450000,bb9fbec9a2833839,3,0,129,95,81,120,108,129,137,85,114,124,79,66,72,90,-13,-45,32
835,320000,bb9fbec9a2833839,3,0,885,789,826,854,952,1272,1166,688,937,1154,552,589,570,765,37,-602,639
145,360000,bb9fbec9a2833839,3,0,172,121,144,151,183,202,193,186,189,178,106,91,98,125,-15,-72,57
251,130000,bb9fbec9a2833839,3,0,325,291,244,275,310,427,423,324,327,378,179,188,184,248,9,-199,208
260,410000,bb9fbec9a2833839,3,0,241,351,217,257,301,336,420,237,276,308,156,143,150,202,-13,-152,139
759,330000,bb9fbec9a2833839,3,0,1058,811,816,971,1162,1196,1045,917,1072,1169,550,543,546,754,-7,-619,612
285,420000,bb9fbec9a2833839,3,0,366,272,236,352,315,395,429,270,308,378,261,177,219,272,-84,-117,33
251,430000,bb9fbec9a2833839,3,0,288,231,235,286,268,360,359,193,226,309,145,129,137,194,-16,-164,148
183,350000,bb9fbec9a2833839,3,0,228,247,214,238,244,281,263,253,214,293,168,110,139,190,-58,-125,67
121,210000,bb9fbec9a2833839,3,0,199,192,184,149,191,241,242,174,177,213,86,85,86,128,-1,-127,126
92,500000,bb9fbec9a2833839,3,0,91,84,83,135,121,146,128,96,89,130,65,59,62,85,-6,-65,59
131,610000,bb9fbec9a2833839,3,0,153,141,143,148,200,229,215,165,164,174,112,81,96,122,-31,-62,31
74,230000,bb9fbec9a2833839,3,0,190,96,96,121,92,130,140,82,95,85,44,40,42,56,-4,-41,37
456,310000,da457d15788fe8ee,3,0,524,428,462,576,421,521,504,402,593,748,538,251,394,512,-287,-210,-77
191,530000,da457d15788fe8ee,3,0,285,234,259,204,306,266,231,316,323,344,263,166,214,258,-97,-81,-16
152,150000,da457d15788fe8ee,3,0,139,167,203,169,162,217,201,207,206,200,197,109,153,169,-88,-3,-85
693,110000,da457d15788fe8ee,3,0,929,887,986,1008,845,898,731,715,939,1050,755,424,590,743,-331,-295,-36
443,510000,da457d15788fe8ee,3,0,657,632,753,748,554,658,1072,583,560,641,624,348,486,538,-276,-17,-259
229,340000,da457d15788fe8ee,3,0,261,270,316,300,257,346,329,282,331,409,330,200,265,313,-130,-79,-51
458,370000,da457d15788fe8ee,3,0,514,607,578,623,481,543,678,438,630,646,659,309,484,538,-350,13,-363
90,140000,da457d15788fe8ee,3,0,103,127,142,127,114,155,143,139,142,103,120,44,82,89,-76,17,-93
1006,440000,da457d15788fe8ee,3,0,1013,985,1219,1303,1074,1237,1342,1295,1408,1829,1269,499,884,1199,-770,-560,-210
152,450000,da457d15788fe8ee,3,0,170,96,158,161,124,125,189,162,142,255,213,82,148,183,-131,-42,-89
954,320000,da457d15788fe8ee,3,0,1034,965,1031,1078,842,1106,1255,1040,1108,1430,1304,649,976,1128,-655,-126,-529
186,360000,da457d15788fe8ee,3,0,194,206,264,228,177,230,275,218,275,247,282,85,184,205,-197,35,-232
337,130000,da457d15788fe8ee,3,0,365,330,420,442,396,476,471,407,417,527,425,254,340,402,-171,-102,-69
354,410000,da457d15788fe8ee,3,0,352,404,359,472,400,422,469,405,382,502,442,251,346,398,-191,-60,-131
836,330000,da457d15788fe8ee,3,0,1059,1028,1051,1251,1000,1181,1241,932,1214,1500,938,567,752,1002,-371,-562,191
428,420000,da457d15788fe8ee,3,0,406,406,395,467,358,427,529,447,473,526,572,259,416,452,-313,46,-359
342,430000,da457d15788fe8ee,3,0,413,420,443,451,322,451,476,369,391,505,374,207,290,362,-167,-131,-36
206,350000,da457d15788fe8ee,3,0,232,234,345,272,282,266,282,298,320,358,335,144,240,279,-191,-23,-168
268,210000,da457d15788fe8ee,3,0,362,315,405,340,365,459,418,357,335,454,281,156,218,297,-125,-173,48
153,500000,da457d15788fe8ee,3,0,206,221,225,291,189,230,259,188,209,244,199,108,154,184,-91,-45,-46
210,610000,da457d15788fe8ee,3,0,242,253,346,302,281,312,352,366,242,346,325,174,250,282,-151,-21,-130
144,230000,da457d15788fe8ee,3,0,276,201,264,224,175,240,219,123,190,198,139,94,116,144,-45,-59,14
696,310000,6858d6dfe680bdf7,3,0,722,679,634,547,444,607,438,357,513,576,543,384,464,501,-159,-33,-126
312,530000,6858d6dfe680bdf7,3,0,279,225,250,183,177,213,139,117,236,257,243,199,221,233,-44,-14,-30
84,150000,6858d6dfe680bdf7,3,0,82,69,87,52,46,43,47,37,60,80,54,43,48,59,-11,-26,15
688,110000,6858d6dfe680bdf7,3,0,673,614,681,595,494,449,410,328,585,816,536,311,424,554,-225,-280,55
640,510000,6858d6dfe680bdf7,3,0,561,619,591,569,444,445,455,290,447,593,591,337,464,507,-254,-2,-252
435,340000,6858d6dfe680bdf7,3,0,315,300,376,284,251,265,236,233,275,385,322,230,276,312,-92,-63,-29
622,370000,6858d6dfe680bdf7,3,0,484,554,521,386,382,358,297,285,401,440,468,289,378,399,-179,28,-207
78,140000,6858d6dfe680bdf7,3,0,81,62,68,61,45,60,31,30,61,103,57,64,60,75,7,-46,53
1449,440000,6858d6dfe680bdf7,3,0,1135,1224,1221,1023,972,1033,800,773,983,1319,1274,618,946,1070,-656,-45,-611
164,450000,6858d6dfe680bdf7,3,0,151,132,140,110,112,99,93,94,126,167,115,84,100,122,-31,-52,21
1681,320000,6858d6dfe680bdf7,3,0,1328,1233,1314,879,894,893,729,862,988,1160,1203,919,1061,1094,-284,43,-327
224,360000,6858d6dfe680bdf7,3,0,178,202,203,160,175,134,144,96,129,200,185,89,137,158,-96,-15,-81
460,130000,6858d6dfe680bdf7,3,0,280,289,334,287,249,266,194,192,281,283,417,232,324,311,-185,134,-319
388,410000,6858d6dfe680bdf7,3,0,309,370,322,315,276,272,209,174,237,350,258,224,241,277,-34,-92,58
2273,330000,6858d6dfe680bdf7,3,0,1725,1897,1719,1389,1189,1547,1208,929,1465,1724,1540,1004,1272,1423,-536,-184,-352
325,420000,6858d6dfe680bdf7,3,0,290,306,263,266,203,235,199,144,218,283,271,143,207,232,-128,-12,-116
380,430000,6858d6dfe680bdf7,3,0,345,396,354,336,258,251,209,203,255,374,375,195,285,315,-180,1,-181
369,350000,6858d6dfe680bdf7,3,0,298,266,319,252,323,276,236,214,251,346,352,161,256,286,-191,6,-197
225,210000,6858d6dfe680bdf7,3,0,306,327,247,205,195,187,133,91,159,186,215,146,180,182,-69,29,-98
290,500000,6858d6dfe680bdf7,3,0,246,273,262,227,183,189,132,105,200,253,198,131,164,194,-67,-55,-12
235,610000,6858d6dfe680bdf7,3,0,215,204,258,182,135,163,159,132,134,174,188,135,162,166,-53,14,-67
104,230000,6858d6dfe680bdf7,3,0,108,94,88,66,52,57,23,28,58,76,70,44,57,63,-26,-6,-20
253,310000,79de4e4b24c35b04,3,0,248,205,249,256,328,379,426,299,501,825,333,136,234,431,-197,-492,295
598,530000,79de4e4b24c35b04,3,0,584,517,594,552,695,707,913,926,928,1393,1050,634,842,1026,-416,-343,-73
207,150000,79de4e4b24c35b04,3,0,151,118,129,99,134,132,200,230,272,405,185,132,158,241,-53,-220,167
199,110000,79de4e4b24c35b04,3,0,284,352,376,194,240,313,370,330,446,852,178,127,152,386,-51,-674,623
512,510000,79de4e4b24c35b04,3,0,753,633,599,569,778,755,971,792,934,1509,1063,565,814,1046,-498,-446,-52
936,340000,79de4e4b24c35b04,3,0,836,765,835,790,1052,1349,1421,1263,1461,2601,1965,1072,1518,1879,-893,-636,-257
1729,370000,79de4e4b24c35b04,3,0,1669,1567,2055,1628,2244,2677,2814,2975,3077,5360,2858,1598,2228,3272,-1260,-2502,1242
447,140000,79de4e4b24c35b04,3,0,351,377,360,353,542,640,778,791,803,1442,701,396,548,846,-305,-741,436
3263,440000,79de4e4b24c35b04,3,0,3366,2719,3307,2768,3295,4086,5098,5032,5800,8421,3465,1872,2668,4586,-1593,-4956,3363
1845,450000,79de4e4b24c35b04,3,0,2406,1619,1976,1690,1981,2497,3110,3025,3479,6171,2981,1510,2246,3554,-1471,-3190,1719
1465,320000,79de4e4b24c35b04,3,0,1369,1121,1352,1272,1577,1829,2045,1978,2153,3757,2028,1542,1785,2442,-486,-1729,1243
434,360000,79de4e4b24c35b04,3,0,516,412,417,410,598,635,806,703,736,1319,827,443,635,863,-384,-492,108
1021,130000,79de4e4b24c35b04,3,0,863,830,1060,888,1184,1505,1631,1500,1789,2863,1366,1047,1206,1759,-319,-1497,1178
2528,410000,79de4e4b24c35b04,3,0,2609,2474,2930,3020,3796,4302,4617,4700,5194,9539,6024,2842,4433,6135,-3182,-3515,333
745,330000,79de4e4b24c35b04,3,0,867,616,852,799,1096,1291,1435,1528,1653,2646,934,580,757,1387,-354,-1712,1358
524,420000,79de4e4b24c35b04,3,0,578,459,481,488,678,753,891,696,982,1629,1137,521,829,1096,-616,-492,-124
808,430000,79de4e4b24c35b04,3,0,806,812,802,747,984,1113,1544,1234,1513,2352,1658,771,1214,1594,-887,-694,-193
456,350000,79de4e4b24c35b04,3,0,474,380,411,360,626,548,706,724,738,1086,453,316,384,618,-137,-633,496
505,210000,79de4e4b24c35b04,3,0,377,398,383,376,528,616,644,644,694,1039,408,313,360,587,-95,-631,536
169,500000,79de4e4b24c35b04,3,0,371,270,261,287,297,277,359,279,304,514,324,210,267,349,-114,-190,76
499,610000,79de4e4b24c35b04,3,0,412,456,460,358,538,648,785,855,1045,1704,937,403,670,1015,-534,-767,233
562,230000,79de4e4b24c35b04,3,0,439,350,475,475,643,791,839,638,832,1045,394,365,380,601,-29,-651,622
505,310000,12f8b7e14947c34d,3,0,848,740,785,835,1350,1065,2065,1032,1283,1483,389,338,364,737,-51,-1094,1043
208,530000,12f8b7e14947c34d,3,0,292,229,244,208,404,346,402,396,360,567,208,160,184,312,-48,-359,311
340,150000,12f8b7e14947c34d,3,0,446,450,527,415,569,575,712,648,698,789,413,215,314,472,-198,-376,178
126,110000,12f8b7e14947c34d,3,0,346,342,374,346,429,397,451,276,389,488,143,102,122,244,-41,-345,304
577,510000,12f8b7e14947c34d,3,0,746,756,677,695,682,820,1286,786,820,1117,531,374,452,674,-157,-586,429
241,340000,12f8b7e14947c34d,3,0,351,363,414,357,477,644,726,594,615,705,385,198,292,429,-187,-320,133
738,370000,12f8b7e14947c34d,3,0,1400,1356,1271,1075,1292,1454,1777,1435,1352,1707,803,424,614,978,-379,-904,525
174,140000,12f8b7e14947c34d,3,0,326,295,376,259,310,346,391,347,352,464,131,87,109,227,-44,-333,289
221,440000,12f8b7e14947c34d,3,0,223,205,277,296,248,286,326,342,407,475,130,117,124,241,-13,-345,332
77,450000,12f8b7e14947c34d,3,0,135,110,154,153,106,135,181,167,158,231,93,43,68,122,-50,-138,88
1094,320000,12f8b7e14947c34d,3,0,2036,1589,1718,1504,1598,2024,2099,1880,1868,2181,991,782,886,1318,-209,-1190,981
183,360000,12f8b7e14947c34d,3,0,332,338,384,268,290,349,532,430,438,495,251,128,190,291,-123,-244,121
592,130000,12f8b7e14947c34d,3,0,697,668,745,713,769,1026,1153,782,978,1229,546,360,453,712,-186,-683,497
492,410000,12f8b7e14947c34d,3,0,507,691,656,595,849,951,954,750,835,1053,508,259,384,607,-249,-545,296
556,330000,12f8b7e14947c34d,3,0,727,703,696,655,723,773,920,884,1063,1213,348,291,320,617,-57,-865,808
136,420000,12f8b7e14947c34d,3,0,248,264,212,303,273,340,406,336,358,440,200,80,140,240,-120,-240,120
254,430000,12f8b7e14947c34d,3,0,375,384,428,388,473,550,688,528,670,749,385,150,268,428,-235,-364,129
178,350000,12f8b7e14947c34d,3,0,319,281,308,207,297,275,314,302,385,408,188,136,162,244,-52,-220,168
81,210000,12f8b7e14947c34d,3,0,162,132,162,151,156,254,246,156,195,210,53,54,54,106,1,-157,158
113,500000,12f8b7e14947c34d,3,0,142,161,182,218,192,205,240,178,181,295,131,85,108,170,-46,-164,118
531,610000,12f8b7e14947c34d,3,0,777,772,950,666,1062,1276,1109,958,1012,1286,412,280,346,659,-132,-874,742
160,230000,12f8b7e14947c34d,3,0,262,257,265,200,199,236,256,202,210,228,66,80,73,125,14,-162,176
263,310000,04e66e578f653ab9,3,0,341,301,229,293,265,342,422,337,524,679,950,175,562,601,-775,271,-1046
135,530000,04e66e578f653ab9,3,0,57,93,77,88,123,129,142,173,215,293,131,118,124,181,-13,-162,149
63,150000,04e66e578f653ab9,3,0,43,68,68,57,63,80,87,94,102,118,60,38,49,72,-22,-58,36
167,110000,04e66e578f653ab9,3,0,160,141,144,157,165,158,241,166,231,280,180,87,134,182,-93,-100,7
210,510000,04e66e578f653ab9,3,0,119,165,176,134,135,208,419,226,291,404,151,140,146,232,-11,-253,242
85,340000,04e66e578f653ab9,3,0,69,84,82,105,84,146,172,127,176,201,116,64,90,127,-52,-85,33
276,370000,04e66e578f653ab9,3,0,288,336,249,208,207,253,405,274,383,451,230,146,188,276,-84,-221,137
68,140000,04e66e578f653ab9,3,0,25,37,54,47,58,68,104,75,85,95,42,23,32,53,-19,-53,34
144,440000,04e66e578f653ab9,3,0,94,95,114,119,105,149,140,175,225,268,104,54,79,142,-50,-164,114
32,450000,04e66e578f653ab9,3,0,28,27,26,35,28,43,42,39,42,71,30,28,29,43,-2,-41,39
388,320000,04e66e578f653ab9,3,0,319,322,305,326,286,477,566,501,644,669,334,279,306,427,-55,-335,280
40,360000,04e66e578f653ab9,3,0,53,46,68,55,61,72,97,83,104,86,64,32,48,61,-32,-22,-10
162,130000,04e66e578f653ab9,3,0,125,133,124,117,113,185,186,192,206,272,140,97,118,170,-43,-132,89
156,410000,04e66e578f653ab9,3,0,78,115,86,115,109,191,156,169,219,319,144,90,117,184,-54,-175,121
235,330000,04e66e578f653ab9,3,0,153,241,174,199,216,262,293,289,400,452,190,120,155,254,-70,-262,192
61,420000,04e66e578f653ab9,3,0,36,44,55,47,45,58,71,47,81,82,146,33,90,87,-113,64,-177
115,430000,04e66e578f653ab9,3,0,96,96,123,93,121,118,158,115,135,228,105,59,82,131,-46,-123,77
64,350000,04e66e578f653ab9,3,0,69,44,77,80,72,82,93,107,132,139,77,43,60,86,-34,-62,28
28,210000,04e66e578f653ab9,3,0,35,39,48,22,42,64,69,52,62,81,42,40,41,54,-2,-39,37
56,500000,04e66e578f653ab9,3,0,28,31,19,68,61,42,66,46,77,87,44,31,38,54,-13,-43,30
169,610000,04e66e578f653ab9,3,0,125,134,132,92,109,169,208,170,201,238,124,83,104,148,-41,-114,73
60,230000,04e66e578f653ab9,3,0,33,46,45,30,38,60,45,45,56,48,22,17,20,29,-5,-26,21
175,310000,dff803b4024d261d,3,0,239,228,169,138,110,96,130,129,206,317,238,124,181,226,-114,-79,-35
50,530000,dff803b4024d261d,3,0,78,75,180,62,53,48,150,68,61,94,64,55,60,71,-9,-30,21
88,150000,dff803b4024d261d,3,0,113,86,107,104,115,80,59,69,77,114,119,58,88,97,-61,5,-66
463,110000,dff803b4024d261d,3,0,502,679,1478,362,522,549,341,411,466,954,488,303,396,582,-185,-466,281
308,510000,dff803b4024d261d,3,0,298,337,329,313,287,213,226,219,270,560,493,212,352,422,-281,-67,-214
126,340000,dff803b4024d261d,3,0,173,287,132,112,137,105,226,131,164,192,238,108,173,179,-130,46,-176
736,370000,dff803b4024d261d,3,0,452,634,622,583,483,376,451,391,462,714,609,352,480,558,-257,-105,-152
152,140000,dff803b4024d261d,3,0,160,138,173,121,88,87,81,104,152,230,168,75,122,158,-93,-62,-31
1157,440000,dff803b4024d261d,3,0,1134,1049,1151,1204,796,688,783,887,1988,1893,1283,554,918,1243,-729,-610,-119
218,450000,dff803b4024d261d,3,0,287,232,292,302,238,333,211,167,204,333,316,132,224,260,-184,-17,-167
701,320000,dff803b4024d261d,3,0,715,817,757,633,614,701,409,489,602,865,785,520,652,723,-265,-80,-185
195,360000,dff803b4024d261d,3,0,160,214,361,199,120,104,272,168,194,280,264,100,182,215,-164,-16,-148
489,130000,dff803b4024d261d,3,0,276,257,299,271,278,358,279,275,250,454,387,248,318,363,-139,-67,-72
195,410000,dff803b4024d261d,3,0,161,254,201,225,287,201,184,168,191,300,319,141,230,253,-178,19,-197
567,330000,dff803b4024d261d,3,0,571,611,676,536,359,406,355,572,795,787,577,391,484,585,-186,-210,24
390,420000,dff803b4024d261d,3,0,556,499,394,422,178,222,287,394,374,566,545,193,369,435,-352,-21,-331
531,430000,dff803b4024d261d,3,0,281,349,524,267,270,181,332,203,423,412,412,410,411,411,-2,0,-2
485,350000,dff803b4024d261d,3,0,320,297,502,255,324,353,331,397,363,562,555,242,398,453,-313,-7,-306
328,210000,dff803b4024d261d,3,0,322,331,310,263,240,234,219,239,228,340,230,163,196,244,-67,-110,43
261,500000,dff803b4024d261d,3,0,377,423,567,467,292,184,281,158,348,846,378,203,290,476,-175,-468,293
103,610000,dff803b4024d261d,3,0,99,165,127,82,202,64,63,62,99,126,138,68,103,111,-70,12,-82
88,230000,dff803b4024d261d,3,0,124,102,107,81,71,56,91,46,89,107,57,72,64,79,15,-50,65
173,310000,61e73e32ad101892,3,0,381,276,268,259,263,265,263,222,276,374,264,140,202,259,-124,-110,-14
278,530000,61e73e32ad101892,3,0,291,288,287,259,444,328,322,420,444,423,403,246,324,357,-157,-20,-137
398,150000,61e73e32ad101892,3,0,345,439,598,415,527,467,541,608,505,619,534,251,392,468,-283,-85,-198
672,110000,61e73e32ad101892,3,0,863,864,925,776,823,803,1019,845,1016,1441,741,459,600,880,-282,-700,418
616,510000,61e73e32ad101892,3,0,697,804,780,668,723,668,1080,712,743,1078,940,507,724,842,-433,-138,-295
152,340000,61e73e32ad101892,3,0,191,191,212,209,143,177,210,217,212,273,247,107,177,209,-140,-26,-114
548,370000,61e73e32ad101892,3,0,560,823,816,666,592,643,866,764,681,1011,688,350,519,683,-338,-323,-15
219,140000,61e73e32ad101892,3,0,206,261,279,232,228,276,283,280,288,348,274,115,194,246,-159,-74,-85
1549,440000,61e73e32ad101892,3,0,1603,1334,1757,1676,1516,1456,1686,2097,2144,2562,1849,777,1313,1729,-1072,-713,-359
278,450000,61e73e32ad101892,3,0,357,308,368,312,289,221,333,376,342,443,364,194,279,334,-170,-79,-91
546,320000,61e73e32ad101892,3,0,732,642,720,594,521,656,670,713,682,857,658,425,542,647,-233,-199,-34
180,360000,61e73e32ad101892,3,0,215,284,272,228,226,207,304,324,277,382,334,121,228,279,-213,-48,-165
572,130000,61e73e32ad101892,3,0,512,623,789,655,636,756,829,875,790,1042,804,407,606,751,-397,-238,-159
427,410000,61e73e32ad101892,3,0,442,561,418,478,457,520,525,514,567,656,654,303,478,538,-351,-2,-349
464,330000,61e73e32ad101892,3,0,692,688,672,696,609,628,658,707,687,970,632,338,485,647,-294,-338,44
890,420000,61e73e32ad101892,3,0,1019,976,969,1189,812,879,1194,1234,1296,1458,1429,526,978,1138,-903,-29,-874
444,430000,61e73e32ad101892,3,0,451,527,529,432,433,504,586,532,579,879,712,262,487,618,-450,-167,-283
336,350000,61e73e32ad101892,3,0,378,320,437,254,309,324,331,423,388,523,387,223,305,378,-164,-136,-28
658,210000,61e73e32ad101892,3,0,785,855,952,717,778,859,919,871,786,1105,571,424,498,700,-147,-534,387
364,500000,61e73e32ad101892,3,0,482,469,390,863,400,378,452,406,568,732,616,327,472,558,-289,-116,-173
381,610000,61e73e32ad101892,3,0,415,526,586,401,428,429,480,618,464,618,561,288,424,489,-273,-57,-216
333,230000,61e73e32ad101892,3,0,403,364,391,379,393,463,364,346,348,497,267,165,216,310,-102,-230,128
61,310000,a432c483b5beb856,3,0,148,107,138,95,119,125,135,111,242,237,68,37,52,114,-31,-169,138
100,530000,a432c483b5beb856,3,0,116,126,123,110,141,143,170,165,182,271,140,100,120,170,-40,-131,91
74,150000,a432c483b5beb856,3,0,127,130,150,140,118,135,135,144,149,195,78,54,66,109,-24,-117,93
59,110000,a432c483b5beb856,3,0,161,133,142,156,136,151,163,97,128,205,34,44,39,94,10,-171,181
178,510000,a432c483b5beb856,3,0,394,366,331,297,273,290,355,284,276,560,275,186,230,340,-89,-285,196
109,340000,a432c483b5beb856,3,0,162,134,155,164,187,210,258,234,289,496,209,109,159,271,-100,-287,187
188,370000,a432c483b5beb856,3,0,365,376,429,398,297,370,455,430,397,599,241,156,198,332,-85,-358,273
65,140000,a432c483b5beb856,3,0,155,134,191,136,138,154,165,187,192,226,67,52,60,115,-15,-159,144
467,440000,a432c483b5beb856,3,0,1001,803,902,957,908,969,966,1096,1273,1753,510,290,400,851,-220,-1243,1023
113,450000,a432c483b5beb856,3,0,173,112,150,145,121,133,163,183,209,314,161,76,118,184,-85,-153,68
360,320000,a432c483b5beb856,3,0,542,500,626,524,494,659,663,720,808,1176,484,399,442,686,-85,-692,607
139,360000,a432c483b5beb856,3,0,159,167,200,179,156,182,243,282,281,556,258,99,178,304,-159,-298,139
133,130000,a432c483b5beb856,3,0,227,222,334,278,240,275,311,284,290,435,164,126,145,242,-38,-271,233
136,410000,a432c483b5beb856,3,0,207,216,293,353,273,313,316,283,364,562,252,130,191,315,-122,-310,188
331,330000,a432c483b5beb856,3,0,580,534,604,578,536,581,660,738,799,1102,332,255,294,563,-77,-770,693
92,420000,a432c483b5beb856,3,0,298,272,226,274,204,230,271,257,362,526,267,110,188,301,-157,-259,102
133,430000,a432c483b5beb856,3,0,198,189,225,184,208,271,292,260,313,627,286,115,200,343,-171,-341,170
160,350000,a432c483b5beb856,3,0,273,232,272,218,246,274,282,315,340,500,185,128,156,271,-57,-315,258
133,210000,a432c483b5beb856,3,0,378,382,339,300,311,310,311,260,209,299,101,86,94,162,-15,-198,183
70,500000,a432c483b5beb856,3,0,208,200,174,215,160,199,165,151,159,317,179,87,133,194,-92,-138,46
62,610000,a432c483b5beb856,3,0,107,132,119,143,116,126,114,163,141,242,89,58,74,130,-31,-153,122
65,230000,a432c483b5beb856,3,0,139,139,154,146,135,155,139,103,121,126,60,44,52,77,-16,-66,50
300,310000,0797526c057dcf5b,3,0,152,176,401,401,321,346,427,336,1289,571,175,135,155,294,-40,-396,356
201,530000,0797526c057dcf5b,3,0,125,149,202,186,247,218,226,257,285,393,160,154,157,236,-6,-233,227
278,150000,0797526c057dcf5b,3,0,151,182,235,185,198,218,291,326,339,631,236,164,200,344,-72,-395,323
315,110000,0797526c057dcf5b,3,0,458,579,619,663,697,743,797,664,656,980,232,253,242,488,21,-748,769
708,510000,0797526c057dcf5b,3,0,383,511,577,808,786,904,1230,923,1016,1536,609,478,544,874,-131,-927,796
522,340000,0797526c057dcf5b,3,0,141,183,258,304,319,476,565,666,550,750,358,257,308,455,-101,-392,291
1635,370000,0797526c057dcf5b,3,0,1159,1838,2095,1935,1835,2200,2915,3148,3502,5481,1788,1203,1496,2824,-585,-3693,3108
567,140000,0797526c057dcf5b,3,0,388,385,544,496,521,585,792,899,919,1474,502,371,436,782,-131,-972,841
8079,440000,0797526c057dcf5b,3,0,6681,6500,8617,8587,8085,9999,11167,12710,12394,15317,5306,3718,4512,8114,-1588,-10011,8423
1366,450000,0797526c057dcf5b,3,0,777,650,933,1046,1010,1186,1639,1709,1789,2693,1195,777,986,1555,-418,-1498,1080
2148,320000,0797526c057dcf5b,3,0,917,1039,1356,1362,1273,1726,2274,2226,2622,3296,1247,1529,1388,2024,282,-2049,2331
797,360000,0797526c057dcf5b,3,0,301,380,537,595,606,715,1083,1277,1265,1764,857,484,670,1035,-373,-907,534
1259,130000,0797526c057dcf5b,3,0,575,834,1174,1117,1091,1516,1988,2221,2449,3796,1214,995,1104,2002,-219,-2582,2363
1290,410000,0797526c057dcf5b,3,0,966,1035,851,918,1151,1553,1783,1739,1951,3130,1278,848,1063,1752,-430,-1852,1422
1246,330000,0797526c057dcf5b,3,0,670,888,1084,1050,1140,1443,1709,2001,2019,2088,700,801,750,1196,101,-1388,1489
772,420000,0797526c057dcf5b,3,0,464,568,585,851,689,870,1071,1120,1425,1562,736,376,556,891,-360,-826,466
1105,430000,0797526c057dcf5b,3,0,1099,1123,1343,1265,1384,1668,1721,1444,1769,3168,1244,677,960,1696,-567,-1924,1357
1058,350000,0797526c057dcf5b,3,0,743,748,1047,978,991,1227,1477,1846,1591,1981,769,598,684,1116,-171,-1212,1041
1642,210000,0797526c057dcf5b,3,0,2185,2416,2738,2351,2715,3298,3035,2443,2622,3705,1059,1132,1096,1965,73,-2646,2719
331,500000,0797526c057dcf5b,3,0,130,208,307,592,510,660,624,494,548,828,333,235,284,465,-98,-495,397
287,610000,0797526c057dcf5b,3,0,148,246,335,408,480,451,462,457,402,722,289,175,232,395,-114,-433,319
604,230000,0797526c057dcf5b,3,0,290,315,472,426,421,630,651,605,913,1064,350,347,348,587,-3,-714,711
224,310000,936168bd4850913d,3,0,267,256,231,232,275,253,330,234,241,272,250,161,206,228,-89,-22,-67
297,530000,936168bd4850913d,3,0,218,222,273,237,317,281,288,285,282,383,494,162,328,346,-332,111,-443
364,150000,936168bd4850913d,3,0,261,297,409,278,346,325,397,353,331,374,412,213,312,333,-199,38,-237
324,110000,936168bd4850913d,3,0,385,428,423,454,541,459,651,432,527,798,336,255,296,463,-81,-462,381
280,510000,936168bd4850913d,3,0,328,404,345,365,374,356,560,353,364,502,560,198,379,420,-362,58,-420
339,340000,936168bd4850913d,3,0,248,311,364,321,347,370,464,369,339,449,378,228,303,352,-150,-71,-79
948,370000,936168bd4850913d,3,0,794,1159,1092,1036,1063,896,1347,1014,1020,1083,1132,648,890,954,-484,49,-533
370,140000,936168bd4850913d,3,0,407,327,404,319,311,334,462,394,347,454,373,276,324,368,-97,-81,-16
2735,440000,936168bd4850913d,3,0,2297,2056,2432,2474,2478,2391,3040,2810,2842,3119,2859,1337,2098,2438,-1522,-260,-1262
306,450000,936168bd4850913d,3,0,277,228,279,260,273,237,346,287,279,316,376,154,265,282,-222,60,-282
905,320000,936168bd4850913d,3,0,864,875,944,898,914,919,1153,908,905,1057,1012,579,796,883,-433,-45,-388
355,360000,936168bd4850913d,3,0,259,334,387,321,370,350,407,325,334,414,397,195,296,335,-202,-17,-185
842,130000,936168bd4850913d,3,0,529,645,721,619,623,691,837,696,646,778,797,602,700,726,-195,19,-214
986,410000,936168bd4850913d,3,0,743,938,870,860,976,801,1165,786,979,1154,954,596,775,901,-358,-200,-158
650,330000,936168bd4850913d,3,0,591,647,679,619,746,631,767,611,709,819,752,388,570,653,-364,-67,-297
1164,420000,936168bd4850913d,3,0,1120,1091,1131,1321,1289,1127,1463,1111,1292,1497,1405,549,977,1150,-856,-92,-764
556,430000,936168bd4850913d,3,0,605,681,762,693,656,726,776,563,649,953,623,341,482,639,-282,-330,48
556,350000,936168bd4850913d,3,0,561,623,627,554,655,558,641,586,610,611,627,347,487,528,-280,16,-296
709,210000,936168bd4850913d,3,0,596,668,714,579,727,667,816,696,727,851,758,485,622,698,-273,-93,-180
111,500000,936168bd4850913d,3,0,151,162,139,215,222,181,222,152,145,208,248,87,168,181,-161,40,-201
331,610000,936168bd4850913d,3,0,307,362,418,335,362,360,429,415,400,482,463,229,346,391,-234,-19,-215
607,230000,936168bd4850913d,3,0,643,636,673,545,503,567,621,450,630,549,617,346,482,504,-271,68,-339
205,310000,cc21c7e91a3b5a0c,3,0,307,268,271,242,256,281,287,238,345,456,114,153,134,241,39,-342,381
364,530000,cc21c7e91a3b5a0c,3,0,287,277,288,270,381,345,327,285,338,442,406,203,304,350,-203,-36,-167
311,150000,cc21c7e91a3b5a0c,3,0,221,205,287,238,235,267,246,282,331,382,195,193,194,257,-2,-187,185
186,110000,cc21c7e91a3b5a0c,3,0,239,243,275,251,253,208,303,262,356,580,121,115,118,272,-6,-459,453
390,510000,cc21c7e91a3b5a0c,3,0,495,459,461,461,453,451,636,487,569,804,459,234,346,499,-225,-345,120
376,340000,cc21c7e91a3b5a0c,3,0,362,355,346,364,377,400,439,428,489,503,403,244,324,383,-159,-100,-59
703,370000,cc21c7e91a3b5a0c,3,0,741,891,877,768,778,692,815,855,912,1164,554,505,530,741,-49,-610,561
301,140000,cc21c7e91a3b5a0c,3,0,274,256,316,230,226,277,310,284,316,428,223,193,208,281,-30,-205,175
2615,440000,cc21c7e91a3b5a0c,3,0,2312,2006,2367,2317,2288,2219,2478,2450,3345,3730,1930,1262,1596,2307,-668,-1800,1132
309,450000,cc21c7e91a3b5a0c,3,0,296,226,316,262,277,270,290,313,377,417,266,187,226,290,-79,-151,72
1069,320000,cc21c7e91a3b5a0c,3,0,1174,1098,1171,1053,1035,1139,1193,1114,1454,1527,877,754,816,1053,-123,-650,527
323,360000,cc21c7e91a3b5a0c,3,0,286,283,344,324,354,314,340,317,350,507,305,161,233,324,-144,-202,58
572,130000,cc21c7e91a3b5a0c,3,0,466,466,575,563,517,521,590,551,574,797,453,434,444,561,-19,-344,325
702,410000,cc21c7e91a3b5a0c,3,0,631,701,609,620,657,647,687,548,872,1036,630,391,510,686,-239,-406,167
861,330000,cc21c7e91a3b5a0c,3,0,868,916,952,851,928,863,800,942,1151,1258,739,529,634,842,-210,-519,309
719,420000,cc21c7e91a3b5a0c,3,0,859,860,857,1022,954,876,1065,918,1189,1511,963,454,708,976,-509,-548,39
443,430000,cc21c7e91a3b5a0c,3,0,432,418,440,412,436,456,456,452,506,737,420,189,304,449,-231,-317,86
640,350000,cc21c7e91a3b5a0c,3,0,585,524,634,509,574,525,556,643,734,779,473,353,413,535,-120,-306,186
431,210000,cc21c7e91a3b5a0c,3,0,394,433,415,359,423,434,437,390,480,602,285,241,263,376,-44,-317,273
179,500000,cc21c7e91a3b5a0c,3,0,154,208,153,256,232,218,203,186,200,305,185,95,140,195,-90,-120,30
234,610000,cc21c7e91a3b5a0c,3,0,255,282,291,238,303,301,293,309,345,496,293,157,225,315,-136,-203,67
322,230000,cc21c7e91a3b5a0c,3,0,410,348,422,361,360,329,347,306,404,422,214,206,210,281,-8,-208,200
212,310000,7aab7fca2470987e,3,0,288,255,249,227,228,228,248,166,277,348,224,140,182,237,-84,-124,40
18,530000,7aab7fca2470987e,3,0,26,19,19,13,29,23,22,12,22,33,19,19,19,24,0,-14,14
29,150000,7aab7fca2470987e,3,0,22,31,32,22,34,26,20,16,19,22,21,19,20,21,-2,-1,-1
378,110000,7aab7fca2470987e,3,0,342,385,371,412,397,450,433,353,372,511,424,244,334,393,-180,-87,-93
47,510000,7aab7fca2470987e,3,0,61,40,41,50,45,33,53,34,42,64,69,42,56,58,-27,5,-32
59,340000,7aab7fca2470987e,3,0,96,94,77,54,58,60,65,52,74,75,83,59,71,72,-24,8,-32
295,370000,7aab7fca2470987e,3,0,279,291,321,323,323,300,349,309,286,341,430,189,310,320,-241,89,-330
83,140000,7aab7fca2470987e,3,0,101,97,85,61,83,86,76,58,62,78,105,64,84,82,-41,27,-68
848,440000,7aab7fca2470987e,3,0,938,782,929,824,845,827,959,887,972,1235,1009,443,726,896,-566,-226,-340
20,450000,7aab7fca2470987e,3,0,27,25,33,22,15,35,23,23,13,26,34,17,26,26,-17,8,-25
351,320000,7aab7fca2470987e,3,0,397,361,372,366,390,384,352,323,380,481,397,258,328,379,-139,-84,-55
26,360000,7aab7fca2470987e,3,0,43,45,28,35,34,41,44,29,35,37,61,16,38,38,-45,24,-69
236,130000,7aab7fca2470987e,3,0,209,215,221,251,231,259,229,234,231,316,308,172,240,265,-136,-8,-128
155,410000,7aab7fca2470987e,3,0,183,203,189,186,204,209,192,150,188,209,242,134,188,195,-108,33,-141
270,330000,7aab7fca2470987e,3,0,351,324,279,263,302,300,252,293,323,375,353,222,288,317,-131,-22,-109
52,420000,7aab7fca2470987e,3,0,64,65,48,56,41,58,58,26,64,62,54,47,50,54,-7,-8,1
27,430000,7aab7fca2470987e,3,0,45,53,33,37,54,26,47,25,31,44,54,26,40,41,-28,10,-38
56,350000,7aab7fca2470987e,3,0,100,71,65,63,56,64,42,57,83,105,92,41,66,79,-51,-13,-38
124,210000,7aab7fca2470987e,3,0,143,201,173,177,170,176,181,127,153,187,158,103,130,149,-55,-29,-26
27,500000,7aab7fca2470987e,3,0,27,25,16,43,25,22,19,17,12,27,22,12,17,20,-10,-5,-5
38,610000,7aab7fca2470987e,3,0,29,33,50,39,32,34,19,25,29,46,61,16,38,41,-45,15,-60
61,230000,7aab7fca2470987e,3,0,94,92,117,107,90,78,77,62,61,65,66,41,54,57,-25,1,-26
190,310000,fde95ea242abd896,3,0,279,297,244,231,222,233,237,260,331,369,161,142,152,224,-19,-208,189
309,530000,fde95ea242abd896,3,0,312,304,293,280,397,351,388,519,521,651,386,202,294,413,-184,-265,81
139,150000,fde95ea242abd896,3,0,126,103,173,112,115,149,181,185,190,234,146,90,118,157,-56,-88,32
181,110000,fde95ea242abd896,3,0,302,248,267,240,223,271,313,223,301,382,210,141,176,244,-69,-172,103
360,510000,fde95ea242abd896,3,0,417,389,401,386,408,384,645,492,617,839,509,240,374,529,-269,-330,61
254,340000,fde95ea242abd896,3,0,336,313,328,323,371,429,508,453,504,690,387,163,275,413,-224,-303,79
464,370000,fde95ea242abd896,3,0,546,625,677,569,603,642,825,774,709,964,444,303,374,570,-141,-520,379
238,140000,fde95ea242abd896,3,0,255,277,268,247,194,300,278,277,302,443,175,132,154,250,-43,-268,225
2906,440000,fde95ea242abd896,3,0,3265,2736,3407,3034,2769,3466,3967,4449,4901,5547,3229,1517,2373,3431,-1712,-2318,606
321,450000,fde95ea242abd896,3,0,394,300,323,305,295,375,362,434,458,665,381,181,281,409,-200,-284,84
722,320000,fde95ea242abd896,3,0,920,905,886,740,767,910,875,888,974,1139,690,508,599,779,-182,-449,267
276,360000,fde95ea242abd896,3,0,252,298,296,306,326,283,440,408,499,625,381,184,282,397,-197,-244,47
433,130000,fde95ea242abd896,3,0,454,470,518,437,434,560,591,602,602,830,407,320,364,519,-87,-423,336
499,410000,fde95ea242abd896,3,0,448,487,451,445,414,574,666,620,614,920,507,247,377,558,-260,-413,153
806,330000,fde95ea242abd896,3,0,939,1038,954,959,917,968,1148,998,1169,1424,732,558,645,905,-174,-692,518
511,420000,fde95ea242abd896,3,0,744,646,667,730,629,764,987,818,1066,1347,698,270,484,772,-428,-649,221
418,430000,fde95ea242abd896,3,0,522,540,567,522,526,503,752,630,700,988,570,203,386,587,-367,-418,51
580,350000,fde95ea242abd896,3,0,559,556,633,509,603,671,676,754,796,1043,605,368,486,672,-237,-438,201
341,210000,fde95ea242abd896,3,0,457,514,445,435,473,472,553,433,460,600,253,193,223,349,-60,-347,287
116,500000,fde95ea242abd896,3,0,155,208,157,246,168,172,243,227,222,229,139,105,122,158,-34,-90,56
140,610000,fde95ea242abd896,3,0,111,120,179,148,148,164,191,253,229,293,140,96,118,176,-44,-153,109
264,230000,fde95ea242abd896,3,0,319,331,309,255,234,372,256,198,199,322,111,123,117,185,12,-211,223
369,310000,97f15de12cfabbd5,3,0,123,139,212,242,279,368,455,354,457,516,264,193,228,324,-71,-252,181
144,530000,97f15de12cfabbd5,3,0,88,54,90,69,134,137,168,236,233,253,206,111,158,190,-95,-47,-48
172,150000,97f15de12cfabbd5,3,0,148,111,161,112,170,148,180,212,200,238,219,114,166,190,-105,-19,-86
482,110000,97f15de12cfabbd5,3,0,489,419,541,572,614,704,733,603,754,1094,601,390,496,695,-211,-493,282
325,510000,97f15de12cfabbd5,3,0,296,215,215,241,286,280,498,363,489,543,391,237,314,390,-154,-152,-2
185,340000,97f15de12cfabbd5,3,0,200,168,222,253,319,361,472,444,568,578,495,153,324,409,-342,-83,-259
846,370000,97f15de12cfabbd5,3,0,450,449,644,594,653,771,1001,1018,1094,1221,1031,476,754,909,-555,-190,-365
369,140000,97f15de12cfabbd5,3,0,187,190,307,319,310,398,381,370,395,605,316,221,268,381,-95,-289,194
2377,440000,97f15de12cfabbd5,3,0,2169,1283,1775,1807,1926,2292,2762,3019,3563,3747,2666,1125,1896,2513,-1541,-1081,-460
119,450000,97f15de12cfabbd5,3,0,105,85,131,107,105,132,134,146,194,174,193,92,142,153,-101,19,-120
1008,320000,97f15de12cfabbd5,3,0,776,574,791,789,884,1139,1155,1292,1491,1524,1070,552,811,1049,-518,-454,-64
166,360000,97f15de12cfabbd5,3,0,153,127,135,142,163,206,280,258,340,409,346,81,214,279,-265,-63,-202
734,130000,97f15de12cfabbd5,3,0,423,400,560,621,573,819,812,975,971,1119,789,422,606,777,-367,-330,-37
488,410000,97f15de12cfabbd5,3,0,326,261,356,378,472,519,592,609,805,866,692,326,509,628,-366,-174,-192
969,330000,97f15de12cfabbd5,3,0,657,569,729,797,1116,1100,1259,1371,1516,1515,1138,549,844,1067,-589,-377,-212
446,420000,97f15de12cfabbd5,3,0,597,355,306,462,346,475,707,729,779,906,749,253,501,636,-496,-157,-339
437,430000,97f15de12cfabbd5,3,0,437,344,400,350,381,419,626,645,767,839,710,238,474,596,-472,-129,-343
542,350000,97f15de12cfabbd5,3,0,292,182,309,251,400,389,434,571,612,638,509,288,398,478,-221,-129,-92
962,210000,97f15de12cfabbd5,3,0,556,678,921,843,1057,1068,1256,1020,1269,1395,898,506,702,933,-392,-497,105
164,500000,97f15de12cfabbd5,3,0,192,141,164,243,183,190,183,170,200,213,159,106,132,159,-53,-54,1
225,610000,97f15de12cfabbd5,3,0,158,121,222,212,278,246,251,273,309,371,227,159,193,252,-68,-144,76
537,230000,97f15de12cfabbd5,3,0,238,301,459,440,381,659,536,422,639,783,366,217,292,455,-149,-417,268
252,310000,f5d69960089c3614,3,0,200,200,179,143,213,231,263,186,304,291,260,125,192,225,-135,-31,-104
59,530000,f5d69960089c3614,3,0,35,27,47,40,86,70,45,62,97,95,78,48,63,74,-30,-17,-13
51,150000,f5d69960089c3614,3,0,65,39,59,30,34,48,53,57,54,64,35,18,26,39,-17,-29,12
445,110000,f5d69960089c3614,3,0,530,530,580,328,387,431,542,458,551,739,435,233,334,469,-202,-304,102
178,510000,f5d69960089c3614,3,0,157,199,189,198,208,192,406,218,246,296,270,133,202,233,-137,-26,-111
89,340000,f5d69960089c3614,3,0,65,66,77,68,83,102,108,119,125,125,156,59,108,113,-97,31,-128
223,370000,f5d69960089c3614,3,0,152,215,226,189,211,236,259,209,228,356,218,112,165,229,-106,-138,32
35,140000,f5d69960089c3614,3,0,35,31,34,37,39,38,29,27,53,51,47,21,34,40,-26,-4,-22
310,440000,f5d69960089c3614,3,0,279,264,290,315,201,283,319,341,442,572,437,152,294,387,-285,-135,-150
25,450000,f5d69960089c3614,3,0,33,39,40,44,25,47,48,35,38,46,44,34,39,41,-10,-2,-8
200,320000,f5d69960089c3614,3,0,177,166,199,160,179,202,235,218,248,301,251,138,194,230,-113,-50,-63
51,360000,f5d69960089c3614,3,0,60,46,67,46,43,63,74,57,75,92,84,32,58,69,-52,-8,-44
112,130000,f5d69960089c3614,3,0,72,82,94,85,75,106,81,95,123,131,106,79,92,105,-27,-25,-2
111,410000,f5d69960089c3614,3,0,115,177,146,115,120,133,136,137,144,187,131,57,94,125,-74,-56,-18
139,330000,f5d69960089c3614,3,0,101,105,120,103,117,123,127,129,149,230,149,78,114,152,-71,-81,10
111,420000,f5d69960089c3614,3,0,95,105,133,83,100,88,128,132,148,184,148,61,104,131,-87,-36,-51
132,430000,f5d69960089c3614,3,0,111,119,132,99,113,129,125,121,157,211,135,74,104,140,-61,-76,15
77,350000,f5d69960089c3614,3,0,75,68,110,85,91,79,63,93,111,124,108,57,82,96,-51,-16,-35
75,210000,f5d69960089c3614,3,0,96,78,114,94,86,129,93,93,126,129,69,51,60,83,-18,-60,42
112,500000,f5d69960089c3614,3,0,107,106,102,141,124,91,113,105,132,160,125,77,101,121,-48,-35,-13
137,610000,f5d69960089c3614,3,0,104,117,132,93,101,114,118,176,150,182,148,77,112,136,-71,-34,-37
68,230000,f5d69960089c3614,3,0,72,66,58,77,51,83,64,44,71,77,53,34,44,55,-19,-24,5
126,310000,5b1c11c3efed5312,3,0,137,166,137,100,120,182,195,186,244,388,154,85,120,209,-69,-234,165
60,530000,5b1c11c3efed5312,3,0,160,138,155,102,132,175,199,190,214,267,194,91,142,184,-103,-73,-30
61,150000,5b1c11c3efed5312,3,0,109,113,123,90,86,129,117,180,167,259,127,62,94,149,-65,-132,67
51,110000,5b1c11c3efed5312,3,0,168,157,135,132,124,189,195,143,181,370,71,41,56,161,-30,-299,269
129,510000,5b1c11c3efed5312,3,0,341,347,268,235,259,271,451,335,432,691,448,194,321,444,-254,-243,-11
227,340000,5b1c11c3efed5312,3,0,428,406,511,409,457,615,665,719,699,1253,712,250,481,738,-462,-541,79
297,370000,5b1c11c3efed5312,3,0,553,712,759,542,525,598,799,850,792,1449,549,320,434,773,-229,-900,671
103,140000,5b1c11c3efed5312,3,0,172,156,184,119,112,180,176,226,231,426,153,81,117,220,-72,-273,201
342,440000,5b1c11c3efed5312,3,0,505,439,656,557,570,682,810,953,1204,1628,496,168,332,764,-328,-1132,804
54,450000,5b1c11c3efed5312,3,0,128,93,99,74,74,93,96,119,135,240,121,56,88,139,-65,-119,54
404,320000,5b1c11c3efed5312,3,0,835,685,815,558,664,879,928,1050,1083,1908,768,543,656,1073,-225,-1140,915
150,360000,5b1c11c3efed5312,3,0,250,275,290,238,256,256,368,358,434,733,453,153,303,446,-300,-280,-20
257,130000,5b1c11c3efed5312,3,0,481,442,541,372,433,513,576,665,667,1158,476,272,374,635,-204,-682,478
312,410000,5b1c11c3efed5312,3,0,612,706,670,565,604,728,823,894,1006,1883,910,372,641,1055,-538,-973,435
386,330000,5b1c11c3efed5312,3,0,741,745,772,623,618,806,968,1022,1202,2202,744,430,587,1125,-314,-1458,1144
138,420000,5b1c11c3efed5312,3,0,249,254,222,214,224,236,278,353,409,749,443,143,293,445,-300,-306,6
137,430000,5b1c11c3efed5312,3,0,262,282,299,206,221,263,352,322,439,744,378,131,254,418,-247,-366,119
173,350000,5b1c11c3efed5312,3,0,251,186,224,163,185,197,242,345,391,594,265,149,207,336,-116,-329,213
80,210000,5b1c11c3efed5312,3,0,164,167,172,127,118,166,151,176,186,256,75,62,68,131,-13,-181,168
29,500000,5b1c11c3efed5312,3,0,103,86,60,103,92,81,101,86,92,172,124,38,81,111,-86,-48,-38
70,610000,5b1c11c3efed5312,3,0,165,166,180,107,108,126,155,205,212,325,144,79,112,183,-65,-181,116
52,230000,5b1c11c3efed5312,3,0,172,142,116,90,66,138,116,107,126,152,43,36,40,77,-7,-109,102
37,310000,17363f08d683d52b,3,0,67,57,61,83,70,93,94,69,88,96,65,19,42,60,-46,-31,-15
82,530000,17363f08d683d52b,3,0,157,153,150,145,260,181,192,214,209,182,216,75,146,158,-141,34,-175
66,150000,17363f08d683d52b,3,0,103,103,189,132,152,130,174,176,130,141,132,46,89,106,-86,-9,-77
65,110000,17363f08d683d52b,3,0,255,224,215,203,267,229,259,158,186,277,124,81,102,161,-43,-153,110
93,510000,17363f08d683d52b,3,0,249,251,265,277,338,249,374,267,205,292,350,117,234,253,-233,58,-291
108,340000,17363f08d683d52b,3,0,259,261,334,403,369,409,407,332,341,384,513,121,317,339,-392,129,-521
153,370000,17363f08d683d52b,3,0,460,477,501,534,578,578,669,572,480,596,555,214,384,455,-341,-41,-300
12,140000,17363f08d683d52b,3,0,88,53,84,72,80,105,82,89,70,67,66,26,46,53,-40,-1,-39
63,440000,17363f08d683d52b,3,0,174,189,205,161,153,130,99,91,101,84,62,19,40,55,-43,-22,-21
26,450000,17363f08d683d52b,3,0,55,61,65,56,59,47,57,42,39,50,45,14,30,36,-31,-5,-26
216,320000,17363f08d683d52b,3,0,501,391,511,498,540,652,534,502,474,569,538,214,376,440,-324,-31,-293
101,360000,17363f08d683d52b,3,0,206,222,322,296,334,361,423,281,274,309,360,94,227,254,-266,51,-317
150,130000,17363f08d683d52b,3,0,326,300,423,331,415,474,378,372,326,383,353,154,254,297,-199,-30,-169
100,410000,17363f08d683d52b,3,0,344,433,458,439,537,516,505,471,372,457,538,139,338,378,-399,81,-480
152,330000,17363f08d683d52b,3,0,480,439,481,523,527,619,525,437,429,453,388,129,258,323,-259,-65,-194
139,420000,17363f08d683d52b,3,0,253,287,274,347,357,348,470,379,317,421,474,120,297,338,-354,53,-407
148,430000,17363f08d683d52b,3,0,271,267,285,332,369,394,455,353,348,428,459,95,277,327,-364,31,-395
44,350000,17363f08d683d52b,3,0,110,105,117,97,156,140,150,148,127,159,136,38,87,111,-98,-23,-75
93,210000,17363f08d683d52b,3,0,206,190,224,186,211,236,239,216,174,238,151,59,105,149,-92,-87,-5
27,500000,17363f08d683d52b,3,0,118,113,119,207,154,160,119,108,151,126,110,41,76,92,-69,-16,-53
67,610000,17363f08d683d52b,3,0,172,200,295,195,243,241,219,279,210,288,180,80,130,183,-100,-108,8
57,230000,17363f08d683d52b,3,0,155,112,155,119,135,185,126,121,118,156,75,46,60,92,-29,-81,52
136,310000,06880909932890ca,3,0,140,123,151,184,200,260,330,188,341,384,208,78,143,223,-130,-176,46
68,530000,06880909932890ca,3,0,97,87,116,115,160,152,177,216,186,206,142,56,99,135,-86,-64,-22
45,150000,06880909932890ca,3,0,68,89,116,92,95,118,103,121,125,115,74,44,59,78,-30,-41,11
206,110000,06880909932890ca,3,0,494,429,502,404,587,598,646,461,553,771,253,139,196,388,-114,-518,404
243,510000,06880909932890ca,3,0,370,360,435,525,529,541,770,548,657,933,673,263,468,623,-410,-260,-150
340,340000,06880909932890ca,3,0,410,494,668,812,815,909,849,800,764,993,964,338,651,765,-626,-29,-597
430,370000,06880909932890ca,3,0,689,772,912,798,955,1028,1068,979,957,1332,1011,383,697,909,-628,-321,-307
102,140000,06880909932890ca,3,0,124,155,182,158,166,260,200,213,203,275,128,67,98,157,-61,-147,86
638,440000,06880909932890ca,3,0,692,651,912,826,970,1165,1341,1182,1660,1546,767,278,522,864,-489,-779,290
105,450000,06880909932890ca,3,0,132,118,154,160,138,192,192,181,188,276,186,86,136,183,-100,-90,-10
984,320000,06880909932890ca,3,0,1437,1322,1690,1549,1784,2086,2054,2015,2022,2642,2094,991,1542,1909,-1103,-548,-555
211,360000,06880909932890ca,3,0,275,317,446,403,446,466,481,368,453,691,614,157,386,487,-457,-77,-380
330,130000,06880909932890ca,3,0,527,489,571,550,679,797,728,665,667,773,530,290,410,531,-240,-243,3
650,410000,06880909932890ca,3,0,741,998,1156,1405,1588,1680,1676,1390,1577,2409,1865,640,1252,1638,-1225,-544,-681
663,330000,06880909932890ca,3,0,1017,1000,1198,1267,1405,1649,1572,1696,1832,2222,1022,501,762,1248,-521,-1200,679
211,420000,06880909932890ca,3,0,322,336,378,470,475,562,525,475,492,661,605,178,392,481,-427,-56,-371
228,430000,06880909932890ca,3,0,348,380,383,445,414,541,561,481,547,698,488,170,329,452,-318,-210,-108
246,350000,06880909932890ca,3,0,232,228,311,284,350,418,427,469,556,601,361,197,279,386,-164,-240,76
120,210000,06880909932890ca,3,0,190,228,287,226,287,309,335,246,211,328,161,100,130,196,-61,-167,106
158,500000,06880909932890ca,3,0,176,207,287,447,415,439,445,330,373,430,326,140,233,299,-186,-104,-82
145,610000,06880909932890ca,3,0,252,248,336,278,349,407,350,449,347,562,349,119,234,343,-230,-213,-17
53,230000,06880909932890ca,3,0,136,101,109,89,128,149,133,82,97,100,69,37,53,69,-32,-31,-1
54,310000,9c1c7ee8ebdda299,3,0,45,21,27,22,13,27,10,4,41,46,32,19,26,32,-13,-14,1
91,530000,9c1c7ee8ebdda299,3,0,170,165,176,148,181,200,159,126,119,169,142,104,123,138,-38,-27,-11
258,150000,9c1c7ee8ebdda299,3,0,295,260,348,233,350,323,327,297,353,430,278,168,223,292,-110,-152,42
30,110000,9c1c7ee8ebdda299,3,0,230,173,167,151,170,121,96,46,78,112,52,38,45,67,-14,-60,46
250,510000,9c1c7ee8ebdda299,3,0,914,753,701,834,869,836,723,408,517,641,617,336,476,531,-281,-24,-257
119,340000,9c1c7ee8ebdda299,3,0,281,292,330,322,293,261,211,71,198,190,278,146,212,205,-132,88,-220
746,370000,9c1c7ee8ebdda299,3,0,1411,1514,1697,1542,1763,1885,1782,1445,1562,2281,1763,885,1324,1643,-878,-518,-360
401,140000,9c1c7ee8ebdda299,3,0,695,566,798,670,854,973,842,579,768,886,691,295,493,624,-396,-195,-201
471,440000,9c1c7ee8ebdda299,3,0,851,657,797,730,793,791,821,619,710,1008,472,229,350,570,-243,-536,293
119,450000,9c1c7ee8ebdda299,3,0,235,139,170,190,169,185,191,132,192,308,251,110,180,223,-141,-57,-84
211,320000,9c1c7ee8ebdda299,3,0,368,309,295,297,299,267,195,95,307,309,370,299,334,326,-71,61,-132
107,360000,9c1c7ee8ebdda299,3,0,223,225,303,258,215,138,145,60,177,182,224,84,154,163,-140,42,-182
941,130000,9c1c7ee8ebdda299,3,0,1679,1513,1845,1547,1898,2125,1949,1092,1644,1840,1468,940,1204,1416,-528,-372,-156
362,410000,9c1c7ee8ebdda299,3,0,746,823,772,817,797,693,546,306,774,911,1101,433,767,815,-668,190,-858
195,330000,9c1c7ee8ebdda299,3,0,257,215,232,213,216,202,149,42,380,352,327,197,262,292,-130,-25,-105
65,420000,9c1c7ee8ebdda299,3,0,165,159,138,172,121,123,100,46,116,125,211,58,134,131,-153,86,-239
87,430000,9c1c7ee8ebdda299,3,0,197,204,204,207,195,142,140,74,141,165,230,105,168,167,-125,65,-190
130,350000,9c1c7ee8ebdda299,3,0,327,238,254,259,254,219,159,110,281,215,204,105,154,175,-99,-11,-88
409,210000,9c1c7ee8ebdda299,3,0,497,548,622,615,791,715,654,384,528,619,375,317,346,437,-58,-244,186
54,500000,9c1c7ee8ebdda299,3,0,127,140,142,167,210,170,119,62,80,104,116,61,88,94,-55,12,-67
136,610000,9c1c7ee8ebdda299,3,0,325,347,415,360,504,331,168,145,214,250,261,108,184,206,-153,11,-164
192,230000,9c1c7ee8ebdda299,3,0,325,312,349,289,307,328,302,291,350,342,207,144,176,231,-63,-135,72
151,310000,c6833cb891626c17,3,0,143,153,184,190,187,321,371,283,435,596,174,80,127,283,-94,-422,328
185,530000,c6833cb891626c17,3,0,243,214,293,278,391,368,477,514,538,699,444,236,340,460,-208,-255,47
125,150000,c6833cb891626c17,3,0,150,144,231,182,278,328,337,354,323,485,221,94,158,267,-127,-264,137
289,110000,c6833cb891626c17,3,0,424,446,557,512,616,785,877,636,879,1517,309,174,242,667,-135,-1208,1073
285,510000,c6833cb891626c17,3,0,385,442,498,519,553,602,1020,712,770,1305,743,339,541,796,-404,-562,158
344,340000,c6833cb891626c17,3,0,335,430,556,596,658,834,1066,894,964,1597,855,344,600,932,-511,-742,231
327,370000,c6833cb891626c17,3,0,583,765,851,801,793,998,1278,1160,1107,1740,687,383,535,937,-304,-1053,749
117,140000,c6833cb891626c17,3,0,151,162,214,187,206,301,280,282,301,514,192,100,146,269,-92,-322,230
403,440000,c6833cb891626c17,3,0,614,549,687,668,710,890,1382,1240,1586,1899,542,186,364,876,-356,-1357,1001
110,450000,c6833cb891626c17,3,0,187,136,186,226,201,232,277,266,309,514,260,96,178,290,-164,-254,90
593,320000,c6833cb891626c17,3,0,808,744,993,872,955,1345,1406,1396,1446,2279,939,574,756,1264,-365,-1340,975
199,360000,c6833cb891626c17,3,0,209,241,288,279,356,409,638,519,571,900,502,180,341,527,-322,-398,76
412,130000,c6833cb891626c17,3,0,577,540,727,602,725,929,1066,990,1108,1749,708,414,561,957,-294,-1041,747
557,410000,c6833cb891626c17,3,0,612,886,926,1021,1208,1438,1525,1493,1622,2735,1331,509,920,1525,-822,-1404,582
616,330000,c6833cb891626c17,3,0,832,846,1069,1144,1284,1635,1804,1911,2130,3255,1119,581,850,1652,-538,-2136,1598
210,420000,c6833cb891626c17,3,0,282,287,324,375,419,485,678,560,634,1014,597,202,400,604,-395,-417,22
209,430000,c6833cb891626c17,3,0,301,351,355,332,374,473,712,546,606,978,498,212,355,563,-286,-480,194
184,350000,c6833cb891626c17,3,0,226,228,280,250,238,291,406,499,552,782,311,141,226,411,-170,-471,301
97,210000,c6833cb891626c17,3,0,255,208,243,206,229,283,315,299,258,424,127,80,104,210,-47,-297,250
78,500000,c6833cb891626c17,3,0,137,183,177,223,193,277,336,267,309,532,260,104,182,299,-156,-272,116
154,610000,c6833cb891626c17,3,0,215,218,355,227,253,326,373,472,366,620,315,130,222,355,-185,-305,120
66,230000,c6833cb891626c17,3,0,192,157,191,155,137,237,206,170,232,274,80,52,66,135,-28,-194,166
174,310000,3e21824be728cbec,3,0,243,160,176,192,187,249,257,239,345,396,369,177,273,314,-192,-27,-165
207,530000,3e21824be728cbec,3,0,291,200,206,289,300,344,358,406,373,334,203,134,168,224,-69,-131,62
42,150000,3e21824be728cbec,3,0,69,59,78,58,65,160,123,116,59,90,51,29,40,57,-22,-39,17
87,110000,3e21824be728cbec,3,0,199,163,119,141,164,139,203,168,222,242,93,60,76,132,-33,-149,116
321,510000,3e21824be728cbec,3,0,557,450,413,455,488,625,731,758,778,781,288,239,264,436,-49,-493,444
301,340000,3e21824be728cbec,3,0,450,279,349,370,347,570,630,644,607,661,309,266,288,412,-43,-352,309
572,370000,3e21824be728cbec,3,0,731,616,559,584,576,690,772,807,782,994,540,419,480,651,-121,-454,333
87,140000,3e21824be728cbec,3,0,151,126,140,127,162,287,240,200,132,201,88,44,66,111,-44,-113,69
477,440000,3e21824be728cbec,3,0,606,453,438,526,486,516,619,721,938,1135,331,231,281,566,-100,-804,704
140,450000,3e21824be728cbec,3,0,278,158,185,230,205,301,268,247,370,403,140,92,116,212,-48,-263,215
885,320000,3e21824be728cbec,3,0,1579,700,765,791,837,1017,1020,1227,1286,1781,805,710,758,1099,-95,-976,881
173,360000,3e21824be728cbec,3,0,320,223,276,230,221,285,391,438,444,431,157,97,127,228,-60,-274,214
484,130000,3e21824be728cbec,3,0,668,556,558,552,574,734,729,766,589,806,391,375,383,524,-16,-415,399
528,410000,3e21824be728cbec,3,0,738,578,632,668,840,854,777,834,729,896,363,334,348,531,-29,-533,504
475,330000,3e21824be728cbec,3,0,865,493,406,443,507,510,573,616,797,1044,341,386,364,590,45,-703,748
194,420000,3e21824be728cbec,3,0,391,284,238,303,280,357,375,452,413,461,270,123,196,285,-147,-191,44
182,430000,3e21824be728cbec,3,0,341,224,235,250,255,292,394,414,458,478,157,99,128,245,-58,-321,263
266,350000,3e21824be728cbec,3,0,489,293,325,290,310,328,339,397,455,593,250,154,202,332,-96,-343,247
75,210000,3e21824be728cbec,3,0,145,108,118,118,139,151,144,114,136,149,45,36,40,77,-9,-104,95
148,500000,3e21824be728cbec,3,0,262,167,239,459,311,410,422,402,422,475,136,124,130,245,-12,-339,327
188,610000,3e21824be728cbec,3,0,280,319,382,320,375,494,446,595,355,464,194,145,170,268,-49,-270,221
82,230000,3e21824be728cbec,3,0,198,154,180,125,146,202,237,176,82,87,40,47,44,58,7,-47,54
288,310000,f8a6975573af1b33,3,0,375,266,306,267,258,427,420,355,228,579,371,131,251,360,-240,-208,-32
179,530000,f8a6975573af1b33,3,0,225,152,177,118,180,214,200,244,165,338,215,134,174,229,-81,-123,42
59,150000,f8a6975573af1b33,3,0,44,26,58,32,43,34,40,41,43,48,41,28,34,39,-13,-7,-6
110,110000,f8a6975573af1b33,3,0,327,244,264,181,202,267,304,268,372,383,131,61,96,192,-70,-252,182
428,510000,f8a6975573af1b33,3,0,488,398,410,336,352,370,632,431,484,820,550,286,418,552,-264,-270,6
432,340000,f8a6975573af1b33,3,0,403,387,411,362,305,443,521,495,362,758,508,322,415,529,-186,-250,64
320,370000,f8a6975573af1b33,3,0,457,424,368,316,303,357,410,423,383,729,410,227,318,455,-183,-319,136
53,140000,f8a6975573af1b33,3,0,102,63,71,48,59,51,78,61,91,136,74,57,66,89,-17,-62,45
1072,440000,f8a6975573af1b33,3,0,1121,875,992,904,879,1153,1298,1305,1034,2232,1023,444,734,1233,-579,-1209,630
160,450000,f8a6975573af1b33,3,0,249,172,201,169,192,217,237,215,191,328,208,107,158,214,-101,-120,19
1023,320000,f8a6975573af1b33,3,0,1427,1017,1202,877,845,1153,1190,1239,807,1846,1142,747,944,1245,-395,-704,309
237,360000,f8a6975573af1b33,3,0,249,182,202,165,177,232,306,226,131,436,290,111,200,279,-179,-146,-33
265,130000,f8a6975573af1b33,3,0,327,290,285,257,243,316,360,308,272,475,287,194,240,319,-93,-188,95
457,410000,f8a6975573af1b33,3,0,491,439,424,404,405,509,554,543,420,747,459,249,354,485,-210,-288,78
780,330000,f8a6975573af1b33,3,0,993,723,767,644,614,743,824,856,695,1454,752,503,628,903,-249,-702,453
246,420000,f8a6975573af1b33,3,0,257,224,213,257,205,250,304,278,190,481,312,158,235,317,-154,-169,15
263,430000,f8a6975573af1b33,3,0,320,299,303,226,226,283,329,289,235,425,324,139,232,296,-185,-101,-84
395,350000,f8a6975573af1b33,3,0,514,351,414,293,354,411,469,472,415,699,508,260,384,489,-248,-191,-57
82,210000,f8a6975573af1b33,3,0,156,120,126,118,94,128,154,125,64,125,66,52,59,81,-14,-59,45
288,500000,f8a6975573af1b33,3,0,399,316,243,316,279,300,389,322,256,548,310,185,248,348,-125,-238,113
124,610000,f8a6975573af1b33,3,0,154,172,180,121,162,175,188,226,181,259,170,96,133,175,-74,-89,15
76,230000,f8a6975573af1b33,3,0,121,105,118,92,95,86,84,67,65,115,61,52,56,76,-9,-54,45
338,310000,54fc07138d70374c,3,0,439,284,312,308,315,327,336,292,421,473,415,199,307,362,-216,-58,-158
353,530000,54fc07138d70374c,3,0,268,226,239,271,381,320,316,363,485,535,500,259,380,431,-241,-35,-206
208,150000,54fc07138d70374c,3,0,159,124,177,198,210,230,224,233,229,234,273,129,201,212,-144,39,-183
402,110000,54fc07138d70374c,3,0,489,359,374,335,454,424,442,429,500,681,534,295,414,503,-239,-147,-92
540,510000,54fc07138d70374c,3,0,509,498,454,508,557,495,659,704,743,849,933,442,688,741,-491,84,-575
210,340000,54fc07138d70374c,3,0,226,184,207,204,219,249,314,271,334,368,404,198,301,323,-206,36,-242
595,370000,54fc07138d70374c,3,0,517,505,542,531,579,617,771,679,776,936,911,376,644,741,-535,-25,-510
141,140000,54fc07138d70374c,3,0,155,129,125,128,113,131,135,142,208,244,213,113,163,190,-100,-31,-69
1068,440000,54fc07138d70374c,3,0,1193,876,978,1056,1120,1145,1408,1392,1836,2078,1526,521,1024,1375,-1005,-552,-453
236,450000,54fc07138d70374c,3,0,248,190,185,216,203,212,207,208,246,317,323,145,234,262,-178,6,-184
589,320000,54fc07138d70374c,3,0,578,403,502,513,553,616,611,660,847,820,821,461,641,701,-360,1,-361
164,360000,54fc07138d70374c,3,0,232,156,222,179,206,215,215,187,249,262,297,113,205,224,-184,35,-219
483,130000,54fc07138d70374c,3,0,398,396,448,411,475,528,576,625,746,750,758,431,594,646,-327,8,-335
615,410000,54fc07138d70374c,3,0,596,488,554,520,548,623,596,604,752,820,826,447,636,698,-379,6,-385
401,330000,54fc07138d70374c,3,0,435,299,309,330,357,379,387,524,623,684,550,252,401,495,-298,-134,-164
299,420000,54fc07138d70374c,3,0,291,252,255,280,268,311,346,310,385,425,481,197,339,368,-284,56,-340
383,430000,54fc07138d70374c,3,0,378,270,349,338,350,384,424,364,460,493,505,239,372,412,-266,12,-278
217,350000,54fc07138d70374c,3,0,290,209,200,169,259,222,223,268,329,338,400,163,282,300,-237,62,-299
274,210000,54fc07138d70374c,3,0,305,230,303,292,281,324,364,303,369,450,249,117,183,272,-132,-201,69
403,500000,54fc07138d70374c,3,0,424,365,346,440,402,372,406,400,540,575,576,284,430,478,-292,1,-293
272,610000,54fc07138d70374c,3,0,276,242,263,225,299,275,293,365,346,404,376,178,277,319,-198,-28,-170
341,230000,54fc07138d70374c,3,0,363,293,273,325,359,356,331,302,341,410,324,206,265,313,-118,-86,-32
180,310000,212083a9246d2fd3,3,0,307,248,310,413,581,617,628,446,636,846,241,179,210,422,-62,-605,543
117,530000,212083a9246d2fd3,3,0,154,145,172,143,197,189,278,304,365,493,290,145,218,309,-145,-203,58
119,150000,212083a9246d2fd3,3,0,111,109,155,125,168,136,222,206,310,562,284,123,204,323,-161,-278,117
55,110000,212083a9246d2fd3,3,0,412,270,321,429,521,473,498,257,444,824,105,71,88,333,-34,-719,685
400,510000,212083a9246d2fd3,3,0,584,606,603,636,717,777,1042,762,1080,1730,983,504,744,1072,-479,-747,268
593,340000,212083a9246d2fd3,3,0,404,412,563,701,945,973,1078,1023,1260,2243,1186,528,857,1319,-658,-1057,399
503,370000,212083a9246d2fd3,3,0,851,1042,1265,1160,1176,1294,1622,1536,1637,2998,1261,553,907,1604,-708,-1737,1029
140,140000,212083a9246d2fd3,3,0,144,177,203,154,257,272,308,299,372,645,313,178,246,379,-135,-332,197
855,440000,212083a9246d2fd3,3,0,608,631,1027,923,1121,1670,1369,1274,1967,3191,905,337,621,1478,-568,-2286,1718
227,450000,212083a9246d2fd3,3,0,141,105,142,190,192,188,232,252,337,697,471,179,325,449,-292,-226,-66
777,320000,212083a9246d2fd3,3,0,1242,1231,1592,1724,1702,2067,2163,1918,2283,3836,1631,972,1302,2146,-659,-2205,1546
229,360000,212083a9246d2fd3,3,0,244,251,345,361,411,440,542,547,676,1270,658,229,444,719,-429,-612,183
442,130000,212083a9246d2fd3,3,0,511,495,710,678,854,909,987,969,1064,2232,950,551,750,1244,-399,-1282,883
807,410000,212083a9246d2fd3,3,0,634,824,900,1091,1257,1337,1548,1431,1720,3243,1894,828,1361,1988,-1066,-1349,283
328,330000,212083a9246d2fd3,3,0,712,672,814,952,886,1003,1067,1140,1205,1850,574,328,451,917,-246,-1276,1030
256,420000,212083a9246d2fd3,3,0,379,335,349,502,356,435,576,710,866,1354,755,244,500,784,-511,-599,88
403,430000,212083a9246d2fd3,3,0,360,426,538,599,590,709,844,687,982,1756,938,322,630,1005,-616,-818,202
250,350000,212083a9246d2fd3,3,0,249,221,268,357,422,486,645,645,746,1041,462,182,322,562,-280,-579,299
144,210000,212083a9246d2fd3,3,0,177,163,241,231,300,418,415,275,422,561,181,92,136,278,-89,-380,291
195,500000,212083a9246d2fd3,3,0,299,375,484,631,758,749,722,571,643,1136,557,231,394,641,-326,-579,253
275,610000,212083a9246d2fd3,3,0,254,261,399,506,811,726,652,682,805,1567,639,298,468,835,-341,-928,587
72,230000,212083a9246d2fd3,3,0,119,141,163,123,259,159,164,109,207,305,102,62,82,156,-40,-203,163
32,310000,4f79773e600518a6,3,0,117,95,90,87,88,90,112,64,139,159,95,31,63,95,-64,-64,0
58,530000,4f79773e600518a6,3,0,132,81,108,54,102,103,88,129,116,195,181,91,136,156,-90,-14,-76
110,150000,4f79773e600518a6,3,0,183,174,223,139,192,148,178,215,227,336,327,113,220,259,-214,-9,-205
29,110000,4f79773e600518a6,3,0,188,157,103,119,110,107,124,113,153,246,99,35,67,127,-64,-147,83
108,510000,4f79773e600518a6,3,0,263,231,201,164,169,165,260,194,267,387,398,155,276,313,-243,11,-254
103,340000,4f79773e600518a6,3,0,241,207,206,161,192,228,277,262,301,471,484,121,302,359,-363,13,-376
300,370000,4f79773e600518a6,3,0,548,574,604,450,433,565,670,629,591,961,723,263,493,649,-460,-238,-222
59,140000,4f79773e600518a6,3,0,100,103,114,81,88,106,92,114,133,167,149,66,108,127,-83,-18,-65
44,440000,4f79773e600518a6,3,0,174,156,103,107,99,112,111,142,134,176,97,19,58,97,-78,-79,1
31,450000,4f79773e600518a6,3,0,90,53,59,61,36,46,27,44,52,62,66,20,43,49,-46,4,-50
137,320000,4f79773e600518a6,3,0,420,362,365,291,216,275,222,289,312,450,333,168,250,317,-165,-117,-48
58,360000,4f79773e600518a6,3,0,142,129,162,110,96,123,158,141,164,252,264,69,166,195,-195,12,-207
165,130000,4f79773e600518a6,3,0,265,258,283,231,209,251,268,281,338,473,362,182,272,339,-180,-111,-69
223,410000,4f79773e600518a6,3,0,456,508,440,420,458,438,436,457,535,679,669,213,441,520,-456,-10,-446
54,330000,4f79773e600518a6,3,0,179,148,165,119,117,144,152,167,161,255,131,59,95,148,-72,-124,52
110,420000,4f79773e600518a6,3,0,218,242,217,211,166,169,231,258,278,385,450,105,278,313,-345,65,-410
262,430000,4f79773e600518a6,3,0,388,395,357,324,322,320,453,378,533,776,857,222,540,618,-635,81,-716
20,350000,4f79773e600518a6,3,0,87,42,60,45,47,38,50,51,83,65,41,21,31,42,-20,-24,4
66,210000,4f79773e600518a6,3,0,129,125,118,82,101,115,152,128,129,166,109,50,80,108,-59,-57,-2
77,500000,4f79773e600518a6,3,0,209,189,156,162,125,149,157,175,189,306,256,58,157,207,-198,-50,-148
190,610000,4f79773e600518a6,3,0,335,296,319,224,270,298,329,421,381,634,493,193,343,440,-300,-141,-159
96,230000,4f79773e600518a6,3,0,190,188,152,109,132,165,141,126,204,277,131,70,100,159,-61,-146,85
95,310000,fc32b1a017b34efe,3,0,199,164,165,139,164,176,188,167,211,361,138,71,104,190,-67,-223,156
256,530000,fc32b1a017b34efe,3,0,412,328,421,327,407,402,486,521,434,743,406,299,352,483,-107,-337,230
211,150000,fc32b1a017b34efe,3,0,274,265,289,218,256,255,374,366,390,683,304,135,220,374,-169,-379,210
121,110000,fc32b1a017b34efe,3,0,434,345,391,298,365,388,458,302,357,675,173,56,114,301,-117,-502,385
782,510000,fc32b1a017b34efe,3,0,1383,1313,1243,1067,1135,1222,1530,1137,1318,2057,1186,681,934,1308,-505,-871,366
213,340000,fc32b1a017b34efe,3,0,408,413,407,292,363,463,479,476,493,865,574,194,384,544,-380,-291,-89
412,370000,fc32b1a017b34efe,3,0,778,983,935,718,720,875,922,870,894,1538,723,282,502,848,-441,-815,374
254,140000,fc32b1a017b34efe,3,0,339,383,469,311,358,454,470,495,510,974,417,214,316,535,-203,-557,354
493,440000,fc32b1a017b34efe,3,0,692,629,703,576,557,610,730,702,768,1105,569,259,414,644,-310,-536,226
165,450000,fc32b1a017b34efe,3,0,209,154,242,164,182,175,217,208,212,406,260,101,180,256,-159,-146,-13
409,320000,fc32b1a017b34efe,3,0,745,631,724,557,652,768,765,828,786,1332,698,402,550,811,-296,-634,338
193,360000,fc32b1a017b34efe,3,0,235,288,311,262,276,281,350,363,356,774,420,110,265,435,-310,-354,44
516,130000,fc32b1a017b34efe,3,0,744,724,862,614,693,937,936,974,964,2069,891,397,644,1119,-494,-1178,684
387,410000,fc32b1a017b34efe,3,0,715,892,850,682,796,900,924,913,934,1916,1026,330,678,1091,-696,-890,194
281,330000,fc32b1a017b34efe,3,0,572,541,581,492,491,561,604,663,556,982,370,195,282,516,-175,-612,437
159,420000,fc32b1a017b34efe,3,0,265,278,276,303,276,301,385,300,389,721,401,105,253,409,-296,-320,24
298,430000,fc32b1a017b34efe,3,0,514,623,562,511,551,548,722,567,687,1290,631,205,418,709,-426,-659,233
138,350000,fc32b1a017b34efe,3,0,218,190,170,135,152,178,217,240,253,385,180,95,138,220,-85,-205,120
181,210000,fc32b1a017b34efe,3,0,237,238,223,208,212,251,209,211,226,330,135,104,120,190,-31,-195,164
464,500000,fc32b1a017b34efe,3,0,800,797,796,935,790,970,909,844,751,1420,661,420,540,834,-241,-759,518
336,610000,fc32b1a017b34efe,3,0,501,575,671,425,496,540,574,623,639,1234,604,184,394,674,-420,-630,210
111,230000,fc32b1a017b34efe,3,0,176,124,152,127,131,146,126,126,150,236,76,111,94,141,35,-160,195
198,310000,feabbf46658382b9,3,0,239,247,291,237,275,484,500,412,620,805,357,95,226,419,-262,-448,186
522,530000,feabbf46658382b9,3,0,481,450,444,342,521,806,851,856,921,1249,829,418,624,832,-411,-420,9
415,150000,feabbf46658382b9,3,0,315,336,322,265,347,507,500,528,675,925,601,288,444,605,-313,-324,11
313,110000,feabbf46658382b9,3,0,478,446,455,384,534,743,672,532,779,1421,437,212,324,690,-225,-984,759
1084,510000,feabbf46658382b9,3,0,1148,1182,899,922,1077,1757,2178,1620,1861,2915,2183,903,1543,2000,-1280,-732,-548
330,340000,feabbf46658382b9,3,0,365,405,383,373,395,690,798,757,934,1307,1141,304,722,917,-837,-166,-671
569,370000,feabbf46658382b9,3,0,611,792,689,593,668,1173,1160,1214,1192,1610,1006,389,698,1002,-617,-604,-13
368,140000,feabbf46658382b9,3,0,325,308,304,235,316,582,505,511,601,970,406,198,302,525,-208,-564,356
825,440000,feabbf46658382b9,3,0,689,958,928,799,758,1347,1576,1507,1902,2685,1203,341,772,1410,-862,-1482,620
235,450000,feabbf46658382b9,3,0,267,191,230,206,193,394,347,352,440,665,433,149,291,416,-284,-232,-52
861,320000,feabbf46658382b9,3,0,887,1007,951,861,1014,1794,1646,1598,1955,2752,1481,650,1066,1628,-831,-1271,440
229,360000,feabbf46658382b9,3,0,214,275,281,260,281,443,510,475,511,802,624,159,392,528,-465,-178,-287
608,130000,feabbf46658382b9,3,0,562,650,653,522,624,985,1009,905,1021,1551,970,478,724,1000,-492,-581,89
672,410000,feabbf46658382b9,3,0,628,786,747,679,846,1361,1342,1399,1530,2696,1928,502,1215,1709,-1426,-768,-658
530,330000,feabbf46658382b9,3,0,535,675,710,572,720,1247,1320,1351,1499,2124,704,292,498,1040,-412,-1420,1008
313,420000,feabbf46658382b9,3,0,307,317,322,323,347,614,653,620,794,1252,837,201,519,763,-636,-415,-221
671,430000,feabbf46658382b9,3,0,596,697,623,625,741,1241,1383,1339,1478,2360,1657,503,1080,1507,-1154,-703,-451
211,350000,feabbf46658382b9,3,0,235,287,264,213,231,425,414,399,601,698,428,129,278,418,-299,-270,-29
226,210000,feabbf46658382b9,3,0,230,240,206,200,191,375,331,306,361,459,235,125,180,273,-110,-224,114
896,500000,feabbf46658382b9,3,0,1012,1031,877,1159,994,1592,1671,1487,1581,2727,1846,758,1302,1777,-1088,-881,-207
426,610000,feabbf46658382b9,3,0,513,636,634,391,538,758,764,827,896,1319,905,333,619,852,-572,-414,-158
199,230000,feabbf46658382b9,3,0,173,167,152,156,136,271,219,256,312,397,173,117,145,229,-56,-224,168
28,310000,f270f6a489c6a9d7,3,0,81,54,48,33,25,37,28,27,30,34,19,29,24,27,10,-15,25
1187,530000,f270f6a489c6a9d7,3,0,1751,1315,1335,1170,1342,1395,1639,1736,1547,1939,1680,1190,1435,1603,-490,-259,-231
117,150000,f270f6a489c6a9d7,3,0,83,96,80,81,79,74,107,93,105,108,54,78,66,80,24,-54,78
157,110000,f270f6a489c6a9d7,3,0,229,233,214,173,229,238,282,198,305,504,106,118,112,243,12,-398,410
678,510000,f270f6a489c6a9d7,3,0,1205,892,875,682,620,742,717,655,773,955,603,645,624,734,42,-352,394
191,340000,f270f6a489c6a9d7,3,0,323,285,216,207,172,194,197,214,225,272,216,223,220,237,7,-56,63
513,370000,f270f6a489c6a9d7,3,0,721,695,659,545,644,631,622,551,636,1105,629,541,585,758,-88,-476,388
127,140000,f270f6a489c6a9d7,3,0,270,155,157,114,131,103,137,118,161,233,166,115,140,171,-51,-67,16
757,440000,f270f6a489c6a9d7,3,0,1291,948,890,830,568,627,644,624,713,866,346,505,426,572,159,-520,679
85,450000,f270f6a489c6a9d7,3,0,173,97,104,62,69,50,93,63,75,97,92,50,71,80,-42,-5,-37
857,320000,f270f6a489c6a9d7,3,0,992,724,727,654,653,752,766,763,871,1150,610,843,726,868,233,-540,773
105,360000,f270f6a489c6a9d7,3,0,183,155,161,110,121,107,134,92,117,148,132,89,110,123,-43,-16,-27
685,130000,f270f6a489c6a9d7,3,0,811,606,636,506,529,574,561,554,769,983,537,616,576,712,79,-446,525
753,410000,f270f6a489c6a9d7,3,0,1260,1027,934,847,759,825,703,746,952,1314,922,778,850,1005,-144,-392,248
511,330000,f270f6a489c6a9d7,3,0,934,557,549,457,405,385,451,456,466,653,312,498,405,488,186,-341,527
482,420000,f270f6a489c6a9d7,3,0,859,536,538,476,513,518,582,592,590,903,514,438,476,618,-76,-389,313
375,430000,f270f6a489c6a9d7,3,0,656,598,440,429,353,375,366,327,426,575,405,314,360,431,-91,-170,79
157,350000,f270f6a489c6a9d7,3,0,270,206,172,148,152,164,156,179,175,195,85,140,112,140,55,-110,165
236,210000,f270f6a489c6a9d7,3,0,331,272,228,230,212,192,216,260,281,370,158,187,172,238,29,-212,241
771,500000,f270f6a489c6a9d7,3,0,1037,781,700,668,554,592,643,645,706,955,636,643,640,745,7,-319,326
198,610000,f270f6a489c6a9d7,3,0,321,306,283,187,180,190,227,209,280,324,195,155,175,225,-40,-129,89
67,230000,f270f6a489c6a9d7,3,0,134,124,103,81,47,88,70,59,76,90,35,48,42,58,13,-55,68
74,310000,d0f245b8781e3631,3,0,116,114,110,134,139,176,218,159,193,281,60,52,56,131,-8,-221,213
130,530000,d0f245b8781e3631,3,0,124,127,149,132,201,192,241,224,227,356,181,119,150,219,-62,-175,113
81,150000,d0f245b8781e3631,3,0,100,61,89,103,103,63,86,129,183,244,117,67,92,143,-50,-127,77
132,110000,d0f245b8781e3631,3,0,520,398,466,501,463,464,472,326,417,805,105,52,78,321,-53,-700,647
505,510000,d0f245b8781e3631,3,0,939,830,726,715,739,855,1133,824,910,1456,816,454,635,909,-362,-640,278
133,340000,d0f245b8781e3631,3,0,164,160,209,240,323,314,310,267,287,463,251,96,174,270,-155,-212,57
311,370000,d0f245b8781e3631,3,0,501,593,571,548,646,773,797,679,738,1182,600,283,442,688,-317,-582,265
135,140000,d0f245b8781e3631,3,0,200,167,199,121,199,221,226,243,264,497,192,96,144,262,-96,-305,209
271,440000,d0f245b8781e3631,3,0,374,342,351,384,378,429,596,574,615,869,297,127,212,431,-170,-572,402
136,450000,d0f245b8781e3631,3,0,162,108,140,126,161,139,167,205,233,425,254,71,162,250,-183,-171,-12
342,320000,d0f245b8781e3631,3,0,606,574,521,545,683,706,761,731,749,1017,461,270,366,583,-191,-556,365
84,360000,d0f245b8781e3631,3,0,127,126,110,128,145,145,229,198,198,315,211,60,136,195,-151,-104,-47
398,130000,d0f245b8781e3631,3,0,446,455,480,501,551,690,771,682,755,1430,754,390,572,858,-364,-676,312
371,410000,d0f245b8781e3631,3,0,500,524,534,645,779,871,851,876,865,1601,892,268,580,920,-624,-709,85
170,330000,d0f245b8781e3631,3,0,280,246,271,509,410,370,1437,406,420,845,174,81,128,367,-93,-671,578
47,420000,d0f245b8781e3631,3,0,139,112,83,118,124,88,110,128,133,246,134,39,86,140,-95,-112,17
231,430000,d0f245b8781e3631,3,0,398,280,324,325,335,319,439,335,447,756,439,130,284,442,-309,-317,8
67,350000,d0f245b8781e3631,3,0,105,96,92,93,116,102,142,175,166,247,102,51,76,133,-51,-145,94
29,210000,d0f245b8781e3631,3,0,64,60,48,65,77,81,68,54,102,113,47,21,34,60,-26,-66,40
298,500000,d0f245b8781e3631,3,0,570,694,1791,780,781,1602,764,548,596,1578,630,283,456,830,-347,-948,601
261,610000,d0f245b8781e3631,3,0,384,352,349,347,435,453,455,455,558,938,498,189,344,542,-309,-440,131
21,230000,d0f245b8781e3631,3,0,20,14,19,35,25,28,17,16,45,45,7,10,8,21,3,-38,41
223,310000,c6cd4e0e073f5ac2,3,0,766,615,1911,902,547,590,1049,393,448,746,228,125,176,366,-103,-518,415
68,530000,c6cd4e0e073f5ac2,3,0,301,236,299,183,317,301,410,266,224,235,105,67,86,136,-38,-130,92
95,150000,c6cd4e0e073f5ac2,3,0,210,170,205,129,178,248,263,289,273,340,208,63,136,204,-145,-132,-13
64,110000,c6cd4e0e073f5ac2,3,0,210,198,2153,193,216,265,2528,156,179,362,72,29,50,154,-43,-290,247
246,510000,c6cd4e0e073f5ac2,3,0,978,987,918,779,942,1243,1666,730,631,1027,542,251,396,607,-291,-485,194
232,340000,c6cd4e0e073f5ac2,3,0,521,577,609,647,742,968,961,755,678,1434,792,244,518,823,-548,-642,94
341,370000,c6cd4e0e073f5ac2,3,0,1597,1972,2081,1738,2176,2848,2646,1380,1053,1685,823,326,574,945,-497,-862,365
162,140000,c6cd4e0e073f5ac2,3,0,332,357,466,412,468,657,660,386,479,604,321,126,224,350,-195,-283,88
374,440000,c6cd4e0e073f5ac2,3,0,1067,835,808,584,546,819,1623,936,1038,1493,451,130,290,691,-321,-1042,721
136,450000,c6cd4e0e073f5ac2,3,0,289,222,206,200,234,316,360,349,312,543,250,76,163,290,-174,-293,119
751,320000,c6cd4e0e073f5ac2,3,0,2036,1793,2058,1654,1827,2527,2388,1650,1467,2828,1205,656,930,1563,-549,-1623,1074
232,360000,c6cd4e0e073f5ac2,3,0,401,428,462,351,450,511,752,626,577,1241,549,138,344,643,-411,-692,281
293,130000,c6cd4e0e073f5ac2,3,0,745,818,940,856,987,1387,1606,840,561,1020,602,249,426,624,-353,-418,65
512,410000,c6cd4e0e073f5ac2,3,0,1036,1237,1242,1377,1416,1736,1669,959,1021,1584,992,320,656,965,-672,-592,-80
342,330000,c6cd4e0e073f5ac2,3,0,854,706,739,693,717,1019,1203,828,859,1272,386,193,290,617,-193,-886,693
272,420000,c6cd4e0e073f5ac2,3,0,611,623,602,550,430,713,769,691,751,1208,523,161,342,631,-362,-685,323
232,430000,c6cd4e0e073f5ac2,3,0,532,566,595,580,641,816,847,522,619,891,508,132,320,510,-376,-383,7
106,350000,c6cd4e0e073f5ac2,3,0,172,152,204,142,221,243,304,268,291,431,173,74,124,226,-99,-258,159
75,210000,c6cd4e0e073f5ac2,3,0,182,229,277,157,228,366,291,139,186,225,91,51,71,122,-40,-134,94
53,500000,c6cd4e0e073f5ac2,3,0,210,204,174,226,215,324,310,182,148,242,128,33,80,134,-95,-114,19
143,610000,c6cd4e0e073f5ac2,3,0,391,524,533,558,687,656,661,278,275,432,182,64,123,226,-118,-250,132
33,230000,c6cd4e0e073f5ac2,3,0,110,100,111,89,97,146,137,83,61,140,53,29,41,74,-24,-87,63
128,310000,a9a43d1a7ecbe75d,3,0,149,133,134,134,141,138,161,113,162,163,142,84,113,130,-58,-21,-37
119,530000,a9a43d1a7ecbe75d,3,0,107,85,86,94,141,123,111,95,152,131,146,84,115,120,-62,15,-77
62,150000,a9a43d1a7ecbe75d,3,0,55,64,107,75,84,71,81,97,81,90,83,41,62,71,-42,-7,-35
74,110000,a9a43d1a7ecbe75d,3,0,85,87,95,97,119,87,131,79,100,123,88,65,76,92,-23,-35,12
223,510000,a9a43d1a7ecbe75d,3,0,228,225,215,255,232,227,447,284,279,330,341,184,262,285,-157,11,-168
149,340000,a9a43d1a7ecbe75d,3,0,134,119,161,145,138,167,182,170,183,198,254,107,180,186,-147,56,-203
162,370000,a9a43d1a7ecbe75d,3,0,124,180,157,181,138,136,198,152,160,191,159,74,116,141,-85,-32,-53
46,140000,a9a43d1a7ecbe75d,3,0,17,25,37,27,30,36,34,32,31,28,41,25,33,31,-16,13,-29
527,440000,a9a43d1a7ecbe75d,3,0,429,345,479,470,487,435,593,541,658,638,568,264,416,490,-304,-70,-234
197,450000,a9a43d1a7ecbe75d,3,0,156,161,164,160,151,154,208,163,172,213,297,121,209,210,-176,84,-260
408,320000,a9a43d1a7ecbe75d,3,0,341,313,360,325,317,361,402,385,402,439,430,213,322,361,-217,-9,-208
101,360000,a9a43d1a7ecbe75d,3,0,64,44,75,70,82,64,94,87,76,120,103,50,76,91,-53,-17,-36
116,130000,a9a43d1a7ecbe75d,3,0,90,92,88,94,88,102,92,82,85,95,109,50,80,85,-59,14,-73
142,410000,a9a43d1a7ecbe75d,3,0,107,141,117,126,120,123,153,141,134,164,130,78,104,124,-52,-34,-18
307,330000,a9a43d1a7ecbe75d,3,0,242,287,301,272,322,299,308,339,364,397,466,185,326,349,-281,69,-350
200,420000,a9a43d1a7ecbe75d,3,0,162,187,145,190,155,179,232,184,244,236,270,129,200,212,-141,34,-175
330,430000,a9a43d1a7ecbe75d,3,0,254,290,293,279,299,298,395,308,355,445,519,215,367,393,-304,74,-378
96,350000,a9a43d1a7ecbe75d,3,0,88,69,99,64,92,91,93,87,125,99,145,57,101,100,-88,46,-134
109,210000,a9a43d1a7ecbe75d,3,0,120,97,133,116,136,158,194,115,126,155,89,59,74,101,-30,-66,36
140,500000,a9a43d1a7ecbe75d,3,0,110,159,135,304,146,146,203,173,179,214,160,89,124,154,-71,-54,-17
228,610000,a9a43d1a7ecbe75d,3,0,179,190,260,217,273,229,256,263,252,263,274,154,214,230,-120,11,-131
91,230000,a9a43d1a7ecbe75d,3,0,89,80,70,81,75,75,68,54,66,57,65,35,50,52,-30,8,-38
264,310000,3c974920a76ac9c1,4,0,266,271,235,260,162,265,228,369,374,305,193,309,251,269,116,-112,228
243,530000,3c974920a76ac9c1,4,0,216,308,279,419,246,217,310,402,456,434,194,302,248,310,108,-240,348
176,150000,3c974920a76ac9c1,4,0,149,236,164,187,153,157,178,204,219,180,128,201,164,170,73,-52,125
340,110000,3c974920a76ac9c1,4,0,404,445,351,322,244,337,371,460,563,468,432,472,452,457,40,-36,76
337,510000,3c974920a76ac9c1,4,0,373,360,329,335,345,623,350,453,570,500,253,378,316,377,125,-247,372
155,340000,3c974920a76ac9c1,4,0,155,154,138,108,127,159,136,179,226,198,76,132,104,135,56,-122,178
484,370000,3c974920a76ac9c1,4,0,482,482,353,339,259,422,394,483,601,468,290,412,351,390,122,-178,300
182,140000,3c974920a76ac9c1,4,0,211,250,166,178,189,194,233,215,260,248,146,249,198,214,103,-102,205
2368,440000,3c974920a76ac9c1,4,0,2080,2897,2187,2183,1804,2265,2711,3532,3800,2692,1680,2958,2319,2443,1278,-1012,2290
277,450000,3c974920a76ac9c1,4,0,259,363,291,276,249,267,349,472,505,425,248,383,316,352,135,-177,312
617,320000,3c974920a76ac9c1,4,0,629,780,561,554,569,631,764,871,1010,800,486,817,652,701,331,-314,645
154,360000,3c974920a76ac9c1,4,0,143,167,149,136,95,156,166,204,262,236,78,191,134,168,113,-158,271
311,130000,3c974920a76ac9c1,4,0,254,280,252,227,235,225,228,291,305,260,190,297,244,249,107,-70,177
393,410000,3c974920a76ac9c1,4,0,394,313,330,384,256,301,351,521,505,405,250,355,302,337,105,-155,260
561,330000,3c974920a76ac9c1,4,0,483,638,453,457,422,545,702,660,865,633,409,621,515,554,212,-224,436
423,420000,3c974920a76ac9c1,4,0,368,357,440,329,325,381,447,480,474,497,228,445,336,390,217,-269,486
304,430000,3c974920a76ac9c1,4,0,266,308,275,250,286,299,327,364,474,347,174,297,236,273,123,-173,296
209,350000,3c974920a76ac9c1,4,0,287,307,223,276,226,258,368,331,404,292,181,307,244,260,126,-111,237
692,210000,3c974920a76ac9c1,4,0,807,900,645,700,556,721,769,941,997,650,566,775,670,664,209,-84,293
107,500000,3c974920a76ac9c1,4,0,106,114,181,131,111,101,120,155,199,115,72,126,99,104,54,-43,97
292,610000,3c974920a76ac9c1,4,0,259,414,206,262,204,187,324,393,440,305,219,295,257,273,76,-86,162
305,230000,3c974920a76ac9c1,4,0,356,398,288,194,351,302,310,458,461,292,234,401,318,309,167,-58,225
321,310000,3d7554f1f56dd664,4,0,342,349,376,356,410,417,271,639,518,268,263,442,352,324,179,-5,184
325,530000,3d7554f1f56dd664,4,0,246,290,259,337,266,368,334,609,519,292,264,403,334,320,139,-28,167
260,150000,3d7554f1f56dd664,4,0,191,270,175,231,216,208,216,370,337,175,149,316,232,213,167,-26,193
369,110000,3d7554f1f56dd664,4,0,412,406,405,459,464,449,231,675,811,368,359,470,414,399,111,-9,120
700,510000,3d7554f1f56dd664,4,0,758,701,656,684,758,1227,469,1053,1125,657,560,806,683,674,246,-97,343
315,340000,3d7554f1f56dd664,4,0,232,224,252,293,358,325,253,574,507,301,225,317,271,281,92,-76,168
1229,370000,3d7554f1f56dd664,4,0,1100,977,862,990,917,1222,876,1567,1574,775,729,1060,894,855,331,-46,377
358,140000,3d7554f1f56dd664,4,0,314,339,253,284,382,372,320,590,571,290,239,407,323,312,168,-51,219
8733,440000,3d7554f1f56dd664,4,0,7234,9327,8266,8709,10596,10140,6925,13598,11515,5136,4688,10371,7530,6732,5683,-448,6131
832,450000,3d7554f1f56dd664,4,0,658,835,723,792,866,969,642,1386,1258,750,559,1074,816,794,515,-191,706
1828,320000,3d7554f1f56dd664,4,0,1655,2026,1678,1827,2216,2075,1763,3112,2877,1445,1635,2184,1910,1755,549,190,359
463,360000,3d7554f1f56dd664,4,0,359,396,344,400,420,535,356,595,741,435,311,545,428,430,234,-124,358
1025,130000,3d7554f1f56dd664,4,0,591,633,520,604,569,722,520,1137,974,498,486,847,666,610,361,-12,373
944,410000,3d7554f1f56dd664,4,0,698,673,695,718,785,808,565,1273,1234,645,486,968,727,700,482,-159,641
1744,330000,3d7554f1f56dd664,4,0,1539,1625,1420,1737,1785,1658,1293,2709,2467,1135,1205,1969,1587,1436,764,70,694
619,420000,3d7554f1f56dd664,4,0,713,668,835,675,883,908,742,1001,1050,703,508,734,621,648,226,-195,421
687,430000,3d7554f1f56dd664,4,0,683,657,625,567,721,958,582,1112,1192,689,445,769,607,634,324,-244,568
1181,350000,3d7554f1f56dd664,4,0,1127,1467,1202,1533,1388,1310,817,2205,1578,856,899,1607,1253,1121,708,43,665
1837,210000,3d7554f1f56dd664,4,0,1870,2279,1544,2253,2301,1915,1064,2892,2161,1110,1306,1905,1606,1440,599,196,403
259,500000,3d7554f1f56dd664,4,0,213,199,327,300,319,331,173,470,398,244,215,285,250,248,70,-29,99
435,610000,3d7554f1f56dd664,4,0,320,486,412,553,492,462,375,582,607,340,260,369,314,323,109,-80,189
639,230000,3d7554f1f56dd664,4,0,626,765,687,670,1107,843,480,1076,1018,447,521,1186,854,718,665,74,591
162,310000,2d0d2c3403909fdb,4,0,184,219,211,160,159,169,112,163,167,157,101,187,144,148,86,-56,142
226,530000,2d0d2c3403909fdb,4,0,260,265,254,351,309,270,218,354,350,290,213,293,253,265,80,-77,157
241,150000,2d0d2c3403909fdb,4,0,228,261,237,261,246,234,155,184,233,279,174,228,201,227,54,-105,159
524,110000,2d0d2c3403909fdb,4,0,670,627,552,633,554,583,457,611,677,549,387,627,507,521,240,-162,402
355,510000,2d0d2c3403909fdb,4,0,327,372,413,373,319,387,300,411,434,516,235,377,306,376,142,-281,423
116,340000,2d0d2c3403909fdb,4,0,116,119,126,118,108,157,129,128,138,176,83,127,105,129,44,-93,137
334,370000,2d0d2c3403909fdb,4,0,317,345,393,358,328,376,327,415,400,420,235,353,294,336,118,-185,303
173,140000,2d0d2c3403909fdb,4,0,161,165,161,170,152,135,111,141,197,179,103,189,146,157,86,-76,162
1536,440000,2d0d2c3403909fdb,4,0,1472,1652,1649,1691,1490,1683,1421,1989,1829,1713,1159,1738,1448,1537,579,-554,1133
149,450000,2d0d2c3403909fdb,4,0,157,187,179,178,141,192,165,181,173,211,121,197,159,176,76,-90,166
386,320000,2d0d2c3403909fdb,4,0,393,413,417,373,340,401,333,437,427,470,296,446,371,404,150,-174,324
112,360000,2d0d2c3403909fdb,4,0,95,119,89,94,84,108,90,107,109,126,55,113,84,98,58,-71,129
364,130000,2d0d2c3403909fdb,4,0,302,305,302,324,321,309,274,302,328,389,251,371,311,337,120,-138,258
306,410000,2d0d2c3403909fdb,4,0,323,298,340,309,300,327,262,352,337,377,202,331,266,303,129,-175,304
335,330000,2d0d2c3403909fdb,4,0,357,357,351,316,352,336,342,428,424,401,264,349,306,338,85,-137,222
255,420000,2d0d2c3403909fdb,4,0,242,242,268,203,201,303,211,267,280,321,189,271,230,260,82,-132,214
262,430000,2d0d2c3403909fdb,4,0,237,248,277,255,193,250,211,244,275,284,146,275,210,235,129,-138,267
85,350000,2d0d2c3403909fdb,4,0,124,113,128,123,95,124,106,151,157,167,81,107,94,118,26,-86,112
433,210000,2d0d2c3403909fdb,4,0,495,542,501,506,466,488,346,464,567,506,316,529,422,450,213,-190,403
148,500000,2d0d2c3403909fdb,4,0,130,156,186,166,134,169,138,184,155,213,116,188,152,172,72,-97,169
291,610000,2d0d2c3403909fdb,4,0,239,271,255,273,253,271,195,252,267,297,206,288,247,264,82,-91,173
267,230000,2d0d2c3403909fdb,4,0,276,357,324,293,304,239,208,258,336,315,155,306,230,259,151,-160,311
131,310000,a28bb927b6fcb33c,4,0,238,251,282,229,249,216,166,212,210,117,96,135,116,116,39,-21,60
185,530000,a28bb927b6fcb33c,4,0,123,154,116,231,232,256,209,270,308,173,110,159,134,147,49,-63,112
148,150000,a28bb927b6fcb33c,4,0,106,123,97,118,134,193,128,165,176,89,72,136,104,99,64,-17,81
166,110000,a28bb927b6fcb33c,4,0,305,237,267,308,309,286,179,246,342,136,109,179,144,141,70,-27,97
425,510000,a28bb927b6fcb33c,4,0,413,430,414,426,492,712,401,438,436,351,212,361,286,308,149,-139,288
182,340000,a28bb927b6fcb33c,4,0,230,261,218,300,368,358,250,325,348,264,151,204,178,206,53,-113,166
467,370000,a28bb927b6fcb33c,4,0,484,405,407,399,489,606,454,468,556,225,175,357,266,252,182,-50,232
181,140000,a28bb927b6fcb33c,4,0,130,124,127,123,233,187,181,144,181,92,70,148,109,103,78,-22,100
3988,440000,a28bb927b6fcb33c,4,0,3317,3840,3624,4020,4618,5211,4012,4216,4195,2391,1639,3992,2816,2674,2353,-752,3105
418,450000,a28bb927b6fcb33c,4,0,277,350,329,360,409,444,331,432,386,248,166,443,304,286,277,-82,359
1039,320000,a28bb927b6fcb33c,4,0,829,888,876,892,1148,1130,943,1033,1154,680,651,982,816,771,331,-29,360
328,360000,a28bb927b6fcb33c,4,0,170,221,210,194,288,380,260,302,351,208,96,254,175,186,158,-112,270
570,130000,a28bb927b6fcb33c,4,0,362,423,480,475,550,584,385,397,419,248,284,584,434,372,300,36,264
638,410000,a28bb927b6fcb33c,4,0,449,371,468,562,658,673,556,567,651,338,242,578,410,386,336,-96,432
1404,330000,a28bb927b6fcb33c,4,0,1039,1012,1006,1138,1244,1296,1228,1343,1310,747,739,1438,1088,975,699,-8,707
459,420000,a28bb927b6fcb33c,4,0,533,457,595,544,655,744,726,677,787,450,226,461,344,379,235,-224,459
554,430000,a28bb927b6fcb33c,4,0,529,476,494,503,610,619,436,474,674,394,223,436,330,351,213,-171,384
612,350000,a28bb927b6fcb33c,4,0,426,506,417,546,535,615,563,615,519,231,173,535,354,313,362,-58,420
646,210000,a28bb927b6fcb33c,4,0,649,665,803,867,1031,840,522,652,848,213,233,610,422,352,377,20,357
157,500000,a28bb927b6fcb33c,4,0,183,200,348,324,316,208,150,157,208,123,85,166,126,125,81,-38,119
242,610000,a28bb927b6fcb33c,4,0,194,239,237,272,274,262,219,225,317,148,105,202,154,152,97,-43,140
244,230000,a28bb927b6fcb33c,4,0,261,255,248,232,335,334,222,288,303,90,85,233,159,136,148,-5,153
169,310000,17bc272c93f19d56,4,0,182,202,234,212,256,234,168,249,477,199,177,267,222,214,90,-22,112
2281,530000,17bc272c93f19d56,4,0,2130,2397,2353,2868,2565,3307,3096,3216,4503,4785,3067,2754,2910,3535,-313,-1718,1405
487,150000,17bc272c93f19d56,4,0,313,361,329,346,368,502,360,520,675,504,451,680,566,545,229,-53,282
124,110000,17bc272c93f19d56,4,0,246,278,163,179,202,242,199,305,514,151,92,197,144,147,105,-59,164
1090,510000,17bc272c93f19d56,4,0,1056,1064,1118,1183,1230,1449,1007,1411,1954,1724,1537,1481,1509,1581,-56,-187,131
1284,340000,17bc272c93f19d56,4,0,1224,1396,1210,1260,1418,1458,1238,1535,2328,2152,1881,1518,1700,1850,-363,-271,-92
2545,370000,17bc272c93f19d56,4,0,2653,3587,2963,3398,3600,3519,3268,3907,6576,4483,3060,2839,2950,3461,-221,-1423,1202
1118,140000,17bc272c93f19d56,4,0,1076,1493,1193,1334,1452,1749,1354,1585,2844,2093,1361,1353,1357,1602,-8,-732,724
1684,440000,17bc272c93f19d56,4,0,1309,1820,1577,1457,1550,1999,1555,2007,3029,1611,1579,2180,1880,1790,601,-32,633
1540,450000,17bc272c93f19d56,4,0,1831,2371,1991,2051,2291,2515,2293,2687,4443,3084,1836,2310,2073,2410,474,-1248,1722
1601,320000,17bc272c93f19d56,4,0,1392,1679,1539,1776,1799,1764,1493,1942,3067,2165,2419,2029,2224,2204,-390,254,-644
668,360000,17bc272c93f19d56,4,0,877,1066,892,885,890,1111,824,980,1510,1290,922,875,898,1029,-47,-368,321
3015,130000,17bc272c93f19d56,4,0,2351,2960,2437,2748,3368,3303,2808,3641,6231,3870,3403,2945,3174,3406,-458,-467,9
2704,410000,17bc272c93f19d56,4,0,2891,3967,3302,3413,3591,3584,3821,4668,7650,5825,3564,3197,3380,4195,-367,-2261,1894
1156,330000,17bc272c93f19d56,4,0,943,1216,1213,1206,1016,1295,1112,1294,2062,1260,1629,1592,1610,1494,-37,369,-406
895,420000,17bc272c93f19d56,4,0,1013,1221,954,900,992,1202,958,1353,2198,1919,1140,1262,1201,1440,122,-779,901
1174,430000,17bc272c93f19d56,4,0,1609,1715,1491,1500,1678,1773,1354,1770,2693,2364,1506,1541,1524,1804,35,-858,893
463,350000,17bc272c93f19d56,4,0,458,576,545,512,565,573,523,688,892,592,650,741,696,661,91,58,33
959,210000,17bc272c93f19d56,4,0,894,1170,1034,1023,1010,1135,824,1154,1710,924,939,1322,1130,1062,383,15,368
212,500000,17bc272c93f19d56,4,0,191,258,225,203,204,284,201,250,357,250,248,235,242,244,-13,-2,-11
1222,610000,17bc272c93f19d56,4,0,1008,1213,1083,1173,1245,1658,1590,1877,3217,2072,1105,1314,1210,1497,209,-967,1176
657,230000,17bc272c93f19d56,4,0,646,736,776,785,835,795,518,816,982,506,518,806,662,610,288,12,276
229,310000,2a2ab41f8f6ff1cb,4,0,198,232,330,331,445,555,272,582,623,382,114,351,232,282,237,-268,505
403,530000,2a2ab41f8f6ff1cb,4,0,246,327,333,428,409,543,553,546,680,484,300,452,376,412,152,-184,336
505,150000,2a2ab41f8f6ff1cb,4,0,472,638,517,552,645,831,715,836,832,551,317,489,403,452,172,-234,406
142,110000,2a2ab41f8f6ff1cb,4,0,260,324,331,345,369,502,362,440,598,212,102,180,141,165,78,-110,188
790,510000,2a2ab41f8f6ff1cb,4,0,847,961,1004,1032,1165,1460,1050,1385,1850,1223,671,850,760,915,179,-552,731
980,340000,2a2ab41f8f6ff1cb,4,0,849,934,1047,1058,1409,1565,1256,1491,1666,1515,717,1018,868,1083,301,-798,1099
1902,370000,2a2ab41f8f6ff1cb,4,0,1413,1635,1575,1773,2139,2580,2061,2146,2737,1706,842,1734,1288,1427,892,-864,1756
582,140000,2a2ab41f8f6ff1cb,4,0,433,477,430,532,655,690,724,762,993,533,312,595,454,480,283,-221,504
4896,440000,2a2ab41f8f6ff1cb,4,0,3887,5187,5010,5237,6544,8215,6582,6734,6492,5607,2647,5713,4180,4656,3066,-2960,6026
453,450000,2a2ab41f8f6ff1cb,4,0,472,589,632,639,680,913,743,853,894,799,409,719,564,642,310,-390,700
1498,320000,2a2ab41f8f6ff1cb,4,0,1467,1717,1679,1859,2252,2410,2283,2584,2672,1728,1016,1729,1372,1491,713,-712,1425
687,360000,2a2ab41f8f6ff1cb,4,0,619,761,704,848,964,1340,1065,1086,1291,1027,356,690,523,691,334,-671,1005
2486,130000,2a2ab41f8f6ff1cb,4,0,1445,1808,1966,2293,2864,3253,2277,2327,2703,2119,1271,2126,1698,1839,855,-848,1703
2566,410000,2a2ab41f8f6ff1cb,4,0,1910,2169,2264,2690,3318,3446,2827,2797,3447,2952,1308,2514,1911,2258,1206,-1644,2850
905,330000,2a2ab41f8f6ff1cb,4,0,721,949,928,974,1151,1369,1262,1632,1972,795,459,876,668,710,417,-336,753
1029,420000,2a2ab41f8f6ff1cb,4,0,1012,1027,1207,1181,1412,1938,1686,1663,2151,1566,597,1095,846,1086,498,-969,1467
1573,430000,2a2ab41f8f6ff1cb,4,0,1396,1570,1605,1889,1918,2573,2247,1966,2770,1651,844,1487,1166,1327,643,-807,1450
267,350000,2a2ab41f8f6ff1cb,4,0,208,292,259,301,348,390,371,447,476,264,148,314,231,242,166,-116,282
293,210000,2a2ab41f8f6ff1cb,4,0,283,311,261,323,369,397,317,403,513,241,211,360,286,271,149,-30,179
453,500000,2a2ab41f8f6ff1cb,4,0,530,585,806,750,810,888,646,803,1149,803,328,472,400,534,144,-475,619
497,610000,2a2ab41f8f6ff1cb,4,0,358,387,403,502,566,687,665,655,845,620,247,468,358,445,221,-373,594
449,230000,2a2ab41f8f6ff1cb,4,0,492,550,570,602,652,669,544,740,1032,399,306,506,406,404,200,-93,293
1119,310000,c06a2a387c0ee510,4,0,994,1124,945,1154,1068,958,710,977,1212,1265,890,1247,1068,1134,357,-375,732
133,530000,c06a2a387c0ee510,4,0,57,124,99,83,62,79,45,66,119,104,63,214,138,127,151,-41,192
131,150000,c06a2a387c0ee510,4,0,50,51,85,56,51,54,43,56,75,86,64,154,109,101,90,-22,112
1132,110000,c06a2a387c0ee510,4,0,872,926,824,1014,976,1027,677,793,1627,1352,1114,1508,1311,1325,394,-238,632
335,510000,c06a2a387c0ee510,4,0,166,175,144,210,234,199,102,145,321,208,187,254,220,216,67,-21,88
340,340000,c06a2a387c0ee510,4,0,190,155,149,157,167,182,145,176,251,253,175,322,248,250,147,-78,225
1248,370000,c06a2a387c0ee510,4,0,729,614,644,701,698,710,494,739,1047,878,649,1303,976,943,654,-229,883
320,140000,c06a2a387c0ee510,4,0,96,90,115,93,101,121,83,105,184,165,123,244,184,177,121,-42,163
1100,440000,c06a2a387c0ee510,4,0,491,557,511,479,453,514,463,571,819,762,448,944,696,718,496,-314,810
134,450000,c06a2a387c0ee510,4,0,38,32,27,46,65,36,87,45,96,92,54,103,78,83,49,-38,87
1289,320000,c06a2a387c0ee510,4,0,808,786,664,704,653,923,563,731,1002,974,650,1188,919,937,538,-324,862
140,360000,c06a2a387c0ee510,4,0,107,79,54,83,56,89,43,74,97,118,85,164,124,122,79,-33,112
660,130000,c06a2a387c0ee510,4,0,240,232,241,288,302,284,232,288,493,470,361,599,480,477,238,-109,347
731,410000,c06a2a387c0ee510,4,0,390,376,374,353,356,387,282,366,596,517,345,763,554,542,418,-172,590
915,330000,c06a2a387c0ee510,4,0,466,382,390,895,578,350,278,533,736,534,424,754,589,571,330,-110,440
253,420000,c06a2a387c0ee510,4,0,139,123,130,108,119,115,66,94,173,151,103,240,172,165,137,-48,185
163,430000,c06a2a387c0ee510,4,0,140,72,59,68,91,68,60,83,119,101,59,203,131,121,144,-42,186
303,350000,c06a2a387c0ee510,4,0,219,92,103,107,123,99,106,97,170,123,106,206,156,145,100,-17,117
324,210000,c06a2a387c0ee510,4,0,266,153,169,211,178,184,111,151,300,181,154,357,256,231,203,-27,230
181,500000,c06a2a387c0ee510,4,0,106,65,63,75,66,120,43,58,100,60,71,130,100,87,59,11,48
305,610000,c06a2a387c0ee510,4,0,185,153,156,195,228,164,136,164,313,234,179,320,250,244,141,-55,196
185,230000,c06a2a387c0ee510,4,0,127,69,65,102,113,130,76,95,177,129,74,323,198,175,249,-55,304
309,310000,7023efdab9cedc03,4,0,561,484,494,547,504,605,431,543,697,325,168,288,228,260,120,-157,277
54,530000,7023efdab9cedc03,4,0,82,70,56,86,60,80,64,106,112,40,25,38,32,34,13,-15,28
46,150000,7023efdab9cedc03,4,0,66,70,55,54,65,50,48,60,75,31,18,29,24,26,11,-13,24
50,110000,7023efdab9cedc03,4,0,177,131,96,96,105,107,59,86,132,40,51,59,55,50,8,11,-3
175,510000,7023efdab9cedc03,4,0,226,211,185,192,194,379,187,278,408,216,117,192,154,175,75,-99,174
278,340000,7023efdab9cedc03,4,0,375,352,304,284,383,452,363,447,587,357,148,207,178,237,59,-209,268
400,370000,7023efdab9cedc03,4,0,655,512,403,384,434,524,437,477,555,320,180,373,276,291,193,-140,333
38,140000,7023efdab9cedc03,4,0,77,84,53,53,40,61,59,55,64,30,23,28,26,27,5,-7,12
158,440000,7023efdab9cedc03,4,0,282,274,225,205,191,284,225,342,408,121,39,166,102,109,127,-82,209
50,450000,7023efdab9cedc03,4,0,77,81,56,48,72,86,66,86,129,68,34,47,40,50,13,-34,47
879,320000,7023efdab9cedc03,4,0,1203,1261,881,934,1240,1311,1156,1271,1767,893,628,788,708,770,160,-265,425
188,360000,7023efdab9cedc03,4,0,241,252,167,187,201,205,175,224,302,169,92,161,126,141,69,-77,146
108,130000,7023efdab9cedc03,4,0,204,145,156,130,129,149,129,127,215,80,56,93,74,76,37,-24,61
329,410000,7023efdab9cedc03,4,0,347,264,222,222,264,300,257,320,368,183,97,185,141,155,88,-86,174
511,330000,7023efdab9cedc03,4,0,810,793,638,611,791,867,742,941,1163,445,309,478,394,411,169,-136,305
184,420000,7023efdab9cedc03,4,0,266,209,221,204,189,253,233,287,401,211,94,172,133,159,78,-117,195
167,430000,7023efdab9cedc03,4,0,256,228,177,169,202,213,182,259,315,201,83,173,128,152,90,-118,208
78,350000,7023efdab9cedc03,4,0,99,97,66,59,77,86,70,117,145,54,20,51,36,42,31,-34,65
82,210000,7023efdab9cedc03,4,0,169,79,56,94,56,78,81,68,104,28,21,52,36,34,31,-7,38
37,500000,7023efdab9cedc03,4,0,50,37,61,45,63,77,40,57,62,28,20,37,28,28,17,-8,25
83,610000,7023efdab9cedc03,4,0,169,156,96,102,126,137,141,113,177,107,51,78,64,79,27,-56,83
18,230000,7023efdab9cedc03,4,0,50,45,25,30,29,39,29,28,30,11,11,8,10,10,-3,0,-3
807,310000,af6f4f548684e14d,4,0,969,925,835,829,878,839,851,1537,1734,940,540,957,748,812,417,-400,817
301,530000,af6f4f548684e14d,4,0,333,370,297,444,406,375,464,639,732,400,288,346,317,345,58,-112,170
333,150000,af6f4f548684e14d,4,0,350,427,288,345,346,426,433,493,573,322,195,323,259,280,128,-127,255
489,110000,af6f4f548684e14d,4,0,585,621,593,551,572,648,532,915,1057,659,394,601,498,551,207,-265,472
761,510000,af6f4f548684e14d,4,0,869,835,754,816,821,1394,1020,1293,1876,1072,611,873,742,852,262,-461,723
664,340000,af6f4f548684e14d,4,0,800,749,648,689,782,938,1018,1287,1597,1015,457,773,615,748,316,-558,874
1236,370000,af6f4f548684e14d,4,0,1662,1314,1119,1240,1232,1497,1547,1722,2394,1077,522,1253,888,951,731,-555,1286
310,140000,af6f4f548684e14d,4,0,423,462,359,317,365,407,489,581,742,375,248,450,349,358,202,-127,329
892,440000,af6f4f548684e14d,4,0,955,1092,904,1023,986,1197,1508,2163,2594,949,463,1024,744,812,561,-486,1047
222,450000,af6f4f548684e14d,4,0,262,320,307,308,261,338,373,502,713,341,210,322,266,291,112,-131,243
1181,320000,af6f4f548684e14d,4,0,1369,1459,1195,1141,1497,1413,1635,2059,2647,1466,939,1519,1229,1308,580,-527,1107
746,360000,af6f4f548684e14d,4,0,710,757,635,717,687,798,900,1083,1527,753,397,757,577,636,360,-356,716
694,130000,af6f4f548684e14d,4,0,695,817,660,609,745,771,828,1012,1235,691,404,655,530,583,251,-287,538
1013,410000,af6f4f548684e14d,4,0,1124,951,899,929,998,1228,1191,1470,2122,1000,589,1119,854,903,530,-411,941
796,330000,af6f4f548684e14d,4,0,913,926,862,813,942,1042,1090,1626,2068,1003,537,978,758,839,441,-466,907
873,420000,af6f4f548684e14d,4,0,894,947,966,785,977,1135,1284,1519,1632,1025,485,1058,772,856,573,-540,1113
962,430000,af6f4f548684e14d,4,0,1065,1061,902,924,1034,1175,1168,1619,2178,1217,467,1068,768,917,601,-750,1351
373,350000,af6f4f548684e14d,4,0,323,473,273,417,426,426,568,767,913,522,257,433,345,404,176,-265,441
329,210000,af6f4f548684e14d,4,0,386,363,316,315,365,365,407,443,594,254,172,277,224,234,105,-82,187
321,500000,af6f4f548684e14d,4,0,331,291,407,357,329,386,354,500,762,420,252,342,297,338,90,-168,258
238,610000,af6f4f548684e14d,4,0,396,383,263,316,283,360,444,478,651,365,184,306,245,285,122,-181,303
187,230000,af6f4f548684e14d,4,0,347,288,202,213,233,201,203,289,372,142,121,207,164,157,86,-21,107
1070,310000,7cf283430b3b5e38,4,0,1391,1398,1353,1616,1715,1560,1261,1546,1428,635,513,975,744,708,462,-122,584
316,530000,7cf283430b3b5e38,4,0,304,335,298,451,462,412,350,412,626,249,167,333,250,250,166,-82,248
330,150000,7cf283430b3b5e38,4,0,304,432,328,313,335,434,451,516,701,285,178,320,249,261,142,-107,249
101,110000,7cf283430b3b5e38,4,0,284,280,232,247,248,278,174,264,913,106,74,113,94,98,39,-32,71
1501,510000,7cf283430b3b5e38,4,0,1763,1713,1549,1800,1833,2351,1555,1783,2691,1134,763,1522,1142,1140,759,-371,1130
2068,340000,7cf283430b3b5e38,4,0,1838,2005,1957,2071,2572,2578,2110,2138,2356,1607,968,1908,1438,1494,940,-639,1579
3779,370000,7cf283430b3b5e38,4,0,3584,3723,2665,3185,3623,4079,3911,3787,4830,2048,1323,3138,2230,2170,1815,-725,2540
610,140000,7cf283430b3b5e38,4,0,562,695,612,635,770,774,678,852,1073,317,283,629,456,410,346,-34,380
1512,440000,7cf283430b3b5e38,4,0,1748,2151,1841,2105,2230,2219,1912,2435,2500,695,488,1495,992,893,1007,-207,1214
554,450000,7cf283430b3b5e38,4,0,401,605,509,467,597,723,646,783,869,475,293,738,516,502,445,-182,627
4083,320000,7cf283430b3b5e38,4,0,4265,5237,4119,4343,5439,5089,5170,5016,5865,2657,2401,4119,3260,3059,1718,-256,1974
1828,360000,7cf283430b3b5e38,4,0,1136,1339,997,1282,1228,1446,1175,1376,1737,923,549,1502,1026,991,953,-374,1327
2198,130000,7cf283430b3b5e38,4,0,1462,1915,1717,1730,2030,2166,1672,1926,2621,900,720,1379,1050,1000,659,-180,839
3199,410000,7cf283430b3b5e38,4,0,2464,2148,2124,2569,3033,2794,2644,2874,3243,1683,1042,2558,1800,1761,1516,-641,2157
1876,330000,7cf283430b3b5e38,4,0,2464,3027,2635,2644,3079,3258,3003,3295,3490,1289,1038,1965,1502,1431,927,-251,1178
1278,420000,7cf283430b3b5e38,4,0,1212,1354,1346,1388,1694,1779,1500,1547,1624,929,480,1234,857,881,754,-449,1203
1616,430000,7cf283430b3b5e38,4,0,1484,1556,1388,1464,1556,1793,1457,1585,1952,989,516,1513,1014,1006,997,-473,1470
878,350000,7cf283430b3b5e38,4,0,695,1147,600,1040,913,859,836,1130,958,546,402,859,630,602,457,-144,601
498,210000,7cf283430b3b5e38,4,0,639,553,466,570,710,667,540,619,821,205,149,446,298,267,297,-56,353
401,500000,7cf283430b3b5e38,4,0,248,344,487,446,463,501,422,419,597,296,163,296,230,252,133,-133,266
689,610000,7cf283430b3b5e38,4,0,620,717,590,762,830,880,891,912,1151,413,242,475,358,377,233,-171,404
193,230000,7cf283430b3b5e38,4,0,355,391,233,247,332,298,250,347,415,118,130,301,216,183,171,12,159
95,310000,d4efbebb087fd03f,4,0,116,132,121,130,170,225,144,225,270,79,27,45,36,50,18,-52,70
192,530000,d4efbebb087fd03f,4,0,130,150,124,141,193,215,192,267,384,296,172,285,228,251,113,-124,237
203,150000,d4efbebb087fd03f,4,0,134,180,155,165,211,257,237,359,450,248,124,211,168,194,87,-124,211
952,110000,d4efbebb087fd03f,4,0,666,671,764,635,596,755,684,938,1287,118,74,556,315,249,482,-44,526
676,510000,d4efbebb087fd03f,4,0,665,754,743,840,1135,1134,707,1002,2805,1326,797,891,844,1005,94,-529,623
520,340000,d4efbebb087fd03f,4,0,458,431,427,626,807,752,716,977,1443,903,436,535,486,625,99,-467,566
1575,370000,d4efbebb087fd03f,4,0,1289,1432,1325,1510,2013,2253,1752,2198,3785,1878,1009,1343,1176,1410,334,-869,1203
464,140000,d4efbebb087fd03f,4,0,293,383,273,396,591,635,370,1993,2925,603,248,417,332,423,169,-355,524
1095,440000,d4efbebb087fd03f,4,0,1031,1203,1183,1216,1851,1526,1065,2044,2419,914,399,1078,738,797,679,-515,1194
403,450000,d4efbebb087fd03f,4,0,250,385,389,373,565,452,368,493,935,666,303,492,398,487,189,-363,552
1041,320000,d4efbebb087fd03f,4,0,897,1057,971,1038,1263,1231,1184,1531,2308,910,648,752,700,770,104,-262,366
561,360000,d4efbebb087fd03f,4,0,469,546,479,591,657,831,701,917,1377,999,364,509,436,624,145,-635,780
953,130000,d4efbebb087fd03f,4,0,479,696,616,754,991,941,754,1144,2067,1110,641,741,691,831,100,-469,569
1423,410000,d4efbebb087fd03f,4,0,1161,1258,1321,1528,1922,1491,1090,1965,3560,2272,888,1199,1044,1453,311,-1384,1695
1097,330000,d4efbebb087fd03f,4,0,1570,1718,1900,1877,2534,1978,2287,3147,4324,1028,639,1114,876,927,475,-389,864
456,420000,d4efbebb087fd03f,4,0,420,420,475,487,636,528,521,941,1534,1004,347,476,412,609,129,-657,786
688,430000,d4efbebb087fd03f,4,0,945,1034,885,1014,1148,1102,762,1142,1719,1133,438,685,562,752,247,-695,942
565,350000,d4efbebb087fd03f,4,0,596,665,596,710,861,605,468,762,1967,434,268,656,462,453,388,-166,554
202,210000,d4efbebb087fd03f,4,0,209,189,242,328,373,319,239,291,520,199,149,205,177,184,56,-50,106
310,500000,d4efbebb087fd03f,4,0,305,265,352,383,500,317,253,326,532,432,291,409,350,377,118,-141,259
612,610000,d4efbebb087fd03f,4,0,511,669,670,984,1191,1013,830,1010,1651,919,422,609,516,650,187,-497,684
128,230000,d4efbebb087fd03f,4,0,79,102,96,114,179,154,114,204,257,135,104,114,109,118,10,-31,41
51,310000,7245e0ee27b195cd,4,0,54,61,91,84,82,78,75,125,158,63,40,60,50,54,20,-23,43
240,530000,7245e0ee27b195cd,4,0,208,229,212,242,297,409,425,375,535,421,246,288,267,318,42,-175,217
212,150000,7245e0ee27b195cd,4,0,157,157,141,155,186,321,287,448,676,363,164,250,207,259,86,-199,285
80,110000,7245e0ee27b195cd,4,0,158,142,166,192,229,328,289,360,496,86,74,109,92,90,35,-12,47
526,510000,7245e0ee27b195cd,4,0,458,502,542,612,740,894,870,831,1260,724,451,621,536,599,170,-273,443
315,340000,7245e0ee27b195cd,4,0,266,327,272,360,423,570,478,510,806,576,272,358,315,402,86,-304,390
1071,370000,7245e0ee27b195cd,4,0,977,950,814,1067,1385,1544,1660,1778,2915,1529,762,977,870,1089,215,-767,982
543,140000,7245e0ee27b195cd,4,0,328,438,304,387,526,657,689,668,1092,615,366,578,472,520,212,-249,461
836,440000,7245e0ee27b195cd,4,0,644,800,706,726,1003,987,1170,1384,1437,718,363,821,592,634,458,-355,813
288,450000,7245e0ee27b195cd,4,0,200,244,215,205,275,336,321,463,659,452,233,370,302,352,137,-219,356
460,320000,7245e0ee27b195cd,4,0,406,417,417,424,503,619,691,743,1008,543,405,518,462,489,113,-138,251
301,360000,7245e0ee27b195cd,4,0,316,324,321,323,384,576,518,577,816,634,247,323,285,401,76,-387,463
1070,130000,7245e0ee27b195cd,4,0,754,897,796,976,1190,1442,1308,1432,2365,1304,951,1023,987,1093,72,-353,425
888,410000,7245e0ee27b195cd,4,0,764,796,796,921,1180,1362,1148,1406,2228,1526,717,888,802,1044,171,-809,980
460,330000,7245e0ee27b195cd,4,0,555,599,497,546,656,656,660,874,1121,438,306,511,408,418,205,-132,337
342,420000,7245e0ee27b195cd,4,0,340,316,308,353,445,594,534,655,903,635,255,364,310,418,109,-380,489
531,430000,7245e0ee27b195cd,4,0,590,590,570,561,665,852,609,763,1216,773,321,479,400,524,158,-452,610
195,350000,7245e0ee27b195cd,4,0,227,185,203,218,279,280,218,239,420,249,153,274,214,225,121,-96,217
326,210000,7245e0ee27b195cd,4,0,267,276,253,308,361,450,328,514,641,287,222,321,272,277,99,-65,164
207,500000,7245e0ee27b195cd,4,0,187,187,221,263,289,325,272,292,402,296,142,238,190,225,96,-154,250
484,610000,7245e0ee27b195cd,4,0,433,446,383,562,667,705,729,755,1158,815,410,484,447,570,74,-405,479
161,230000,7245e0ee27b195cd,4,0,118,155,141,189,179,249,176,328,336,166,145,205,175,172,60,-21,81
125,310000,8c915fe4632fb9fa,4,0,94,156,130,143,149,181,158,314,461,180,102,190,146,157,88,-78,166
650,530000,8c915fe4632fb9fa,4,0,239,336,248,387,336,447,627,757,1396,1059,575,778,676,804,203,-484,687
409,150000,8c915fe4632fb9fa,4,0,117,165,174,186,216,287,324,527,720,520,270,473,372,421,203,-250,453
127,110000,8c915fe4632fb9fa,4,0,85,99,100,137,177,237,199,242,487,101,86,162,124,116,76,-15,91
1156,510000,8c915fe4632fb9fa,4,0,554,759,618,741,845,1263,1243,1605,2433,1860,1194,1302,1248,1452,108,-666,774
861,340000,8c915fe4632fb9fa,4,0,483,561,546,651,840,1069,1269,1370,2298,1440,720,878,799,1013,158,-720,878
1812,370000,8c915fe4632fb9fa,4,0,585,723,768,927,999,1485,1686,2126,3804,2217,1109,1504,1306,1610,395,-1108,1503
661,140000,8c915fe4632fb9fa,4,0,166,255,224,271,379,496,642,748,1215,772,404,591,498,589,187,-368,555
1064,440000,8c915fe4632fb9fa,4,0,449,600,502,550,650,835,848,1467,2021,1040,446,977,712,821,531,-594,1125
454,450000,8c915fe4632fb9fa,4,0,170,257,240,225,284,342,388,511,880,738,330,660,495,576,330,-408,738
1246,320000,8c915fe4632fb9fa,4,0,648,883,678,762,1001,1116,1451,1816,2525,1540,1130,1441,1286,1370,311,-410,721
631,360000,8c915fe4632fb9fa,4,0,270,410,377,409,440,725,733,889,1320,1015,377,598,488,663,221,-638,859
2041,130000,8c915fe4632fb9fa,4,0,487,781,785,958,1014,1437,1548,2026,3281,1882,1126,1456,1291,1488,330,-756,1086
1518,410000,8c915fe4632fb9fa,4,0,542,634,719,857,953,1313,1473,1843,2975,2324,1002,1413,1208,1580,411,-1322,1733
893,330000,8c915fe4632fb9fa,4,0,591,746,723,731,805,1089,1175,1502,2235,958,565,880,722,801,315,-393,708
723,420000,8c915fe4632fb9fa,4,0,444,503,489,505,669,868,924,1339,1557,1148,463,782,622,798,319,-685,1004
664,430000,8c915fe4632fb9fa,4,0,309,371,399,407,438,633,772,835,1281,1235,439,733,586,802,294,-796,1090
461,350000,8c915fe4632fb9fa,4,0,174,227,178,234,282,307,414,622,877,518,365,529,447,471,164,-153,317
397,210000,8c915fe4632fb9fa,4,0,155,177,191,236,231,291,296,396,542,311,224,349,286,295,125,-87,212
334,500000,8c915fe4632fb9fa,4,0,169,207,227,218,259,311,316,419,666,489,274,346,310,370,72,-215,287
535,610000,8c915fe4632fb9fa,4,0,202,287,271,303,362,519,627,715,1549,1036,394,463,428,631,69,-642,711
679,230000,8c915fe4632fb9fa,4,0,252,344,319,336,422,442,411,616,998,401,372,684,528,486,312,-29,341
354,310000,6155b214590c66e6,4,0,534,459,422,464,522,661,472,781,1047,423,192,279,236,298,87,-231,318
992,530000,6155b214590c66e6,4,0,856,985,706,939,877,1084,1148,1159,1879,1354,680,631,656,888,-49,-674,625
786,150000,6155b214590c66e6,4,0,492,583,433,551,578,725,701,941,1442,814,347,566,456,576,219,-467,686
280,110000,6155b214590c66e6,4,0,406,411,391,454,496,664,474,569,1295,274,176,281,228,244,105,-98,203
1488,510000,6155b214590c66e6,4,0,1892,1614,1306,1417,1488,2289,1556,2162,4188,2540,1081,1111,1096,1577,30,-1459,1489
1218,340000,6155b214590c66e6,4,0,1361,1443,1295,1412,1803,1996,1889,2073,3650,2495,863,893,878,1417,30,-1632,1662
3249,370000,6155b214590c66e6,4,0,2492,2580,2168,2583,2886,3461,3252,3594,6275,3467,1356,2002,1679,2275,646,-2111,2757
790,140000,6155b214590c66e6,4,0,602,630,509,619,652,805,800,914,1576,743,357,500,428,533,143,-386,529
1722,440000,6155b214590c66e6,4,0,1766,2201,1866,1837,2246,2808,2902,3269,4342,1784,653,1364,1008,1267,711,-1131,1842
538,450000,6155b214590c66e6,4,0,500,655,477,518,574,670,621,739,1316,892,381,556,468,610,175,-511,686
2607,320000,6155b214590c66e6,4,0,2838,3224,2468,2600,3230,3453,3560,3776,5864,3032,1760,2316,2038,2369,556,-1272,1828
962,360000,6155b214590c66e6,4,0,897,980,839,839,860,1325,1195,1285,2160,1579,453,603,528,878,150,-1126,1276
2467,130000,6155b214590c66e6,4,0,1778,2039,1774,2024,2258,2481,2298,2594,4551,2375,1231,1427,1329,1678,196,-1144,1340
2716,410000,6155b214590c66e6,4,0,2494,2508,2539,3103,3396,3571,3427,4047,8018,5309,1586,1915,1750,2937,329,-3723,4052
1890,330000,6155b214590c66e6,4,0,1980,2136,1905,1897,2229,2579,2724,3014,4336,1679,826,1161,994,1222,335,-853,1188
1028,420000,6155b214590c66e6,4,0,1346,1186,1236,1304,1341,1747,1512,1848,3179,2049,551,906,728,1169,355,-1498,1853
1395,430000,6155b214590c66e6,4,0,1610,1468,1450,1536,1679,2187,1872,2355,3747,2461,732,1157,944,1450,425,-1729,2154
616,350000,6155b214590c66e6,4,0,639,683,519,626,618,738,859,1140,1306,596,364,463,414,474,99,-232,331
1227,210000,6155b214590c66e6,4,0,900,949,846,1022,1132,1218,970,1188,1784,769,415,765,590,650,350,-354,704
529,500000,6155b214590c66e6,4,0,660,656,695,635,655,770,622,761,1417,877,373,399,386,550,26,-504,530
648,610000,6155b214590c66e6,4,0,548,688,468,587,654,727,899,841,1546,1008,303,361,332,557,58,-705,763
725,230000,6155b214590c66e6,4,0,624,692,573,663,777,675,517,944,1290,579,365,604,484,516,239,-214,453
667,310000,28e29f2c03dcd84c,4,0,712,656,680,680,720,820,623,807,1293,851,433,764,598,683,331,-418,749
361,530000,28e29f2c03dcd84c,4,0,184,252,242,468,405,456,394,535,639,509,300,415,358,408,115,-209,324
527,150000,28e29f2c03dcd84c,4,0,266,364,340,407,480,482,477,451,580,494,276,556,416,442,280,-218,498
982,110000,28e29f2c03dcd84c,4,0,1000,1124,1019,1062,1143,1276,969,1288,2146,1327,923,1308,1116,1186,385,-404,789
597,510000,28e29f2c03dcd84c,4,0,447,452,487,585,715,1123,634,781,1105,856,454,680,567,663,226,-402,628
584,340000,28e29f2c03dcd84c,4,0,507,478,422,472,667,840,774,803,1070,953,364,644,504,654,280,-589,869
1284,370000,28e29f2c03dcd84c,4,0,932,915,988,988,1162,1315,1224,1513,1837,1329,778,1244,1011,1117,466,-551,1017
713,140000,28e29f2c03dcd84c,4,0,602,669,598,604,750,729,770,798,1203,945,474,746,610,722,272,-471,743
549,440000,28e29f2c03dcd84c,4,0,221,266,335,313,351,438,425,536,825,423,180,427,304,343,247,-243,490
141,450000,28e29f2c03dcd84c,4,0,79,110,114,93,121,141,135,160,243,179,71,140,106,130,69,-108,177
1288,320000,28e29f2c03dcd84c,4,0,1122,1198,1215,1276,1793,1838,1848,1951,2643,1820,1058,1565,1312,1481,507,-762,1269
301,360000,28e29f2c03dcd84c,4,0,293,295,274,321,334,419,377,424,571,408,151,325,238,295,174,-257,431
1523,130000,28e29f2c03dcd84c,4,0,923,1024,961,977,1321,1377,1264,1433,1923,1604,884,1377,1130,1288,493,-720,1213
1062,410000,28e29f2c03dcd84c,4,0,723,780,738,834,1010,1081,952,1113,1482,1178,548,1003,776,910,455,-630,1085
681,330000,28e29f2c03dcd84c,4,0,432,444,464,536,601,733,722,894,1112,767,352,679,516,599,327,-415,742
261,420000,28e29f2c03dcd84c,4,0,236,284,317,260,295,373,329,377,483,446,164,271,218,294,107,-282,389
359,430000,28e29f2c03dcd84c,4,0,317,301,333,339,383,464,438,477,783,487,262,452,357,400,190,-225,415
217,350000,28e29f2c03dcd84c,4,0,213,189,158,212,189,235,212,345,456,397,140,227,184,255,87,-257,344
218,210000,28e29f2c03dcd84c,4,0,236,253,279,277,296,261,247,251,310,270,165,356,260,264,191,-105,296
381,500000,28e29f2c03dcd84c,4,0,328,342,482,408,414,486,426,491,644,555,263,408,336,409,145,-292,437
579,610000,28e29f2c03dcd84c,4,0,293,395,348,388,413,568,617,622,758,719,361,603,482,561,242,-358,600
106,230000,28e29f2c03dcd84c,4,0,121,150,115,124,187,159,142,152,169,104,79,149,114,111,70,-25,95
109,310000,37aa9169b575ef79,4,0,37,32,39,46,46,41,395,67,117,63,37,86,62,62,49,-26,75
755,530000,37aa9169b575ef79,4,0,1186,1072,971,1395,1426,1254,988,1142,1590,946,692,1035,864,891,343,-254,597
724,150000,37aa9169b575ef79,4,0,698,895,690,744,864,895,802,945,982,602,413,714,564,576,301,-189,490
282,110000,37aa9169b575ef79,4,0,803,698,717,716,794,737,477,625,985,300,271,404,338,325,133,-29,162
2405,510000,37aa9169b575ef79,4,0,2537,2734,2651,2620,2791,2955,1733,2221,3340,1470,1639,3175,2407,2095,1536,169,1367
279,340000,37aa9169b575ef79,4,0,410,402,479,502,552,488,424,410,575,248,260,384,322,297,124,12,112
2376,370000,37aa9169b575ef79,4,0,3356,3511,2812,3126,3130,3837,3617,3662,4024,1903,1708,2748,2228,2120,1040,-195,1235
792,140000,37aa9169b575ef79,4,0,933,1057,828,993,1217,1561,1243,1188,1616,679,442,672,557,598,230,-237,467
1558,440000,37aa9169b575ef79,4,0,1775,1785,1654,1766,1963,2010,1906,2111,2398,1196,1075,2249,1662,1507,1174,-121,1295
664,450000,37aa9169b575ef79,4,0,403,353,331,405,319,409,384,459,435,440,301,449,375,397,148,-139,287
605,320000,37aa9169b575ef79,4,0,753,875,786,701,745,840,781,777,930,527,626,655,640,603,29,99,-70
270,360000,37aa9169b575ef79,4,0,339,330,292,330,358,538,488,482,540,354,189,356,272,300,167,-165,332
2656,130000,37aa9169b575ef79,4,0,3025,3349,3221,3102,3388,3910,3483,3233,4206,2068,1780,2633,2206,2160,853,-288,1141
1515,410000,37aa9169b575ef79,4,0,1984,2022,1974,2200,2100,2323,1931,2018,2962,1570,1050,1823,1436,1481,773,-520,1293
555,330000,37aa9169b575ef79,4,0,836,827,820,769,777,723,606,634,886,424,422,628,525,491,206,-2,208
304,420000,37aa9169b575ef79,4,0,611,610,623,595,715,725,585,544,920,483,270,442,356,398,172,-213,385
835,430000,37aa9169b575ef79,4,0,1616,1475,1358,1456,1533,1680,1444,1489,2336,1714,653,1232,942,1200,579,-1061,1640
424,350000,37aa9169b575ef79,4,0,579,484,487,627,773,710,690,597,622,308,292,460,376,353,168,-16,184
1119,210000,37aa9169b575ef79,4,0,1484,1508,1498,1804,1815,1871,1308,1478,1878,681,691,1319,1005,897,628,10,618
160,500000,37aa9169b575ef79,4,0,211,204,370,530,502,347,184,172,247,131,105,125,115,120,20,-26,46
487,610000,37aa9169b575ef79,4,0,729,604,479,874,1106,695,580,634,1051,558,384,605,494,516,221,-174,395
1254,230000,37aa9169b575ef79,4,0,1499,1291,1253,1193,1427,1562,1308,1636,1781,730,952,1556,1254,1079,604,222,382
4039,310000,63065128401bb3ff,4,0,2672,2922,2462,1180,1500,2397,1674,2362,3060,1909,501,2672,1586,1694,2171,-1408,3579
603,530000,63065128401bb3ff,4,0,630,647,551,884,974,1076,1038,1033,1402,656,504,651,578,604,147,-152,299
413,150000,63065128401bb3ff,4,0,430,507,344,410,446,541,468,630,827,268,214,376,295,286,162,-54,216
1550,110000,63065128401bb3ff,4,0,1941,2551,971,995,1118,835,516,1494,2145,217,200,2331,1266,916,2131,-17,2148
2078,510000,63065128401bb3ff,4,0,1834,1543,1533,1662,1864,2707,1708,2119,2450,1355,937,1478,1208,1257,541,-418,959
1362,340000,63065128401bb3ff,4,0,1722,1828,1799,2028,2809,2863,2529,2927,3132,1460,775,1436,1106,1224,661,-685,1346
2269,370000,63065128401bb3ff,4,0,3589,3471,2715,3147,4018,4409,4129,4087,5401,1885,1225,2010,1618,1707,785,-660,1445
974,140000,63065128401bb3ff,4,0,1022,1337,977,1223,1490,1510,1452,1547,2066,692,491,877,684,687,386,-201,587
1506,440000,63065128401bb3ff,4,0,1816,1983,1796,1715,2112,2192,2036,2188,2519,625,462,1475,968,854,1013,-163,1176
289,450000,63065128401bb3ff,4,0,377,518,379,413,503,589,568,596,616,308,176,366,271,283,190,-132,322
2631,320000,63065128401bb3ff,4,0,3393,3757,3219,3369,4854,5016,4475,5007,5643,2143,1862,2644,2253,2216,782,-281,1063
895,360000,63065128401bb3ff,4,0,1276,1370,1233,1308,1681,2044,1627,1981,2357,973,442,916,679,777,474,-531,1005
2652,130000,63065128401bb3ff,4,0,2675,3198,2587,2964,3829,3951,3277,3711,5424,1723,1261,2043,1652,1676,782,-462,1244
2562,410000,63065128401bb3ff,4,0,2757,2736,2702,3421,4398,4500,3793,4237,5119,2463,1238,2429,1834,2043,1191,-1225,2416
1321,330000,63065128401bb3ff,4,0,1853,2092,1953,2021,2513,2777,2324,2401,2755,895,768,1359,1064,1007,591,-127,718
848,420000,63065128401bb3ff,4,0,1205,1158,1213,1120,1591,1818,1296,1466,1985,1002,357,841,599,733,484,-645,1129
1014,430000,63065128401bb3ff,4,0,1645,1561,1517,1583,1906,2187,1670,2078,2533,1085,531,1104,818,907,573,-554,1127
721,350000,63065128401bb3ff,4,0,977,1082,843,1055,1347,1279,1170,1218,1549,440,400,775,588,538,375,-40,415
587,210000,63065128401bb3ff,4,0,766,859,586,702,806,897,700,869,1098,268,212,386,299,289,174,-56,230
607,500000,63065128401bb3ff,4,0,946,870,1013,987,1230,1171,824,938,1120,617,359,603,481,526,244,-258,502
1831,610000,63065128401bb3ff,4,0,1036,1284,861,1113,1278,1300,1165,1199,1748,631,397,661,529,563,264,-234,498
218,230000,63065128401bb3ff,4,0,451,421,327,303,404,404,286,466,480,162,156,276,216,198,120,-6,126
319,310000,ea489c253676aafc,4,0,709,759,629,425,535,502,314,574,754,315,362,767,564,481,405,47,358
404,530000,ea489c253676aafc,4,0,421,595,461,551,450,435,635,692,866,452,295,448,372,398,153,-157,310
556,150000,ea489c253676aafc,4,0,507,561,440,380,452,427,495,612,941,427,254,591,422,424,337,-173,510
100,110000,ea489c253676aafc,4,0,498,353,301,382,397,346,199,341,546,125,89,159,124,124,70,-36,106
1235,510000,ea489c253676aafc,4,0,1326,1270,1055,1379,1197,903,838,1187,1812,1017,704,1344,1024,1022,640,-313,953
701,340000,ea489c253676aafc,4,0,1065,1021,869,1109,958,734,813,952,1669,741,475,869,672,695,394,-266,660
2841,370000,ea489c253676aafc,4,0,3634,3404,2787,3450,3299,2451,2995,3812,5496,2330,1515,2865,2190,2237,1350,-815,2165
1425,140000,ea489c253676aafc,4,0,1678,1725,1270,1462,1588,1052,1126,1234,2626,1165,641,1247,944,1018,606,-524,1130
540,440000,ea489c253676aafc,4,0,397,473,460,457,448,529,384,525,1055,368,255,433,344,352,178,-113,291
485,450000,ea489c253676aafc,4,0,182,302,352,363,291,255,362,355,448,365,155,240,198,253,85,-210,295
1281,320000,ea489c253676aafc,4,0,1304,1178,1368,1353,1085,864,1310,1728,2261,1167,1028,1507,1268,1234,479,-139,618
236,360000,ea489c253676aafc,4,0,421,412,315,365,335,301,356,946,847,641,223,316,270,393,93,-418,511
3513,130000,ea489c253676aafc,4,0,3004,3190,2715,3210,3609,2265,2586,3058,5478,1932,1551,2981,2266,2155,1430,-381,1811
1504,410000,ea489c253676aafc,4,0,1867,1905,1469,1701,1452,1141,1472,1941,3092,1731,893,1695,1294,1440,802,-838,1640
598,330000,ea489c253676aafc,4,0,916,1100,1016,1000,913,659,638,706,1205,504,467,741,604,571,274,-37,311
222,420000,ea489c253676aafc,4,0,470,347,353,277,263,202,272,348,657,298,154,273,214,242,119,-144,263
437,430000,ea489c253676aafc,4,0,827,849,769,962,701,698,568,587,1351,576,253,448,350,426,195,-323,518
232,350000,ea489c253676aafc,4,0,321,335,225,356,355,342,307,452,617,215,148,255,202,206,107,-67,174
721,210000,ea489c253676aafc,4,0,733,783,589,621,716,684,572,853,1026,394,408,768,588,523,360,14,346
329,500000,ea489c253676aafc,4,0,493,497,413,558,474,304,408,379,694,353,248,346,297,316,98,-105,203
600,610000,ea489c253676aafc,4,0,683,599,723,667,832,623,693,804,1400,754,418,791,604,654,373,-336,709
464,230000,ea489c253676aafc,4,0,645,383,283,369,508,307,324,496,710,280,266,503,384,350,237,-14,251
249,310000,cd5841d44fd7625e,4,0,246,249,228,201,232,150,148,312,359,339,177,321,249,279,144,-162,306
375,530000,cd5841d44fd7625e,4,0,283,346,330,388,290,304,344,442,485,409,248,357,302,338,109,-161,270
443,150000,cd5841d44fd7625e,4,0,276,395,262,398,348,325,432,401,434,519,319,522,420,453,203,-200,403
1047,110000,cd5841d44fd7625e,4,0,1112,1156,1039,990,1183,1150,795,1121,1802,1263,877,1267,1072,1136,390,-386,776
827,510000,cd5841d44fd7625e,4,0,702,679,596,623,519,741,610,732,1083,1390,565,951,758,969,386,-825,1211
534,340000,cd5841d44fd7625e,4,0,339,414,403,381,360,323,440,519,629,667,315,471,393,484,156,-352,508
1694,370000,cd5841d44fd7625e,4,0,1362,1499,1162,1256,1311,1391,1370,1666,1642,1861,878,1578,1228,1439,700,-983,1683
395,140000,cd5841d44fd7625e,4,0,342,380,264,316,332,330,480,421,414,426,317,451,384,398,134,-109,243
693,440000,cd5841d44fd7625e,4,0,400,553,537,509,516,523,704,995,1243,727,322,827,574,625,505,-405,910
139,450000,cd5841d44fd7625e,4,0,87,113,102,97,101,156,159,192,214,225,119,204,162,183,85,-106,191
1124,320000,cd5841d44fd7625e,4,0,1024,1236,925,785,871,1280,881,1099,1374,1336,868,1301,1084,1168,433,-468,901
237,360000,cd5841d44fd7625e,4,0,208,246,191,199,169,178,237,276,329,364,141,291,216,265,150,-223,373
1805,130000,cd5841d44fd7625e,4,0,1150,1563,1391,1238,1360,1115,1052,1461,1615,1768,1165,1697,1431,1543,532,-603,1135
1403,410000,cd5841d44fd7625e,4,0,984,996,913,957,1047,1104,1357,1223,1443,1429,856,1325,1090,1203,469,-573,1042
633,330000,cd5841d44fd7625e,4,0,482,592,492,475,404,404,512,747,863,742,356,707,532,602,351,-386,737
396,420000,cd5841d44fd7625e,4,0,350,345,337,298,379,393,374,473,566,558,262,443,352,421,181,-296,477
383,430000,cd5841d44fd7625e,4,0,261,307,277,273,291,253,248,418,494,519,230,424,327,391,194,-289,483
251,350000,cd5841d44fd7625e,4,0,229,307,216,229,183,186,285,325,402,404,188,330,259,307,142,-216,358
783,210000,cd5841d44fd7625e,4,0,616,593,769,652,721,569,738,644,1082,704,546,870,708,707,324,-158,482
319,500000,cd5841d44fd7625e,4,0,260,274,314,254,213,262,251,282,391,433,202,335,268,323,133,-231,364
390,610000,cd5841d44fd7625e,4,0,411,522,312,356,360,419,276,346,497,487,257,378,318,374,121,-230,351
1070,230000,cd5841d44fd7625e,4,0,775,794,828,639,929,731,657,664,964,785,666,1198,932,883,532,-119,651
532,310000,b25c4e2e3856af22,4,0,987,982,1141,897,946,1150,1010,1563,1504,815,447,731,589,664,284,-368,652
310,530000,b25c4e2e3856af22,4,0,429,522,373,681,595,570,759,692,785,585,277,403,340,422,126,-308,434
177,150000,b25c4e2e3856af22,4,0,243,365,254,296,333,327,407,342,430,303,110,229,170,214,119,-193,312
371,110000,b25c4e2e3856af22,4,0,745,768,998,675,772,925,740,925,1127,376,284,427,356,362,143,-92,235
657,510000,b25c4e2e3856af22,4,0,980,978,903,990,1085,1885,1100,1320,1775,1096,562,764,663,807,202,-534,736
581,340000,b25c4e2e3856af22,4,0,764,823,725,769,980,1023,1001,1064,1490,952,364,600,482,639,236,-588,824
813,370000,b25c4e2e3856af22,4,0,1108,1210,1082,1134,1323,1432,1303,1408,1739,940,501,805,653,749,304,-439,743
138,140000,b25c4e2e3856af22,4,0,291,326,221,257,295,289,333,332,371,229,113,151,132,164,38,-116,154
862,440000,b25c4e2e3856af22,4,0,995,1269,1114,1097,1195,1320,1463,1644,2216,854,451,986,718,764,535,-403,938
155,450000,b25c4e2e3856af22,4,0,212,277,223,187,218,240,280,255,372,218,114,237,176,190,123,-104,227
1015,320000,b25c4e2e3856af22,4,0,1487,1639,1433,1571,1947,1897,1872,2263,3132,1586,987,1345,1166,1306,358,-599,957
430,360000,b25c4e2e3856af22,4,0,722,759,661,681,684,855,798,870,1144,754,284,498,391,512,214,-470,684
687,130000,b25c4e2e3856af22,4,0,716,788,622,676,985,861,883,944,1218,652,442,599,520,564,157,-210,367
719,410000,b25c4e2e3856af22,4,0,959,936,866,965,1056,1067,1021,1121,1578,856,471,700,586,676,229,-385,614
1150,330000,b25c4e2e3856af22,4,0,1823,1961,1826,1921,2037,2367,2323,2703,3371,1749,893,1369,1131,1337,476,-856,1332
523,420000,b25c4e2e3856af22,4,0,751,751,798,730,829,920,1033,988,1333,941,363,579,471,628,216,-578,794
610,430000,b25c4e2e3856af22,4,0,869,852,770,811,908,1056,973,1081,1561,1003,386,716,551,702,330,-617,947
387,350000,b25c4e2e3856af22,4,0,580,799,587,681,684,714,853,905,1102,667,370,551,460,529,181,-297,478
212,210000,b25c4e2e3856af22,4,0,339,376,332,444,478,491,437,403,555,253,188,258,223,233,70,-65,135
290,500000,b25c4e2e3856af22,4,0,450,403,448,421,422,477,428,496,740,452,184,293,238,310,109,-268,377
216,610000,b25c4e2e3856af22,4,0,347,397,335,338,351,433,450,479,533,395,223,292,258,303,69,-172,241
217,230000,b25c4e2e3856af22,4,0,369,422,399,362,461,359,320,352,428,213,219,281,250,238,62,6,56
369,310000,4a103c30d593fbbe,4,0,480,438,464,464,563,552,450,685,688,275,231,396,314,301,165,-44,209
427,530000,4a103c30d593fbbe,4,0,494,611,509,837,743,640,687,714,1001,409,321,443,382,391,122,-88,210
455,150000,4a103c30d593fbbe,4,0,555,665,393,509,544,557,650,671,789,370,239,440,340,350,201,-131,332
496,110000,4a103c30d593fbbe,4,0,1175,1102,1018,1021,1288,1431,1045,1332,1807,402,360,619,490,460,259,-42,301
1538,510000,4a103c30d593fbbe,4,0,2107,1866,1748,1887,2009,2921,2017,2913,3590,1589,1106,1523,1314,1406,417,-483,900
1124,340000,4a103c30d593fbbe,4,0,1182,1170,1110,1307,1431,1596,1491,1717,1968,921,593,995,794,836,402,-328,730
2083,370000,4a103c30d593fbbe,4,0,2449,2486,1895,2003,2387,2615,2547,2776,3299,1329,945,1856,1400,1377,911,-384,1295
549,140000,4a103c30d593fbbe,4,0,634,789,589,641,800,787,813,782,1130,401,261,510,386,391,249,-140,389
908,440000,4a103c30d593fbbe,4,0,996,1286,1093,1029,1303,1438,1702,2171,2397,475,354,1081,718,637,727,-121,848
224,450000,4a103c30d593fbbe,4,0,263,323,295,287,282,358,395,493,595,225,179,348,264,251,169,-46,215
2129,320000,4a103c30d593fbbe,4,0,2473,3080,2334,2394,3107,2962,3228,3579,4302,1623,1477,2234,1856,1778,757,-146,903
551,360000,4a103c30d593fbbe,4,0,598,657,503,672,641,755,781,885,1016,398,230,537,384,388,307,-168,475
2725,130000,4a103c30d593fbbe,4,0,2475,2921,2392,2559,2979,2860,2877,2989,3954,1565,1311,2239,1775,1705,928,-254,1182
1948,410000,4a103c30d593fbbe,4,0,2122,1817,1841,2115,2398,2493,2358,2638,3291,1489,872,1684,1278,1348,812,-617,1429
1417,330000,4a103c30d593fbbe,4,0,1755,1827,1550,1572,1914,1992,2163,2458,2897,961,793,1491,1142,1082,698,-168,866
667,420000,4a103c30d593fbbe,4,0,703,828,848,789,996,1142,948,1247,1304,805,357,634,496,599,277,-448,725
544,430000,4a103c30d593fbbe,4,0,632,689,696,720,817,950,757,948,1222,427,264,565,414,419,301,-163,464
415,350000,4a103c30d593fbbe,4,0,569,777,495,680,640,694,837,946,924,385,327,518,422,410,191,-58,249
916,210000,4a103c30d593fbbe,4,0,1021,1093,717,904,1088,1057,1007,1160,1513,414,423,828,626,555,405,9,396
300,500000,4a103c30d593fbbe,4,0,317,246,378,375,374,365,407,493,612,296,209,288,248,264,79,-87,166
468,610000,4a103c30d593fbbe,4,0,607,926,472,701,761,801,945,946,1143,404,239,410,324,351,171,-165,336
713,230000,4a103c30d593fbbe,4,0,974,825,774,757,1154,914,753,1190,1198,462,436,1058,747,652,622,-26,648
555,310000,7a7885e2d7c00bcf,4,0,523,603,553,600,670,690,633,790,925,325,455,653,554,478,198,130,68
270,530000,7a7885e2d7c00bcf,4,0,322,387,317,493,447,408,431,527,546,194,218,317,268,243,99,24,75
292,150000,7a7885e2d7c00bcf,4,0,265,350,301,313,341,355,371,359,418,168,163,287,225,206,124,-5,129
698,110000,7a7885e2d7c00bcf,4,0,846,916,826,879,911,1074,915,1162,1615,471,523,831,677,608,308,52,256
665,510000,7a7885e2d7c00bcf,4,0,706,738,715,745,722,1155,772,961,1167,445,516,738,627,566,222,71,151
653,340000,7a7885e2d7c00bcf,4,0,647,692,656,677,767,841,878,933,1003,374,418,658,538,483,240,44,196
1860,370000,7a7885e2d7c00bcf,4,0,1822,1978,1685,1638,1852,2308,2307,2370,2766,875,984,1739,1362,1199,755,109,646
243,140000,7a7885e2d7c00bcf,4,0,241,352,275,285,300,313,320,355,484,139,184,247,216,190,63,45,18
629,440000,7a7885e2d7c00bcf,4,0,810,979,912,937,951,992,1092,1209,1464,402,402,896,649,567,494,0,494
157,450000,7a7885e2d7c00bcf,4,0,186,265,233,260,262,246,259,290,384,118,109,224,166,150,115,-9,124
1953,320000,7a7885e2d7c00bcf,4,0,1949,2522,2016,2112,2209,2679,2595,2801,3241,1057,1612,2234,1923,1634,622,555,67
307,360000,7a7885e2d7c00bcf,4,0,361,405,347,434,393,442,498,481,511,213,176,385,280,258,209,-37,246
1690,130000,7a7885e2d7c00bcf,4,0,1277,1469,1298,1298,1461,1525,1603,1929,2115,754,885,1533,1209,1057,648,131,517
1228,410000,7a7885e2d7c00bcf,4,0,1137,1026,959,1096,1283,1383,1309,1461,1740,591,724,1200,962,838,476,133,343
1676,330000,7a7885e2d7c00bcf,4,0,1632,1956,1671,1999,1697,1991,2033,2127,2662,818,1237,1764,1500,1273,527,419,108
356,420000,7a7885e2d7c00bcf,4,0,473,508,574,499,596,611,603,616,685,305,279,470,374,351,191,-26,217
347,430000,7a7885e2d7c00bcf,4,0,412,494,442,503,514,645,501,559,768,256,278,497,388,344,219,22,197
262,350000,7a7885e2d7c00bcf,4,0,409,530,373,503,451,397,473,480,608,216,257,389,323,287,132,41,91
408,210000,7a7885e2d7c00bcf,4,0,476,514,420,483,505,553,489,516,595,169,217,412,314,266,195,48,147
100,500000,7a7885e2d7c00bcf,4,0,120,135,198,189,145,189,159,216,258,69,99,133,116,100,34,30,4
306,610000,7a7885e2d7c00bcf,4,0,393,540,321,402,487,425,510,487,657,185,238,361,300,261,123,53,70
404,230000,7a7885e2d7c00bcf,4,0,493,470,454,420,611,511,443,413,533,157,228,535,382,307,307,71,236
61,310000,346393c2c6305fb1,4,0,123,63,113,83,134,126,104,114,215,76,41,45,43,54,4,-35,39
36,530000,346393c2c6305fb1,4,0,92,106,89,141,121,133,139,121,182,95,41,34,38,57,-7,-54,47
76,150000,346393c2c6305fb1,4,0,107,124,111,114,92,121,108,174,205,99,66,95,80,87,29,-33,62
53,110000,346393c2c6305fb1,4,0,172,132,149,201,202,250,161,243,439,74,40,54,47,56,14,-34,48
133,510000,346393c2c6305fb1,4,0,331,262,301,284,317,459,291,297,513,309,153,136,144,199,-17,-156,139
307,340000,346393c2c6305fb1,4,0,514,529,526,633,733,655,600,692,1047,578,273,312,292,388,39,-305,344
572,370000,346393c2c6305fb1,4,0,922,771,855,1000,1063,1138,1097,1099,1844,902,381,538,460,607,157,-521,678
226,140000,346393c2c6305fb1,4,0,211,195,143,212,261,250,277,308,545,238,158,237,198,211,79,-80,159
103,440000,346393c2c6305fb1,4,0,162,145,223,291,295,282,277,289,373,126,71,118,94,105,47,-55,102
35,450000,346393c2c6305fb1,4,0,54,71,100,108,107,108,100,115,162,93,53,69,61,72,16,-40,56
206,320000,346393c2c6305fb1,4,0,332,411,403,402,461,370,406,397,621,300,168,197,182,222,29,-132,161
68,360000,346393c2c6305fb1,4,0,96,91,121,141,112,150,164,143,266,151,36,61,48,83,25,-115,140
459,130000,346393c2c6305fb1,4,0,514,537,455,575,645,742,699,808,1460,748,389,430,410,522,41,-359,400
240,410000,346393c2c6305fb1,4,0,313,364,453,477,544,566,471,617,1100,524,174,251,212,316,77,-350,427
66,330000,346393c2c6305fb1,4,0,153,145,161,194,181,198,211,191,260,101,55,63,59,73,8,-46,54
125,420000,346393c2c6305fb1,4,0,178,180,285,274,266,326,324,313,534,275,79,103,91,152,24,-196,220
126,430000,346393c2c6305fb1,4,0,217,180,205,282,273,347,286,335,535,308,119,163,141,197,44,-189,233
31,350000,346393c2c6305fb1,4,0,56,58,88,101,114,102,89,87,129,60,25,51,38,45,26,-35,61
121,210000,346393c2c6305fb1,4,0,252,262,234,252,331,280,278,265,371,149,91,133,112,124,42,-58,100
66,500000,346393c2c6305fb1,4,0,190,138,222,247,251,250,189,199,335,168,84,69,76,107,-15,-84,69
76,610000,346393c2c6305fb1,4,0,112,151,113,180,161,167,197,186,360,209,62,83,72,118,21,-147,168
101,230000,346393c2c6305fb1,4,0,165,177,206,165,264,248,169,223,312,126,95,154,124,125,59,-31,90
600,310000,02aab221aabc03b9,4,0,507,485,527,653,687,651,489,558,362,679,494,731,612,635,237,-185,422
186,530000,02aab221aabc03b9,4,0,151,202,185,247,209,201,174,160,155,229,130,223,176,194,93,-99,192
99,150000,02aab221aabc03b9,4,0,76,95,106,108,130,97,99,82,59,106,63,136,100,102,73,-43,116
575,110000,02aab221aabc03b9,4,0,545,566,646,748,847,831,642,654,521,798,532,838,685,723,306,-266,572
524,510000,02aab221aabc03b9,4,0,421,431,486,460,559,615,471,430,474,703,394,653,524,583,259,-309,568
311,340000,02aab221aabc03b9,4,0,252,223,244,244,344,348,248,228,187,338,203,372,288,304,169,-135,304
527,370000,02aab221aabc03b9,4,0,457,437,443,584,549,525,474,421,353,610,362,607,484,526,245,-248,493
139,140000,02aab221aabc03b9,4,0,93,114,101,121,154,121,105,117,105,129,94,160,127,128,66,-35,101
1093,440000,02aab221aabc03b9,4,0,891,1008,1160,1083,1238,1180,1049,976,1007,1207,847,1361,1104,1138,514,-360,874
121,450000,02aab221aabc03b9,4,0,79,114,129,142,161,151,126,138,119,159,102,172,137,144,70,-57,127
1523,320000,02aab221aabc03b9,4,0,1291,1323,1469,1509,1821,1585,1270,1186,1077,1735,1066,1713,1390,1505,647,-669,1316
216,360000,02aab221aabc03b9,4,0,158,177,165,198,224,232,164,154,152,242,146,291,218,226,145,-96,241
379,130000,02aab221aabc03b9,4,0,297,312,337,350,330,362,307,254,182,340,242,360,301,314,118,-98,216
289,410000,02aab221aabc03b9,4,0,358,277,291,353,389,339,239,284,223,320,199,311,255,277,112,-121,233
1326,330000,02aab221aabc03b9,4,0,1124,1121,1210,1486,1568,1439,1239,1136,1024,1529,973,1602,1288,1368,629,-556,1185
296,420000,02aab221aabc03b9,4,0,286,265,300,346,383,407,272,273,274,370,238,369,304,326,131,-132,263
275,430000,02aab221aabc03b9,4,0,229,207,229,257,270,285,213,205,215,305,186,346,266,279,160,-119,279
350,350000,02aab221aabc03b9,4,0,340,375,354,394,437,448,353,321,324,518,242,572,407,444,330,-276,606
225,210000,02aab221aabc03b9,4,0,234,226,254,291,346,299,229,207,174,292,205,321,263,273,116,-87,203
240,500000,02aab221aabc03b9,4,0,204,204,232,259,222,255,197,217,217,267,199,277,238,248,78,-68,146
203,610000,02aab221aabc03b9,4,0,213,288,241,238,319,283,263,205,197,285,151,281,216,239,130,-134,264
85,230000,02aab221aabc03b9,4,0,80,87,80,75,119,71,81,63,53,93,68,133,100,98,65,-25,90
263,310000,5d7fb682edd0f937,4,0,283,308,272,297,303,281,281,247,225,315,160,297,228,257,137,-155,292
133,530000,5d7fb682edd0f937,4,0,143,175,143,190,187,165,167,133,176,164,108,164,136,145,56,-56,112
111,150000,5d7fb682edd0f937,4,0,82,115,109,112,117,120,96,85,86,86,62,103,82,84,41,-24,65
270,110000,5d7fb682edd0f937,4,0,353,385,362,331,427,429,308,324,417,323,190,356,273,290,166,-133,299
313,510000,5d7fb682edd0f937,4,0,344,382,380,359,376,389,305,301,337,483,166,411,288,353,245,-317,562
183,340000,5d7fb682edd0f937,4,0,162,175,187,156,227,205,162,169,174,188,119,173,146,160,54,-69,123
297,370000,5d7fb682edd0f937,4,0,276,307,309,263,302,292,265,227,253,339,160,306,233,268,146,-179,325
101,140000,5d7fb682edd0f937,4,0,59,95,91,82,103,99,83,81,91,111,56,97,76,88,41,-55,96
409,440000,5d7fb682edd0f937,4,0,501,543,522,480,565,575,462,510,512,581,314,531,422,475,217,-267,484
59,450000,5d7fb682edd0f937,4,0,103,113,124,96,117,108,102,103,109,128,57,103,80,96,46,-71,117
678,320000,5d7fb682edd0f937,4,0,673,752,698,733,823,757,642,661,734,807,456,741,598,668,285,-351,636
126,360000,5d7fb682edd0f937,4,0,134,157,139,120,153,155,115,129,138,165,79,158,118,134,79,-86,165
195,130000,5d7fb682edd0f937,4,0,188,230,197,195,219,226,184,180,178,203,126,201,164,177,75,-77,152
191,410000,5d7fb682edd0f937,4,0,205,180,189,189,186,187,161,189,173,186,103,191,147,160,88,-83,171
625,330000,5d7fb682edd0f937,4,0,636,660,565,645,709,620,587,599,595,656,382,738,560,592,356,-274,630
214,420000,5d7fb682edd0f937,4,0,230,266,292,242,319,331,219,258,266,270,142,257,200,223,115,-128,243
161,430000,5d7fb682edd0f937,4,0,206,200,169,164,219,179,160,168,191,210,114,205,160,176,91,-96,187
183,350000,5d7fb682edd0f937,4,0,219,230,256,240,260,259,202,201,205,241,127,267,197,212,140,-114,254
125,210000,5d7fb682edd0f937,4,0,166,150,154,152,161,165,130,138,128,140,90,113,102,114,23,-50,73
102,500000,5d7fb682edd0f937,4,0,134,144,142,148,158,109,123,106,134,131,54,117,86,101,63,-77,140
119,610000,5d7fb682edd0f937,4,0,163,199,168,161,205,192,172,135,145,159,85,142,114,129,57,-74,131
65,230000,5d7fb682edd0f937,4,0,72,91,70,67,99,74,50,53,61,68,34,78,56,60,44,-34,78
562,310000,a207df29ec9583f0,4,0,355,455,551,438,559,478,428,493,474,835,424,592,508,617,168,-411,579
223,530000,a207df29ec9583f0,4,0,123,203,222,190,240,237,204,210,215,310,178,234,206,241,56,-132,188
104,150000,a207df29ec9583f0,4,0,62,91,81,74,115,91,72,82,74,139,87,116,102,114,29,-52,81
763,110000,a207df29ec9583f0,4,0,509,573,717,674,824,853,604,747,817,1033,648,841,744,841,193,-385,578
456,510000,a207df29ec9583f0,4,0,334,442,494,344,458,388,382,361,382,695,383,524,454,534,141,-312,453
259,340000,a207df29ec9583f0,4,0,138,167,188,148,226,228,183,176,177,354,152,225,188,244,73,-202,275
488,370000,a207df29ec9583f0,4,0,259,291,346,365,453,344,338,348,336,608,328,530,429,489,202,-280,482
118,140000,a207df29ec9583f0,4,0,95,88,102,105,108,108,84,93,100,165,96,130,113,130,34,-69,103
964,440000,a207df29ec9583f0,4,0,560,678,769,689,886,875,627,766,825,1178,690,1101,896,990,411,-488,899
133,450000,a207df29ec9583f0,4,0,57,97,100,90,105,124,72,100,114,160,106,163,134,143,57,-54,111
1026,320000,a207df29ec9583f0,4,0,801,890,962,857,1124,918,791,915,1007,1591,766,1115,940,1157,349,-825,1174
214,360000,a207df29ec9583f0,4,0,99,112,125,115,140,155,101,129,108,227,115,167,141,170,52,-112,164
289,130000,a207df29ec9583f0,4,0,183,199,229,221,266,200,202,203,219,376,209,316,262,300,107,-167,274
304,410000,a207df29ec9583f0,4,0,185,185,207,254,276,252,194,283,262,357,201,287,244,282,86,-156,242
967,330000,a207df29ec9583f0,4,0,641,723,810,824,880,834,733,849,908,1436,623,970,796,1010,347,-813,1160
316,420000,a207df29ec9583f0,4,0,212,243,260,260,327,326,230,315,356,436,202,366,284,335,164,-234,398
255,430000,a207df29ec9583f0,4,0,121,164,200,157,190,184,143,174,192,302,179,246,212,242,67,-123,190
297,350000,a207df29ec9583f0,4,0,208,225,265,234,296,266,197,227,256,500,212,338,275,350,126,-288,414
261,210000,a207df29ec9583f0,4,0,172,190,254,215,281,225,176,194,227,304,176,286,231,255,110,-128,238
197,500000,a207df29ec9583f0,4,0,114,168,164,192,184,176,151,174,194,265,152,205,178,207,53,-113,166
205,610000,a207df29ec9583f0,4,0,186,174,206,235,213,228,210,194,216,307,140,222,181,223,82,-167,249
116,230000,a207df29ec9583f0,4,0,62,72,97,59,106,77,74,83,85,102,84,125,104,104,41,-18,59
113,310000,b4be3a4917289c82,4,0,166,151,149,152,203,190,188,201,262,80,97,160,128,112,63,17,46
50,530000,b4be3a4917289c82,4,0,81,86,43,35,60,52,76,100,59,26,35,34,34,32,-1,9,-10
37,150000,b4be3a4917289c82,4,0,34,38,23,35,33,31,42,40,37,22,17,26,22,22,9,-5,14
137,110000,b4be3a4917289c82,4,0,267,259,192,172,203,232,200,230,226,93,117,153,135,121,36,24,12
137,510000,b4be3a4917289c82,4,0,124,131,94,121,152,216,166,240,223,57,76,90,83,74,14,19,-5
81,340000,b4be3a4917289c82,4,0,91,91,85,90,104,106,110,130,121,57,59,72,66,63,13,2,11
152,370000,b4be3a4917289c82,4,0,273,264,203,199,232,258,215,231,199,113,137,218,178,156,81,24,57
22,140000,b4be3a4917289c82,4,0,23,35,28,32,37,31,31,28,33,16,10,28,19,18,18,-6,24
223,440000,b4be3a4917289c82,4,0,207,253,209,182,223,290,309,396,384,120,115,231,173,155,116,-5,121
25,450000,b4be3a4917289c82,4,0,21,31,23,25,29,35,34,41,40,20,18,18,18,19,0,-2,2
342,320000,b4be3a4917289c82,4,0,327,438,345,389,471,447,420,635,591,225,325,414,370,321,89,100,-11
40,360000,b4be3a4917289c82,4,0,44,50,31,41,43,50,52,66,85,10,18,37,28,22,19,8,11
131,130000,b4be3a4917289c82,4,0,105,161,119,127,130,145,141,166,161,78,99,131,115,103,32,21,11
88,410000,b4be3a4917289c82,4,0,107,118,88,93,86,118,117,128,163,57,77,90,84,75,13,20,-7
386,330000,b4be3a4917289c82,4,0,431,415,297,361,382,415,422,523,567,168,290,344,317,267,54,122,-68
88,420000,b4be3a4917289c82,4,0,72,86,72,79,106,110,92,120,142,48,54,76,65,59,22,6,16
74,430000,b4be3a4917289c82,4,0,84,62,48,45,64,96,79,112,124,41,43,61,52,48,18,2,16
51,350000,b4be3a4917289c82,4,0,68,83,59,50,84,61,85,108,127,23,28,50,39,34,22,5,17
45,210000,b4be3a4917289c82,4,0,79,77,61,82,88,87,77,106,83,28,38,67,52,44,29,10,19
34,500000,b4be3a4917289c82,4,0,35,34,28,26,35,47,43,77,67,17,20,19,20,19,-1,3,-4
66,610000,b4be3a4917289c82,4,0,77,99,52,57,82,79,83,68,82,41,52,48,50,47,-4,11,-15
30,230000,b4be3a4917289c82,4,0,63,68,50,44,61,42,40,48,45,18,18,48,33,28,30,0,30
311,310000,ef76a85c4b39f693,4,0,493,512,736,581,360,145,129,306,492,378,283,374,328,345,91,-95,186
149,530000,ef76a85c4b39f693,4,0,224,243,237,221,153,83,75,142,154,140,101,145,123,129,44,-39,83
124,150000,ef76a85c4b39f693,4,0,133,164,131,165,105,47,48,67,109,121,79,109,94,103,30,-42,72
522,110000,ef76a85c4b39f693,4,0,701,789,881,663,502,321,175,311,576,511,299,438,368,416,139,-212,351
444,510000,ef76a85c4b39f693,4,0,495,600,609,554,488,356,206,340,526,495,291,361,326,382,70,-204,274
319,340000,ef76a85c4b39f693,4,0,315,306,319,309,208,104,111,219,307,304,148,259,204,237,111,-156,267
479,370000,ef76a85c4b39f693,4,0,643,668,672,573,446,246,241,312,378,406,284,400,342,363,116,-122,238
97,140000,ef76a85c4b39f693,4,0,126,145,145,138,80,47,46,58,83,94,61,99,80,85,38,-33,71
642,440000,ef76a85c4b39f693,4,0,692,927,973,869,740,398,282,593,912,598,355,607,481,520,252,-243,495
72,450000,ef76a85c4b39f693,4,0,69,104,120,85,95,39,30,50,68,74,33,77,55,61,44,-41,85
910,320000,ef76a85c4b39f693,4,0,1133,1369,1500,1116,610,270,351,609,1028,993,652,891,772,845,239,-341,580
150,360000,ef76a85c4b39f693,4,0,180,188,194,175,130,47,59,107,208,200,69,151,110,140,82,-131,213
382,130000,ef76a85c4b39f693,4,0,396,489,506,429,351,172,141,298,340,342,250,323,286,305,73,-92,165
341,410000,ef76a85c4b39f693,4,0,443,350,442,406,206,143,136,170,239,290,184,293,238,256,109,-106,215
1088,330000,ef76a85c4b39f693,4,0,1481,1596,1826,1257,815,643,498,965,1300,996,708,969,838,891,261,-288,549
279,420000,ef76a85c4b39f693,4,0,320,331,346,286,253,116,101,212,331,334,134,250,192,239,116,-200,316
271,430000,ef76a85c4b39f693,4,0,305,370,344,325,229,78,92,180,310,284,146,251,198,227,105,-138,243
164,350000,ef76a85c4b39f693,4,0,210,345,285,288,200,69,95,138,176,229,97,153,125,160,56,-132,188
317,210000,ef76a85c4b39f693,4,0,364,390,459,433,291,193,157,189,261,256,190,274,232,240,84,-66,150
97,500000,ef76a85c4b39f693,4,0,161,172,225,158,135,51,35,76,157,115,82,120,101,106,38,-33,71
239,610000,ef76a85c4b39f693,4,0,275,312,315,249,241,115,96,127,205,223,136,166,151,175,30,-87,117
138,230000,ef76a85c4b39f693,4,0,234,241,211,111,123,58,56,108,145,104,92,153,122,116,61,-12,73
256,310000,bb9fbec9a2833839,4,0,364,320,327,408,528,494,298,341,507,266,214,347,280,276,133,-52,185
158,530000,bb9fbec9a2833839,4,0,191,127,108,198,213,197,180,169,225,142,99,142,120,128,43,-43,86
133,150000,bb9fbec9a2833839,4,0,132,135,136,178,178,174,157,121,169,76,74,105,90,85,31,-2,33
234,110000,bb9fbec9a2833839,4,0,394,364,332,388,450,529,355,417,450,177,170,259,214,202,89,-7,96
333,510000,bb9fbec9a2833839,4,0,337,371,406,440,533,641,403,433,394,242,224,324,274,263,100,-18,118
231,340000,bb9fbec9a2833839,4,0,208,185,223,244,297,328,172,256,310,160,139,211,175,170,72,-21,93
402,370000,bb9fbec9a2833839,4,0,377,302,378,352,487,582,453,469,507,305,251,332,292,296,81,-54,135
86,140000,bb9fbec9a2833839,4,0,107,116,114,132,168,143,117,124,97,55,43,101,72,66,58,-12,70
599,440000,bb9fbec9a2833839,4,0,587,591,684,704,813,867,710,821,895,435,271,630,450,445,359,-164,523
95,450000,bb9fbec9a2833839,4,0,95,81,120,108,129,137,85,114,124,79,66,108,87,84,42,-13,55
807,320000,bb9fbec9a2833839,4,0,789,826,854,952,1272,1166,688,937,1154,552,589,835,712,659,246,37,209
142,360000,bb9fbec9a2833839,4,0,121,144,151,183,202,193,186,189,178,106,91,145,118,114,54,-15,69
302,130000,bb9fbec9a2833839,4,0,291,244,275,310,427,423,324,327,378,179,188,251,220,206,63,9,54
258,410000,bb9fbec9a2833839,4,0,351,217,257,301,336,420,237,276,308,156,143,260,202,186,117,-13,130
841,330000,bb9fbec9a2833839,4,0,811,816,971,1162,1196,1045,917,1072,1169,550,543,759,651,617,216,-7,223
262,420000,bb9fbec9a2833839,4,0,272,236,352,315,395,429,270,308,378,261,177,285,231,241,108,-84,192
238,430000,bb9fbec9a2833839,4,0,231,235,286,268,360,359,193,226,309,145,129,251,190,175,122,-16,138
202,350000,bb9fbec9a2833839,4,0,247,214,238,244,281,263,253,214,293,168,110,183,146,154,73,-58,131
151,210000,bb9fbec9a2833839,4,0,192,184,149,191,241,242,174,177,213,86,85,121,103,97,36,-1,37
68,500000,bb9fbec9a2833839,4,0,84,83,135,121,146,128,96,89,130,65,59,92,76,72,33,-6,39
150,610000,bb9fbec9a2833839,4,0,141,143,148,200,229,215,165,164,174,112,81,131,106,108,50,-31,81
82,230000,bb9fbec9a2833839,4,0,96,96,121,92,130,140,82,95,85,44,40,74,57,53,34,-4,38
315,310000,da457d15788fe8ee,4,0,428,462,576,421,521,504,402,593,748,538,251,456,354,415,205,-287,492
198,530000,da457d15788fe8ee,4,0,234,259,204,306,266,231,316,323,344,263,166,191,178,207,25,-97,122
165,150000,da457d15788fe8ee,4,0,167,203,169,162,217,201,207,206,200,197,109,152,130,153,43,-88,131
651,110000,da457d15788fe8ee,4,0,887,986,1008,845,898,731,715,939,1050,755,424,693,558,624,269,-331,600
468,510000,da457d15788fe8ee,4,0,632,753,748,554,658,1072,583,560,641,624,348,443,396,472,95,-276,371
256,340000,da457d15788fe8ee,4,0,270,316,300,257,346,329,282,331,409,330,200,229,214,253,29,-130,159
540,370000,da457d15788fe8ee,4,0,607,578,623,481,543,678,438,630,646,659,309,458,384,475,149,-350,499
120,140000,da457d15788fe8ee,4,0,127,142,127,114,155,143,139,142,103,120,44,90,67,85,46,-76,122
894,440000,da457d15788fe8ee,4,0,985,1219,1303,1074,1237,1342,1295,1408,1829,1269,499,1006,752,925,507,-770,1277
117,450000,da457d15788fe8ee,4,0,96,158,161,124,125,189,162,142,255,213,82,152,117,149,70,-131,201
933,320000,da457d15788fe8ee,4,0,965,1031,1078,842,1106,1255,1040,1108,1430,1304,649,954,802,969,305,-655,960
198,360000,da457d15788fe8ee,4,0,206,264,228,177,230,275,218,275,247,282,85,186,136,184,101,-197,298
412,130000,da457d15788fe8ee,4,0,330,420,442,396,476,471,407,417,527,425,254,337,296,339,83,-171,254
426,410000,da457d15788fe8ee,4,0,404,359,472,400,422,469,405,382,502,442,251,354,302,349,103,-191,294
888,330000,da457d15788fe8ee,4,0,1028,1051,1251,1000,1181,1241,932,1214,1500,938,567,836,702,780,269,-371,640
363,420000,da457d15788fe8ee,4,0,406,395,467,358,427,529,447,473,526,572,259,428,344,420,169,-313,482
370,430000,da457d15788fe8ee,4,0,420,443,451,322,451,476,369,391,505,374,207,342,274,308,135,-167,302
194,350000,da457d15788fe8ee,4,0,234,345,272,282,266,282,298,320,358,335,144,206,175,228,62,-191,253
293,210000,da457d15788fe8ee,4,0,315,405,340,365,459,418,357,335,454,281,156,268,212,235,112,-125,237
121,500000,da457d15788fe8ee,4,0,221,225,291,189,230,259,188,209,244,199,108,153,130,153,45,-91,136
225,610000,da457d15788fe8ee,4,0,253,346,302,281,312,352,366,242,346,325,174,210,192,236,36,-151,187
137,230000,da457d15788fe8ee,4,0,201,264,224,175,240,219,123,190,198,139,94,144,119,126,50,-45,95
487,310000,6858d6dfe680bdf7,4,0,679,634,547,444,607,438,357,513,576,543,384,696,540,541,312,-159,471
234,530000,6858d6dfe680bdf7,4,0,225,250,183,177,213,139,117,236,257,243,199,312,256,251,113,-44,157
76,150000,6858d6dfe680bdf7,4,0,69,87,52,46,43,47,37,60,80,54,43,84,64,60,41,-11,52
527,110000,6858d6dfe680bdf7,4,0,614,681,595,494,449,410,328,585,816,536,311,688,500,512,377,-225,602
478,510000,6858d6dfe680bdf7,4,0,619,591,569,444,445,455,290,447,593,591,337,640,488,523,303,-254,557
350,340000,6858d6dfe680bdf7,4,0,300,376,284,251,265,236,233,275,385,322,230,435,332,329,205,-92,297
538,370000,6858d6dfe680bdf7,4,0,554,521,386,382,358,297,285,401,440,468,289,622,456,460,333,-179,512
79,140000,6858d6dfe680bdf7,4,0,62,68,61,45,60,31,30,61,103,57,64,78,71,66,14,7,7
1061,440000,6858d6dfe680bdf7,4,0,1224,1221,1023,972,1033,800,773,983,1319,1274,618,1449,1034,1114,831,-656,1487
123,450000,6858d6dfe680bdf7,4,0,132,140,110,112,99,93,94,126,167,115,84,164,124,121,80,-31,111
1193,320000,6858d6dfe680bdf7,4,0,1233,1314,879,894,893,729,862,988,1160,1203,919,1681,1300,1268,762,-284,1046
198,360000,6858d6dfe680bdf7,4,0,202,203,160,175,134,144,96,129,200,185,89,224,156,166,135,-96,231
496,130000,6858d6dfe680bdf7,4,0,289,334,287,249,266,194,192,281,283,417,232,460,346,370,228,-185,413
425,410000,6858d6dfe680bdf7,4,0,370,322,315,276,272,209,174,237,350,258,224,388,306,290,164,-34,198
1596,330000,6858d6dfe680bdf7,4,0,1897,1719,1389,1189,1547,1208,929,1465,1724,1540,1004,2273,1638,1606,1269,-536,1805
266,420000,6858d6dfe680bdf7,4,0,306,263,266,203,235,199,144,218,283,271,143,325,234,246,182,-128,310
321,430000,6858d6dfe680bdf7,4,0,396,354,336,258,251,209,203,255,374,375,195,380,288,317,185,-180,365
304,350000,6858d6dfe680bdf7,4,0,266,319,252,323,276,236,214,251,346,352,161,369,265,294,208,-191,399
256,210000,6858d6dfe680bdf7,4,0,327,247,205,195,187,133,91,159,186,215,146,225,186,195,79,-69,148
195,500000,6858d6dfe680bdf7,4,0,273,262,227,183,189,132,105,200,253,198,131,290,210,206,159,-67,226
193,610000,6858d6dfe680bdf7,4,0,204,258,182,135,163,159,132,134,174,188,135,235,185,186,100,-53,153
104,230000,6858d6dfe680bdf7,4,0,94,88,66,52,57,23,28,58,76,70,44,104,74,73,60,-26,86
217,310000,79de4e4b24c35b04,4,0,205,249,256,328,379,426,299,501,825,333,136,253,194,241,117,-197,314
559,530000,79de4e4b24c35b04,4,0,517,594,552,695,707,913,926,928,1393,1050,634,598,616,761,-36,-416,380
141,150000,79de4e4b24c35b04,4,0,118,129,99,134,132,200,230,272,405,185,132,207,170,175,75,-53,128
127,110000,79de4e4b24c35b04,4,0,352,376,194,240,313,370,330,446,852,178,127,199,163,168,72,-51,123
413,510000,79de4e4b24c35b04,4,0,633,599,569,778,755,971,792,934,1509,1063,565,512,538,713,-53,-498,445
771,340000,79de4e4b24c35b04,4,0,765,835,790,1052,1349,1421,1263,1461,2601,1965,1072,936,1004,1324,-136,-893,757
1694,370000,79de4e4b24c35b04,4,0,1567,2055,1628,2244,2677,2814,2975,3077,5360,2858,1598,1729,1664,2062,131,-1260,1391
437,140000,79de4e4b24c35b04,4,0,377,360,353,542,640,778,791,803,1442,701,396,447,422,515,51,-305,356
2465,440000,79de4e4b24c35b04,4,0,2719,3307,2768,3295,4086,5098,5032,5800,8421,3465,1872,3263,2568,2867,1391,-1593,2984
1206,450000,79de4e4b24c35b04,4,0,1619,1976,1690,1981,2497,3110,3025,3479,6171,2981,1510,1845,1678,2112,335,-1471,1806
1325,320000,79de4e4b24c35b04,4,0,1121,1352,1272,1577,1829,2045,1978,2153,3757,2028,1542,1465,1504,1678,-77,-486,409
359,360000,79de4e4b24c35b04,4,0,412,417,410,598,635,806,703,736,1319,827,443,434,438,568,-9,-384,375
1146,130000,79de4e4b24c35b04,4,0,830,1060,888,1184,1505,1631,1500,1789,2863,1366,1047,1021,1034,1145,-26,-319,293
2423,410000,79de4e4b24c35b04,4,0,2474,2930,3020,3796,4302,4617,4700,5194,9539,6024,2842,2528,2685,3798,-314,-3182,2868
680,330000,79de4e4b24c35b04,4,0,616,852,799,1096,1291,1435,1528,1653,2646,934,580,745,662,753,165,-354,519
406,420000,79de4e4b24c35b04,4,0,459,481,488,678,753,891,696,982,1629,1137,521,524,522,727,3,-616,619
663,430000,79de4e4b24c35b04,4,0,812,802,747,984,1113,1544,1234,1513,2352,1658,771,808,790,1079,37,-887,924
314,350000,79de4e4b24c35b04,4,0,380,411,360,626,548,706,724,738,1086,453,316,456,386,408,140,-137,277
468,210000,79de4e4b24c35b04,4,0,398,383,376,528,616,644,644,694,1039,408,313,505,409,409,192,-95,287
172,500000,79de4e4b24c35b04,4,0,270,261,287,297,277,359,279,304,514,324,210,169,190,234,-41,-114,73
452,610000,79de4e4b24c35b04,4,0,456,460,358,538,648,785,855,1045,1704,937,403,499,451,613,96,-534,630
482,230000,79de4e4b24c35b04,4,0,350,475,475,643,791,839,638,832,1045,394,365,562,464,440,197,-29,226
521,310000,12f8b7e14947c34d,4,0,740,785,835,1350,1065,2065,1032,1283,1483,389,338,505,422,411,167,-51,218
214,530000,12f8b7e14947c34d,4,0,229,244,208,404,346,402,396,360,567,208,160,208,184,192,48,-48,96
311,150000,12f8b7e14947c34d,4,0,450,527,415,569,575,712,648,698,789,413,215,340,278,323,125,-198,323
84,110000,12f8b7e14947c34d,4,0,342,374,346,429,397,451,276,389,488,143,102,126,114,124,24,-41,65
521,510000,12f8b7e14947c34d,4,0,756,677,695,682,820,1286,786,820,1117,531,374,577,476,494,203,-157,360
246,340000,12f8b7e14947c34d,4,0,363,414,357,477,644,726,594,615,705,385,198,241,220,275,43,-187,230
843,370000,12f8b7e14947c34d,4,0,1356,1271,1075,1292,1454,1777,1435,1352,1707,803,424,738,581,655,314,-379,693
169,140000,12f8b7e14947c34d,4,0,295,376,259,310,346,391,347,352,464,131,87,174,130,131,87,-44,131
195,440000,12f8b7e14947c34d,4,0,205,277,296,248,286,326,342,407,475,130,117,221,169,156,104,-13,117
54,450000,12f8b7e14947c34d,4,0,110,154,153,106,135,181,167,158,231,93,43,77,60,71,34,-50,84
1007,320000,12f8b7e14947c34d,4,0,1589,1718,1504,1598,2024,2099,1880,1868,2181,991,782,1094,938,956,312,-209,521
180,360000,12f8b7e14947c34d,4,0,338,384,268,290,349,532,430,438,495,251,128,183,156,187,55,-123,178
598,130000,12f8b7e14947c34d,4,0,668,745,713,769,1026,1153,782,978,1229,546,360,592,476,499,232,-186,418
410,410000,12f8b7e14947c34d,4,0,691,656,595,849,951,954,750,835,1053,508,259,492,376,420,233,-249,482
450,330000,12f8b7e14947c34d,4,0,703,696,655,723,773,920,884,1063,1213,348,291,556,424,398,265,-57,322
138,420000,12f8b7e14947c34d,4,0,264,212,303,273,340,406,336,358,440,200,80,136,108,139,56,-120,176
224,430000,12f8b7e14947c34d,4,0,384,428,388,473,550,688,528,670,749,385,150,254,202,263,104,-235,339
176,350000,12f8b7e14947c34d,4,0,281,308,207,297,275,314,302,385,408,188,136,178,157,167,42,-52,94
84,210000,12f8b7e14947c34d,4,0,132,162,151,156,254,246,156,195,210,53,54,81,68,63,27,1,26
117,500000,12f8b7e14947c34d,4,0,161,182,218,192,205,240,178,181,295,131,85,113,99,110,28,-46,74
610,610000,12f8b7e14947c34d,4,0,772,950,666,1062,1276,1109,958,1012,1286,412,280,531,406,408,251,-132,383
104,230000,12f8b7e14947c34d,4,0,257,265,200,199,236,256,202,210,228,66,80,160,120,102,80,14,66
226,310000,04e66e578f653ab9,4,0,301,229,293,265,342,422,337,524,679,950,175,263,219,463,88,-775,863
108,530000,04e66e578f653ab9,4,0,93,77,88,123,129,142,173,215,293,131,118,135,126,128,17,-13,30
48,150000,04e66e578f653ab9,4,0,68,68,57,63,80,87,94,102,118,60,38,63,50,54,25,-22,47
105,110000,04e66e578f653ab9,4,0,141,144,157,165,158,241,166,231,280,180,87,167,127,145,80,-93,173
163,510000,04e66e578f653ab9,4,0,165,176,134,135,208,419,226,291,404,151,140,210,175,167,70,-11,81
74,340000,04e66e578f653ab9,4,0,84,82,105,84,146,172,127,176,201,116,64,85,74,88,21,-52,73
296,370000,04e66e578f653ab9,4,0,336,249,208,207,253,405,274,383,451,230,146,276,211,217,130,-84,214
34,140000,04e66e578f653ab9,4,0,37,54,47,58,68,104,75,85,95,42,23,68,46,44,45,-19,64
101,440000,04e66e578f653ab9,4,0,95,114,119,105,149,140,175,225,268,104,54,144,99,101,90,-50,140
17,450000,04e66e578f653ab9,4,0,27,26,35,28,43,42,39,42,71,30,28,32,30,30,4,-2,6
278,320000,04e66e578f653ab9,4,0,322,305,326,286,477,566,501,644,669,334,279,388,334,334,109,-55,164
53,360000,04e66e578f653ab9,4,0,46,68,55,61,72,97,83,104,86,64,32,40,36,45,8,-32,40
151,130000,04e66e578f653ab9,4,0,133,124,117,113,185,186,192,206,272,140,97,162,130,133,65,-43,108
142,410000,04e66e578f653ab9,4,0,115,86,115,109,191,156,169,219,319,144,90,156,123,130,66,-54,120
179,330000,04e66e578f653ab9,4,0,241,174,199,216,262,293,289,400,452,190,120,235,178,182,115,-70,185
41,420000,04e66e578f653ab9,4,0,44,55,47,45,58,71,47,81,82,146,33,61,47,80,28,-113,141
89,430000,04e66e578f653ab9,4,0,96,123,93,121,118,158,115,135,228,105,59,115,87,93,56,-46,102
62,350000,04e66e578f653ab9,4,0,44,77,80,72,82,93,107,132,139,77,43,64,54,61,21,-34,55
19,210000,04e66e578f653ab9,4,0,39,48,22,42,64,69,52,62,81,42,40,28,34,37,-12,-2,-10
52,500000,04e66e578f653ab9,4,0,31,19,68,61,42,66,46,77,87,44,31,56,44,44,25,-13,38
151,610000,04e66e578f653ab9,4,0,134,132,92,109,169,208,170,201,238,124,83,169,126,125,86,-41,127
50,230000,04e66e578f653ab9,4,0,46,45,30,38,60,45,45,56,48,22,17,60,38,33,43,-5,48
178,310000,dff803b4024d261d,4,0,228,169,138,110,96,130,129,206,317,238,124,175,150,179,51,-114,165
58,530000,dff803b4024d261d,4,0,75,180,62,53,48,150,68,61,94,64,55,50,52,56,-5,-9,4
84,150000,dff803b4024d261d,4,0,86,107,104,115,80,59,69,77,114,119,58,88,73,88,30,-61,91
422,110000,dff803b4024d261d,4,0,679,1478,362,522,549,341,411,466,954,488,303,463,383,418,160,-185,345
310,510000,dff803b4024d261d,4,0,337,329,313,287,213,226,219,270,560,493,212,308,260,338,96,-281,377
152,340000,dff803b4024d261d,4,0,287,132,112,137,105,226,131,164,192,238,108,126,117,157,18,-130,148
802,370000,dff803b4024d261d,4,0,634,622,583,483,376,451,391,462,714,609,352,736,544,566,384,-257,641
133,140000,dff803b4024d261d,4,0,138,173,121,88,87,81,104,152,230,168,75,152,114,132,77,-93,170
1342,440000,dff803b4024d261d,4,0,1049,1151,1204,796,688,783,887,1988,1893,1283,554,1157,856,998,603,-729,1332
179,450000,dff803b4024d261d,4,0,232,292,302,238,333,211,167,204,333,316,132,218,175,222,86,-184,270
575,320000,dff803b4024d261d,4,0,817,757,633,614,701,409,489,602,865,785,520,701,610,669,181,-265,446
178,360000,dff803b4024d261d,4,0,214,361,199,120,104,272,168,194,280,264,100,195,148,186,95,-164,259
372,130000,dff803b4024d261d,4,0,257,299,271,278,358,279,275,250,454,387,248,489,368,375,241,-139,380
250,410000,dff803b4024d261d,4,0,254,201,225,287,201,184,168,191,300,319,141,195,168,218,54,-178,232
562,330000,dff803b4024d261d,4,0,611,676,536,359,406,355,572,795,787,577,391,567,479,512,176,-186,362
310,420000,dff803b4024d261d,4,0,499,394,422,178,222,287,394,374,566,545,193,390,292,376,197,-352,549
262,430000,dff803b4024d261d,4,0,349,524,267,270,181,332,203,423,412,412,410,531,470,451,121,-2,123
658,350000,dff803b4024d261d,4,0,297,502,255,324,353,331,397,363,562,555,242,485,364,427,243,-313,556
229,210000,dff803b4024d261d,4,0,331,310,263,240,234,219,239,228,340,230,163,328,246,240,165,-67,232
239,500000,dff803b4024d261d,4,0,423,567,467,292,184,281,158,348,846,378,203,261,232,281,58,-175,233
103,610000,dff803b4024d261d,4,0,165,127,82,202,64,63,62,99,126,138,68,103,86,103,35,-70,105
195,230000,dff803b4024d261d,4,0,102,107,81,71,56,91,46,89,107,57,72,88,80,72,16,15,1
111,310000,61e73e32ad101892,4,0,276,268,259,263,265,263,222,276,374,264,140,173,156,192,33,-124,157
240,530000,61e73e32ad101892,4,0,288,287,259,444,328,322,420,444,423,403,246,278,262,309,32,-157,189
363,150000,61e73e32ad101892,4,0,439,598,415,527,467,541,608,505,619,534,251,398,324,394,147,-283,430
521,110000,61e73e32ad101892,4,0,864,925,776,823,803,1019,845,1016,1441,741,459,672,566,624,213,-282,495
610,510000,61e73e32ad101892,4,0,804,780,668,723,668,1080,712,743,1078,940,507,616,562,688,109,-433,542
149,340000,61e73e32ad101892,4,0,191,212,209,143,177,210,217,212,273,247,107,152,130,169,45,-140,185
657,370000,61e73e32ad101892,4,0,823,816,666,592,643,866,764,681,1011,688,350,548,449,529,198,-338,536
218,140000,61e73e32ad101892,4,0,261,279,232,228,276,283,280,288,348,274,115,219,167,203,104,-159,263
1067,440000,61e73e32ad101892,4,0,1334,1757,1676,1516,1456,1686,2097,2144,2562,1849,777,1549,1163,1392,772,-1072,1844
172,450000,61e73e32ad101892,4,0,308,368,312,289,221,333,376,342,443,364,194,278,236,279,84,-170,254
407,320000,61e73e32ad101892,4,0,642,720,594,521,656,670,713,682,857,658,425,546,486,543,121,-233,354
176,360000,61e73e32ad101892,4,0,284,272,228,226,207,304,324,277,382,334,121,180,150,212,59,-213,272
721,130000,61e73e32ad101892,4,0,623,789,655,636,756,829,875,790,1042,804,407,572,490,594,165,-397,562
422,410000,61e73e32ad101892,4,0,561,418,478,457,520,525,514,567,656,654,303,427,365,461,124,-351,475
407,330000,61e73e32ad101892,4,0,688,672,696,609,628,658,707,687,970,632,338,464,401,478,126,-294,420
740,420000,61e73e32ad101892,4,0,976,969,1189,812,879,1194,1234,1296,1458,1429,526,890,708,948,364,-903,1267
376,430000,61e73e32ad101892,4,0,527,529,432,433,504,586,532,579,879,712,262,444,353,473,182,-450,632
237,350000,61e73e32ad101892,4,0,320,437,254,309,324,331,423,388,523,387,223,336,280,315,113,-164,277
595,210000,61e73e32ad101892,4,0,855,952,717,778,859,919,871,786,1105,571,424,658,541,551,234,-147,381
351,500000,61e73e32ad101892,4,0,469,390,863,400,378,452,406,568,732,616,327,364,346,436,37,-289,326
522,610000,61e73e32ad101892,4,0,526,586,401,428,429,480,618,464,618,561,288,381,334,410,93,-273,366
307,230000,61e73e32ad101892,4,0,364,391,379,393,463,364,346,348,497,267,165,333,249,255,168,-102,270
48,310000,a432c483b5beb856,4,0,107,138,95,119,125,135,111,242,237,68,37,61,49,55,24,-31,55
97,530000,a432c483b5beb856,4,0,126,123,110,141,143,170,165,182,271,140,100,100,100,113,0,-40,40
78,150000,a432c483b5beb856,4,0,130,150,140,118,135,135,144,149,195,78,54,74,64,69,20,-24,44
36,110000,a432c483b5beb856,4,0,133,142,156,136,151,163,97,128,205,34,44,59,52,46,15,10,5
154,510000,a432c483b5beb856,4,0,366,331,297,273,290,355,284,276,560,275,186,178,182,213,-8,-89,81
97,340000,a432c483b5beb856,4,0,134,155,164,187,210,258,234,289,496,209,109,109,109,142,0,-100,100
181,370000,a432c483b5beb856,4,0,376,429,398,297,370,455,430,397,599,241,156,188,172,195,32,-85,117
70,140000,a432c483b5beb856,4,0,134,191,136,138,154,165,187,192,226,67,52,65,58,61,13,-15,28
429,440000,a432c483b5beb856,4,0,803,902,957,908,969,966,1096,1273,1753,510,290,467,378,422,177,-220,397
66,450000,a432c483b5beb856,4,0,112,150,145,121,133,163,183,209,314,161,76,113,94,117,37,-85,122
358,320000,a432c483b5beb856,4,0,500,626,524,494,659,663,720,808,1176,484,399,360,380,414,-39,-85,46
120,360000,a432c483b5beb856,4,0,167,200,179,156,182,243,282,281,556,258,99,139,119,165,40,-159,199
165,130000,a432c483b5beb856,4,0,222,334,278,240,275,311,284,290,435,164,126,133,130,141,7,-38,45
161,410000,a432c483b5beb856,4,0,216,293,353,273,313,316,283,364,562,252,130,136,133,173,6,-122,128
293,330000,a432c483b5beb856,4,0,534,604,578,536,581,660,738,799,1102,332,255,331,293,306,76,-77,153
100,420000,a432c483b5beb856,4,0,272,226,274,204,230,271,257,362,526,267,110,92,101,156,-18,-157,139
96,430000,a432c483b5beb856,4,0,189,225,184,208,271,292,260,313,627,286,115,133,124,178,18,-171,189
130,350000,a432c483b5beb856,4,0,232,272,218,246,274,282,315,340,500,185,128,160,144,158,32,-57,89
111,210000,a432c483b5beb856,4,0,382,339,300,311,310,311,260,209,299,101,86,133,110,107,47,-15,62
59,500000,a432c483b5beb856,4,0,200,174,215,160,199,165,151,159,317,179,87,70,78,112,-17,-92,75
55,610000,a432c483b5beb856,4,0,132,119,143,116,126,114,163,141,242,89,58,62,60,70,4,-31,35
66,230000,a432c483b5beb856,4,0,139,154,146,135,155,139,103,121,126,60,44,65,54,56,21,-16,37
320,310000,0797526c057dcf5b,4,0,176,401,401,321,346,427,336,1289,571,175,135,300,218,203,165,-40,205
154,530000,0797526c057dcf5b,4,0,149,202,186,247,218,226,257,285,393,160,154,201,178,172,47,-6,53
287,150000,0797526c057dcf5b,4,0,182,235,185,198,218,291,326,339,631,236,164,278,221,226,114,-72,186
319,110000,0797526c057dcf5b,4,0,579,619,663,697,743,797,664,656,980,232,253,315,284,267,62,21,41
677,510000,0797526c057dcf5b,4,0,511,577,808,786,904,1230,923,1016,1536,609,478,708,593,598,230,-131,361
447,340000,0797526c057dcf5b,4,0,183,258,304,319,476,565,666,550,750,358,257,522,390,379,265,-101,366
2012,370000,0797526c057dcf5b,4,0,1838,2095,1935,1835,2200,2915,3148,3502,5481,1788,1203,1635,1419,1542,432,-585,1017
626,140000,0797526c057dcf5b,4,0,385,544,496,521,585,792,899,919,1474,502,371,567,469,480,196,-131,327
6812,440000,0797526c057dcf5b,4,0,6500,8617,8587,8085,9999,11167,12710,12394,15317,5306,3718,8079,5898,5701,4361,-1588,5949
1087,450000,0797526c057dcf5b,4,0,650,933,1046,1010,1186,1639,1709,1789,2693,1195,777,1366,1072,1113,589,-418,1007
2087,320000,0797526c057dcf5b,4,0,1039,1356,1362,1273,1726,2274,2226,2622,3296,1247,1529,2148,1838,1641,619,282,337
835,360000,0797526c057dcf5b,4,0,380,537,595,606,715,1083,1277,1265,1764,857,484,797,640,713,313,-373,686
1697,130000,0797526c057dcf5b,4,0,834,1174,1117,1091,1516,1988,2221,2449,3796,1214,995,1259,1127,1156,264,-219,483
1492,410000,0797526c057dcf5b,4,0,1035,851,918,1151,1553,1783,1739,1951,3130,1278,848,1290,1069,1139,442,-430,872
1369,330000,0797526c057dcf5b,4,0,888,1084,1050,1140,1443,1709,2001,2019,2088,700,801,1246,1024,916,445,101,344
827,420000,0797526c057dcf5b,4,0,568,585,851,689,870,1071,1120,1425,1562,736,376,772,574,628,396,-360,756
1093,430000,0797526c057dcf5b,4,0,1123,1343,1265,1384,1668,1721,1444,1769,3168,1244,677,1105,891,1009,428,-567,995
945,350000,0797526c057dcf5b,4,0,748,1047,978,991,1227,1477,1846,1591,1981,769,598,1058,828,808,460,-171,631
1541,210000,0797526c057dcf5b,4,0,2416,2738,2351,2715,3298,3035,2443,2622,3705,1059,1132,1642,1387,1278,510,73,437
330,500000,0797526c057dcf5b,4,0,208,307,592,510,660,624,494,548,828,333,235,331,283,300,96,-98,194
284,610000,0797526c057dcf5b,4,0,246,335,408,480,451,462,457,402,722,289,175,287,231,250,112,-114,226
509,230000,0797526c057dcf5b,4,0,315,472,426,421,630,651,605,913,1064,350,347,604,476,434,257,-3,260
213,310000,936168bd4850913d,4,0,256,231,232,275,253,330,234,241,272,250,161,224,192,212,63,-89,152
298,530000,936168bd4850913d,4,0,222,273,237,317,281,288,285,282,383,494,162,297,230,318,135,-332,467
399,150000,936168bd4850913d,4,0,297,409,278,346,325,397,353,331,374,412,213,364,288,330,151,-199,350
347,110000,936168bd4850913d,4,0,428,423,454,541,459,651,432,527,798,336,255,324,290,305,69,-81,150
354,510000,936168bd4850913d,4,0,404,345,365,374,356,560,353,364,502,560,198,280,239,346,82,-362,444
365,340000,936168bd4850913d,4,0,311,364,321,347,370,464,369,339,449,378,228,339,284,315,111,-150,261
1214,370000,936168bd4850913d,4,0,1159,1092,1036,1063,896,1347,1014,1020,1083,1132,648,948,798,909,300,-484,784
403,140000,936168bd4850913d,4,0,327,404,319,311,334,462,394,347,454,373,276,370,323,340,94,-97,191
2621,440000,936168bd4850913d,4,0,2056,2432,2474,2478,2391,3040,2810,2842,3119,2859,1337,2735,2036,2310,1398,-1522,2920
255,450000,936168bd4850913d,4,0,228,279,260,273,237,346,287,279,316,376,154,306,230,279,152,-222,374
787,320000,936168bd4850913d,4,0,875,944,898,914,919,1153,908,905,1057,1012,579,905,742,832,326,-433,759
439,360000,936168bd4850913d,4,0,334,387,321,370,350,407,325,334,414,397,195,355,275,316,160,-202,362
1066,130000,936168bd4850913d,4,0,645,721,619,623,691,837,696,646,778,797,602,842,722,747,240,-195,435
1159,410000,936168bd4850913d,4,0,938,870,860,976,801,1165,786,979,1154,954,596,986,791,845,390,-358,748
682,330000,936168bd4850913d,4,0,647,679,619,746,631,767,611,709,819,752,388,650,519,597,262,-364,626
1131,420000,936168bd4850913d,4,0,1091,1131,1321,1289,1127,1463,1111,1292,1497,1405,549,1164,856,1039,615,-856,1471
689,430000,936168bd4850913d,4,0,681,762,693,656,726,776,563,649,953,623,341,556,448,507,215,-282,497
479,350000,936168bd4850913d,4,0,623,627,554,655,558,641,586,610,611,627,347,556,452,510,209,-280,489
730,210000,936168bd4850913d,4,0,668,714,579,727,667,816,696,727,851,758,485,709,597,651,224,-273,497
125,500000,936168bd4850913d,4,0,162,139,215,222,181,222,152,145,208,248,87,111,99,149,24,-161,185
386,610000,936168bd4850913d,4,0,362,418,335,362,360,429,415,400,482,463,229,331,280,341,102,-234,336
485,230000,936168bd4850913d,4,0,636,673,545,503,567,621,450,630,549,617,346,607,476,523,261,-271,532
172,310000,cc21c7e91a3b5a0c,4,0,268,271,242,256,281,287,238,345,456,114,153,205,179,157,52,39,13
347,530000,cc21c7e91a3b5a0c,4,0,277,288,270,381,345,327,285,338,442,406,203,364,284,324,161,-203,364
298,150000,cc21c7e91a3b5a0c,4,0,205,287,238,235,267,246,282,331,382,195,193,311,252,233,118,-2,120
128,110000,cc21c7e91a3b5a0c,4,0,243,275,251,253,208,303,262,356,580,121,115,186,150,141,71,-6,77
378,510000,cc21c7e91a3b5a0c,4,0,459,461,461,453,451,636,487,569,804,459,234,390,312,361,156,-225,381
434,340000,cc21c7e91a3b5a0c,4,0,355,346,364,377,400,439,428,489,503,403,244,376,310,341,132,-159,291
953,370000,cc21c7e91a3b5a0c,4,0,891,877,768,778,692,815,855,912,1164,554,505,703,604,587,198,-49,247
299,140000,cc21c7e91a3b5a0c,4,0,256,316,230,226,277,310,284,316,428,223,193,301,247,239,108,-30,138
2284,440000,cc21c7e91a3b5a0c,4,0,2006,2367,2317,2288,2219,2478,2450,3345,3730,1930,1262,2615,1938,1936,1353,-668,2021
304,450000,cc21c7e91a3b5a0c,4,0,226,316,262,277,270,290,313,377,417,266,187,309,248,254,122,-79,201
1130,320000,cc21c7e91a3b5a0c,4,0,1098,1171,1053,1035,1139,1193,1114,1454,1527,877,754,1069,912,900,315,-123,438
377,360000,cc21c7e91a3b5a0c,4,0,283,344,324,354,314,340,317,350,507,305,161,323,242,263,162,-144,306
723,130000,cc21c7e91a3b5a0c,4,0,466,575,563,517,521,590,551,574,797,453,434,572,503,486,138,-19,157
797,410000,cc21c7e91a3b5a0c,4,0,701,609,620,657,647,687,548,872,1036,630,391,702,546,574,311,-239,550
969,330000,cc21c7e91a3b5a0c,4,0,916,952,851,928,863,800,942,1151,1258,739,529,861,695,710,332,-210,542
775,420000,cc21c7e91a3b5a0c,4,0,860,857,1022,954,876,1065,918,1189,1511,963,454,719,586,712,265,-509,774
430,430000,cc21c7e91a3b5a0c,4,0,418,440,412,436,456,456,452,506,737,420,189,443,316,351,254,-231,485
561,350000,cc21c7e91a3b5a0c,4,0,524,634,509,574,525,556,643,734,779,473,353,640,496,489,287,-120,407
475,210000,cc21c7e91a3b5a0c,4,0,433,415,359,423,434,437,390,480,602,285,241,431,336,319,190,-44,234
155,500000,cc21c7e91a3b5a0c,4,0,208,153,256,232,218,203,186,200,305,185,95,179,137,153,84,-90,174
292,610000,cc21c7e91a3b5a0c,4,0,282,291,238,303,301,293,309,345,496,293,157,234,196,228,77,-136,213
309,230000,cc21c7e91a3b5a0c,4,0,348,422,361,360,329,347,306,404,422,214,206,322,264,247,116,-8,124
313,310000,7aab7fca2470987e,4,0,255,249,227,228,228,248,166,277,348,224,140,212,176,192,72,-84,156
22,530000,7aab7fca2470987e,4,0,19,19,13,29,23,22,12,22,33,19,19,18,18,19,-1,0,-1
36,150000,7aab7fca2470987e,4,0,31,32,22,34,26,20,16,19,22,21,19,29,24,23,10,-2,12
320,110000,7aab7fca2470987e,4,0,385,371,412,397,450,433,353,372,511,424,244,378,311,349,134,-180,314
33,510000,7aab7fca2470987e,4,0,40,41,50,45,33,53,34,42,64,69,42,47,44,53,5,-27,32
57,340000,7aab7fca2470987e,4,0,94,77,54,58,60,65,52,74,75,83,59,59,59,67,0,-24,24
303,370000,7aab7fca2470987e,4,0,291,321,323,323,300,349,309,286,341,430,189,295,242,305,106,-241,347
78,140000,7aab7fca2470987e,4,0,97,85,61,83,86,76,58,62,78,105,64,83,74,84,19,-41,60
749,440000,7aab7fca2470987e,4,0,782,929,824,845,827,959,887,972,1235,1009,443,848,646,767,405,-566,971
12,450000,7aab7fca2470987e,4,0,25,33,22,15,35,23,23,13,26,34,17,20,18,24,3,-17,20
301,320000,7aab7fca2470987e,4,0,361,372,366,390,384,352,323,380,481,397,258,351,304,335,93,-139,232
40,360000,7aab7fca2470987e,4,0,45,28,35,34,41,44,29,35,37,61,16,26,21,34,10,-45,55
271,130000,7aab7fca2470987e,4,0,215,221,251,231,259,229,234,231,316,308,172,236,204,239,64,-136,200
146,410000,7aab7fca2470987e,4,0,203,189,186,204,209,192,150,188,209,242,134,155,144,177,21,-108,129
371,330000,7aab7fca2470987e,4,0,324,279,263,302,300,252,293,323,375,353,222,270,246,282,48,-131,179
51,420000,7aab7fca2470987e,4,0,65,48,56,41,58,58,26,64,62,54,47,52,50,51,5,-7,12
28,430000,7aab7fca2470987e,4,0,53,33,37,54,26,47,25,31,44,54,26,27,26,36,1,-28,29
43,350000,7aab7fca2470987e,4,0,71,65,63,56,64,42,57,83,105,92,41,56,48,63,15,-51,66
129,210000,7aab7fca2470987e,4,0,201,173,177,170,176,181,127,153,187,158,103,124,114,128,21,-55,76
12,500000,7aab7fca2470987e,4,0,25,16,43,25,22,19,17,12,27,22,12,27,20,20,15,-10,25
37,610000,7aab7fca2470987e,4,0,33,50,39,32,34,19,25,29,46,61,16,38,27,38,22,-45,67
62,230000,7aab7fca2470987e,4,0,92,117,107,90,78,77,62,61,65,66,41,61,51,56,20,-25,45
140,310000,fde95ea242abd896,4,0,297,244,231,222,233,237,260,331,369,161,142,190,166,164,48,-19,67
233,530000,fde95ea242abd896,4,0,304,293,280,397,351,388,519,521,651,386,202,309,256,299,107,-184,291
127,150000,fde95ea242abd896,4,0,103,173,112,115,149,181,185,190,234,146,90,139,114,125,49,-56,105
149,110000,fde95ea242abd896,4,0,248,267,240,223,271,313,223,301,382,210,141,181,161,177,40,-69,109
342,510000,fde95ea242abd896,4,0,389,401,386,408,384,645,492,617,839,509,240,360,300,370,120,-269,389
266,340000,fde95ea242abd896,4,0,313,328,323,371,429,508,453,504,690,387,163,254,208,268,91,-224,315
570,370000,fde95ea242abd896,4,0,625,677,569,603,642,825,774,709,964,444,303,464,384,404,161,-141,302
204,140000,fde95ea242abd896,4,0,277,268,247,194,300,278,277,302,443,175,132,238,185,182,106,-43,149
3040,440000,fde95ea242abd896,4,0,2736,3407,3034,2769,3466,3967,4449,4901,5547,3229,1517,2906,2212,2551,1389,-1712,3101
247,450000,fde95ea242abd896,4,0,300,323,305,295,375,362,434,458,665,381,181,321,251,294,140,-200,340
614,320000,fde95ea242abd896,4,0,905,886,740,767,910,875,888,974,1139,690,508,722,615,640,214,-182,396
300,360000,fde95ea242abd896,4,0,298,296,306,326,283,440,408,499,625,381,184,276,230,280,92,-197,289
514,130000,fde95ea242abd896,4,0,470,518,437,434,560,591,602,602,830,407,320,433,376,387,113,-87,200
530,410000,fde95ea242abd896,4,0,487,451,445,414,574,666,620,614,920,507,247,499,373,418,252,-260,512
842,330000,fde95ea242abd896,4,0,1038,954,959,917,968,1148,998,1169,1424,732,558,806,682,699,248,-174,422
498,420000,fde95ea242abd896,4,0,646,667,730,629,764,987,818,1066,1347,698,270,511,390,493,241,-428,669
421,430000,fde95ea242abd896,4,0,540,567,522,526,503,752,630,700,988,570,203,418,310,397,215,-367,582
595,350000,fde95ea242abd896,4,0,556,633,509,603,671,676,754,796,1043,605,368,580,474,518,212,-237,449
357,210000,fde95ea242abd896,4,0,514,445,435,473,472,553,433,460,600,253,193,341,267,262,148,-60,208
140,500000,fde95ea242abd896,4,0,208,157,246,168,172,243,227,222,229,139,105,116,110,120,11,-34,45
126,610000,fde95ea242abd896,4,0,120,179,148,148,164,191,253,229,293,140,96,140,118,125,44,-44,88
218,230000,fde95ea242abd896,4,0,331,309,255,234,372,256,198,199,322,111,123,264,194,166,141,12,129
368,310000,97f15de12cfabbd5,4,0,139,212,242,279,368,455,354,457,516,264,193,369,281,275,176,-71,247
116,530000,97f15de12cfabbd5,4,0,54,90,69,134,137,168,236,233,253,206,111,144,128,154,33,-95,128
145,150000,97f15de12cfabbd5,4,0,111,161,112,170,148,180,212,200,238,219,114,172,143,168,58,-105,163
397,110000,97f15de12cfabbd5,4,0,419,541,572,614,704,733,603,754,1094,601,390,482,436,491,92,-211,303
296,510000,97f15de12cfabbd5,4,0,215,215,241,286,280,498,363,489,543,391,237,325,281,318,88,-154,242
233,340000,97f15de12cfabbd5,4,0,168,222,253,319,361,472,444,568,578,495,153,185,169,278,32,-342,374
727,370000,97f15de12cfabbd5,4,0,449,644,594,653,771,1001,1018,1094,1221,1031,476,846,661,784,370,-555,925
335,140000,97f15de12cfabbd5,4,0,190,307,319,310,398,381,370,395,605,316,221,369,295,302,148,-95,243
2460,440000,97f15de12cfabbd5,4,0,1283,1775,1807,1926,2292,2762,3019,3563,3747,2666,1125,2377,1751,2056,1252,-1541,2793
101,450000,97f15de12cfabbd5,4,0,85,131,107,105,132,134,146,194,174,193,92,119,106,135,27,-101,128
901,320000,97f15de12cfabbd5,4,0,574,791,789,884,1139,1155,1292,1491,1524,1070,552,1008,780,877,456,-518,974
179,360000,97f15de12cfabbd5,4,0,127,135,142,163,206,280,258,340,409,346,81,166,124,198,85,-265,350
762,130000,97f15de12cfabbd5,4,0,400,560,621,573,819,812,975,971,1119,789,422,734,578,648,312,-367,679
531,410000,97f15de12cfabbd5,4,0,261,356,378,472,519,592,609,805,866,692,326,488,407,502,162,-366,528
1010,330000,97f15de12cfabbd5,4,0,569,729,797,1116,1100,1259,1371,1516,1515,1138,549,969,759,885,420,-589,1009
434,420000,97f15de12cfabbd5,4,0,355,306,462,346,475,707,729,779,906,749,253,446,350,483,193,-496,689
402,430000,97f15de12cfabbd5,4,0,344,400,350,381,419,626,645,767,839,710,238,437,338,462,199,-472,671
508,350000,97f15de12cfabbd5,4,0,182,309,251,400,389,434,571,612,638,509,288,542,415,446,254,-221,475
872,210000,97f15de12cfabbd5,4,0,678,921,843,1057,1068,1256,1020,1269,1395,898,506,962,734,789,456,-392,848
130,500000,97f15de12cfabbd5,4,0,141,164,243,183,190,183,170,200,213,159,106,164,135,143,58,-53,111
195,610000,97f15de12cfabbd5,4,0,121,222,212,278,246,251,273,309,371,227,159,225,192,204,66,-68,134
358,230000,97f15de12cfabbd5,4,0,301,459,440,381,659,536,422,639,783,366,217,537,377,373,320,-149,469
169,310000,f5d69960089c3614,4,0,200,179,143,213,231,263,186,304,291,260,125,252,188,212,127,-135,262
48,530000,f5d69960089c3614,4,0,27,47,40,86,70,45,62,97,95,78,48,59,54,62,11,-30,41
53,150000,f5d69960089c3614,4,0,39,59,30,34,48,53,57,54,64,35,18,51,34,35,33,-17,50
341,110000,f5d69960089c3614,4,0,530,580,328,387,431,542,458,551,739,435,233,445,339,371,212,-202,414
212,510000,f5d69960089c3614,4,0,199,189,198,208,192,406,218,246,296,270,133,178,156,194,45,-137,182
69,340000,f5d69960089c3614,4,0,66,77,68,83,102,108,119,125,125,156,59,89,74,101,30,-97,127
197,370000,f5d69960089c3614,4,0,215,226,189,211,236,259,209,228,356,218,112,223,168,184,111,-106,217
29,140000,f5d69960089c3614,4,0,31,34,37,39,38,29,27,53,51,47,21,35,28,34,14,-26,40
246,440000,f5d69960089c3614,4,0,264,290,315,201,283,319,341,442,572,437,152,310,231,300,158,-285,443
32,450000,f5d69960089c3614,4,0,39,40,44,25,47,48,35,38,46,44,34,25,30,34,-9,-10,1
177,320000,f5d69960089c3614,4,0,166,199,160,179,202,235,218,248,301,251,138,200,169,196,62,-113,175
53,360000,f5d69960089c3614,4,0,46,67,46,43,63,74,57,75,92,84,32,51,42,56,19,-52,71
113,130000,f5d69960089c3614,4,0,82,94,85,75,106,81,95,123,131,106,79,112,96,99,33,-27,60
155,410000,f5d69960089c3614,4,0,177,146,115,120,133,136,137,144,187,131,57,111,84,100,54,-74,128
107,330000,f5d69960089c3614,4,0,105,120,103,117,123,127,129,149,230,149,78,139,108,122,61,-71,132
94,420000,f5d69960089c3614,4,0,105,133,83,100,88,128,132,148,184,148,61,111,86,107,50,-87,137
109,430000,f5d69960089c3614,4,0,119,132,99,113,129,125,121,157,211,135,74,132,103,114,58,-61,119
71,350000,f5d69960089c3614,4,0,68,110,85,91,79,63,93,111,124,108,57,77,67,81,20,-51,71
76,210000,f5d69960089c3614,4,0,78,114,94,86,129,93,93,126,129,69,51,75,63,65,24,-18,42
97,500000,f5d69960089c3614,4,0,106,102,141,124,91,113,105,132,160,125,77,112,94,105,35,-48,83
111,610000,f5d69960089c3614,4,0,117,132,93,101,114,118,176,150,182,148,77,137,107,121,60,-71,131
53,230000,f5d69960089c3614,4,0,66,58,77,51,83,64,44,71,77,53,34,68,51,52,34,-19,53
92,310000,5b1c11c3efed5312,4,0,166,137,100,120,182,195,186,244,388,154,85,126,106,122,41,-69,110
53,530000,5b1c11c3efed5312,4,0,138,155,102,132,175,199,190,214,267,194,91,60,76,115,-31,-103,72
62,150000,5b1c11c3efed5312,4,0,113,123,90,86,129,117,180,167,259,127,62,61,62,83,-1,-65,64
25,110000,5b1c11c3efed5312,4,0,157,135,132,124,189,195,143,181,370,71,41,51,46,54,10,-30,40
110,510000,5b1c11c3efed5312,4,0,347,268,235,259,271,451,335,432,691,448,194,129,162,257,-65,-254,189
217,340000,5b1c11c3efed5312,4,0,406,511,409,457,615,665,719,699,1253,712,250,227,238,396,-23,-462,439
347,370000,5b1c11c3efed5312,4,0,712,759,542,525,598,799,850,792,1449,549,320,297,308,389,-23,-229,206
83,140000,5b1c11c3efed5312,4,0,156,184,119,112,180,176,226,231,426,153,81,103,92,112,22,-72,94
246,440000,5b1c11c3efed5312,4,0,439,656,557,570,682,810,953,1204,1628,496,168,342,255,335,174,-328,502
26,450000,5b1c11c3efed5312,4,0,93,99,74,74,93,96,119,135,240,121,56,54,55,77,-2,-65,63
402,320000,5b1c11c3efed5312,4,0,685,815,558,664,879,928,1050,1083,1908,768,543,404,474,572,-139,-225,86
168,360000,5b1c11c3efed5312,4,0,275,290,238,256,256,368,358,434,733,453,153,150,152,252,-3,-300,297
300,130000,5b1c11c3efed5312,4,0,442,541,372,433,513,576,665,667,1158,476,272,257,264,335,-15,-204,189
380,410000,5b1c11c3efed5312,4,0,706,670,565,604,728,823,894,1006,1883,910,372,312,342,531,-60,-538,478
337,330000,5b1c11c3efed5312,4,0,745,772,623,618,806,968,1022,1202,2202,744,430,386,408,520,-44,-314,270
130,420000,5b1c11c3efed5312,4,0,254,222,214,224,236,278,353,409,749,443,143,138,140,241,-5,-300,295
149,430000,5b1c11c3efed5312,4,0,282,299,206,221,263,352,322,439,744,378,131,137,134,215,6,-247,253
130,350000,5b1c11c3efed5312,4,0,186,224,163,185,197,242,345,391,594,265,149,173,161,196,24,-116,140
75,210000,5b1c11c3efed5312,4,0,167,172,127,118,166,151,176,186,256,75,62,80,71,72,18,-13,31
23,500000,5b1c11c3efed5312,4,0,86,60,103,92,81,101,86,92,172,124,38,29,34,64,-9,-86,77
64,610000,5b1c11c3efed5312,4,0,166,180,107,108,126,155,205,212,325,144,79,70,74,98,-9,-65,56
38,230000,5b1c11c3efed5312,4,0,142,116,90,66,138,116,107,126,152,43,36,52,44,44,16,-7,23
175,310000,17363f08d683d52b,4,0,57,61,83,70,93,94,69,88,96,65,19,37,28,40,18,-46,64
86,530000,17363f08d683d52b,4,0,153,150,145,260,181,192,214,209,182,216,75,82,78,124,7,-141,148
45,150000,17363f08d683d52b,4,0,103,189,132,152,130,174,176,130,141,132,46,66,56,81,20,-86,106
48,110000,17363f08d683d52b,4,0,224,215,203,267,229,259,158,186,277,124,81,65,73,90,-16,-43,27
78,510000,17363f08d683d52b,4,0,251,265,277,338,249,374,267,205,292,350,117,93,105,187,-24,-233,209
92,340000,17363f08d683d52b,4,0,261,334,403,369,409,407,332,341,384,513,121,108,114,247,-13,-392,379
209,370000,17363f08d683d52b,4,0,477,501,534,578,578,669,572,480,596,555,214,153,184,307,-61,-341,280
22,140000,17363f08d683d52b,4,0,53,84,72,80,105,82,89,70,67,66,26,12,19,35,-14,-40,26
37,440000,17363f08d683d52b,4,0,189,205,161,153,130,99,91,101,84,62,19,63,41,48,44,-43,87
20,450000,17363f08d683d52b,4,0,61,65,56,59,47,57,42,39,50,45,14,26,20,28,12,-31,43
188,320000,17363f08d683d52b,4,0,391,511,498,540,652,534,502,474,569,538,214,216,215,323,2,-324,326
91,360000,17363f08d683d52b,4,0,222,322,296,334,361,423,281,274,309,360,94,101,98,185,7,-266,273
162,130000,17363f08d683d52b,4,0,300,423,331,415,474,378,372,326,383,353,154,150,152,219,-4,-199,195
129,410000,17363f08d683d52b,4,0,433,458,439,537,516,505,471,372,457,538,139,100,120,259,-39,-399,360
151,330000,17363f08d683d52b,4,0,439,481,523,527,619,525,437,429,453,388,129,152,140,223,23,-259,282
119,420000,17363f08d683d52b,4,0,287,274,347,357,348,470,379,317,421,474,120,139,130,244,19,-354,373
114,430000,17363f08d683d52b,4,0,267,285,332,369,394,455,353,348,428,459,95,148,122,234,53,-364,417
37,350000,17363f08d683d52b,4,0,105,117,97,156,140,150,148,127,159,136,38,44,41,73,6,-98,104
137,210000,17363f08d683d52b,4,0,190,224,186,211,236,239,216,174,238,151,59,93,76,101,34,-92,126
16,500000,17363f08d683d52b,4,0,113,119,207,154,160,119,108,151,126,110,41,27,34,59,-14,-69,55
82,610000,17363f08d683d52b,4,0,200,295,195,243,241,219,279,210,288,180,80,67,74,109,-13,-100,87
45,230000,17363f08d683d52b,4,0,112,155,119,135,185,126,121,118,156,75,46,57,52,59,11,-29,40
169,310000,06880909932890ca,4,0,123,151,184,200,260,330,188,341,384,208,78,136,107,141,58,-130,188
79,530000,06880909932890ca,4,0,87,116,115,160,152,177,216,186,206,142,56,68,62,89,12,-86,98
52,150000,06880909932890ca,4,0,89,116,92,95,118,103,121,125,115,74,44,45,44,54,1,-30,31
162,110000,06880909932890ca,4,0,429,502,404,587,598,646,461,553,771,253,139,206,172,199,67,-114,181
304,510000,06880909932890ca,4,0,360,435,525,529,541,770,548,657,933,673,263,243,253,393,-20,-410,390
389,340000,06880909932890ca,4,0,494,668,812,815,909,849,800,764,993,964,338,340,339,547,2,-626,628
537,370000,06880909932890ca,4,0,772,912,798,955,1028,1068,979,957,1332,1011,383,430,406,608,47,-628,675
111,140000,06880909932890ca,4,0,155,182,158,166,260,200,213,203,275,128,67,102,84,99,35,-61,96
579,440000,06880909932890ca,4,0,651,912,826,970,1165,1341,1182,1660,1546,767,278,638,458,561,360,-489,849
86,450000,06880909932890ca,4,0,118,154,160,138,192,192,181,188,276,186,86,105,96,126,19,-100,119
1074,320000,06880909932890ca,4,0,1322,1690,1549,1784,2086,2054,2015,2022,2642,2094,991,984,988,1356,-7,-1103,1096
274,360000,06880909932890ca,4,0,317,446,403,446,466,481,368,453,691,614,157,211,184,327,54,-457,511
342,130000,06880909932890ca,4,0,489,571,550,679,797,728,665,667,773,530,290,330,310,383,40,-240,280
891,410000,06880909932890ca,4,0,998,1156,1405,1588,1680,1676,1390,1577,2409,1865,640,650,645,1052,10,-1225,1235
715,330000,06880909932890ca,4,0,1000,1198,1267,1405,1649,1572,1696,1832,2222,1022,501,663,582,729,162,-521,683
256,420000,06880909932890ca,4,0,336,378,470,475,562,525,475,492,661,605,178,211,194,331,33,-427,460
287,430000,06880909932890ca,4,0,380,383,445,414,541,561,481,547,698,488,170,228,199,295,58,-318,376
246,350000,06880909932890ca,4,0,228,311,284,350,418,427,469,556,601,361,197,246,222,268,49,-164,213
120,210000,06880909932890ca,4,0,228,287,226,287,309,335,246,211,328,161,100,120,110,127,20,-61,81
145,500000,06880909932890ca,4,0,207,287,447,415,439,445,330,373,430,326,140,158,149,208,18,-186,204
167,610000,06880909932890ca,4,0,248,336,278,349,407,350,449,347,562,349,119,145,132,204,26,-230,256
48,230000,06880909932890ca,4,0,101,109,89,128,149,133,82,97,100,69,37,53,45,53,16,-32,48
17,310000,9c1c7ee8ebdda299,4,0,21,27,22,13,27,10,4,41,46,32,19,54,36,35,35,-13,48
53,530000,9c1c7ee8ebdda299,4,0,165,176,148,181,200,159,126,119,169,142,104,91,98,112,-13,-38,25
163,150000,9c1c7ee8ebdda299,4,0,260,348,233,350,323,327,297,353,430,278,168,258,213,235,90,-110,200
13,110000,9c1c7ee8ebdda299,4,0,173,167,151,170,121,96,46,78,112,52,38,30,34,40,-8,-14,6
134,510000,9c1c7ee8ebdda299,4,0,753,701,834,869,836,723,408,517,641,617,336,250,293,401,-86,-281,195
59,340000,9c1c7ee8ebdda299,4,0,292,330,322,293,261,211,71,198,190,278,146,119,132,181,-27,-132,105
509,370000,9c1c7ee8ebdda299,4,0,1514,1697,1542,1763,1885,1782,1445,1562,2281,1763,885,746,816,1131,-139,-878,739
285,140000,9c1c7ee8ebdda299,4,0,566,798,670,854,973,842,579,768,886,691,295,401,348,462,106,-396,502
212,440000,9c1c7ee8ebdda299,4,0,657,797,730,793,791,821,619,710,1008,472,229,471,350,391,242,-243,485
55,450000,9c1c7ee8ebdda299,4,0,139,170,190,169,185,191,132,192,308,251,110,119,114,160,9,-141,150
106,320000,9c1c7ee8ebdda299,4,0,309,295,297,299,267,195,95,307,309,370,299,211,255,293,-88,-71,-17
42,360000,9c1c7ee8ebdda299,4,0,225,303,258,215,138,145,60,177,182,224,84,107,96,138,23,-140,163
733,130000,9c1c7ee8ebdda299,4,0,1513,1845,1547,1898,2125,1949,1092,1644,1840,1468,940,941,940,1116,1,-528,529
211,410000,9c1c7ee8ebdda299,4,0,823,772,817,797,693,546,306,774,911,1101,433,362,398,632,-71,-668,597
168,330000,9c1c7ee8ebdda299,4,0,215,232,213,216,202,149,42,380,352,327,197,195,196,240,-2,-130,128
32,420000,9c1c7ee8ebdda299,4,0,159,138,172,121,123,100,46,116,125,211,58,65,62,111,7,-153,160
42,430000,9c1c7ee8ebdda299,4,0,204,204,207,195,142,140,74,141,165,230,105,87,96,141,-18,-125,107
66,350000,9c1c7ee8ebdda299,4,0,238,254,259,254,219,159,110,281,215,204,105,130,118,146,25,-99,124
425,210000,9c1c7ee8ebdda299,4,0,548,622,615,791,715,654,384,528,619,375,317,409,363,367,92,-58,150
25,500000,9c1c7ee8ebdda299,4,0,140,142,167,210,170,119,62,80,104,116,61,54,58,77,-7,-55,48
75,610000,9c1c7ee8ebdda299,4,0,347,415,360,504,331,168,145,214,250,261,108,136,122,168,28,-153,181
137,230000,9c1c7ee8ebdda299,4,0,312,349,289,307,328,302,291,350,342,207,144,192,168,181,48,-63,111
177,310000,c6833cb891626c17,4,0,153,184,190,187,321,371,283,435,596,174,80,151,116,135,71,-94,165
176,530000,c6833cb891626c17,4,0,214,293,278,391,368,477,514,538,699,444,236,185,210,288,-51,-208,157
138,150000,c6833cb891626c17,4,0,144,231,182,278,328,337,354,323,485,221,94,125,110,147,31,-127,158
242,110000,c6833cb891626c17,4,0,446,557,512,616,785,877,636,879,1517,309,174,289,232,257,115,-135,250
287,510000,c6833cb891626c17,4,0,442,498,519,553,602,1020,712,770,1305,743,339,285,312,456,-54,-404,350
422,340000,c6833cb891626c17,4,0,430,556,596,658,834,1066,894,964,1597,855,344,344,344,514,0,-511,511
543,370000,c6833cb891626c17,4,0,765,851,801,793,998,1278,1160,1107,1740,687,383,327,355,466,-56,-304,248
126,140000,c6833cb891626c17,4,0,162,214,187,206,301,280,282,301,514,192,100,117,108,136,17,-92,109
360,440000,c6833cb891626c17,4,0,549,687,668,710,890,1382,1240,1586,1899,542,186,403,294,377,217,-356,573
81,450000,c6833cb891626c17,4,0,136,186,226,201,232,277,266,309,514,260,96,110,103,155,14,-164,178
645,320000,c6833cb891626c17,4,0,744,993,872,955,1345,1406,1396,1446,2279,939,574,593,584,702,19,-365,384
229,360000,c6833cb891626c17,4,0,241,288,279,356,409,638,519,571,900,502,180,199,190,294,19,-322,341
600,130000,c6833cb891626c17,4,0,540,727,602,725,929,1066,990,1108,1749,708,414,412,413,511,-2,-294,292
792,410000,c6833cb891626c17,4,0,886,926,1021,1208,1438,1525,1493,1622,2735,1331,509,557,533,799,48,-822,870
676,330000,c6833cb891626c17,4,0,846,1069,1144,1284,1635,1804,1911,2130,3255,1119,581,616,598,772,35,-538,573
256,420000,c6833cb891626c17,4,0,287,324,375,419,485,678,560,634,1014,597,202,210,206,336,8,-395,403
272,430000,c6833cb891626c17,4,0,351,355,332,374,473,712,546,606,978,498,212,209,210,306,-3,-286,283
131,350000,c6833cb891626c17,4,0,228,280,250,238,291,406,499,552,782,311,141,184,162,212,43,-170,213
131,210000,c6833cb891626c17,4,0,208,243,206,229,283,315,299,258,424,127,80,97,88,101,17,-47,64
93,500000,c6833cb891626c17,4,0,183,177,223,193,277,336,267,309,532,260,104,78,91,147,-26,-156,130
179,610000,c6833cb891626c17,4,0,218,355,227,253,326,373,472,366,620,315,130,154,142,200,24,-185,209
71,230000,c6833cb891626c17,4,0,157,191,155,137,237,206,170,232,274,80,52,66,59,66,14,-28,42
163,310000,3e21824be728cbec,4,0,160,176,192,187,249,257,239,345,396,369,177,174,176,240,-3,-192,189
159,530000,3e21824be728cbec,4,0,200,206,289,300,344,358,406,373,334,203,134,207,170,181,73,-69,142
27,150000,3e21824be728cbec,4,0,59,78,58,65,160,123,116,59,90,51,29,42,36,41,13,-22,35
42,110000,3e21824be728cbec,4,0,163,119,141,164,139,203,168,222,242,93,60,87,74,80,27,-33,60
272,510000,3e21824be728cbec,4,0,450,413,455,488,625,731,758,778,781,288,239,321,280,283,82,-49,131
237,340000,3e21824be728cbec,4,0,279,349,370,347,570,630,644,607,661,309,266,301,284,292,35,-43,78
464,370000,3e21824be728cbec,4,0,616,559,584,576,690,772,807,782,994,540,419,572,496,510,153,-121,274
60,140000,3e21824be728cbec,4,0,126,140,127,162,287,240,200,132,201,88,44,87,66,73,43,-44,87
411,440000,3e21824be728cbec,4,0,453,438,526,486,516,619,721,938,1135,331,231,477,354,346,246,-100,346
131,450000,3e21824be728cbec,4,0,158,185,230,205,301,268,247,370,403,140,92,140,116,124,48,-48,96
641,320000,3e21824be728cbec,4,0,700,765,791,837,1017,1020,1227,1286,1781,805,710,885,798,800,175,-95,270
170,360000,3e21824be728cbec,4,0,223,276,230,221,285,391,438,444,431,157,97,173,135,142,76,-60,136
404,130000,3e21824be728cbec,4,0,556,558,552,574,734,729,766,589,806,391,375,484,430,417,109,-16,125
418,410000,3e21824be728cbec,4,0,578,632,668,840,854,777,834,729,896,363,334,528,431,408,194,-29,223
363,330000,3e21824be728cbec,4,0,493,406,443,507,510,573,616,797,1044,341,386,475,430,401,89,45,44
119,420000,3e21824be728cbec,4,0,284,238,303,280,357,375,452,413,461,270,123,194,158,196,71,-147,218
167,430000,3e21824be728cbec,4,0,224,235,250,255,292,394,414,458,478,157,99,182,140,146,83,-58,141
219,350000,3e21824be728cbec,4,0,293,325,290,310,328,339,397,455,593,250,154,266,210,223,112,-96,208
66,210000,3e21824be728cbec,4,0,108,118,118,139,151,144,114,136,149,45,36,75,56,52,39,-9,48
136,500000,3e21824be728cbec,4,0,167,239,459,311,410,422,402,422,475,136,124,148,136,136,24,-12,36
141,610000,3e21824be728cbec,4,0,319,382,320,375,494,446,595,355,464,194,145,188,166,176,43,-49,92
54,230000,3e21824be728cbec,4,0,154,180,125,146,202,237,176,82,87,40,47,82,64,56,35,7,28
266,310000,f8a6975573af1b33,4,0,266,306,267,258,427,420,355,228,579,371,131,288,210,263,157,-240,397
192,530000,f8a6975573af1b33,4,0,152,177,118,180,214,200,244,165,338,215,134,179,156,176,45,-81,126
37,150000,f8a6975573af1b33,4,0,26,58,32,43,34,40,41,43,48,41,28,59,44,43,31,-13,44
108,110000,f8a6975573af1b33,4,0,244,264,181,202,267,304,268,372,383,131,61,110,86,101,49,-70,119
433,510000,f8a6975573af1b33,4,0,398,410,336,352,370,632,431,484,820,550,286,428,357,421,142,-264,406
425,340000,f8a6975573af1b33,4,0,387,411,362,305,443,521,495,362,758,508,322,432,377,421,110,-186,296
381,370000,f8a6975573af1b33,4,0,424,368,316,303,357,410,423,383,729,410,227,320,274,319,93,-183,276
62,140000,f8a6975573af1b33,4,0,63,71,48,59,51,78,61,91,136,74,57,53,55,61,-4,-17,13
1007,440000,f8a6975573af1b33,4,0,875,992,904,879,1153,1298,1305,1034,2232,1023,444,1072,758,846,628,-579,1207
131,450000,f8a6975573af1b33,4,0,172,201,169,192,217,237,215,191,328,208,107,160,134,158,53,-101,154
870,320000,f8a6975573af1b33,4,0,1017,1202,877,845,1153,1190,1239,807,1846,1142,747,1023,885,971,276,-395,671
235,360000,f8a6975573af1b33,4,0,182,202,165,177,232,306,226,131,436,290,111,237,174,213,126,-179,305
298,130000,f8a6975573af1b33,4,0,290,285,257,243,316,360,308,272,475,287,194,265,230,249,71,-93,164
513,410000,f8a6975573af1b33,4,0,439,424,404,405,509,554,543,420,747,459,249,457,353,388,208,-210,418
679,330000,f8a6975573af1b33,4,0,723,767,644,614,743,824,856,695,1454,752,503,780,642,678,277,-249,526
258,420000,f8a6975573af1b33,4,0,224,213,257,205,250,304,278,190,481,312,158,246,202,239,88,-154,242
238,430000,f8a6975573af1b33,4,0,299,303,226,226,283,329,289,235,425,324,139,263,201,242,124,-185,309
323,350000,f8a6975573af1b33,4,0,351,414,293,354,411,469,472,415,699,508,260,395,328,388,135,-248,383
116,210000,f8a6975573af1b33,4,0,120,126,118,94,128,154,125,64,125,66,52,82,67,67,30,-14,44
287,500000,f8a6975573af1b33,4,0,316,243,316,279,300,389,322,256,548,310,185,288,236,261,103,-125,228
121,610000,f8a6975573af1b33,4,0,172,180,121,162,175,188,226,181,259,170,96,124,110,130,28,-74,102
85,230000,f8a6975573af1b33,4,0,105,118,92,95,86,84,67,65,115,61,52,76,64,63,24,-9,33
303,310000,54fc07138d70374c,4,0,284,312,308,315,327,336,292,421,473,415,199,338,268,317,139,-216,355
295,530000,54fc07138d70374c,4,0,226,239,271,381,320,316,363,485,535,500,259,353,306,371,94,-241,335
180,150000,54fc07138d70374c,4,0,124,177,198,210,230,224,233,229,234,273,129,208,168,203,79,-144,223
398,110000,54fc07138d70374c,4,0,359,374,335,454,424,442,429,500,681,534,295,402,348,410,107,-239,346
493,510000,54fc07138d70374c,4,0,498,454,508,557,495,659,704,743,849,933,442,540,491,638,98,-491,589
162,340000,54fc07138d70374c,4,0,184,207,204,219,249,314,271,334,368,404,198,210,204,271,12,-206,218
546,370000,54fc07138d70374c,4,0,505,542,531,579,617,771,679,776,936,911,376,595,486,627,219,-535,754
101,140000,54fc07138d70374c,4,0,129,125,128,113,131,135,142,208,244,213,113,141,127,156,28,-100,128
875,440000,54fc07138d70374c,4,0,876,978,1056,1120,1145,1408,1392,1836,2078,1526,521,1068,794,1038,547,-1005,1552
156,450000,54fc07138d70374c,4,0,190,185,216,203,212,207,208,246,317,323,145,236,190,235,91,-178,269
458,320000,54fc07138d70374c,4,0,403,502,513,553,616,611,660,847,820,821,461,589,525,624,128,-360,488
151,360000,54fc07138d70374c,4,0,156,222,179,206,215,215,187,249,262,297,113,164,138,191,51,-184,235
470,130000,54fc07138d70374c,4,0,396,448,411,475,528,576,625,746,750,758,431,483,457,557,52,-327,379
567,410000,54fc07138d70374c,4,0,488,554,520,548,623,596,604,752,820,826,447,615,531,629,168,-379,547
254,330000,54fc07138d70374c,4,0,299,309,330,357,379,387,524,623,684,550,252,401,326,401,149,-298,447
246,420000,54fc07138d70374c,4,0,252,255,280,268,311,346,310,385,425,481,197,299,248,326,102,-284,386
321,430000,54fc07138d70374c,4,0,270,349,338,350,384,424,364,460,493,505,239,383,311,376,144,-266,410
128,350000,54fc07138d70374c,4,0,209,200,169,259,222,223,268,329,338,400,163,217,190,260,54,-237,291
320,210000,54fc07138d70374c,4,0,230,303,292,281,324,364,303,369,450,249,117,274,196,213,157,-132,289
314,500000,54fc07138d70374c,4,0,365,346,440,402,372,406,400,540,575,576,284,403,344,421,119,-292,411
285,610000,54fc07138d70374c,4,0,242,263,225,299,275,293,365,346,404,376,178,272,225,275,94,-198,292
242,230000,54fc07138d70374c,4,0,293,273,325,359,356,331,302,341,410,324,206,341,274,290,135,-118,253
191,310000,212083a9246d2fd3,4,0,248,310,413,581,617,628,446,636,846,241,179,180,180,200,1,-62,63
124,530000,212083a9246d2fd3,4,0,145,172,143,197,189,278,304,365,493,290,145,117,131,184,-28,-145,117
71,150000,212083a9246d2fd3,4,0,109,155,125,168,136,222,206,310,562,284,123,119,121,175,-4,-161,157
60,110000,212083a9246d2fd3,4,0,270,321,429,521,473,498,257,444,824,105,71,55,63,77,-16,-34,18
394,510000,212083a9246d2fd3,4,0,606,603,636,717,777,1042,762,1080,1730,983,504,400,452,629,-104,-479,375
566,340000,212083a9246d2fd3,4,0,412,563,701,945,973,1078,1023,1260,2243,1186,528,593,560,769,65,-658,723
551,370000,212083a9246d2fd3,4,0,1042,1265,1160,1176,1294,1622,1536,1637,2998,1261,553,503,528,772,-50,-708,658
164,140000,212083a9246d2fd3,4,0,177,203,154,257,272,308,299,372,645,313,178,140,159,210,-38,-135,97
959,440000,212083a9246d2fd3,4,0,631,1027,923,1121,1670,1369,1274,1967,3191,905,337,855,596,699,518,-568,1086
188,450000,212083a9246d2fd3,4,0,105,142,190,192,188,232,252,337,697,471,179,227,203,292,48,-292,340
763,320000,212083a9246d2fd3,4,0,1231,1592,1724,1702,2067,2163,1918,2283,3836,1631,972,777,874,1127,-195,-659,464
221,360000,212083a9246d2fd3,4,0,251,345,361,411,440,542,547,676,1270,658,229,229,229,372,0,-429,429
578,130000,212083a9246d2fd3,4,0,495,710,678,854,909,987,969,1064,2232,950,551,442,496,648,-109,-399,290
1011,410000,212083a9246d2fd3,4,0,824,900,1091,1257,1337,1548,1431,1720,3243,1894,828,807,818,1176,-21,-1066,1045
361,330000,212083a9246d2fd3,4,0,672,814,952,886,1003,1067,1140,1205,1850,574,328,328,328,410,0,-246,246
243,420000,212083a9246d2fd3,4,0,335,349,502,356,435,576,710,866,1354,755,244,256,250,418,12,-511,523
371,430000,212083a9246d2fd3,4,0,426,538,599,590,709,844,687,982,1756,938,322,403,362,554,81,-616,697
215,350000,212083a9246d2fd3,4,0,221,268,357,422,486,645,645,746,1041,462,182,250,216,298,68,-280,348
178,210000,212083a9246d2fd3,4,0,163,241,231,300,418,415,275,422,561,181,92,144,118,139,52,-89,141
203,500000,212083a9246d2fd3,4,0,375,484,631,758,749,722,571,643,1136,557,231,195,213,328,-36,-326,290
310,610000,212083a9246d2fd3,4,0,261,399,506,811,726,652,682,805,1567,639,298,275,286,404,-23,-341,318
62,230000,212083a9246d2fd3,4,0,141,163,123,259,159,164,109,207,305,102,62,72,67,79,10,-40,50
33,310000,4f79773e600518a6,4,0,95,90,87,88,90,112,64,139,159,95,31,32,32,53,1,-64,65
50,530000,4f79773e600518a6,4,0,81,108,54,102,103,88,129,116,195,181,91,58,74,110,-33,-90,57
91,150000,4f79773e600518a6,4,0,174,223,139,192,148,178,215,227,336,327,113,110,112,183,-3,-214,211
28,110000,4f79773e600518a6,4,0,157,103,119,110,107,124,113,153,246,99,35,29,32,54,-6,-64,58
95,510000,4f79773e600518a6,4,0,231,201,164,169,165,260,194,267,387,398,155,108,132,220,-47,-243,196
101,340000,4f79773e600518a6,4,0,207,206,161,192,228,277,262,301,471,484,121,103,112,236,-18,-363,345
312,370000,4f79773e600518a6,4,0,574,604,450,433,565,670,629,591,961,723,263,300,282,429,37,-460,497
57,140000,4f79773e600518a6,4,0,103,114,81,88,106,92,114,133,167,149,66,59,62,91,-7,-83,76
38,440000,4f79773e600518a6,4,0,156,103,107,99,112,111,142,134,176,97,19,44,32,53,25,-78,103
15,450000,4f79773e600518a6,4,0,53,59,61,36,46,27,44,52,62,66,20,31,26,39,11,-46,57
94,320000,4f79773e600518a6,4,0,362,365,291,216,275,222,289,312,450,333,168,137,152,213,-31,-165,134
63,360000,4f79773e600518a6,4,0,129,162,110,96,123,158,141,164,252,264,69,58,64,130,-11,-195,184
226,130000,4f79773e600518a6,4,0,258,283,231,209,251,268,281,338,473,362,182,165,174,236,-17,-180,163
212,410000,4f79773e600518a6,4,0,508,440,420,458,438,436,457,535,679,669,213,223,218,368,10,-456,466
69,330000,4f79773e600518a6,4,0,148,165,119,117,144,152,167,161,255,131,59,54,56,81,-5,-72,67
104,420000,4f79773e600518a6,4,0,242,217,211,166,169,231,258,278,385,450,105,110,108,222,5,-345,350
247,430000,4f79773e600518a6,4,0,395,357,324,322,320,453,378,533,776,857,222,262,242,447,40,-635,675
20,350000,4f79773e600518a6,4,0,42,60,45,47,38,50,51,83,65,41,21,20,20,27,-1,-20,19
72,210000,4f79773e600518a6,4,0,125,118,82,101,115,152,128,129,166,109,50,66,58,75,16,-59,75
65,500000,4f79773e600518a6,4,0,189,156,162,125,149,157,175,189,306,256,58,77,68,130,19,-198,217
176,610000,4f79773e600518a6,4,0,296,319,224,270,298,329,421,381,634,493,193,190,192,292,-3,-300,297
70,230000,4f79773e600518a6,4,0,188,152,109,132,165,141,126,204,277,131,70,96,83,99,26,-61,87
74,310000,fc32b1a017b34efe,4,0,164,165,139,164,176,188,167,211,361,138,71,95,83,101,24,-67,91
259,530000,fc32b1a017b34efe,4,0,328,421,327,407,402,486,521,434,743,406,299,256,278,320,-43,-107,64
181,150000,fc32b1a017b34efe,4,0,265,289,218,256,255,374,366,390,683,304,135,211,173,217,76,-169,245
79,110000,fc32b1a017b34efe,4,0,345,391,298,365,388,458,302,357,675,173,56,121,88,117,65,-117,182
644,510000,fc32b1a017b34efe,4,0,1313,1243,1067,1135,1222,1530,1137,1318,2057,1186,681,782,732,883,101,-505,606
248,340000,fc32b1a017b34efe,4,0,413,407,292,363,463,479,476,493,865,574,194,213,204,327,19,-380,399
473,370000,fc32b1a017b34efe,4,0,983,935,718,720,875,922,870,894,1538,723,282,412,347,472,130,-441,571
346,140000,fc32b1a017b34efe,4,0,383,469,311,358,454,470,495,510,974,417,214,254,234,295,40,-203,243
354,440000,fc32b1a017b34efe,4,0,629,703,576,557,610,730,702,768,1105,569,259,493,376,440,234,-310,544
105,450000,fc32b1a017b34efe,4,0,154,242,164,182,175,217,208,212,406,260,101,165,133,175,64,-159,223
494,320000,fc32b1a017b34efe,4,0,631,724,557,652,768,765,828,786,1332,698,402,409,406,503,7,-296,303
205,360000,fc32b1a017b34efe,4,0,288,311,262,276,281,350,363,356,774,420,110,193,152,241,83,-310,393
929,130000,fc32b1a017b34efe,4,0,724,862,614,693,937,936,974,964,2069,891,397,516,456,601,119,-494,613
521,410000,fc32b1a017b34efe,4,0,892,850,682,796,900,924,913,934,1916,1026,330,387,358,581,57,-696,753
311,330000,fc32b1a017b34efe,4,0,541,581,492,491,561,604,663,556,982,370,195,281,238,282,86,-175,261
186,420000,fc32b1a017b34efe,4,0,278,276,303,276,301,385,300,389,721,401,105,159,132,222,54,-296,350
333,430000,fc32b1a017b34efe,4,0,623,562,511,551,548,722,567,687,1290,631,205,298,252,378,93,-426,519
114,350000,fc32b1a017b34efe,4,0,190,170,135,152,178,217,240,253,385,180,95,138,116,138,43,-85,128
144,210000,fc32b1a017b34efe,4,0,238,223,208,212,251,209,211,226,330,135,104,181,142,140,77,-31,108
477,500000,fc32b1a017b34efe,4,0,797,796,935,790,970,909,844,751,1420,661,420,464,442,515,44,-241,285
402,610000,fc32b1a017b34efe,4,0,575,671,425,496,540,574,623,639,1234,604,184,336,260,375,152,-420,572
78,230000,fc32b1a017b34efe,4,0,124,152,127,131,146,126,126,150,236,76,111,111,111,99,0,35,-35
187,310000,feabbf46658382b9,4,0,247,291,237,275,484,500,412,620,805,357,95,198,146,217,103,-262,365
444,530000,feabbf46658382b9,4,0,450,444,342,521,806,851,856,921,1249,829,418,522,470,590,104,-411,515
322,150000,feabbf46658382b9,4,0,336,322,265,347,507,500,528,675,925,601,288,415,352,435,127,-313,440
278,110000,feabbf46658382b9,4,0,446,455,384,534,743,672,532,779,1421,437,212,313,262,321,101,-225,326
938,510000,feabbf46658382b9,4,0,1182,899,922,1077,1757,2178,1620,1861,2915,2183,903,1084,994,1390,181,-1280,1461
322,340000,feabbf46658382b9,4,0,405,383,373,395,690,798,757,934,1307,1141,304,330,317,592,26,-837,863
611,370000,feabbf46658382b9,4,0,792,689,593,668,1173,1160,1214,1192,1610,1006,389,569,479,655,180,-617,797
305,140000,feabbf46658382b9,4,0,308,304,235,316,582,505,511,601,970,406,198,368,283,324,170,-208,378
879,440000,feabbf46658382b9,4,0,958,928,799,758,1347,1576,1507,1902,2685,1203,341,825,583,790,484,-862,1346
168,450000,feabbf46658382b9,4,0,191,230,206,193,394,347,352,440,665,433,149,235,192,272,86,-284,370
854,320000,feabbf46658382b9,4,0,1007,951,861,1014,1794,1646,1598,1955,2752,1481,650,861,756,997,211,-831,1042
268,360000,feabbf46658382b9,4,0,275,281,260,281,443,510,475,511,802,624,159,229,194,337,70,-465,535
767,130000,feabbf46658382b9,4,0,650,653,522,624,985,1009,905,1021,1551,970,478,608,543,685,130,-492,622
701,410000,feabbf46658382b9,4,0,786,747,679,846,1361,1342,1399,1530,2696,1928,502,672,587,1034,170,-1426,1596
641,330000,feabbf46658382b9,4,0,675,710,572,720,1247,1320,1351,1499,2124,704,292,530,411,509,238,-412,650
330,420000,feabbf46658382b9,4,0,317,322,323,347,614,653,620,794,1252,837,201,313,257,450,112,-636,748
579,430000,feabbf46658382b9,4,0,697,623,625,741,1241,1383,1339,1478,2360,1657,503,671,587,944,168,-1154,1322
219,350000,feabbf46658382b9,4,0,287,264,213,231,425,414,399,601,698,428,129,211,170,256,82,-299,381
187,210000,feabbf46658382b9,4,0,240,206,200,191,375,331,306,361,459,235,125,226,176,195,101,-110,211
740,500000,feabbf46658382b9,4,0,1031,877,1159,994,1592,1671,1487,1581,2727,1846,758,896,827,1167,138,-1088,1226
445,610000,feabbf46658382b9,4,0,636,634,391,538,758,764,827,896,1319,905,333,426,380,555,93,-572,665
155,230000,feabbf46658382b9,4,0,167,152,156,136,271,219,256,312,397,173,117,199,158,163,82,-56,138
25,310000,f270f6a489c6a9d7,4,0,54,48,33,25,37,28,27,30,34,19,29,28,28,25,-1,10,-11
815,530000,f270f6a489c6a9d7,4,0,1315,1335,1170,1342,1395,1639,1736,1547,1939,1680,1190,1187,1188,1352,-3,-490,487
71,150000,f270f6a489c6a9d7,4,0,96,80,81,79,74,107,93,105,108,54,78,117,98,83,39,24,15
120,110000,f270f6a489c6a9d7,4,0,233,214,173,229,238,282,198,305,504,106,118,157,138,127,39,12,27
519,510000,f270f6a489c6a9d7,4,0,892,875,682,620,742,717,655,773,955,603,645,678,662,642,33,42,-9
165,340000,f270f6a489c6a9d7,4,0,285,216,207,172,194,197,214,225,272,216,223,191,207,210,-32,7,-39
451,370000,f270f6a489c6a9d7,4,0,695,659,545,644,631,622,551,636,1105,629,541,513,527,561,-28,-88,60
118,140000,f270f6a489c6a9d7,4,0,155,157,114,131,103,137,118,161,233,166,115,127,121,136,12,-51,63
513,440000,f270f6a489c6a9d7,4,0,948,890,830,568,627,644,624,713,866,346,505,757,631,536,252,159,93
53,450000,f270f6a489c6a9d7,4,0,97,104,62,69,50,93,63,75,97,92,50,85,68,76,35,-42,77
623,320000,f270f6a489c6a9d7,4,0,724,727,654,653,752,766,763,871,1150,610,843,857,850,770,14,233,-219
90,360000,f270f6a489c6a9d7,4,0,155,161,110,121,107,134,92,117,148,132,89,105,97,109,16,-43,59
621,130000,f270f6a489c6a9d7,4,0,606,636,506,529,574,561,554,769,983,537,616,685,650,613,69,79,-10
612,410000,f270f6a489c6a9d7,4,0,1027,934,847,759,825,703,746,952,1314,922,778,753,766,818,-25,-144,119
368,330000,f270f6a489c6a9d7,4,0,557,549,457,405,385,451,456,466,653,312,498,511,504,440,13,186,-173
408,420000,f270f6a489c6a9d7,4,0,536,538,476,513,518,582,592,590,903,514,438,482,460,478,44,-76,120
353,430000,f270f6a489c6a9d7,4,0,598,440,429,353,375,366,327,426,575,405,314,375,344,365,61,-91,152
133,350000,f270f6a489c6a9d7,4,0,206,172,148,152,164,156,179,175,195,85,140,157,148,127,17,55,-38
191,210000,f270f6a489c6a9d7,4,0,272,228,230,212,192,216,260,281,370,158,187,236,212,194,49,29,20
438,500000,f270f6a489c6a9d7,4,0,781,700,668,554,592,643,645,706,955,636,643,771,707,683,128,7,121
180,610000,f270f6a489c6a9d7,4,0,306,283,187,180,190,227,209,280,324,195,155,198,176,183,43,-40,83
46,230000,f270f6a489c6a9d7,4,0,124,103,81,47,88,70,59,76,90,35,48,67,58,50,19,13,6
61,310000,d0f245b8781e3631,4,0,114,110,134,139,176,218,159,193,281,60,52,74,63,62,22,-8,30
103,530000,d0f245b8781e3631,4,0,127,149,132,201,192,241,224,227,356,181,119,130,124,143,11,-62,73
65,150000,d0f245b8781e3631,4,0,61,89,103,103,63,86,129,183,244,117,67,81,74,88,14,-50,64
97,110000,d0f245b8781e3631,4,0,398,466,501,463,464,472,326,417,805,105,52,132,92,96,80,-53,133
463,510000,d0f245b8781e3631,4,0,830,726,715,739,855,1133,824,910,1456,816,454,505,480,592,51,-362,413
88,340000,d0f245b8781e3631,4,0,160,209,240,323,314,310,267,287,463,251,96,133,114,160,37,-155,192
395,370000,d0f245b8781e3631,4,0,593,571,548,646,773,797,679,738,1182,600,283,311,297,398,28,-317,345
117,140000,d0f245b8781e3631,4,0,167,199,121,199,221,226,243,264,497,192,96,135,116,141,39,-96,135
262,440000,d0f245b8781e3631,4,0,342,351,384,378,429,596,574,615,869,297,127,271,199,232,144,-170,314
107,450000,d0f245b8781e3631,4,0,108,140,126,161,139,167,205,233,425,254,71,136,104,154,65,-183,248
363,320000,d0f245b8781e3631,4,0,574,521,545,683,706,761,731,749,1017,461,270,342,306,358,72,-191,263
84,360000,d0f245b8781e3631,4,0,126,110,128,145,145,229,198,198,315,211,60,84,72,118,24,-151,175
481,130000,d0f245b8781e3631,4,0,455,480,501,551,690,771,682,755,1430,754,390,398,394,514,8,-364,372
333,410000,d0f245b8781e3631,4,0,524,534,645,779,871,851,876,865,1601,892,268,371,320,510,103,-624,727
192,330000,d0f245b8781e3631,4,0,246,271,509,410,370,1437,406,420,845,174,81,170,126,142,89,-93,182
55,420000,d0f245b8781e3631,4,0,112,83,118,124,88,110,128,133,246,134,39,47,43,73,8,-95,103
191,430000,d0f245b8781e3631,4,0,280,324,325,335,319,439,335,447,756,439,130,231,180,267,101,-309,410
60,350000,d0f245b8781e3631,4,0,96,92,93,116,102,142,175,166,247,102,51,67,59,73,16,-51,67
27,210000,d0f245b8781e3631,4,0,60,48,65,77,81,68,54,102,113,47,21,29,25,32,8,-26,34
337,500000,d0f245b8781e3631,4,0,694,1791,780,781,1602,764,548,596,1578,630,283,298,290,404,15,-347,362
260,610000,d0f245b8781e3631,4,0,352,349,347,435,453,455,455,558,938,498,189,261,225,316,72,-309,381
11,230000,d0f245b8781e3631,4,0,14,19,35,25,28,17,16,45,45,7,10,21,16,13,11,3,8
190,310000,c6cd4e0e073f5ac2,4,0,615,1911,902,547,590,1049,393,448,746,228,125,223,174,192,98,-103,201
72,530000,c6cd4e0e073f5ac2,4,0,236,299,183,317,301,410,266,224,235,105,67,68,68,80,1,-38,39
64,150000,c6cd4e0e073f5ac2,4,0,170,205,129,178,248,263,289,273,340,208,63,95,79,122,32,-145,177
61,110000,c6cd4e0e073f5ac2,4,0,198,2153,193,216,265,2528,156,179,362,72,29,64,46,55,35,-43,78
265,510000,c6cd4e0e073f5ac2,4,0,987,918,779,942,1243,1666,730,631,1027,542,251,246,248,346,-5,-291,286
308,340000,c6cd4e0e073f5ac2,4,0,577,609,647,742,968,961,755,678,1434,792,244,232,238,423,-12,-548,536
453,370000,c6cd4e0e073f5ac2,4,0,1972,2081,1738,2176,2848,2646,1380,1053,1685,823,326,341,334,497,15,-497,512
162,140000,c6cd4e0e073f5ac2,4,0,357,466,412,468,657,660,386,479,604,321,126,162,144,203,36,-195,231
366,440000,c6cd4e0e073f5ac2,4,0,835,808,584,546,819,1623,936,1038,1493,451,130,374,252,318,244,-321,565
99,450000,c6cd4e0e073f5ac2,4,0,222,206,200,234,316,360,349,312,543,250,76,136,106,154,60,-174,234
787,320000,c6cd4e0e073f5ac2,4,0,1793,2058,1654,1827,2527,2388,1650,1467,2828,1205,656,751,704,871,95,-549,644
271,360000,c6cd4e0e073f5ac2,4,0,428,462,351,450,511,752,626,577,1241,549,138,232,185,306,94,-411,505
362,130000,c6cd4e0e073f5ac2,4,0,818,940,856,987,1387,1606,840,561,1020,602,249,293,271,381,44,-353,397
660,410000,c6cd4e0e073f5ac2,4,0,1237,1242,1377,1416,1736,1669,959,1021,1584,992,320,512,416,608,192,-672,864
341,330000,c6cd4e0e073f5ac2,4,0,706,739,693,717,1019,1203,828,859,1272,386,193,342,268,307,149,-193,342
326,420000,c6cd4e0e073f5ac2,4,0,623,602,550,430,713,769,691,751,1208,523,161,272,216,319,111,-362,473
212,430000,c6cd4e0e073f5ac2,4,0,566,595,580,641,816,847,522,619,891,508,132,232,182,291,100,-376,476
104,350000,c6cd4e0e073f5ac2,4,0,152,204,142,221,243,304,268,291,431,173,74,106,90,118,32,-99,131
101,210000,c6cd4e0e073f5ac2,4,0,229,277,157,228,366,291,139,186,225,91,51,75,63,72,24,-40,64
51,500000,c6cd4e0e073f5ac2,4,0,204,174,226,215,324,310,182,148,242,128,33,53,43,71,20,-95,115
136,610000,c6cd4e0e073f5ac2,4,0,524,533,558,687,656,661,278,275,432,182,64,143,104,130,79,-118,197
28,230000,c6cd4e0e073f5ac2,4,0,100,111,89,97,146,137,83,61,140,53,29,33,31,38,4,-24,28
99,310000,a9a43d1a7ecbe75d,4,0,133,134,134,141,138,161,113,162,163,142,84,128,106,118,44,-58,102
80,530000,a9a43d1a7ecbe75d,4,0,85,86,94,141,123,111,95,152,131,146,84,119,102,116,35,-62,97
87,150000,a9a43d1a7ecbe75d,4,0,64,107,75,84,71,81,97,81,90,83,41,62,52,62,21,-42,63
70,110000,a9a43d1a7ecbe75d,4,0,87,95,97,119,87,131,79,100,123,88,65,74,70,76,9,-23,32
201,510000,a9a43d1a7ecbe75d,4,0,225,215,255,232,227,447,284,279,330,341,184,223,204,249,39,-157,196
150,340000,a9a43d1a7ecbe75d,4,0,119,161,145,138,167,182,170,183,198,254,107,149,128,170,42,-147,189
163,370000,a9a43d1a7ecbe75d,4,0,180,157,181,138,136,198,152,160,191,159,74,162,118,132,88,-85,173
41,140000,a9a43d1a7ecbe75d,4,0,25,37,27,30,36,34,32,31,28,41,25,46,36,37,21,-16,37
387,440000,a9a43d1a7ecbe75d,4,0,345,479,470,487,435,593,541,658,638,568,264,527,396,453,263,-304,567
152,450000,a9a43d1a7ecbe75d,4,0,161,164,160,151,154,208,163,172,213,297,121,197,159,205,76,-176,252
324,320000,a9a43d1a7ecbe75d,4,0,313,360,325,317,361,402,385,402,439,430,213,408,310,350,195,-217,412
76,360000,a9a43d1a7ecbe75d,4,0,44,75,70,82,64,94,87,76,120,103,50,101,76,85,51,-53,104
95,130000,a9a43d1a7ecbe75d,4,0,92,88,94,88,102,92,82,85,95,109,50,116,83,92,66,-59,125
114,410000,a9a43d1a7ecbe75d,4,0,141,117,126,120,123,153,141,134,164,130,78,142,110,117,64,-52,116
317,330000,a9a43d1a7ecbe75d,4,0,287,301,272,322,299,308,339,364,397,466,185,307,246,319,122,-281,403
183,420000,a9a43d1a7ecbe75d,4,0,187,145,190,155,179,232,184,244,236,270,129,200,164,200,71,-141,212
301,430000,a9a43d1a7ecbe75d,4,0,290,293,279,299,298,395,308,355,445,519,215,330,272,355,115,-304,419
88,350000,a9a43d1a7ecbe75d,4,0,69,99,64,92,91,93,87,125,99,145,57,96,76,99,39,-88,127
102,210000,a9a43d1a7ecbe75d,4,0,97,133,116,136,158,194,115,126,155,89,59,109,84,86,50,-30,80
134,500000,a9a43d1a7ecbe75d,4,0,159,135,304,146,146,203,173,179,214,160,89,140,114,130,51,-71,122
212,610000,a9a43d1a7ecbe75d,4,0,190,260,217,273,229,256,263,252,263,274,154,228,191,219,74,-120,194
67,230000,a9a43d1a7ecbe75d,4,0,80,70,81,75,75,68,54,66,57,65,35,91,63,64,56,-30,86
241,310000,3c974920a76ac9c1,5,0,271,235,260,162,265,228,369,374,305,193,309,264,286,255,-45,116,-161
321,530000,3c974920a76ac9c1,5,0,308,279,419,246,217,310,402,456,434,194,302,243,272,246,-59,108,-167
192,150000,3c974920a76ac9c1,5,0,236,164,187,153,157,178,204,219,180,128,201,176,188,168,-25,73,-98
407,110000,3c974920a76ac9c1,5,0,445,351,322,244,337,371,460,563,468,432,472,340,406,415,-132,40,-172
331,510000,3c974920a76ac9c1,5,0,360,329,335,345,623,350,453,570,500,253,378,337,358,323,-41,125,-166
144,340000,3c974920a76ac9c1,5,0,154,138,108,127,159,136,179,226,198,76,132,155,144,121,23,56,-33
450,370000,3c974920a76ac9c1,5,0,482,353,339,259,422,394,483,601,468,290,412,484,448,395,72,122,-50
251,140000,3c974920a76ac9c1,5,0,250,166,178,189,194,233,215,260,248,146,249,182,216,192,-67,103,-170
2754,440000,3c974920a76ac9c1,5,0,2897,2187,2183,1804,2265,2711,3532,3800,2692,1680,2958,2368,2663,2335,-590,1278,-1868
377,450000,3c974920a76ac9c1,5,0,363,291,276,249,267,349,472,505,425,248,383,277,330,303,-106,135,-241
720,320000,3c974920a76ac9c1,5,0,780,561,554,569,631,764,871,1010,800,486,817,617,717,640,-200,331,-531
186,360000,3c974920a76ac9c1,5,0,167,149,136,95,156,166,204,262,236,78,191,154,172,141,-37,113,-150
328,130000,3c974920a76ac9c1,5,0,280,252,227,235,225,228,291,305,260,190,297,311,304,266,14,107,-93
307,410000,3c974920a76ac9c1,5,0,313,330,384,256,301,351,521,505,405,250,355,393,374,333,38,105,-67
562,330000,3c974920a76ac9c1,5,0,638,453,457,422,545,702,660,865,633,409,621,561,591,530,-60,212,-272
403,420000,3c974920a76ac9c1,5,0,357,440,329,325,381,447,480,474,497,228,445,423,434,365,-22,217,-239
284,430000,3c974920a76ac9c1,5,0,308,275,250,286,299,327,364,474,347,174,297,304,300,258,7,123,-116
324,350000,3c974920a76ac9c1,5,0,307,223,276,226,258,368,331,404,292,181,307,209,258,232,-98,126,-224
738,210000,3c974920a76ac9c1,5,0,900,645,700,556,721,769,941,997,650,566,775,692,734,678,-83,209,-292
119,500000,3c974920a76ac9c1,5,0,114,181,131,111,101,120,155,199,115,72,126,107,116,102,-19,54,-73
328,610000,3c974920a76ac9c1,5,0,414,206,262,204,187,324,393,440,305,219,295,292,294,269,-3,76,-79
324,230000,3c974920a76ac9c1,5,0,398,288,194,351,302,310,458,461,292,234,401,305,353,313,-96,167,-263
383,310000,3d7554f1f56dd664,5,0,349,376,356,410,417,271,639,518,268,263,442,321,382,342,-121,179,-300
415,530000,3d7554f1f56dd664,5,0,290,259,337,266,368,334,609,519,292,264,403,325,364,331,-78,139,-217
258,150000,3d7554f1f56dd664,5,0,270,175,231,216,208,216,370,337,175,149,316,260,288,242,-56,167,-223
376,110000,3d7554f1f56dd664,5,0,406,405,459,464,449,231,675,811,368,359,470,369,420,399,-101,111,-212
679,510000,3d7554f1f56dd664,5,0,701,656,684,758,1227,469,1053,1125,657,560,806,700,753,689,-106,246,-352
350,340000,3d7554f1f56dd664,5,0,224,252,293,358,325,253,574,507,301,225,317,315,316,286,-2,92,-94
1119,370000,3d7554f1f56dd664,5,0,977,862,990,917,1222,876,1567,1574,775,729,1060,1229,1144,1006,169,331,-162
384,140000,3d7554f1f56dd664,5,0,339,253,284,382,372,320,590,571,290,239,407,358,382,335,-49,168,-217
8990,440000,3d7554f1f56dd664,5,0,9327,8266,8709,10596,10140,6925,13598,11515,5136,4688,10371,8733,9552,7931,-1638,5683,-7321
939,450000,3d7554f1f56dd664,5,0,835,723,792,866,969,642,1386,1258,750,559,1074,832,953,822,-242,515,-757
1916,320000,3d7554f1f56dd664,5,0,2026,1678,1827,2216,2075,1763,3112,2877,1445,1635,2184,1828,2006,1882,-356,549,-905
483,360000,3d7554f1f56dd664,5,0,396,344,400,420,535,356,595,741,435,311,545,463,504,440,-82,234,-316
993,130000,3d7554f1f56dd664,5,0,633,520,604,569,722,520,1137,974,498,486,847,1025,936,786,178,361,-183
932,410000,3d7554f1f56dd664,5,0,673,695,718,785,808,565,1273,1234,645,486,968,944,956,799,-24,482,-506
1919,330000,3d7554f1f56dd664,5,0,1625,1420,1737,1785,1658,1293,2709,2467,1135,1205,1969,1744,1856,1639,-225,764,-989
699,420000,3d7554f1f56dd664,5,0,668,835,675,883,908,742,1001,1050,703,508,734,619,676,620,-115,226,-341
748,430000,3d7554f1f56dd664,5,0,657,625,567,721,958,582,1112,1192,689,445,769,687,728,634,-82,324,-406
1494,350000,3d7554f1f56dd664,5,0,1467,1202,1533,1388,1310,817,2205,1578,856,899,1607,1181,1394,1229,-426,708,-1134
1784,210000,3d7554f1f56dd664,5,0,2279,1544,2253,2301,1915,1064,2892,2161,1110,1306,1905,1837,1871,1683,-68,599,-667
240,500000,3d7554f1f56dd664,5,0,199,327,300,319,331,173,470,398,244,215,285,259,272,253,-26,70,-96
466,610000,3d7554f1f56dd664,5,0,486,412,553,492,462,375,582,607,340,260,369,435,402,355,66,109,-43
827,230000,3d7554f1f56dd664,5,0,765,687,670,1107,843,480,1076,1018,447,521,1186,639,912,782,-547,665,-1212
155,310000,2d0d2c3403909fdb,5,0,219,211,160,159,169,112,163,167,157,101,187,162,174,150,-25,86,-111
236,530000,2d0d2c3403909fdb,5,0,265,254,351,309,270,218,354,350,290,213,293,226,260,244,-67,80,-147
255,150000,2d0d2c3403909fdb,5,0,261,237,261,246,234,155,184,233,279,174,228,241,234,214,13,54,-41
389,110000,2d0d2c3403909fdb,5,0,627,552,633,554,583,457,611,677,549,387,627,524,576,513,-103,240,-343
370,510000,2d0d2c3403909fdb,5,0,372,413,373,319,387,300,411,434,516,235,377,355,366,322,-22,142,-164
129,340000,2d0d2c3403909fdb,5,0,119,126,118,108,157,129,128,138,176,83,127,116,122,109,-11,44,-55
323,370000,2d0d2c3403909fdb,5,0,345,393,358,328,376,327,415,400,420,235,353,334,344,307,-19,118,-137
157,140000,2d0d2c3403909fdb,5,0,165,161,170,152,135,111,141,197,179,103,189,173,181,155,-16,86,-102
1581,440000,2d0d2c3403909fdb,5,0,1652,1649,1691,1490,1683,1421,1989,1829,1713,1159,1738,1536,1637,1478,-202,579,-781
174,450000,2d0d2c3403909fdb,5,0,187,179,178,141,192,165,181,173,211,121,197,149,173,156,-48,76,-124
375,320000,2d0d2c3403909fdb,5,0,413,417,373,340,401,333,437,427,470,296,446,386,416,376,-60,150,-210
112,360000,2d0d2c3403909fdb,5,0,119,89,94,84,108,90,107,109,126,55,113,112,112,93,-1,58,-59
437,130000,2d0d2c3403909fdb,5,0,305,302,324,321,309,274,302,328,389,251,371,364,368,329,-7,120,-127
338,410000,2d0d2c3403909fdb,5,0,298,340,309,300,327,262,352,337,377,202,331,306,318,280,-25,129,-154
366,330000,2d0d2c3403909fdb,5,0,357,351,316,352,336,342,428,424,401,264,349,335,342,316,-14,85,-99
230,420000,2d0d2c3403909fdb,5,0,242,268,203,201,303,211,267,280,321,189,271,255,263,238,-16,82,-98
250,430000,2d0d2c3403909fdb,5,0,248,277,255,193,250,211,244,275,284,146,275,262,268,228,-13,129,-142
111,350000,2d0d2c3403909fdb,5,0,113,128,123,95,124,106,151,157,167,81,107,85,96,91,-22,26,-48
489,210000,2d0d2c3403909fdb,5,0,542,501,506,466,488,346,464,567,506,316,529,433,481,426,-96,213,-309
168,500000,2d0d2c3403909fdb,5,0,156,186,166,134,169,138,184,155,213,116,188,148,168,151,-40,72,-112
280,610000,2d0d2c3403909fdb,5,0,271,255,273,253,271,195,252,267,297,206,288,291,290,262,3,82,-79
240,230000,2d0d2c3403909fdb,5,0,357,324,293,304,239,208,258,336,315,155,306,267,286,243,-39,151,-190
161,310000,a28bb927b6fcb33c,5,0,251,282,229,249,216,166,212,210,117,96,135,131,133,121,-4,39,-43
191,530000,a28bb927b6fcb33c,5,0,154,116,231,232,256,209,270,308,173,110,159,185,172,151,26,49,-23
139,150000,a28bb927b6fcb33c,5,0,123,97,118,134,193,128,165,176,89,72,136,148,142,119,12,64,-52
96,110000,a28bb927b6fcb33c,5,0,237,267,308,309,286,179,246,342,136,109,179,166,172,151,-13,70,-83
290,510000,a28bb927b6fcb33c,5,0,430,414,426,492,712,401,438,436,351,212,361,425,393,333,64,149,-85
203,340000,a28bb927b6fcb33c,5,0,261,218,300,368,358,250,325,348,264,151,204,182,193,179,-22,53,-75
449,370000,a28bb927b6fcb33c,5,0,405,407,399,489,606,454,468,556,225,175,357,467,412,333,110,182,-72
165,140000,a28bb927b6fcb33c,5,0,124,127,123,233,187,181,144,181,92,70,148,181,164,133,33,78,-45
3668,440000,a28bb927b6fcb33c,5,0,3840,3624,4020,4618,5211,4012,4216,4195,2391,1639,3992,3988,3990,3206,-4,2353,-2357
434,450000,a28bb927b6fcb33c,5,0,350,329,360,409,444,331,432,386,248,166,443,418,430,342,-25,277,-302
1051,320000,a28bb927b6fcb33c,5,0,888,876,892,1148,1130,943,1033,1154,680,651,982,1039,1010,891,57,331,-274
298,360000,a28bb927b6fcb33c,5,0,221,210,194,288,380,260,302,351,208,96,254,328,291,226,74,158,-84
485,130000,a28bb927b6fcb33c,5,0,423,480,475,550,584,385,397,419,248,284,584,570,577,479,-14,300,-314
439,410000,a28bb927b6fcb33c,5,0,371,468,562,658,673,556,567,651,338,242,578,638,608,486,60,336,-276
1200,330000,a28bb927b6fcb33c,5,0,1012,1006,1138,1244,1296,1228,1343,1310,747,739,1438,1404,1421,1194,-34,699,-733
468,420000,a28bb927b6fcb33c,5,0,457,595,544,655,744,726,677,787,450,226,461,459,460,382,-2,235,-237
554,430000,a28bb927b6fcb33c,5,0,476,494,503,610,619,436,474,674,394,223,436,554,495,404,118,213,-95
676,350000,a28bb927b6fcb33c,5,0,506,417,546,535,615,563,615,519,231,173,535,612,574,440,77,362,-285
562,210000,a28bb927b6fcb33c,5,0,665,803,867,1031,840,522,652,848,213,233,610,646,628,496,36,377,-341
116,500000,a28bb927b6fcb33c,5,0,200,348,324,316,208,150,157,208,123,85,166,157,162,136,-9,81,-90
221,610000,a28bb927b6fcb33c,5,0,239,237,272,274,262,219,225,317,148,105,202,242,222,183,40,97,-57
241,230000,a28bb927b6fcb33c,5,0,255,248,232,335,334,222,288,303,90,85,233,244,238,187,11,148,-137
193,310000,17bc272c93f19d56,5,0,202,234,212,256,234,168,249,477,199,177,267,169,218,204,-98,90,-188
2227,530000,17bc272c93f19d56,5,0,2397,2353,2868,2565,3307,3096,3216,4503,4785,3067,2754,2281,2518,2701,-473,-313,-160
440,150000,17bc272c93f19d56,5,0,361,329,346,368,502,360,520,675,504,451,680,487,584,539,-193,229,-422
132,110000,17bc272c93f19d56,5,0,278,163,179,202,242,199,305,514,151,92,197,124,160,138,-73,105,-178
1021,510000,17bc272c93f19d56,5,0,1064,1118,1183,1230,1449,1007,1411,1954,1724,1537,1481,1090,1286,1369,-391,-56,-335
1266,340000,17bc272c93f19d56,5,0,1396,1210,1260,1418,1458,1238,1535,2328,2152,1881,1518,1284,1401,1561,-234,-363,129
2879,370000,17bc272c93f19d56,5,0,3587,2963,3398,3600,3519,3268,3907,6576,4483,3060,2839,2545,2692,2815,-294,-221,-73
1259,140000,17bc272c93f19d56,5,0,1493,1193,1334,1452,1749,1354,1585,2844,2093,1361,1353,1118,1236,1277,-235,-8,-227
1684,440000,17bc272c93f19d56,5,0,1820,1577,1457,1550,1999,1555,2007,3029,1611,1579,2180,1684,1932,1814,-496,601,-1097
1616,450000,17bc272c93f19d56,5,0,2371,1991,2051,2291,2515,2293,2687,4443,3084,1836,2310,1540,1925,1895,-770,474,-1244
1578,320000,17bc272c93f19d56,5,0,1679,1539,1776,1799,1764,1493,1942,3067,2165,2419,2029,1601,1815,2016,-428,-390,-38
648,360000,17bc272c93f19d56,5,0,1066,892,885,890,1111,824,980,1510,1290,922,875,668,772,822,-207,-47,-160
3119,130000,17bc272c93f19d56,5,0,2960,2437,2748,3368,3303,2808,3641,6231,3870,3403,2945,3015,2980,3121,70,-458,528
2715,410000,17bc272c93f19d56,5,0,3967,3302,3413,3591,3584,3821,4668,7650,5825,3564,3197,2704,2950,3155,-493,-367,-126
1224,330000,17bc272c93f19d56,5,0,1216,1213,1206,1016,1295,1112,1294,2062,1260,1629,1592,1156,1374,1459,-436,-37,-399
1069,420000,17bc272c93f19d56,5,0,1221,954,900,992,1202,958,1353,2198,1919,1140,1262,895,1078,1099,-367,122,-489
1020,430000,17bc272c93f19d56,5,0,1715,1491,1500,1678,1773,1354,1770,2693,2364,1506,1541,1174,1358,1407,-367,35,-402
546,350000,17bc272c93f19d56,5,0,576,545,512,565,573,523,688,892,592,650,741,463,602,618,-278,91,-369
988,210000,17bc272c93f19d56,5,0,1170,1034,1023,1010,1135,824,1154,1710,924,939,1322,959,1140,1073,-363,383,-746
191,500000,17bc272c93f19d56,5,0,258,225,203,204,284,201,250,357,250,248,235,212,224,232,-23,-13,-10
1105,610000,17bc272c93f19d56,5,0,1213,1083,1173,1245,1658,1590,1877,3217,2072,1105,1314,1222,1268,1214,-92,209,-301
585,230000,17bc272c93f19d56,5,0,736,776,785,835,795,518,816,982,506,518,806,657,732,660,-149,288,-437
285,310000,2a2ab41f8f6ff1cb,5,0,232,330,331,445,555,272,582,623,382,114,351,229,290,231,-122,237,-359
419,530000,2a2ab41f8f6ff1cb,5,0,327,333,428,409,543,553,546,680,484,300,452,403,428,385,-49,152,-201
604,150000,2a2ab41f8f6ff1cb,5,0,638,517,552,645,831,715,836,832,551,317,489,505,497,437,16,172,-156
124,110000,2a2ab41f8f6ff1cb,5,0,324,331,345,369,502,362,440,598,212,102,180,142,161,141,-38,78,-116
838,510000,2a2ab41f8f6ff1cb,5,0,961,1004,1032,1165,1460,1050,1385,1850,1223,671,850,790,820,770,-60,179,-239
1077,340000,2a2ab41f8f6ff1cb,5,0,934,1047,1058,1409,1565,1256,1491,1666,1515,717,1018,980,999,905,-38,301,-339
2031,370000,2a2ab41f8f6ff1cb,5,0,1635,1575,1773,2139,2580,2061,2146,2737,1706,842,1734,1902,1818,1493,168,892,-724
569,140000,2a2ab41f8f6ff1cb,5,0,477,430,532,655,690,724,762,993,533,312,595,582,588,496,-13,283,-296
5717,440000,2a2ab41f8f6ff1cb,5,0,5187,5010,5237,6544,8215,6582,6734,6492,5607,2647,5713,4896,5304,4419,-817,3066,-3883
603,450000,2a2ab41f8f6ff1cb,5,0,589,632,639,680,913,743,853,894,799,409,719,453,586,527,-266,310,-576
1701,320000,2a2ab41f8f6ff1cb,5,0,1717,1679,1859,2252,2410,2283,2584,2672,1728,1016,1729,1498,1614,1414,-231,713,-944
838,360000,2a2ab41f8f6ff1cb,5,0,761,704,848,964,1340,1065,1086,1291,1027,356,690,687,688,578,-3,334,-337
2863,130000,2a2ab41f8f6ff1cb,5,0,1808,1966,2293,2864,3253,2277,2327,2703,2119,1271,2126,2486,2306,1961,360,855,-495
2841,410000,2a2ab41f8f6ff1cb,5,0,2169,2264,2690,3318,3446,2827,2797,3447,2952,1308,2514,2566,2540,2129,52,1206,-1154
1141,330000,2a2ab41f8f6ff1cb,5,0,949,928,974,1151,1369,1262,1632,1972,795,459,876,905,890,747,29,417,-388
1047,420000,2a2ab41f8f6ff1cb,5,0,1027,1207,1181,1412,1938,1686,1663,2151,1566,597,1095,1029,1062,907,-66,498,-564
1636,430000,2a2ab41f8f6ff1cb,5,0,1570,1605,1889,1918,2573,2247,1966,2770,1651,844,1487,1573,1530,1301,86,643,-557
427,350000,2a2ab41f8f6ff1cb,5,0,292,259,301,348,390,371,447,476,264,148,314,267,290,243,-47,166,-213
362,210000,2a2ab41f8f6ff1cb,5,0,311,261,323,369,397,317,403,513,241,211,360,293,326,288,-67,149,-216
543,500000,2a2ab41f8f6ff1cb,5,0,585,806,750,810,888,646,803,1149,803,328,472,453,462,418,-19,144,-163
551,610000,2a2ab41f8f6ff1cb,5,0,387,403,502,566,687,665,655,845,620,247,468,497,482,404,29,221,-192
585,230000,2a2ab41f8f6ff1cb,5,0,550,570,602,652,669,544,740,1032,399,306,506,449,478,420,-57,200,-257
1184,310000,c06a2a387c0ee510,5,0,1124,945,1154,1068,958,710,977,1212,1265,890,1247,1119,1183,1085,-128,357,-485
132,530000,c06a2a387c0ee510,5,0,124,99,83,62,79,45,66,119,104,63,214,133,174,137,-81,151,-232
164,150000,c06a2a387c0ee510,5,0,51,85,56,51,54,43,56,75,86,64,154,131,142,116,-23,90,-113
1430,110000,c06a2a387c0ee510,5,0,926,824,1014,976,1027,677,793,1627,1352,1114,1508,1132,1320,1251,-376,394,-770
308,510000,c06a2a387c0ee510,5,0,175,144,210,234,199,102,145,321,208,187,254,335,294,259,81,67,14
315,340000,c06a2a387c0ee510,5,0,155,149,157,167,182,145,176,251,253,175,322,340,331,279,18,147,-129
1216,370000,c06a2a387c0ee510,5,0,614,644,701,698,710,494,739,1047,878,649,1303,1248,1276,1067,-55,654,-709
272,140000,c06a2a387c0ee510,5,0,90,115,93,101,121,83,105,184,165,123,244,320,282,229,76,121,-45
1025,440000,c06a2a387c0ee510,5,0,557,511,479,453,514,463,571,819,762,448,944,1100,1022,831,156,496,-340
119,450000,c06a2a387c0ee510,5,0,32,27,46,65,36,87,45,96,92,54,103,134,118,97,31,49,-18
1048,320000,c06a2a387c0ee510,5,0,786,664,704,653,923,563,731,1002,974,650,1188,1289,1238,1042,101,538,-437
153,360000,c06a2a387c0ee510,5,0,79,54,83,56,89,43,74,97,118,85,164,140,152,130,-24,79,-103
769,130000,c06a2a387c0ee510,5,0,232,241,288,302,284,232,288,493,470,361,599,660,630,540,61,238,-177
685,410000,c06a2a387c0ee510,5,0,376,374,353,356,387,282,366,596,517,345,763,731,747,613,-32,418,-450
865,330000,c06a2a387c0ee510,5,0,382,390,895,578,350,278,533,736,534,424,754,915,834,698,161,330,-169
187,420000,c06a2a387c0ee510,5,0,123,130,108,119,115,66,94,173,151,103,240,253,246,199,13,137,-124
182,430000,c06a2a387c0ee510,5,0,72,59,68,91,68,60,83,119,101,59,203,163,183,142,-40,144,-184
187,350000,c06a2a387c0ee510,5,0,92,103,107,123,99,106,97,170,123,106,206,303,254,205,97,100,-3
363,210000,c06a2a387c0ee510,5,0,153,169,211,178,184,111,151,300,181,154,357,324,340,278,-33,203,-236
128,500000,c06a2a387c0ee510,5,0,65,63,75,66,120,43,58,100,60,71,130,181,156,127,51,59,-8
340,610000,c06a2a387c0ee510,5,0,153,156,195,228,164,136,164,313,234,179,320,305,312,268,-15,141,-156
255,230000,c06a2a387c0ee510,5,0,69,65,102,113,130,76,95,177,129,74,323,185,254,194,-138,249,-387
527,310000,7023efdab9cedc03,5,0,484,494,547,504,605,431,543,697,325,168,288,309,298,255,21,120,-99
68,530000,7023efdab9cedc03,5,0,70,56,86,60,80,64,106,112,40,25,38,54,46,39,16,13,3
51,150000,7023efdab9cedc03,5,0,70,55,54,65,50,48,60,75,31,18,29,46,38,31,17,11,6
54,110000,7023efdab9cedc03,5,0,131,96,96,105,107,59,86,132,40,51,59,50,54,53,-9,8,-17
229,510000,7023efdab9cedc03,5,0,211,185,192,194,379,187,278,408,216,117,192,175,184,161,-17,75,-92
368,340000,7023efdab9cedc03,5,0,352,304,284,383,452,363,447,587,357,148,207,278,242,211,71,59,12
374,370000,7023efdab9cedc03,5,0,512,403,384,434,524,437,477,555,320,180,373,400,386,318,27,193,-166
44,140000,7023efdab9cedc03,5,0,84,53,53,40,61,59,55,64,30,23,28,38,33,30,10,5,5
211,440000,7023efdab9cedc03,5,0,274,225,205,191,284,225,342,408,121,39,166,158,162,121,-8,127,-135
71,450000,7023efdab9cedc03,5,0,81,56,48,72,86,66,86,129,68,34,47,50,48,44,3,13,-10
1067,320000,7023efdab9cedc03,5,0,1261,881,934,1240,1311,1156,1271,1767,893,628,788,879,834,765,91,160,-69
202,360000,7023efdab9cedc03,5,0,252,167,187,201,205,175,224,302,169,92,161,188,174,147,27,69,-42
163,130000,7023efdab9cedc03,5,0,145,156,130,129,149,129,127,215,80,56,93,108,100,86,15,37,-22
340,410000,7023efdab9cedc03,5,0,264,222,222,264,300,257,320,368,183,97,185,329,257,204,144,88,56
775,330000,7023efdab9cedc03,5,0,793,638,611,791,867,742,941,1163,445,309,478,511,494,433,33,169,-136
195,420000,7023efdab9cedc03,5,0,209,221,204,189,253,233,287,401,211,94,172,184,178,150,12,78,-66
198,430000,7023efdab9cedc03,5,0,228,177,169,202,213,182,259,315,201,83,173,167,170,141,-6,90,-96
114,350000,7023efdab9cedc03,5,0,97,66,59,77,86,70,117,145,54,20,51,78,64,50,27,31,-4
45,210000,7023efdab9cedc03,5,0,79,56,94,56,78,81,68,104,28,21,52,82,67,52,30,31,-1
33,500000,7023efdab9cedc03,5,0,37,61,45,63,77,40,57,62,28,20,37,37,37,31,0,17,-17
124,610000,7023efdab9cedc03,5,0,156,96,102,126,137,141,113,177,107,51,78,83,80,71,5,27,-22
20,230000,7023efdab9cedc03,5,0,45,25,30,29,39,29,28,30,11,11,8,18,13,12,10,-3,13
919,310000,af6f4f548684e14d,5,0,925,835,829,878,839,851,1537,1734,940,540,957,807,882,768,-150,417,-567
327,530000,af6f4f548684e14d,5,0,370,297,444,406,375,464,639,732,400,288,346,301,324,312,-45,58,-103
363,150000,af6f4f548684e14d,5,0,427,288,345,346,426,433,493,573,322,195,323,333,328,284,10,128,-118
595,110000,af6f4f548684e14d,5,0,621,593,551,572,648,532,915,1057,659,394,601,489,545,495,-112,207,-319
808,510000,af6f4f548684e14d,5,0,835,754,816,821,1394,1020,1293,1876,1072,611,873,761,817,748,-112,262,-374
769,340000,af6f4f548684e14d,5,0,749,648,689,782,938,1018,1287,1597,1015,457,773,664,718,631,-109,316,-425
1215,370000,af6f4f548684e14d,5,0,1314,1119,1240,1232,1497,1547,1722,2394,1077,522,1253,1236,1244,1004,-17,731,-748
404,140000,af6f4f548684e14d,5,0,462,359,317,365,407,489,581,742,375,248,450,310,380,336,-140,202,-342
976,440000,af6f4f548684e14d,5,0,1092,904,1023,986,1197,1508,2163,2594,949,463,1024,892,958,793,-132,561,-693
345,450000,af6f4f548684e14d,5,0,320,307,308,261,338,373,502,713,341,210,322,222,272,251,-100,112,-212
1355,320000,af6f4f548684e14d,5,0,1459,1195,1141,1497,1413,1635,2059,2647,1466,939,1519,1181,1350,1213,-338,580,-918
837,360000,af6f4f548684e14d,5,0,757,635,717,687,798,900,1083,1527,753,397,757,746,752,633,-11,360,-371
773,130000,af6f4f548684e14d,5,0,817,660,609,745,771,828,1012,1235,691,404,655,694,674,584,39,251,-212
903,410000,af6f4f548684e14d,5,0,951,899,929,998,1228,1191,1470,2122,1000,589,1119,1013,1066,907,-106,530,-636
1015,330000,af6f4f548684e14d,5,0,926,862,813,942,1042,1090,1626,2068,1003,537,978,796,887,770,-182,441,-623
1015,420000,af6f4f548684e14d,5,0,947,966,785,977,1135,1284,1519,1632,1025,485,1058,873,966,805,-185,573,-758
1084,430000,af6f4f548684e14d,5,0,1061,902,924,1034,1175,1168,1619,2178,1217,467,1068,962,1015,832,-106,601,-707
497,350000,af6f4f548684e14d,5,0,473,273,417,426,426,568,767,913,522,257,433,373,403,354,-60,176,-236
290,210000,af6f4f548684e14d,5,0,363,316,315,365,365,407,443,594,254,172,277,329,303,259,52,105,-53
324,500000,af6f4f548684e14d,5,0,291,407,357,329,386,354,500,762,420,252,342,321,332,305,-21,90,-111
357,610000,af6f4f548684e14d,5,0,383,263,316,283,360,444,478,651,365,184,306,238,272,243,-68,122,-190
231,230000,af6f4f548684e14d,5,0,288,202,213,233,201,203,289,372,142,121,207,187,197,172,-20,86,-106
1137,310000,7cf283430b3b5e38,5,0,1398,1353,1616,1715,1560,1261,1546,1428,635,513,975,1070,1022,853,95,462,-367
408,530000,7cf283430b3b5e38,5,0,335,298,451,462,412,350,412,626,249,167,333,316,324,272,-17,166,-183
439,150000,7cf283430b3b5e38,5,0,432,328,313,335,434,451,516,701,285,178,320,330,325,276,10,142,-132
453,110000,7cf283430b3b5e38,5,0,280,232,247,248,278,174,264,913,106,74,113,101,107,96,-12,39,-51
1649,510000,7cf283430b3b5e38,5,0,1713,1549,1800,1833,2351,1555,1783,2691,1134,763,1522,1501,1512,1262,-21,759,-780
2171,340000,7cf283430b3b5e38,5,0,2005,1957,2071,2572,2578,2110,2138,2356,1607,968,1908,2068,1988,1648,160,940,-780
4223,370000,7cf283430b3b5e38,5,0,3723,2665,3185,3623,4079,3911,3787,4830,2048,1323,3138,3779,3458,2747,641,1815,-1174
883,140000,7cf283430b3b5e38,5,0,695,612,635,770,774,678,852,1073,317,283,629,610,620,507,-19,346,-365
1848,440000,7cf283430b3b5e38,5,0,2151,1841,2105,2230,2219,1912,2435,2500,695,488,1495,1512,1504,1165,17,1007,-990
830,450000,7cf283430b3b5e38,5,0,605,509,467,597,723,646,783,869,475,293,738,554,646,528,-184,445,-629
4704,320000,7cf283430b3b5e38,5,0,5237,4119,4343,5439,5089,5170,5016,5865,2657,2401,4119,4083,4101,3534,-36,1718,-1754
1895,360000,7cf283430b3b5e38,5,0,1339,997,1282,1228,1446,1175,1376,1737,923,549,1502,1828,1665,1293,326,953,-627
2809,130000,7cf283430b3b5e38,5,0,1915,1717,1730,2030,2166,1672,1926,2621,900,720,1379,2198,1788,1432,819,659,160
3067,410000,7cf283430b3b5e38,5,0,2148,2124,2569,3033,2794,2644,2874,3243,1683,1042,2558,3199,2878,2266,641,1516,-875
2506,330000,7cf283430b3b5e38,5,0,3027,2635,2644,3079,3258,3003,3295,3490,1289,1038,1965,1876,1920,1626,-89,927,-1016
1437,420000,7cf283430b3b5e38,5,0,1354,1346,1388,1694,1779,1500,1547,1624,929,480,1234,1278,1256,997,44,754,-710
1696,430000,7cf283430b3b5e38,5,0,1556,1388,1464,1556,1793,1457,1585,1952,989,516,1513,1616,1564,1215,103,997,-894
1319,350000,7cf283430b3b5e38,5,0,1147,600,1040,913,859,836,1130,958,546,402,859,878,868,713,19,457,-438
474,210000,7cf283430b3b5e38,5,0,553,466,570,710,667,540,619,821,205,149,446,498,472,364,52,297,-245
429,500000,7cf283430b3b5e38,5,0,344,487,446,463,501,422,419,597,296,163,296,401,348,287,105,133,-28
883,610000,7cf283430b3b5e38,5,0,717,590,762,830,880,891,912,1151,413,242,475,689,582,469,214,233,-19
254,230000,7cf283430b3b5e38,5,0,391,233,247,332,298,250,347,415,118,130,301,193,247,208,-108,171,-279
103,310000,d4efbebb087fd03f,5,0,132,121,130,170,225,144,225,270,79,27,45,95,70,56,50,18,32
231,530000,d4efbebb087fd03f,5,0,150,124,141,193,215,192,267,384,296,172,285,192,238,216,-93,113,-206
178,150000,d4efbebb087fd03f,5,0,180,155,165,211,257,237,359,450,248,124,211,203,207,179,-8,87,-95
1106,110000,d4efbebb087fd03f,5,0,671,764,635,596,755,684,938,1287,118,74,556,952,754,527,396,482,-86
702,510000,d4efbebb087fd03f,5,0,754,743,840,1135,1134,707,1002,2805,1326,797,891,676,784,788,-215,94,-309
582,340000,d4efbebb087fd03f,5,0,431,427,626,807,752,716,977,1443,903,436,535,520,528,497,-15,99,-114
1488,370000,d4efbebb087fd03f,5,0,1432,1325,1510,2013,2253,1752,2198,3785,1878,1009,1343,1575,1459,1309,232,334,-102
574,140000,d4efbebb087fd03f,5,0,383,273,396,591,635,370,1993,2925,603,248,417,464,440,376,47,169,-122
1082,440000,d4efbebb087fd03f,5,0,1203,1183,1216,1851,1526,1065,2044,2419,914,399,1078,1095,1086,857,17,679,-662
512,450000,d4efbebb087fd03f,5,0,385,389,373,565,452,368,493,935,666,303,492,403,448,399,-89,189,-278
985,320000,d4efbebb087fd03f,5,0,1057,971,1038,1263,1231,1184,1531,2308,910,648,752,1041,896,814,289,104,185
555,360000,d4efbebb087fd03f,5,0,546,479,591,657,831,701,917,1377,999,364,509,561,535,478,52,145,-93
1002,130000,d4efbebb087fd03f,5,0,696,616,754,991,941,754,1144,2067,1110,641,741,953,847,778,212,100,112
1368,410000,d4efbebb087fd03f,5,0,1258,1321,1528,1922,1491,1090,1965,3560,2272,888,1199,1423,1311,1170,224,311,-87
2340,330000,d4efbebb087fd03f,5,0,1718,1900,1877,2534,1978,2287,3147,4324,1028,639,1114,1097,1106,950,-17,475,-492
410,420000,d4efbebb087fd03f,5,0,420,475,487,636,528,521,941,1534,1004,347,476,456,466,426,-20,129,-149
650,430000,d4efbebb087fd03f,5,0,1034,885,1014,1148,1102,762,1142,1719,1133,438,685,688,686,604,3,247,-244
712,350000,d4efbebb087fd03f,5,0,665,596,710,861,605,468,762,1967,434,268,656,565,610,496,-91,388,-479
188,210000,d4efbebb087fd03f,5,0,189,242,328,373,319,239,291,520,199,149,205,202,204,185,-3,56,-59
302,500000,d4efbebb087fd03f,5,0,265,352,383,500,317,253,326,532,432,291,409,310,360,337,-99,118,-217
587,610000,d4efbebb087fd03f,5,0,669,670,984,1191,1013,830,1010,1651,919,422,609,612,610,548,3,187,-184
104,230000,d4efbebb087fd03f,5,0,102,96,114,179,154,114,204,257,135,104,114,128,121,115,14,10,4
45,310000,7245e0ee27b195cd,5,0,61,91,84,82,78,75,125,158,63,40,60,51,56,50,-9,20,-29
252,530000,7245e0ee27b195cd,5,0,229,212,242,297,409,425,375,535,421,246,288,240,264,258,-48,42,-90
180,150000,7245e0ee27b195cd,5,0,157,141,155,186,321,287,448,676,363,164,250,212,231,209,-38,86,-124
71,110000,7245e0ee27b195cd,5,0,142,166,192,229,328,289,360,496,86,74,109,80,94,88,-29,35,-64
535,510000,7245e0ee27b195cd,5,0,502,542,612,740,894,870,831,1260,724,451,621,526,574,533,-95,170,-265
316,340000,7245e0ee27b195cd,5,0,327,272,360,423,570,478,510,806,576,272,358,315,336,315,-43,86,-129
1025,370000,7245e0ee27b195cd,5,0,950,814,1067,1385,1544,1660,1778,2915,1529,762,977,1071,1024,937,94,215,-121
590,140000,7245e0ee27b195cd,5,0,438,304,387,526,657,689,668,1092,615,366,578,543,560,496,-35,212,-247
734,440000,7245e0ee27b195cd,5,0,800,706,726,1003,987,1170,1384,1437,718,363,821,836,828,673,15,458,-443
292,450000,7245e0ee27b195cd,5,0,244,215,205,275,336,321,463,659,452,233,370,288,329,297,-82,137,-219
406,320000,7245e0ee27b195cd,5,0,417,417,424,503,619,691,743,1008,543,405,518,460,489,461,-58,113,-171
331,360000,7245e0ee27b195cd,5,0,324,321,323,384,576,518,577,816,634,247,323,301,312,290,-22,76,-98
1210,130000,7245e0ee27b195cd,5,0,897,796,976,1190,1442,1308,1432,2365,1304,951,1023,1070,1046,1015,47,72,-25
823,410000,7245e0ee27b195cd,5,0,796,796,921,1180,1362,1148,1406,2228,1526,717,888,888,888,831,0,171,-171
520,330000,7245e0ee27b195cd,5,0,599,497,546,656,656,660,874,1121,438,306,511,460,486,426,-51,205,-256
325,420000,7245e0ee27b195cd,5,0,316,308,353,445,594,534,655,903,635,255,364,342,353,320,-22,109,-131
540,430000,7245e0ee27b195cd,5,0,590,570,561,665,852,609,763,1216,773,321,479,531,505,444,52,158,-106
252,350000,7245e0ee27b195cd,5,0,185,203,218,279,280,218,239,420,249,153,274,195,234,207,-79,121,-200
279,210000,7245e0ee27b195cd,5,0,276,253,308,361,450,328,514,641,287,222,321,326,324,290,5,99,-94
233,500000,7245e0ee27b195cd,5,0,187,221,263,289,325,272,292,402,296,142,238,207,222,196,-31,96,-127
492,610000,7245e0ee27b195cd,5,0,446,383,562,667,705,729,755,1158,815,410,484,484,484,459,0,74,-74
183,230000,7245e0ee27b195cd,5,0,155,141,189,179,249,176,328,336,166,145,205,161,183,170,-44,60,-104
145,310000,8c915fe4632fb9fa,5,0,156,130,143,149,181,158,314,461,180,102,190,125,158,139,-65,88,-153
682,530000,8c915fe4632fb9fa,5,0,336,248,387,336,447,627,757,1396,1059,575,778,650,714,668,-128,203,-331
472,150000,8c915fe4632fb9fa,5,0,165,174,186,216,287,324,527,720,520,270,473,409,441,384,-64,203,-267
117,110000,8c915fe4632fb9fa,5,0,99,100,137,177,237,199,242,487,101,86,162,127,144,125,-35,76,-111
1192,510000,8c915fe4632fb9fa,5,0,759,618,741,845,1263,1243,1605,2433,1860,1194,1302,1156,1229,1217,-146,108,-254
934,340000,8c915fe4632fb9fa,5,0,561,546,651,840,1069,1269,1370,2298,1440,720,878,861,870,820,-17,158,-175
1956,370000,8c915fe4632fb9fa,5,0,723,768,927,999,1485,1686,2126,3804,2217,1109,1504,1812,1658,1475,308,395,-87
732,140000,8c915fe4632fb9fa,5,0,255,224,271,379,496,642,748,1215,772,404,591,661,626,552,70,187,-117
948,440000,8c915fe4632fb9fa,5,0,600,502,550,650,835,848,1467,2021,1040,446,977,1064,1020,829,87,531,-444
586,450000,8c915fe4632fb9fa,5,0,257,240,225,284,342,388,511,880,738,330,660,454,557,481,-206,330,-536
1265,320000,8c915fe4632fb9fa,5,0,883,678,762,1001,1116,1451,1816,2525,1540,1130,1441,1246,1344,1272,-195,311,-506
632,360000,8c915fe4632fb9fa,5,0,410,377,409,440,725,733,889,1320,1015,377,598,631,614,535,33,221,-188
2368,130000,8c915fe4632fb9fa,5,0,781,785,958,1014,1437,1548,2026,3281,1882,1126,1456,2041,1748,1541,585,330,255
1509,410000,8c915fe4632fb9fa,5,0,634,719,857,953,1313,1473,1843,2975,2324,1002,1413,1518,1466,1311,105,411,-306
948,330000,8c915fe4632fb9fa,5,0,746,723,731,805,1089,1175,1502,2235,958,565,880,893,886,779,13,315,-302
758,420000,8c915fe4632fb9fa,5,0,503,489,505,669,868,924,1339,1557,1148,463,782,723,752,656,-59,319,-378
655,430000,8c915fe4632fb9fa,5,0,371,399,407,438,633,772,835,1281,1235,439,733,664,698,612,-69,294,-363
541,350000,8c915fe4632fb9fa,5,0,227,178,234,282,307,414,622,877,518,365,529,461,495,452,-68,164,-232
405,210000,8c915fe4632fb9fa,5,0,177,191,236,231,291,296,396,542,311,224,349,397,373,323,48,125,-77
368,500000,8c915fe4632fb9fa,5,0,207,227,218,259,311,316,419,666,489,274,346,334,340,318,-12,72,-84
597,610000,8c915fe4632fb9fa,5,0,287,271,303,362,519,627,715,1549,1036,394,463,535,499,464,72,69,3
736,230000,8c915fe4632fb9fa,5,0,344,319,336,422,442,411,616,998,401,372,684,679,682,578,-5,312,-317
355,310000,6155b214590c66e6,5,0,459,422,464,522,661,472,781,1047,423,192,279,354,316,275,75,87,-12
1295,530000,6155b214590c66e6,5,0,985,706,939,877,1084,1148,1159,1879,1354,680,631,992,812,768,361,-49,410
1042,150000,6155b214590c66e6,5,0,583,433,551,578,725,701,941,1442,814,347,566,786,676,566,220,219,1
376,110000,6155b214590c66e6,5,0,411,391,454,496,664,474,569,1295,274,176,281,280,280,246,-1,105,-106
1668,510000,6155b214590c66e6,5,0,1614,1306,1417,1488,2289,1556,2162,4188,2540,1081,1111,1488,1300,1227,377,30,347
1582,340000,6155b214590c66e6,5,0,1443,1295,1412,1803,1996,1889,2073,3650,2495,863,893,1218,1056,991,325,30,295
3444,370000,6155b214590c66e6,5,0,2580,2168,2583,2886,3461,3252,3594,6275,3467,1356,2002,3249,2626,2202,1247,646,601
998,140000,6155b214590c66e6,5,0,630,509,619,652,805,800,914,1576,743,357,500,790,645,549,290,143,147
2162,440000,6155b214590c66e6,5,0,2201,1866,1837,2246,2808,2902,3269,4342,1784,653,1364,1722,1543,1246,358,711,-353
802,450000,6155b214590c66e6,5,0,655,477,518,574,670,621,739,1316,892,381,556,538,547,492,-18,175,-193
3244,320000,6155b214590c66e6,5,0,3224,2468,2600,3230,3453,3560,3776,5864,3032,1760,2316,2607,2462,2228,291,556,-265
960,360000,6155b214590c66e6,5,0,980,839,839,860,1325,1195,1285,2160,1579,453,603,962,782,673,359,150,209
3049,130000,6155b214590c66e6,5,0,2039,1774,2024,2258,2481,2298,2594,4551,2375,1231,1427,2467,1947,1708,1040,196,844
3025,410000,6155b214590c66e6,5,0,2508,2539,3103,3396,3571,3427,4047,8018,5309,1586,1915,2716,2316,2072,801,329,472
2275,330000,6155b214590c66e6,5,0,2136,1905,1897,2229,2579,2724,3014,4336,1679,826,1161,1890,1526,1292,729,335,394
1278,420000,6155b214590c66e6,5,0,1186,1236,1304,1341,1747,1512,1848,3179,2049,551,906,1028,967,828,122,355,-233
1621,430000,6155b214590c66e6,5,0,1468,1450,1536,1679,2187,1872,2355,3747,2461,732,1157,1395,1276,1095,238,425,-187
759,350000,6155b214590c66e6,5,0,683,519,626,618,738,859,1140,1306,596,364,463,616,540,481,153,99,54
1203,210000,6155b214590c66e6,5,0,949,846,1022,1132,1218,970,1188,1784,769,415,765,1227,996,802,462,350,112
594,500000,6155b214590c66e6,5,0,656,695,635,655,770,622,761,1417,877,373,399,529,464,434,130,26,104
917,610000,6155b214590c66e6,5,0,688,468,587,654,727,899,841,1546,1008,303,361,648,504,437,287,58,229
778,230000,6155b214590c66e6,5,0,692,573,663,777,675,517,944,1290,579,365,604,725,664,565,121,239,-118
727,310000,28e29f2c03dcd84c,5,0,656,680,680,720,820,623,807,1293,851,433,764,667,716,621,-97,331,-428
462,530000,28e29f2c03dcd84c,5,0,252,242,468,405,456,394,535,639,509,300,415,361,388,359,-54,115,-169
562,150000,28e29f2c03dcd84c,5,0,364,340,407,480,482,477,451,580,494,276,556,527,542,453,-29,280,-309
1002,110000,28e29f2c03dcd84c,5,0,1124,1019,1062,1143,1276,969,1288,2146,1327,923,1308,982,1145,1071,-326,385,-711
621,510000,28e29f2c03dcd84c,5,0,452,487,585,715,1123,634,781,1105,856,454,680,597,638,577,-83,226,-309
685,340000,28e29f2c03dcd84c,5,0,478,422,472,667,840,774,803,1070,953,364,644,584,614,531,-60,280,-340
1298,370000,28e29f2c03dcd84c,5,0,915,988,988,1162,1315,1224,1513,1837,1329,778,1244,1284,1264,1102,40,466,-426
727,140000,28e29f2c03dcd84c,5,0,669,598,604,750,729,770,798,1203,945,474,746,713,730,644,-33,272,-305
477,440000,28e29f2c03dcd84c,5,0,266,335,313,351,438,425,536,825,423,180,427,549,488,385,122,247,-125
183,450000,28e29f2c03dcd84c,5,0,110,114,93,121,141,135,160,243,179,71,140,141,140,117,1,69,-68
1340,320000,28e29f2c03dcd84c,5,0,1198,1215,1276,1793,1838,1848,1951,2643,1820,1058,1565,1288,1426,1304,-277,507,-784
312,360000,28e29f2c03dcd84c,5,0,295,274,321,334,419,377,424,571,408,151,325,301,313,259,-24,174,-198
1631,130000,28e29f2c03dcd84c,5,0,1024,961,977,1321,1377,1264,1433,1923,1604,884,1377,1523,1450,1261,146,493,-347
1044,410000,28e29f2c03dcd84c,5,0,780,738,834,1010,1081,952,1113,1482,1178,548,1003,1062,1032,871,59,455,-396
651,330000,28e29f2c03dcd84c,5,0,444,464,536,601,733,722,894,1112,767,352,679,681,680,571,2,327,-325
296,420000,28e29f2c03dcd84c,5,0,284,317,260,295,373,329,377,483,446,164,271,261,266,232,-10,107,-117
428,430000,28e29f2c03dcd84c,5,0,301,333,339,383,464,438,477,783,487,262,452,359,406,358,-93,190,-283
291,350000,28e29f2c03dcd84c,5,0,189,158,212,189,235,212,345,456,397,140,227,217,222,195,-10,87,-97
179,210000,28e29f2c03dcd84c,5,0,253,279,277,296,261,247,251,310,270,165,356,218,287,246,-138,191,-329
378,500000,28e29f2c03dcd84c,5,0,342,482,408,414,486,426,491,644,555,263,408,381,394,351,-27,145,-172
645,610000,28e29f2c03dcd84c,5,0,395,348,388,413,568,617,622,758,719,361,603,579,591,514,-24,242,-266
141,230000,28e29f2c03dcd84c,5,0,150,115,124,187,159,142,152,169,104,79,149,106,128,111,-43,70,-113
100,310000,37aa9169b575ef79,5,0,32,39,46,46,41,395,67,117,63,37,86,109,98,77,23,49,-26
884,530000,37aa9169b575ef79,5,0,1072,971,1395,1426,1254,988,1142,1590,946,692,1035,755,895,827,-280,343,-623
743,150000,37aa9169b575ef79,5,0,895,690,744,864,895,802,945,982,602,413,714,724,719,617,10,301,-291
274,110000,37aa9169b575ef79,5,0,698,717,716,794,737,477,625,985,300,271,404,282,343,319,-122,133,-255
2457,510000,37aa9169b575ef79,5,0,2734,2651,2620,2791,2955,1733,2221,3340,1470,1639,3175,2405,2790,2406,-770,1536,-2306
286,340000,37aa9169b575ef79,5,0,402,479,502,552,488,424,410,575,248,260,384,279,332,308,-105,124,-229
2932,370000,37aa9169b575ef79,5,0,3511,2812,3126,3130,3837,3617,3662,4024,1903,1708,2748,2376,2562,2277,-372,1040,-1412
892,140000,37aa9169b575ef79,5,0,1057,828,993,1217,1561,1243,1188,1616,679,442,672,792,732,635,120,230,-110
2005,440000,37aa9169b575ef79,5,0,1785,1654,1766,1963,2010,1906,2111,2398,1196,1075,2249,1558,1904,1627,-691,1174,-1865
501,450000,37aa9169b575ef79,5,0,353,331,405,319,409,384,459,435,440,301,449,664,556,471,215,148,67
586,320000,37aa9169b575ef79,5,0,875,786,701,745,840,781,777,930,527,626,655,605,630,629,-50,29,-79
359,360000,37aa9169b575ef79,5,0,330,292,330,358,538,488,482,540,354,189,356,270,313,272,-86,167,-253
3148,130000,37aa9169b575ef79,5,0,3349,3221,3102,3388,3910,3483,3233,4206,2068,1780,2633,2656,2644,2356,23,853,-830
1509,410000,37aa9169b575ef79,5,0,2022,1974,2200,2100,2323,1931,2018,2962,1570,1050,1823,1515,1669,1463,-308,773,-1081
606,330000,37aa9169b575ef79,5,0,827,820,769,777,723,606,634,886,424,422,628,555,592,535,-73,206,-279
376,420000,37aa9169b575ef79,5,0,610,623,595,715,725,585,544,920,483,270,442,304,373,339,-138,172,-310
1023,430000,37aa9169b575ef79,5,0,1475,1358,1456,1533,1680,1444,1489,2336,1714,653,1232,835,1034,907,-397,579,-976
486,350000,37aa9169b575ef79,5,0,484,487,627,773,710,690,597,622,308,292,460,424,442,392,-36,168,-204
1215,210000,37aa9169b575ef79,5,0,1508,1498,1804,1815,1871,1308,1478,1878,681,691,1319,1119,1219,1043,-200,628,-828
126,500000,37aa9169b575ef79,5,0,204,370,530,502,347,184,172,247,131,105,125,160,142,130,35,20,15
577,610000,37aa9169b575ef79,5,0,604,479,874,1106,695,580,634,1051,558,384,605,487,546,492,-118,221,-339
1336,230000,37aa9169b575ef79,5,0,1291,1253,1193,1427,1562,1308,1636,1781,730,952,1556,1254,1405,1254,-302,604,-906
883,310000,63065128401bb3ff,5,0,2922,2462,1180,1500,2397,1674,2362,3060,1909,501,2672,4039,3356,2404,1367,2171,-804
785,530000,63065128401bb3ff,5,0,647,551,884,974,1076,1038,1033,1402,656,504,651,603,627,586,-48,147,-195
543,150000,63065128401bb3ff,5,0,507,344,410,446,541,468,630,827,268,214,376,413,394,334,37,162,-125
280,110000,63065128401bb3ff,5,0,2551,971,995,1118,835,516,1494,2145,217,200,2331,1550,1940,1360,-781,2131,-2912
1399,510000,63065128401bb3ff,5,0,1543,1533,1662,1864,2707,1708,2119,2450,1355,937,1478,2078,1778,1498,600,541,59
1591,340000,63065128401bb3ff,5,0,1828,1799,2028,2809,2863,2529,2927,3132,1460,775,1436,1362,1399,1191,-74,661,-735
2615,370000,63065128401bb3ff,5,0,3471,2715,3147,4018,4409,4129,4087,5401,1885,1225,2010,2269,2140,1835,259,785,-526
1192,140000,63065128401bb3ff,5,0,1337,977,1223,1490,1510,1452,1547,2066,692,491,877,974,926,781,97,386,-289
1216,440000,63065128401bb3ff,5,0,1983,1796,1715,2112,2192,2036,2188,2519,625,462,1475,1506,1490,1148,31,1013,-982
407,450000,63065128401bb3ff,5,0,518,379,413,503,589,568,596,616,308,176,366,289,328,277,-77,190,-267
3008,320000,63065128401bb3ff,5,0,3757,3219,3369,4854,5016,4475,5007,5643,2143,1862,2644,2631,2638,2379,-13,782,-795
1031,360000,63065128401bb3ff,5,0,1370,1233,1308,1681,2044,1627,1981,2357,973,442,916,895,906,751,-21,474,-495
2981,130000,63065128401bb3ff,5,0,3198,2587,2964,3829,3951,3277,3711,5424,1723,1261,2043,2652,2348,1985,609,782,-173
2723,410000,63065128401bb3ff,5,0,2736,2702,3421,4398,4500,3793,4237,5119,2463,1238,2429,2562,2496,2076,133,1191,-1058
1533,330000,63065128401bb3ff,5,0,2092,1953,2021,2513,2777,2324,2401,2755,895,768,1359,1321,1340,1149,-38,591,-629
822,420000,63065128401bb3ff,5,0,1158,1213,1120,1591,1818,1296,1466,1985,1002,357,841,848,844,682,7,484,-477
1204,430000,63065128401bb3ff,5,0,1561,1517,1583,1906,2187,1670,2078,2533,1085,531,1104,1014,1059,883,-90,573,-663
1235,350000,63065128401bb3ff,5,0,1082,843,1055,1347,1279,1170,1218,1549,440,400,775,721,748,632,-54,375,-429
555,210000,63065128401bb3ff,5,0,859,586,702,806,897,700,869,1098,268,212,386,587,486,395,201,174,27
619,500000,63065128401bb3ff,5,0,870,1013,987,1230,1171,824,938,1120,617,359,603,607,605,523,4,244,-240
842,610000,63065128401bb3ff,5,0,1284,861,1113,1278,1300,1165,1199,1748,631,397,661,1831,1246,963,1170,264,906
323,230000,63065128401bb3ff,5,0,421,327,303,404,404,286,466,480,162,156,276,218,247,217,-58,120,-178
351,310000,ea489c253676aafc,5,0,759,629,425,535,502,314,574,754,315,362,767,319,543,483,-448,405,-853
525,530000,ea489c253676aafc,5,0,595,461,551,450,435,635,692,866,452,295,448,404,426,382,-44,153,-197
550,150000,ea489c253676aafc,5,0,561,440,380,452,427,495,612,941,427,254,591,556,574,467,-35,337,-372
115,110000,ea489c253676aafc,5,0,353,301,382,397,346,199,341,546,125,89,159,100,130,116,-59,70,-129
1081,510000,ea489c253676aafc,5,0,1270,1055,1379,1197,903,838,1187,1812,1017,704,1344,1235,1290,1094,-109,640,-749
638,340000,ea489c253676aafc,5,0,1021,869,1109,958,734,813,952,1669,741,475,869,701,785,682,-168,394,-562
2834,370000,ea489c253676aafc,5,0,3404,2787,3450,3299,2451,2995,3812,5496,2330,1515,2865,2841,2853,2407,-24,1350,-1374
1531,140000,ea489c253676aafc,5,0,1725,1270,1462,1588,1052,1126,1234,2626,1165,641,1247,1425,1336,1104,178,606,-428
513,440000,ea489c253676aafc,5,0,473,460,457,448,529,384,525,1055,368,255,433,540,486,409,107,178,-71
249,450000,ea489c253676aafc,5,0,302,352,363,291,255,362,355,448,365,155,240,485,362,293,245,85,160
827,320000,ea489c253676aafc,5,0,1178,1368,1353,1085,864,1310,1728,2261,1167,1028,1507,1281,1394,1272,-226,479,-705
253,360000,ea489c253676aafc,5,0,412,315,365,335,301,356,946,847,641,223,316,236,276,258,-80,93,-173
3250,130000,ea489c253676aafc,5,0,3190,2715,3210,3609,2265,2586,3058,5478,1932,1551,2981,3513,3247,2682,532,1430,-898
1408,410000,ea489c253676aafc,5,0,1905,1469,1701,1452,1141,1472,1941,3092,1731,893,1695,1504,1600,1364,-191,802,-993
514,330000,ea489c253676aafc,5,0,1100,1016,1000,913,659,638,706,1205,504,467,741,598,670,602,-143,274,-417
166,420000,ea489c253676aafc,5,0,347,353,277,263,202,272,348,657,298,154,273,222,248,216,-51,119,-170
409,430000,ea489c253676aafc,5,0,849,769,962,701,698,568,587,1351,576,253,448,437,442,379,-11,195,-206
240,350000,ea489c253676aafc,5,0,335,225,356,355,342,307,452,617,215,148,255,232,244,212,-23,107,-130
776,210000,ea489c253676aafc,5,0,783,589,621,716,684,572,853,1026,394,408,768,721,744,632,-47,360,-407
249,500000,ea489c253676aafc,5,0,497,413,558,474,304,408,379,694,353,248,346,329,338,308,-17,98,-115
553,610000,ea489c253676aafc,5,0,599,723,667,832,623,693,804,1400,754,418,791,600,696,603,-191,373,-564
518,230000,ea489c253676aafc,5,0,383,283,369,508,307,324,496,710,280,266,503,464,484,411,-39,237,-276
248,310000,cd5841d44fd7625e,5,0,249,228,201,232,150,148,312,359,339,177,321,249,285,249,-72,144,-216
412,530000,cd5841d44fd7625e,5,0,346,330,388,290,304,344,442,485,409,248,357,375,366,327,18,109,-91
583,150000,cd5841d44fd7625e,5,0,395,262,398,348,325,432,401,434,519,319,522,443,482,428,-79,203,-282
1549,110000,cd5841d44fd7625e,5,0,1156,1039,990,1183,1150,795,1121,1802,1263,877,1267,1047,1157,1064,-220,390,-610
852,510000,cd5841d44fd7625e,5,0,679,596,623,519,741,610,732,1083,1390,565,951,827,889,781,-124,386,-510
553,340000,cd5841d44fd7625e,5,0,414,403,381,360,323,440,519,629,667,315,471,534,502,440,63,156,-93
1792,370000,cd5841d44fd7625e,5,0,1499,1162,1256,1311,1391,1370,1666,1642,1861,878,1578,1694,1636,1383,116,700,-584
445,140000,cd5841d44fd7625e,5,0,380,264,316,332,330,480,421,414,426,317,451,395,423,388,-56,134,-190
791,440000,cd5841d44fd7625e,5,0,553,537,509,516,523,704,995,1243,727,322,827,693,760,614,-134,505,-639
193,450000,cd5841d44fd7625e,5,0,113,102,97,101,156,159,192,214,225,119,204,139,172,154,-65,85,-150
1278,320000,cd5841d44fd7625e,5,0,1236,925,785,871,1280,881,1099,1374,1336,868,1301,1124,1212,1098,-177,433,-610
315,360000,cd5841d44fd7625e,5,0,246,191,199,169,178,237,276,329,364,141,291,237,264,223,-54,150,-204
2074,130000,cd5841d44fd7625e,5,0,1563,1391,1238,1360,1115,1052,1461,1615,1768,1165,1697,1805,1751,1556,108,532,-424
1419,410000,cd5841d44fd7625e,5,0,996,913,957,1047,1104,1357,1223,1443,1429,856,1325,1403,1364,1195,78,469,-391
707,330000,cd5841d44fd7625e,5,0,592,492,475,404,404,512,747,863,742,356,707,633,670,565,-74,351,-425
470,420000,cd5841d44fd7625e,5,0,345,337,298,379,393,374,473,566,558,262,443,396,420,367,-47,181,-228
397,430000,cd5841d44fd7625e,5,0,307,277,273,291,253,248,418,494,519,230,424,383,404,346,-41,194,-235
340,350000,cd5841d44fd7625e,5,0,307,216,229,183,186,285,325,402,404,188,330,251,290,256,-79,142,-221
781,210000,cd5841d44fd7625e,5,0,593,769,652,721,569,738,644,1082,704,546,870,783,826,733,-87,324,-411
317,500000,cd5841d44fd7625e,5,0,274,314,254,213,262,251,282,391,433,202,335,319,327,285,-16,133,-149
460,610000,cd5841d44fd7625e,5,0,522,312,356,360,419,276,346,497,487,257,378,390,384,342,12,121,-109
1179,230000,cd5841d44fd7625e,5,0,794,828,639,929,731,657,664,964,785,666,1198,1070,1134,978,-128,532,-660
612,310000,b25c4e2e3856af22,5,0,982,1141,897,946,1150,1010,1563,1504,815,447,731,532,632,570,-199,284,-483
422,530000,b25c4e2e3856af22,5,0,522,373,681,595,570,759,692,785,585,277,403,310,356,330,-93,126,-219
183,150000,b25c4e2e3856af22,5,0,365,254,296,333,327,407,342,430,303,110,229,177,203,172,-52,119,-171
462,110000,b25c4e2e3856af22,5,0,768,998,675,772,925,740,925,1127,376,284,427,371,399,361,-56,143,-199
680,510000,b25c4e2e3856af22,5,0,978,903,990,1085,1885,1100,1320,1775,1096,562,764,657,710,661,-107,202,-309
589,340000,b25c4e2e3856af22,5,0,823,725,769,980,1023,1001,1064,1490,952,364,600,581,590,515,-19,236,-255
957,370000,b25c4e2e3856af22,5,0,1210,1082,1134,1323,1432,1303,1408,1739,940,501,805,813,809,706,8,304,-296
130,140000,b25c4e2e3856af22,5,0,326,221,257,295,289,333,332,371,229,113,151,138,144,134,-13,38,-51
846,440000,b25c4e2e3856af22,5,0,1269,1114,1097,1195,1320,1463,1644,2216,854,451,986,862,924,766,-124,535,-659
197,450000,b25c4e2e3856af22,5,0,277,223,187,218,240,280,255,372,218,114,237,155,196,169,-82,123,-205
1158,320000,b25c4e2e3856af22,5,0,1639,1433,1571,1947,1897,1872,2263,3132,1586,987,1345,1015,1180,1116,-330,358,-688
503,360000,b25c4e2e3856af22,5,0,759,661,681,684,855,798,870,1144,754,284,498,430,464,404,-68,214,-282
716,130000,b25c4e2e3856af22,5,0,788,622,676,985,861,883,944,1218,652,442,599,687,643,576,88,157,-69
644,410000,b25c4e2e3856af22,5,0,936,866,965,1056,1067,1021,1121,1578,856,471,700,719,710,630,19,229,-210
1156,330000,b25c4e2e3856af22,5,0,1961,1826,1921,2037,2367,2323,2703,3371,1749,893,1369,1150,1260,1137,-219,476,-695
593,420000,b25c4e2e3856af22,5,0,751,798,730,829,920,1033,988,1333,941,363,579,523,551,488,-56,216,-272
659,430000,b25c4e2e3856af22,5,0,852,770,811,908,1056,973,1081,1561,1003,386,716,610,663,571,-106,330,-436
534,350000,b25c4e2e3856af22,5,0,799,587,681,684,714,853,905,1102,667,370,551,387,469,436,-164,181,-345
206,210000,b25c4e2e3856af22,5,0,376,332,444,478,491,437,403,555,253,188,258,212,235,219,-46,70,-116
264,500000,b25c4e2e3856af22,5,0,403,448,421,422,477,428,496,740,452,184,293,290,292,256,-3,109,-112
328,610000,b25c4e2e3856af22,5,0,397,335,338,351,433,450,479,533,395,223,292,216,254,244,-76,69,-145
259,230000,b25c4e2e3856af22,5,0,422,399,362,461,359,320,352,428,213,219,281,217,249,239,-64,62,-126
368,310000,4a103c30d593fbbe,5,0,438,464,464,563,552,450,685,688,275,231,396,369,382,332,-27,165,-192
437,530000,4a103c30d593fbbe,5,0,611,509,837,743,640,687,714,1001,409,321,443,427,435,397,-16,122,-138
525,150000,4a103c30d593fbbe,5,0,665,393,509,544,557,650,671,789,370,239,440,455,448,378,15,201,-186
497,110000,4a103c30d593fbbe,5,0,1102,1018,1021,1288,1431,1045,1332,1807,402,360,619,496,558,492,-123,259,-382
1537,510000,4a103c30d593fbbe,5,0,1866,1748,1887,2009,2921,2017,2913,3590,1589,1106,1523,1538,1530,1389,15,417,-402
1199,340000,4a103c30d593fbbe,5,0,1170,1110,1307,1431,1596,1491,1717,1968,921,593,995,1124,1060,904,129,402,-273
2108,370000,4a103c30d593fbbe,5,0,2486,1895,2003,2387,2615,2547,2776,3299,1329,945,1856,2083,1970,1628,227,911,-684
610,140000,4a103c30d593fbbe,5,0,789,589,641,800,787,813,782,1130,401,261,510,549,530,440,39,249,-210
1044,440000,4a103c30d593fbbe,5,0,1286,1093,1029,1303,1438,1702,2171,2397,475,354,1081,908,994,781,-173,727,-900
290,450000,4a103c30d593fbbe,5,0,323,295,287,282,358,395,493,595,225,179,348,224,286,250,-124,169,-293
2434,320000,4a103c30d593fbbe,5,0,3080,2334,2394,3107,2962,3228,3579,4302,1623,1477,2234,2129,2182,1947,-105,757,-862
590,360000,4a103c30d593fbbe,5,0,657,503,672,641,755,781,885,1016,398,230,537,551,544,439,14,307,-293
3260,130000,4a103c30d593fbbe,5,0,2921,2392,2559,2979,2860,2877,2989,3954,1565,1311,2239,2725,2482,2092,486,928,-442
1801,410000,4a103c30d593fbbe,5,0,1817,1841,2115,2398,2493,2358,2638,3291,1489,872,1684,1948,1816,1501,264,812,-548
1453,330000,4a103c30d593fbbe,5,0,1827,1550,1572,1914,1992,2163,2458,2897,961,793,1491,1417,1454,1234,-74,698,-772
656,420000,4a103c30d593fbbe,5,0,828,848,789,996,1142,948,1247,1304,805,357,634,667,650,553,33,277,-244
561,430000,4a103c30d593fbbe,5,0,689,696,720,817,950,757,948,1222,427,264,565,544,554,458,-21,301,-322
620,350000,4a103c30d593fbbe,5,0,777,495,680,640,694,837,946,924,385,327,518,415,466,420,-103,191,-294
847,210000,4a103c30d593fbbe,5,0,1093,717,904,1088,1057,1007,1160,1513,414,423,828,916,872,722,88,405,-317
336,500000,4a103c30d593fbbe,5,0,246,378,375,374,365,407,493,612,296,209,288,300,294,266,12,79,-67
587,610000,4a103c30d593fbbe,5,0,926,472,701,761,801,945,946,1143,404,239,410,468,439,372,58,171,-113
772,230000,4a103c30d593fbbe,5,0,825,774,757,1154,914,753,1190,1198,462,436,1058,713,886,736,-345,622,-967
624,310000,7a7885e2d7c00bcf,5,0,603,553,600,670,690,633,790,925,325,455,653,555,604,554,-98,198,-296
316,530000,7a7885e2d7c00bcf,5,0,387,317,493,447,408,431,527,546,194,218,317,270,294,268,-47,99,-146
335,150000,7a7885e2d7c00bcf,5,0,350,301,313,341,355,371,359,418,168,163,287,292,290,247,5,124,-119
714,110000,7a7885e2d7c00bcf,5,0,916,826,879,911,1074,915,1162,1615,471,523,831,698,764,684,-133,308,-441
640,510000,7a7885e2d7c00bcf,5,0,738,715,745,722,1155,772,961,1167,445,516,738,665,702,640,-73,222,-295
606,340000,7a7885e2d7c00bcf,5,0,692,656,677,767,841,878,933,1003,374,418,658,653,656,576,-5,240,-245
1899,370000,7a7885e2d7c00bcf,5,0,1978,1685,1638,1852,2308,2307,2370,2766,875,984,1739,1860,1800,1528,121,755,-634
229,140000,7a7885e2d7c00bcf,5,0,352,275,285,300,313,320,355,484,139,184,247,243,245,225,-4,63,-67
772,440000,7a7885e2d7c00bcf,5,0,979,912,937,951,992,1092,1209,1464,402,402,896,629,762,642,-267,494,-761
222,450000,7a7885e2d7c00bcf,5,0,265,233,260,262,246,259,290,384,118,109,224,157,190,163,-67,115,-182
2227,320000,7a7885e2d7c00bcf,5,0,2522,2016,2112,2209,2679,2595,2801,3241,1057,1612,2234,1953,2094,1933,-281,622,-903
351,360000,7a7885e2d7c00bcf,5,0,405,347,434,393,442,498,481,511,213,176,385,307,346,289,-78,209,-287
1813,130000,7a7885e2d7c00bcf,5,0,1469,1298,1298,1461,1525,1603,1929,2115,754,885,1533,1690,1612,1369,157,648,-491
1058,410000,7a7885e2d7c00bcf,5,0,1026,959,1096,1283,1383,1309,1461,1740,591,724,1200,1228,1214,1051,28,476,-448
1729,330000,7a7885e2d7c00bcf,5,0,1956,1671,1999,1697,1991,2033,2127,2662,818,1237,1764,1676,1720,1559,-88,527,-615
444,420000,7a7885e2d7c00bcf,5,0,508,574,499,596,611,603,616,685,305,279,470,356,413,368,-114,191,-305
424,430000,7a7885e2d7c00bcf,5,0,494,442,503,514,645,501,559,768,256,278,497,347,422,374,-150,219,-369
395,350000,7a7885e2d7c00bcf,5,0,530,373,503,451,397,473,480,608,216,257,389,262,326,303,-127,132,-259
386,210000,7a7885e2d7c00bcf,5,0,514,420,483,505,553,489,516,595,169,217,412,408,410,346,-4,195,-199
129,500000,7a7885e2d7c00bcf,5,0,135,198,189,145,189,159,216,258,69,99,133,100,116,111,-33,34,-67
395,610000,7a7885e2d7c00bcf,5,0,540,321,402,487,425,510,487,657,185,238,361,306,334,302,-55,123,-178
398,230000,7a7885e2d7c00bcf,5,0,470,454,420,611,511,443,413,533,157,228,535,404,470,389,-131,307,-438
38,310000,346393c2c6305fb1,5,0,63,113,83,134,126,104,114,215,76,41,45,61,53,49,16,4,12
31,530000,346393c2c6305fb1,5,0,106,89,141,121,133,139,121,182,95,41,34,36,35,37,2,-7,9
72,150000,346393c2c6305fb1,5,0,124,111,114,92,121,108,174,205,99,66,95,76,86,79,-19,29,-48
41,110000,346393c2c6305fb1,5,0,132,149,201,202,250,161,243,439,74,40,54,53,54,49,-1,14,-15
149,510000,346393c2c6305fb1,5,0,262,301,284,317,459,291,297,513,309,153,136,133,134,141,-3,-17,14
331,340000,346393c2c6305fb1,5,0,529,526,633,733,655,600,692,1047,578,273,312,307,310,297,-5,39,-44
675,370000,346393c2c6305fb1,5,0,771,855,1000,1063,1138,1097,1099,1844,902,381,538,572,555,497,34,157,-123
236,140000,346393c2c6305fb1,5,0,195,143,212,261,250,277,308,545,238,158,237,226,232,207,-11,79,-90
101,440000,346393c2c6305fb1,5,0,145,223,291,295,282,277,289,373,126,71,118,103,110,97,-15,47,-62
53,450000,346393c2c6305fb1,5,0,71,100,108,107,108,100,115,162,93,53,69,35,52,52,-34,16,-50
183,320000,346393c2c6305fb1,5,0,411,403,402,461,370,406,397,621,300,168,197,206,202,190,9,29,-20
60,360000,346393c2c6305fb1,5,0,91,121,141,112,150,164,143,266,151,36,61,68,64,55,7,25,-18
518,130000,346393c2c6305fb1,5,0,537,455,575,645,742,699,808,1460,748,389,430,459,444,426,29,41,-12
290,410000,346393c2c6305fb1,5,0,364,453,477,544,566,471,617,1100,524,174,251,240,246,222,-11,77,-88
67,330000,346393c2c6305fb1,5,0,145,161,194,181,198,211,191,260,101,55,63,66,64,61,3,8,-5
96,420000,346393c2c6305fb1,5,0,180,285,274,266,326,324,313,534,275,79,103,125,114,102,22,24,-2
142,430000,346393c2c6305fb1,5,0,180,205,282,273,347,286,335,535,308,119,163,126,144,136,-37,44,-81
35,350000,346393c2c6305fb1,5,0,58,88,101,114,102,89,87,129,60,25,51,31,41,36,-20,26,-46
130,210000,346393c2c6305fb1,5,0,262,234,252,331,280,278,265,371,149,91,133,121,127,115,-12,42,-54
80,500000,346393c2c6305fb1,5,0,138,222,247,251,250,189,199,335,168,84,69,66,68,73,-3,-15,12
106,610000,346393c2c6305fb1,5,0,151,113,180,161,167,197,186,360,209,62,83,76,80,74,-7,21,-28
143,230000,346393c2c6305fb1,5,0,177,206,165,264,248,169,223,312,126,95,154,101,128,117,-53,59,-112
672,310000,02aab221aabc03b9,5,0,485,527,653,687,651,489,558,362,679,494,731,600,666,608,-131,237,-368
188,530000,02aab221aabc03b9,5,0,202,185,247,209,201,174,160,155,229,130,223,186,204,180,-37,93,-130
113,150000,02aab221aabc03b9,5,0,95,106,108,130,97,99,82,59,106,63,136,99,118,99,-37,73,-110
694,110000,02aab221aabc03b9,5,0,566,646,748,847,831,642,654,521,798,532,838,575,706,648,-263,306,-569
606,510000,02aab221aabc03b9,5,0,431,486,460,559,615,471,430,474,703,394,653,524,588,524,-129,259,-388
341,340000,02aab221aabc03b9,5,0,223,244,244,344,348,248,228,187,338,203,372,311,342,295,-61,169,-230
608,370000,02aab221aabc03b9,5,0,437,443,584,549,525,474,421,353,610,362,607,527,567,499,-80,245,-325
138,140000,02aab221aabc03b9,5,0,114,101,121,154,121,105,117,105,129,94,160,139,150,131,-21,66,-87
1267,440000,02aab221aabc03b9,5,0,1008,1160,1083,1238,1180,1049,976,1007,1207,847,1361,1093,1227,1100,-268,514,-782
154,450000,02aab221aabc03b9,5,0,114,129,142,161,151,126,138,119,159,102,172,121,146,132,-51,70,-121
1554,320000,02aab221aabc03b9,5,0,1323,1469,1509,1821,1585,1270,1186,1077,1735,1066,1713,1523,1618,1434,-190,647,-837
232,360000,02aab221aabc03b9,5,0,177,165,198,224,232,164,154,152,242,146,291,216,254,218,-75,145,-220
362,130000,02aab221aabc03b9,5,0,312,337,350,330,362,307,254,182,340,242,360,379,370,327,19,118,-99
319,410000,02aab221aabc03b9,5,0,277,291,353,389,339,239,284,223,320,199,311,289,300,266,-22,112,-134
1507,330000,02aab221aabc03b9,5,0,1121,1210,1486,1568,1439,1239,1136,1024,1529,973,1602,1326,1464,1300,-276,629,-905
339,420000,02aab221aabc03b9,5,0,265,300,346,383,407,272,273,274,370,238,369,296,332,301,-73,131,-204
278,430000,02aab221aabc03b9,5,0,207,229,257,270,285,213,205,215,305,186,346,275,310,269,-71,160,-231
498,350000,02aab221aabc03b9,5,0,375,354,394,437,448,353,321,324,518,242,572,350,461,388,-222,330,-552
242,210000,02aab221aabc03b9,5,0,226,254,291,346,299,229,207,174,292,205,321,225,273,250,-96,116,-212
244,500000,02aab221aabc03b9,5,0,204,232,259,222,255,197,217,217,267,199,277,240,258,239,-37,78,-115
248,610000,02aab221aabc03b9,5,0,288,241,238,319,283,263,205,197,285,151,281,203,242,212,-78,130,-208
82,230000,02aab221aabc03b9,5,0,87,80,75,119,71,81,63,53,93,68,133,85,109,95,-48,65,-113
287,310000,5d7fb682edd0f937,5,0,308,272,297,303,281,281,247,225,315,160,297,263,280,240,-34,137,-171
153,530000,5d7fb682edd0f937,5,0,175,143,190,187,165,167,133,176,164,108,164,133,148,135,-31,56,-87
102,150000,5d7fb682edd0f937,5,0,115,109,112,117,120,96,85,86,86,62,103,111,107,92,8,41,-33
290,110000,5d7fb682edd0f937,5,0,385,362,331,427,429,308,324,417,323,190,356,270,313,272,-86,166,-252
351,510000,5d7fb682edd0f937,5,0,382,380,359,376,389,305,301,337,483,166,411,313,362,297,-98,245,-343
210,340000,5d7fb682edd0f937,5,0,175,187,156,227,205,162,169,174,188,119,173,183,178,158,10,54,-44
331,370000,5d7fb682edd0f937,5,0,307,309,263,302,292,265,227,253,339,160,306,297,302,254,-9,146,-155
97,140000,5d7fb682edd0f937,5,0,95,91,82,103,99,83,81,91,111,56,97,101,99,85,4,41,-37
540,440000,5d7fb682edd0f937,5,0,543,522,480,565,575,462,510,512,581,314,531,409,470,418,-122,217,-339
104,450000,5d7fb682edd0f937,5,0,113,124,96,117,108,102,103,109,128,57,103,59,81,73,-44,46,-90
793,320000,5d7fb682edd0f937,5,0,752,698,733,823,757,642,661,734,807,456,741,678,710,625,-63,285,-348
152,360000,5d7fb682edd0f937,5,0,157,139,120,153,155,115,129,138,165,79,158,126,142,121,-32,79,-111
251,130000,5d7fb682edd0f937,5,0,230,197,195,219,226,184,180,178,203,126,201,195,198,174,-6,75,-81
194,410000,5d7fb682edd0f937,5,0,180,189,189,186,187,161,189,173,186,103,191,191,191,162,0,88,-88
720,330000,5d7fb682edd0f937,5,0,660,565,645,709,620,587,599,595,656,382,738,625,682,582,-113,356,-469
255,420000,5d7fb682edd0f937,5,0,266,292,242,319,331,219,258,266,270,142,257,214,236,204,-43,115,-158
191,430000,5d7fb682edd0f937,5,0,200,169,164,219,179,160,168,191,210,114,205,161,183,160,-44,91,-135
283,350000,5d7fb682edd0f937,5,0,230,256,240,260,259,202,201,205,241,127,267,183,225,192,-84,140,-224
138,210000,5d7fb682edd0f937,5,0,150,154,152,161,165,130,138,128,140,90,113,125,119,109,12,23,-11
136,500000,5d7fb682edd0f937,5,0,144,142,148,158,109,123,106,134,131,54,117,102,110,91,-15,63,-78
156,610000,5d7fb682edd0f937,5,0,199,168,161,205,192,172,135,145,159,85,142,119,130,115,-23,57,-80
79,230000,5d7fb682edd0f937,5,0,91,70,67,99,74,50,53,61,68,34,78,65,72,59,-13,44,-57
626,310000,a207df29ec9583f0,5,0,455,551,438,559,478,428,493,474,835,424,592,562,577,526,-30,168,-198
203,530000,a207df29ec9583f0,5,0,203,222,190,240,237,204,210,215,310,178,234,223,228,212,-11,56,-67
125,150000,a207df29ec9583f0,5,0,91,81,74,115,91,72,82,74,139,87,116,104,110,102,-12,29,-41
792,110000,a207df29ec9583f0,5,0,573,717,674,824,853,604,747,817,1033,648,841,763,802,751,-78,193,-271
456,510000,a207df29ec9583f0,5,0,442,494,344,458,388,382,361,382,695,383,524,456,490,454,-68,141,-209
222,340000,a207df29ec9583f0,5,0,167,188,148,226,228,183,176,177,354,152,225,259,242,212,34,73,-39
475,370000,a207df29ec9583f0,5,0,291,346,365,453,344,338,348,336,608,328,530,488,509,449,-42,202,-244
97,140000,a207df29ec9583f0,5,0,88,102,105,108,108,84,93,100,165,96,130,118,124,115,-12,34,-46
1020,440000,a207df29ec9583f0,5,0,678,769,689,886,875,627,766,825,1178,690,1101,964,1032,918,-137,411,-548
138,450000,a207df29ec9583f0,5,0,97,100,90,105,124,72,100,114,160,106,163,133,148,134,-30,57,-87
1072,320000,a207df29ec9583f0,5,0,890,962,857,1124,918,791,915,1007,1591,766,1115,1026,1070,969,-89,349,-438
182,360000,a207df29ec9583f0,5,0,112,125,115,140,155,101,129,108,227,115,167,214,190,165,47,52,-5
290,130000,a207df29ec9583f0,5,0,199,229,221,266,200,202,203,219,376,209,316,289,302,271,-27,107,-134
275,410000,a207df29ec9583f0,5,0,185,207,254,276,252,194,283,262,357,201,287,304,296,264,17,86,-69
965,330000,a207df29ec9583f0,5,0,723,810,824,880,834,733,849,908,1436,623,970,967,968,853,-3,347,-350
282,420000,a207df29ec9583f0,5,0,243,260,260,327,326,230,315,356,436,202,366,316,341,295,-50,164,-214
226,430000,a207df29ec9583f0,5,0,164,200,157,190,184,143,174,192,302,179,246,255,250,227,9,67,-58
357,350000,a207df29ec9583f0,5,0,225,265,234,296,266,197,227,256,500,212,338,297,318,282,-41,126,-167
241,210000,a207df29ec9583f0,5,0,190,254,215,281,225,176,194,227,304,176,286,261,274,241,-25,110,-135
174,500000,a207df29ec9583f0,5,0,168,164,192,184,176,151,174,194,265,152,205,197,201,185,-8,53,-61
251,610000,a207df29ec9583f0,5,0,174,206,235,213,228,210,194,216,307,140,222,205,214,189,-17,82,-99
121,230000,a207df29ec9583f0,5,0,72,97,59,106,77,74,83,85,102,84,125,116,120,108,-9,41,-50
154,310000,b4be3a4917289c82,5,0,151,149,152,203,190,188,201,262,80,97,160,113,136,123,-47,63,-110
78,530000,b4be3a4917289c82,5,0,86,43,35,60,52,76,100,59,26,35,34,50,42,40,16,-1,17
25,150000,b4be3a4917289c82,5,0,38,23,35,33,31,42,40,37,22,17,26,37,32,27,11,9,2
139,110000,b4be3a4917289c82,5,0,259,192,172,203,232,200,230,226,93,117,153,137,145,136,-16,36,-52
164,510000,b4be3a4917289c82,5,0,131,94,121,152,216,166,240,223,57,76,90,137,114,101,47,14,33
74,340000,b4be3a4917289c82,5,0,91,85,90,104,106,110,130,121,57,59,72,81,76,71,9,13,-4
167,370000,b4be3a4917289c82,5,0,264,203,199,232,258,215,231,199,113,137,218,152,185,169,-66,81,-147
76,140000,b4be3a4917289c82,5,0,35,28,32,37,31,31,28,33,16,10,28,22,25,20,-6,18,-24
244,440000,b4be3a4917289c82,5,0,253,209,182,223,290,309,396,384,120,115,231,223,227,190,-8,116,-124
33,450000,b4be3a4917289c82,5,0,31,23,25,29,35,34,41,40,20,18,18,25,22,20,7,0,7
390,320000,b4be3a4917289c82,5,0,438,345,389,471,447,420,635,591,225,325,414,342,378,360,-72,89,-161
39,360000,b4be3a4917289c82,5,0,50,31,41,43,50,52,66,85,10,18,37,40,38,32,3,19,-16
102,130000,b4be3a4917289c82,5,0,161,119,127,130,145,141,166,161,78,99,131,131,131,120,0,32,-32
75,410000,b4be3a4917289c82,5,0,118,88,93,86,118,117,128,163,57,77,90,88,89,85,-2,13,-15
300,330000,b4be3a4917289c82,5,0,415,297,361,382,415,422,523,567,168,290,344,386,365,340,42,54,-12
66,420000,b4be3a4917289c82,5,0,86,72,79,106,110,92,120,142,48,54,76,88,82,73,12,22,-10
75,430000,b4be3a4917289c82,5,0,62,48,45,64,96,79,112,124,41,43,61,74,68,59,13,18,-5
59,350000,b4be3a4917289c82,5,0,83,59,50,84,61,85,108,127,23,28,50,51,50,43,1,22,-21
65,210000,b4be3a4917289c82,5,0,77,61,82,88,87,77,106,83,28,38,67,45,56,50,-22,29,-51
34,500000,b4be3a4917289c82,5,0,34,28,26,35,47,43,77,67,17,20,19,34,26,24,15,-1,16
99,610000,b4be3a4917289c82,5,0,99,52,57,82,79,83,68,82,41,52,48,66,57,55,18,-4,22
46,230000,b4be3a4917289c82,5,0,68,50,44,61,42,40,48,45,18,18,48,30,39,32,-18,30,-48
427,310000,ef76a85c4b39f693,5,0,512,736,581,360,145,129,306,492,378,283,374,311,342,323,-63,91,-154
178,530000,ef76a85c4b39f693,5,0,243,237,221,153,83,75,142,154,140,101,145,149,147,132,4,44,-40
169,150000,ef76a85c4b39f693,5,0,164,131,165,105,47,48,67,109,121,79,109,124,116,104,15,30,-15
580,110000,ef76a85c4b39f693,5,0,789,881,663,502,321,175,311,576,511,299,438,522,480,420,84,139,-55
497,510000,ef76a85c4b39f693,5,0,600,609,554,488,356,206,340,526,495,291,361,444,402,365,83,70,13
271,340000,ef76a85c4b39f693,5,0,306,319,309,208,104,111,219,307,304,148,259,319,289,242,60,111,-51
557,370000,ef76a85c4b39f693,5,0,668,672,573,446,246,241,312,378,406,284,400,479,440,388,79,116,-37
93,140000,ef76a85c4b39f693,5,0,145,145,138,80,47,46,58,83,94,61,99,97,98,86,-2,38,-40
701,440000,ef76a85c4b39f693,5,0,927,973,869,740,398,282,593,912,598,355,607,642,624,535,35,252,-217
113,450000,ef76a85c4b39f693,5,0,104,120,85,95,39,30,50,68,74,33,77,72,74,61,-5,44,-49
1046,320000,ef76a85c4b39f693,5,0,1369,1500,1116,610,270,351,609,1028,993,652,891,910,900,818,19,239,-220
175,360000,ef76a85c4b39f693,5,0,188,194,175,130,47,59,107,208,200,69,151,150,150,123,-1,82,-83
440,130000,ef76a85c4b39f693,5,0,489,506,429,351,172,141,298,340,342,250,323,382,352,318,59,73,-14
325,410000,ef76a85c4b39f693,5,0,350,442,406,206,143,136,170,239,290,184,293,341,317,273,48,109,-61
1209,330000,ef76a85c4b39f693,5,0,1596,1826,1257,815,643,498,965,1300,996,708,969,1088,1028,922,119,261,-142
305,420000,ef76a85c4b39f693,5,0,331,346,286,253,116,101,212,331,334,134,250,279,264,221,29,116,-87
354,430000,ef76a85c4b39f693,5,0,370,344,325,229,78,92,180,310,284,146,251,271,261,223,20,105,-85
270,350000,ef76a85c4b39f693,5,0,345,285,288,200,69,95,138,176,229,97,153,164,158,138,11,56,-45
341,210000,ef76a85c4b39f693,5,0,390,459,433,291,193,157,189,261,256,190,274,317,296,260,43,84,-41
175,500000,ef76a85c4b39f693,5,0,172,225,158,135,51,35,76,157,115,82,120,97,108,100,-23,38,-61
247,610000,ef76a85c4b39f693,5,0,312,315,249,241,115,96,127,205,223,136,166,239,202,180,73,30,43
145,230000,ef76a85c4b39f693,5,0,241,211,111,123,58,56,108,145,104,92,153,138,146,128,-15,61,-76
335,310000,bb9fbec9a2833839,5,0,320,327,408,528,494,298,341,507,266,214,347,256,302,272,-91,133,-224
164,530000,bb9fbec9a2833839,5,0,127,108,198,213,197,180,169,225,142,99,142,158,150,133,16,43,-27
145,150000,bb9fbec9a2833839,5,0,135,136,178,178,174,157,121,169,76,74,105,133,119,104,28,31,-3
290,110000,bb9fbec9a2833839,5,0,364,332,388,450,529,355,417,450,177,170,259,234,246,221,-25,89,-114
361,510000,bb9fbec9a2833839,5,0,371,406,440,533,641,403,433,394,242,224,324,333,328,294,9,100,-91
217,340000,bb9fbec9a2833839,5,0,185,223,244,297,328,172,256,310,160,139,211,231,221,194,20,72,-52
428,370000,bb9fbec9a2833839,5,0,302,378,352,487,582,453,469,507,305,251,332,402,367,328,70,81,-11
111,140000,bb9fbec9a2833839,5,0,116,114,132,168,143,117,124,97,55,43,101,86,94,77,-15,58,-73
641,440000,bb9fbec9a2833839,5,0,591,684,704,813,867,710,821,895,435,271,630,599,614,500,-31,359,-390
119,450000,bb9fbec9a2833839,5,0,81,120,108,129,137,85,114,124,79,66,108,95,102,90,-13,42,-55
903,320000,bb9fbec9a2833839,5,0,826,854,952,1272,1166,688,937,1154,552,589,835,807,821,744,-28,246,-274
176,360000,bb9fbec9a2833839,5,0,144,151,183,202,193,186,189,178,106,91,145,142,144,126,-3,54,-57
319,130000,bb9fbec9a2833839,5,0,244,275,310,427,423,324,327,378,179,188,251,302,276,247,51,63,-12
238,410000,bb9fbec9a2833839,5,0,217,257,301,336,420,237,276,308,156,143,260,258,259,220,-2,117,-119
892,330000,bb9fbec9a2833839,5,0,816,971,1162,1196,1045,917,1072,1169,550,543,759,841,800,714,82,216,-134
281,420000,bb9fbec9a2833839,5,0,236,352,315,395,429,270,308,378,261,177,285,262,274,241,-23,108,-131
285,430000,bb9fbec9a2833839,5,0,235,286,268,360,359,193,226,309,145,129,251,238,244,206,-13,122,-135
270,350000,bb9fbec9a2833839,5,0,214,238,244,281,263,253,214,293,168,110,183,202,192,165,19,73,-54
164,210000,bb9fbec9a2833839,5,0,184,149,191,241,242,174,177,213,86,85,121,151,136,119,30,36,-6
101,500000,bb9fbec9a2833839,5,0,83,135,121,146,128,96,89,130,65,59,92,68,80,73,-24,33,-57
180,610000,bb9fbec9a2833839,5,0,143,148,200,229,215,165,164,174,112,81,131,150,140,121,19,50,-31
95,230000,bb9fbec9a2833839,5,0,96,121,92,130,140,82,95,85,44,40,74,82,78,65,8,34,-26
445,310000,da457d15788fe8ee,5,0,462,576,421,521,504,402,593,748,538,251,456,315,386,341,-141,205,-346
263,530000,da457d15788fe8ee,5,0,259,204,306,266,231,316,323,344,263,166,191,198,194,185,7,25,-18
213,150000,da457d15788fe8ee,5,0,203,169,162,217,201,207,206,200,197,109,152,165,158,142,13,43,-30
781,110000,da457d15788fe8ee,5,0,986,1008,845,898,731,715,939,1050,755,424,693,651,672,589,-42,269,-311
502,510000,da457d15788fe8ee,5,0,753,748,554,658,1072,583,560,641,624,348,443,468,456,420,25,95,-70
264,340000,da457d15788fe8ee,5,0,316,300,257,346,329,282,331,409,330,200,229,256,242,228,27,29,-2
534,370000,da457d15788fe8ee,5,0,578,623,481,543,678,438,630,646,659,309,458,540,499,436,82,149,-67
136,140000,da457d15788fe8ee,5,0,142,127,114,155,143,139,142,103,120,44,90,120,105,85,30,46,-16
1099,440000,da457d15788fe8ee,5,0,1219,1303,1074,1237,1342,1295,1408,1829,1269,499,1006,894,950,800,-112,507,-619
156,450000,da457d15788fe8ee,5,0,158,161,124,125,189,162,142,255,213,82,152,117,134,117,-35,70,-105
1003,320000,da457d15788fe8ee,5,0,1031,1078,842,1106,1255,1040,1108,1430,1304,649,954,933,944,845,-21,305,-326
229,360000,da457d15788fe8ee,5,0,264,228,177,230,275,218,275,247,282,85,186,198,192,156,12,101,-89
434,130000,da457d15788fe8ee,5,0,420,442,396,476,471,407,417,527,425,254,337,412,374,334,75,83,-8
325,410000,da457d15788fe8ee,5,0,359,472,400,422,469,405,382,502,442,251,354,426,390,344,72,103,-31
1017,330000,da457d15788fe8ee,5,0,1051,1251,1000,1181,1241,932,1214,1500,938,567,836,888,862,764,52,269,-217
377,420000,da457d15788fe8ee,5,0,395,467,358,427,529,447,473,526,572,259,428,363,396,350,-65,169,-234
431,430000,da457d15788fe8ee,5,0,443,451,322,451,476,369,391,505,374,207,342,370,356,306,28,135,-107
282,350000,da457d15788fe8ee,5,0,345,272,282,266,282,298,320,358,335,144,206,194,200,181,-12,62,-74
330,210000,da457d15788fe8ee,5,0,405,340,365,459,418,357,335,454,281,156,268,293,280,239,25,112,-87
186,500000,da457d15788fe8ee,5,0,225,291,189,230,259,188,209,244,199,108,153,121,137,127,-32,45,-77
299,610000,da457d15788fe8ee,5,0,346,302,281,312,352,366,242,346,325,174,210,225,218,203,15,36,-21
133,230000,da457d15788fe8ee,5,0,264,224,175,240,219,123,190,198,139,94,144,137,140,125,-7,50,-57
649,310000,6858d6dfe680bdf7,5,0,634,547,444,607,438,357,513,576,543,384,696,487,592,522,-209,312,-521
314,530000,6858d6dfe680bdf7,5,0,250,183,177,213,139,117,236,257,243,199,312,234,273,248,-78,113,-191
64,150000,6858d6dfe680bdf7,5,0,87,52,46,43,47,37,60,80,54,43,84,76,80,68,-8,41,-49
617,110000,6858d6dfe680bdf7,5,0,681,595,494,449,410,328,585,816,536,311,688,527,608,509,-161,377,-538
571,510000,6858d6dfe680bdf7,5,0,591,569,444,445,455,290,447,593,591,337,640,478,559,485,-162,303,-465
391,340000,6858d6dfe680bdf7,5,0,376,284,251,265,236,233,275,385,322,230,435,350,392,338,-85,205,-290
593,370000,6858d6dfe680bdf7,5,0,521,386,382,358,297,285,401,440,468,289,622,538,580,483,-84,333,-417
91,140000,6858d6dfe680bdf7,5,0,68,61,45,60,31,30,61,103,57,64,78,79,78,74,1,14,-13
1394,440000,6858d6dfe680bdf7,5,0,1221,1023,972,1033,800,773,983,1319,1274,618,1449,1061,1255,1043,-388,831,-1219
176,450000,6858d6dfe680bdf7,5,0,140,110,112,99,93,94,126,167,115,84,164,123,144,124,-41,80,-121
1428,320000,6858d6dfe680bdf7,5,0,1314,879,894,893,729,862,988,1160,1203,919,1681,1193,1437,1264,-488,762,-1250
224,360000,6858d6dfe680bdf7,5,0,203,160,175,134,144,96,129,200,185,89,224,198,211,170,-26,135,-161
484,130000,6858d6dfe680bdf7,5,0,334,287,249,266,194,192,281,283,417,232,460,496,478,396,36,228,-192
429,410000,6858d6dfe680bdf7,5,0,322,315,276,272,209,174,237,350,258,224,388,425,406,346,37,164,-127
1876,330000,6858d6dfe680bdf7,5,0,1719,1389,1189,1547,1208,929,1465,1724,1540,1004,2273,1596,1934,1624,-677,1269,-1946
300,420000,6858d6dfe680bdf7,5,0,263,266,203,235,199,144,218,283,271,143,325,266,296,245,-59,182,-241
402,430000,6858d6dfe680bdf7,5,0,354,336,258,251,209,203,255,374,375,195,380,321,350,299,-59,185,-244
419,350000,6858d6dfe680bdf7,5,0,319,252,323,276,236,214,251,346,352,161,369,304,336,278,-65,208,-273
285,210000,6858d6dfe680bdf7,5,0,247,205,195,187,133,91,159,186,215,146,225,256,240,209,31,79,-48
274,500000,6858d6dfe680bdf7,5,0,262,227,183,189,132,105,200,253,198,131,290,195,242,205,-95,159,-254
286,610000,6858d6dfe680bdf7,5,0,258,182,135,163,159,132,134,174,188,135,235,193,214,188,-42,100,-142
97,230000,6858d6dfe680bdf7,5,0,88,66,52,57,23,28,58,76,70,44,104,104,104,84,0,60,-60
192,310000,79de4e4b24c35b04,5,0,249,256,328,379,426,299,501,825,333,136,253,217,235,202,-36,117,-153
552,530000,79de4e4b24c35b04,5,0,594,552,695,707,913,926,928,1393,1050,634,598,559,578,597,-39,-36,-3
156,150000,79de4e4b24c35b04,5,0,129,99,134,132,200,230,272,405,185,132,207,141,174,160,-66,75,-141
128,110000,79de4e4b24c35b04,5,0,376,194,240,313,370,330,446,852,178,127,199,127,163,151,-72,72,-144
385,510000,79de4e4b24c35b04,5,0,599,569,778,755,971,792,934,1509,1063,565,512,413,462,497,-99,-53,-46
749,340000,79de4e4b24c35b04,5,0,835,790,1052,1349,1421,1263,1461,2601,1965,1072,936,771,854,926,-165,-136,-29
1756,370000,79de4e4b24c35b04,5,0,2055,1628,2244,2677,2814,2975,3077,5360,2858,1598,1729,1694,1712,1674,-35,131,-166
462,140000,79de4e4b24c35b04,5,0,360,353,542,640,778,791,803,1442,701,396,447,437,442,427,-10,51,-61
2754,440000,79de4e4b24c35b04,5,0,3307,2768,3295,4086,5098,5032,5800,8421,3465,1872,3263,2465,2864,2533,-798,1391,-2189
1444,450000,79de4e4b24c35b04,5,0,1976,1690,1981,2497,3110,3025,3479,6171,2981,1510,1845,1206,1526,1520,-639,335,-974
1301,320000,79de4e4b24c35b04,5,0,1352,1272,1577,1829,2045,1978,2153,3757,2028,1542,1465,1325,1395,1444,-140,-77,-63
341,360000,79de4e4b24c35b04,5,0,417,410,598,635,806,703,736,1319,827,443,434,359,396,412,-75,-9,-66
1168,130000,79de4e4b24c35b04,5,0,1060,888,1184,1505,1631,1500,1789,2863,1366,1047,1021,1146,1084,1071,125,-26,151
2523,410000,79de4e4b24c35b04,5,0,2930,3020,3796,4302,4617,4700,5194,9539,6024,2842,2528,2423,2476,2598,-105,-314,209
733,330000,79de4e4b24c35b04,5,0,852,799,1096,1291,1435,1528,1653,2646,934,580,745,680,712,668,-65,165,-230
468,420000,79de4e4b24c35b04,5,0,481,488,678,753,891,696,982,1629,1137,521,524,406,465,484,-118,3,-121
615,430000,79de4e4b24c35b04,5,0,802,747,984,1113,1544,1234,1513,2352,1658,771,808,663,736,747,-145,37,-182
359,350000,79de4e4b24c35b04,5,0,411,360,626,548,706,724,738,1086,453,316,456,314,385,362,-142,140,-282
482,210000,79de4e4b24c35b04,5,0,383,376,528,616,644,644,694,1039,408,313,505,468,486,429,-37,192,-229
136,500000,79de4e4b24c35b04,5,0,261,287,297,277,359,279,304,514,324,210,169,172,170,184,3,-41,44
488,610000,79de4e4b24c35b04,5,0,460,358,538,648,785,855,1045,1704,937,403,499,452,476,451,-47,96,-143
469,230000,79de4e4b24c35b04,5,0,475,475,643,791,839,638,832,1045,394,365,562,482,522,470,-80,197,-277
647,310000,12f8b7e14947c34d,5,0,785,835,1350,1065,2065,1032,1283,1483,389,338,505,521,513,455,16,167,-151
226,530000,12f8b7e14947c34d,5,0,244,208,404,346,402,396,360,567,208,160,208,214,211,194,6,48,-42
387,150000,12f8b7e14947c34d,5,0,527,415,569,575,712,648,698,789,413,215,340,311,326,289,-29,125,-154
102,110000,12f8b7e14947c34d,5,0,374,346,429,397,451,276,389,488,143,102,126,84,105,104,-42,24,-66
559,510000,12f8b7e14947c34d,5,0,677,695,682,820,1286,786,820,1117,531,374,577,521,549,491,-56,203,-259
257,340000,12f8b7e14947c34d,5,0,414,357,477,644,726,594,615,705,385,198,241,246,244,228,5,43,-38
928,370000,12f8b7e14947c34d,5,0,1271,1075,1292,1454,1777,1435,1352,1707,803,424,738,843,790,668,105,314,-209
231,140000,12f8b7e14947c34d,5,0,376,259,310,346,391,347,352,464,131,87,174,169,172,143,-5,87,-92
239,440000,12f8b7e14947c34d,5,0,277,296,248,286,326,342,407,475,130,117,221,195,208,178,-26,104,-130
89,450000,12f8b7e14947c34d,5,0,154,153,106,135,181,167,158,231,93,43,77,54,66,58,-23,34,-57
1280,320000,12f8b7e14947c34d,5,0,1718,1504,1598,2024,2099,1880,1868,2181,991,782,1094,1007,1050,961,-87,312,-399
217,360000,12f8b7e14947c34d,5,0,384,268,290,349,532,430,438,495,251,128,183,180,182,164,-3,55,-58
847,130000,12f8b7e14947c34d,5,0,745,713,769,1026,1153,782,978,1229,546,360,592,598,595,517,6,232,-226
471,410000,12f8b7e14947c34d,5,0,656,595,849,951,954,750,835,1053,508,259,492,410,451,387,-82,233,-315
632,330000,12f8b7e14947c34d,5,0,696,655,723,773,920,884,1063,1213,348,291,556,450,503,432,-106,265,-371
174,420000,12f8b7e14947c34d,5,0,212,303,273,340,406,336,358,440,200,80,136,138,137,118,2,56,-54
307,430000,12f8b7e14947c34d,5,0,428,388,473,550,688,528,670,749,385,150,254,224,239,209,-30,104,-134
297,350000,12f8b7e14947c34d,5,0,308,207,297,275,314,302,385,408,188,136,178,176,177,163,-2,42,-44
109,210000,12f8b7e14947c34d,5,0,162,151,156,254,246,156,195,210,53,54,81,84,82,73,3,27,-24
117,500000,12f8b7e14947c34d,5,0,182,218,192,205,240,178,181,295,131,85,113,117,115,105,4,28,-24
649,610000,12f8b7e14947c34d,5,0,950,666,1062,1276,1109,958,1012,1286,412,280,531,610,570,474,79,251,-172
150,230000,12f8b7e14947c34d,5,0,265,200,199,236,256,202,210,228,66,80,160,104,132,115,-56,80,-136
214,310000,04e66e578f653ab9,5,0,229,293,265,342,422,337,524,679,950,175,263,226,244,221,-37,88,-125
106,530000,04e66e578f653ab9,5,0,77,88,123,129,142,173,215,293,131,118,135,108,122,120,-27,17,-44
62,150000,04e66e578f653ab9,5,0,68,57,63,80,87,94,102,118,60,38,63,48,56,50,-15,25,-40
117,110000,04e66e578f653ab9,5,0,144,157,165,158,241,166,231,280,180,87,167,105,136,120,-62,80,-142
126,510000,04e66e578f653ab9,5,0,176,134,135,208,419,226,291,404,151,140,210,163,186,171,-47,70,-117
80,340000,04e66e578f653ab9,5,0,82,105,84,146,172,127,176,201,116,64,85,74,80,74,-11,21,-32
237,370000,04e66e578f653ab9,5,0,249,208,207,253,405,274,383,451,230,146,276,296,286,239,20,130,-110
43,140000,04e66e578f653ab9,5,0,54,47,58,68,104,75,85,95,42,23,68,34,51,42,-34,45,-79
111,440000,04e66e578f653ab9,5,0,114,119,105,149,140,175,225,268,104,54,144,101,122,100,-43,90,-133
42,450000,04e66e578f653ab9,5,0,26,35,28,43,42,39,42,71,30,28,32,17,24,26,-15,4,-19
361,320000,04e66e578f653ab9,5,0,305,326,286,477,566,501,644,669,334,279,388,278,333,315,-110,109,-219
58,360000,04e66e578f653ab9,5,0,68,55,61,72,97,83,104,86,64,32,40,53,46,42,13,8,5
190,130000,04e66e578f653ab9,5,0,124,117,113,185,186,192,206,272,140,97,162,151,156,137,-11,65,-76
133,410000,04e66e578f653ab9,5,0,86,115,109,191,156,169,219,319,144,90,156,142,149,129,-14,66,-80
236,330000,04e66e578f653ab9,5,0,174,199,216,262,293,289,400,452,190,120,235,179,207,178,-56,115,-171
44,420000,04e66e578f653ab9,5,0,55,47,45,58,71,47,81,82,146,33,61,41,51,45,-20,28,-48
71,430000,04e66e578f653ab9,5,0,123,93,121,118,158,115,135,228,105,59,115,89,102,88,-26,56,-82
76,350000,04e66e578f653ab9,5,0,77,80,72,82,93,107,132,139,77,43,64,62,63,56,-2,21,-23
48,210000,04e66e578f653ab9,5,0,48,22,42,64,69,52,62,81,42,40,28,19,24,29,-9,-12,3
34,500000,04e66e578f653ab9,5,0,19,68,61,42,66,46,77,87,44,31,56,52,54,46,-4,25,-29
120,610000,04e66e578f653ab9,5,0,132,92,109,169,208,170,201,238,124,83,169,151,160,134,-18,86,-104
40,230000,04e66e578f653ab9,5,0,45,30,38,60,45,45,56,48,22,17,60,50,55,42,-10,43,-53
198,310000,dff803b4024d261d,5,0,169,138,110,96,130,129,206,317,238,124,175,178,176,159,3,51,-48
59,530000,dff803b4024d261d,5,0,180,62,53,48,150,68,61,94,64,55,50,58,54,54,8,-5,13
113,150000,dff803b4024d261d,5,0,107,104,115,80,59,69,77,114,119,58,88,84,86,77,-4,30,-34
404,110000,dff803b4024d261d,5,0,1478,362,522,549,341,411,466,954,488,303,463,422,442,396,-41,160,-201
321,510000,dff803b4024d261d,5,0,329,313,287,213,226,219,270,560,493,212,308,310,309,277,2,96,-94
161,340000,dff803b4024d261d,5,0,132,112,137,105,226,131,164,192,238,108,126,152,139,129,26,18,8
743,370000,dff803b4024d261d,5,0,622,583,483,376,451,391,462,714,609,352,736,802,769,630,66,384,-318
162,140000,dff803b4024d261d,5,0,173,121,88,87,81,104,152,230,168,75,152,133,142,120,-19,77,-96
1371,440000,dff803b4024d261d,5,0,1151,1204,796,688,783,887,1988,1893,1283,554,1157,1342,1250,1018,185,603,-418
232,450000,dff803b4024d261d,5,0,292,302,238,333,211,167,204,333,316,132,218,179,198,176,-39,86,-125
790,320000,dff803b4024d261d,5,0,757,633,614,701,409,489,602,865,785,520,701,575,638,599,-126,181,-307
199,360000,dff803b4024d261d,5,0,361,199,120,104,272,168,194,280,264,100,195,178,186,158,-17,95,-112
444,130000,dff803b4024d261d,5,0,299,271,278,358,279,275,250,454,387,248,489,372,430,370,-117,241,-358
224,410000,dff803b4024d261d,5,0,201,225,287,201,184,168,191,300,319,141,195,250,222,195,55,54,1
623,330000,dff803b4024d261d,5,0,676,536,359,406,355,572,795,787,577,391,567,562,564,507,-5,176,-181
389,420000,dff803b4024d261d,5,0,394,422,178,222,287,394,374,566,545,193,390,310,350,298,-80,197,-277
352,430000,dff803b4024d261d,5,0,524,267,270,181,332,203,423,412,412,410,531,262,396,401,-269,121,-390
692,350000,dff803b4024d261d,5,0,502,255,324,353,331,397,363,562,555,242,485,658,572,462,173,243,-70
232,210000,dff803b4024d261d,5,0,310,263,240,234,219,239,228,340,230,163,328,229,278,240,-99,165,-264
256,500000,dff803b4024d261d,5,0,567,467,292,184,281,158,348,846,378,203,261,239,250,234,-22,58,-80
121,610000,dff803b4024d261d,5,0,127,82,202,64,63,62,99,126,138,68,103,103,103,91,0,35,-35
88,230000,dff803b4024d261d,5,0,107,81,71,56,91,46,89,107,57,72,88,195,142,118,107,16,91
133,310000,61e73e32ad101892,5,0,268,259,263,265,263,222,276,374,264,140,173,111,142,141,-62,33,-95
349,530000,61e73e32ad101892,5,0,287,259,444,328,322,420,444,423,403,246,278,240,259,255,-38,32,-70
397,150000,61e73e32ad101892,5,0,598,415,527,467,541,608,505,619,534,251,398,363,380,337,-35,147,-182
645,110000,61e73e32ad101892,5,0,925,776,823,803,1019,845,1016,1441,741,459,672,521,596,551,-151,213,-364
516,510000,61e73e32ad101892,5,0,780,668,723,668,1080,712,743,1078,940,507,616,610,613,578,-6,109,-115
170,340000,61e73e32ad101892,5,0,212,209,143,177,210,217,212,273,247,107,152,149,150,136,-3,45,-48
631,370000,61e73e32ad101892,5,0,816,666,592,643,866,764,681,1011,688,350,548,657,602,518,109,198,-89
272,140000,61e73e32ad101892,5,0,279,232,228,276,283,280,288,348,274,115,219,218,218,184,-1,104,-105
1547,440000,61e73e32ad101892,5,0,1757,1676,1516,1456,1686,2097,2144,2562,1849,777,1549,1067,1308,1131,-482,772,-1254
226,450000,61e73e32ad101892,5,0,368,312,289,221,333,376,342,443,364,194,278,172,225,215,-106,84,-190
545,320000,61e73e32ad101892,5,0,720,594,521,656,670,713,682,857,658,425,546,407,476,459,-139,121,-260
242,360000,61e73e32ad101892,5,0,272,228,226,207,304,324,277,382,334,121,180,176,178,159,-4,59,-63
849,130000,61e73e32ad101892,5,0,789,655,636,756,829,875,790,1042,804,407,572,721,646,567,149,165,-16
450,410000,61e73e32ad101892,5,0,418,478,457,520,525,514,567,656,654,303,427,422,424,384,-5,124,-129
503,330000,61e73e32ad101892,5,0,672,696,609,628,658,707,687,970,632,338,464,407,436,403,-57,126,-183
929,420000,61e73e32ad101892,5,0,969,1189,812,879,1194,1234,1296,1458,1429,526,890,740,815,719,-150,364,-514
475,430000,61e73e32ad101892,5,0,529,432,433,504,586,532,579,879,712,262,444,376,410,361,-68,182,-250
399,350000,61e73e32ad101892,5,0,437,254,309,324,331,423,388,523,387,223,336,237,286,265,-99,113,-212
611,210000,61e73e32ad101892,5,0,952,717,778,859,919,871,786,1105,571,424,658,595,626,559,-63,234,-297
290,500000,61e73e32ad101892,5,0,390,863,400,378,452,406,568,732,616,327,364,351,358,347,-13,37,-50
505,610000,61e73e32ad101892,5,0,586,401,428,429,480,618,464,618,561,288,381,522,452,397,141,93,48
314,230000,61e73e32ad101892,5,0,391,379,393,463,364,346,348,497,267,165,333,307,320,268,-26,168,-194
42,310000,a432c483b5beb856,5,0,138,95,119,125,135,111,242,237,68,37,61,48,54,49,-13,24,-37
72,530000,a432c483b5beb856,5,0,123,110,141,143,170,165,182,271,140,100,100,97,98,99,-3,0,-3
87,150000,a432c483b5beb856,5,0,150,140,118,135,135,144,149,195,78,54,74,78,76,69,4,20,-16
32,110000,a432c483b5beb856,5,0,142,156,136,151,163,97,128,205,34,44,59,36,48,46,-23,15,-38
123,510000,a432c483b5beb856,5,0,331,297,273,290,355,284,276,560,275,186,178,154,166,173,-24,-8,-16
103,340000,a432c483b5beb856,5,0,155,164,187,210,258,234,289,496,209,109,109,97,103,105,-12,0,-12
193,370000,a432c483b5beb856,5,0,429,398,297,370,455,430,397,599,241,156,188,181,184,175,-7,32,-39
76,140000,a432c483b5beb856,5,0,191,136,138,154,165,187,192,226,67,52,65,70,68,62,5,13,-8
504,440000,a432c483b5beb856,5,0,902,957,908,969,966,1096,1273,1753,510,290,467,429,448,395,-38,177,-215
89,450000,a432c483b5beb856,5,0,150,145,121,133,163,183,209,314,161,76,113,66,90,85,-47,37,-84
395,320000,a432c483b5beb856,5,0,626,524,494,659,663,720,808,1176,484,399,360,358,359,372,-2,-39,37
123,360000,a432c483b5beb856,5,0,200,179,156,182,243,282,281,556,258,99,139,120,130,119,-19,40,-59
184,130000,a432c483b5beb856,5,0,334,278,240,275,311,284,290,435,164,126,133,165,149,141,32,7,25
188,410000,a432c483b5beb856,5,0,293,353,273,313,316,283,364,562,252,130,136,161,148,142,25,6,19
293,330000,a432c483b5beb856,5,0,604,578,536,581,660,738,799,1102,332,255,331,293,312,293,-38,76,-114
79,420000,a432c483b5beb856,5,0,226,274,204,230,271,257,362,526,267,110,92,100,96,101,8,-18,26
119,430000,a432c483b5beb856,5,0,225,184,208,271,292,260,313,627,286,115,133,96,114,115,-37,18,-55
141,350000,a432c483b5beb856,5,0,272,218,246,274,282,315,340,500,185,128,160,130,145,139,-30,32,-62
127,210000,a432c483b5beb856,5,0,339,300,311,310,311,260,209,299,101,86,133,111,122,110,-22,47,-69
80,500000,a432c483b5beb856,5,0,174,215,160,199,165,151,159,317,179,87,70,59,64,72,-11,-17,6
62,610000,a432c483b5beb856,5,0,119,143,116,126,114,163,141,242,89,58,62,55,58,58,-7,4,-11
61,230000,a432c483b5beb856,5,0,154,146,135,155,139,103,121,126,60,44,65,66,66,58,1,21,-20
311,310000,0797526c057dcf5b,5,0,401,401,321,346,427,336,1289,571,175,135,300,320,310,252,20,165,-145
174,530000,0797526c057dcf5b,5,0,202,186,247,218,226,257,285,393,160,154,201,154,178,170,-47,47,-94
352,150000,0797526c057dcf5b,5,0,235,185,198,218,291,326,339,631,236,164,278,287,282,243,9,114,-105
299,110000,0797526c057dcf5b,5,0,619,663,697,743,797,664,656,980,232,253,315,319,317,296,4,62,-58
703,510000,0797526c057dcf5b,5,0,577,808,786,904,1230,923,1016,1536,609,478,708,677,692,621,-31,230,-261
450,340000,0797526c057dcf5b,5,0,258,304,319,476,565,666,550,750,358,257,522,447,484,409,-75,265,-340
1985,370000,0797526c057dcf5b,5,0,2095,1935,1835,2200,2915,3148,3502,5481,1788,1203,1635,2012,1824,1617,377,432,-55
775,140000,0797526c057dcf5b,5,0,544,496,521,585,792,899,919,1474,502,371,567,626,596,521,59,196,-137
7957,440000,0797526c057dcf5b,5,0,8617,8587,8085,9999,11167,12710,12394,15317,5306,3718,8079,6812,7446,6203,-1267,4361,-5628
1463,450000,0797526c057dcf5b,5,0,933,1046,1010,1186,1639,1709,1789,2693,1195,777,1366,1087,1226,1077,-279,589,-868
2259,320000,0797526c057dcf5b,5,0,1356,1362,1273,1726,2274,2226,2622,3296,1247,1529,2148,2087,2118,1921,-61,619,-680
979,360000,0797526c057dcf5b,5,0,537,595,606,715,1083,1277,1265,1764,857,484,797,835,816,705,38,313,-275
1832,130000,0797526c057dcf5b,5,0,1174,1117,1091,1516,1988,2221,2449,3796,1214,995,1259,1697,1478,1317,438,264,174
1391,410000,0797526c057dcf5b,5,0,851,918,1151,1553,1783,1739,1951,3130,1278,848,1290,1492,1391,1210,202,442,-240
1509,330000,0797526c057dcf5b,5,0,1084,1050,1140,1443,1709,2001,2019,2088,700,801,1246,1369,1308,1139,123,445,-322
842,420000,0797526c057dcf5b,5,0,585,851,689,870,1071,1120,1425,1562,736,376,772,827,800,658,55,396,-341
1503,430000,0797526c057dcf5b,5,0,1343,1265,1384,1668,1721,1444,1769,3168,1244,677,1105,1093,1099,958,-12,428,-440
1316,350000,0797526c057dcf5b,5,0,1047,978,991,1227,1477,1846,1591,1981,769,598,1058,945,1002,867,-113,460,-573
1606,210000,0797526c057dcf5b,5,0,2738,2351,2715,3298,3035,2443,2622,3705,1059,1132,1642,1541,1592,1438,-101,510,-611
400,500000,0797526c057dcf5b,5,0,307,592,510,660,624,494,548,828,333,235,331,330,330,299,-1,96,-97
326,610000,0797526c057dcf5b,5,0,335,408,480,451,462,457,402,722,289,175,287,284,286,249,-3,112,-115
589,230000,0797526c057dcf5b,5,0,472,426,421,630,651,605,913,1064,350,347,604,509,556,487,-95,257,-352
175,310000,936168bd4850913d,5,0,231,232,275,253,330,234,241,272,250,161,224,213,218,199,-11,63,-74
329,530000,936168bd4850913d,5,0,273,237,317,281,288,285,282,383,494,162,297,298,298,252,1,135,-134
353,150000,936168bd4850913d,5,0,409,278,346,325,397,353,331,374,412,213,364,399,382,325,35,151,-116
230,110000,936168bd4850913d,5,0,423,454,541,459,651,432,527,798,336,255,324,347,336,309,23,69,-46
296,510000,936168bd4850913d,5,0,345,365,374,356,560,353,364,502,560,198,280,354,317,277,74,82,-8
359,340000,936168bd4850913d,5,0,364,321,347,370,464,369,339,449,378,228,339,365,352,311,26,111,-85
1085,370000,936168bd4850913d,5,0,1092,1036,1063,896,1347,1014,1020,1083,1132,648,948,1214,1081,937,266,300,-34
345,140000,936168bd4850913d,5,0,404,319,311,334,462,394,347,454,373,276,370,403,386,350,33,94,-61
2524,440000,936168bd4850913d,5,0,2432,2474,2478,2391,3040,2810,2842,3119,2859,1337,2735,2621,2678,2231,-114,1398,-1512
297,450000,936168bd4850913d,5,0,279,260,273,237,346,287,279,316,376,154,306,255,280,238,-51,152,-203
820,320000,936168bd4850913d,5,0,944,898,914,919,1153,908,905,1057,1012,579,905,787,846,757,-118,326,-444
342,360000,936168bd4850913d,5,0,387,321,370,350,407,325,334,414,397,195,355,439,397,330,84,160,-76
971,130000,936168bd4850913d,5,0,721,619,623,691,837,696,646,778,797,602,842,1066,954,837,224,240,-16
919,410000,936168bd4850913d,5,0,870,860,976,801,1165,786,979,1154,954,596,986,1159,1072,914,173,390,-217
669,330000,936168bd4850913d,5,0,679,619,746,631,767,611,709,819,752,388,650,682,666,573,32,262,-230
1057,420000,936168bd4850913d,5,0,1131,1321,1289,1127,1463,1111,1292,1497,1405,549,1164,1131,1148,948,-33,615,-648
570,430000,936168bd4850913d,5,0,762,693,656,726,776,563,649,953,623,341,556,689,622,529,133,215,-82
612,350000,936168bd4850913d,5,0,627,554,655,558,641,586,610,611,627,347,556,479,518,461,-77,209,-286
631,210000,936168bd4850913d,5,0,714,579,727,667,816,696,727,851,758,485,709,730,720,641,21,224,-203
128,500000,936168bd4850913d,5,0,139,215,222,181,222,152,145,208,248,87,111,125,118,108,14,24,-10
360,610000,936168bd4850913d,5,0,418,335,362,360,429,415,400,482,463,229,331,386,358,315,55,102,-47
461,230000,936168bd4850913d,5,0,673,545,503,567,621,450,630,549,617,346,607,485,546,479,-122,261,-383
211,310000,cc21c7e91a3b5a0c,5,0,271,242,256,281,287,238,345,456,114,153,205,172,188,177,-33,52,-85
383,530000,cc21c7e91a3b5a0c,5,0,288,270,381,345,327,285,338,442,406,203,364,347,356,305,-17,161,-178
379,150000,cc21c7e91a3b5a0c,5,0,287,238,235,267,246,282,331,382,195,193,311,298,304,267,-13,118,-131
156,110000,cc21c7e91a3b5a0c,5,0,275,251,253,208,303,262,356,580,121,115,186,128,157,143,-58,71,-129
467,510000,cc21c7e91a3b5a0c,5,0,461,461,453,451,636,487,569,804,459,234,390,378,384,334,-12,156,-168
485,340000,cc21c7e91a3b5a0c,5,0,346,364,377,400,439,428,489,503,403,244,376,434,405,351,58,132,-74
906,370000,cc21c7e91a3b5a0c,5,0,877,768,778,692,815,855,912,1164,554,505,703,953,828,720,250,198,52
310,140000,cc21c7e91a3b5a0c,5,0,316,230,226,277,310,284,316,428,223,193,301,299,300,264,-2,108,-110
2880,440000,cc21c7e91a3b5a0c,5,0,2367,2317,2288,2219,2478,2450,3345,3730,1930,1262,2615,2284,2450,2054,-331,1353,-1684
370,450000,cc21c7e91a3b5a0c,5,0,316,262,277,270,290,313,377,417,266,187,309,304,306,267,-5,122,-127
1243,320000,cc21c7e91a3b5a0c,5,0,1171,1053,1035,1139,1193,1114,1454,1527,877,754,1069,1130,1100,984,61,315,-254
500,360000,cc21c7e91a3b5a0c,5,0,344,324,354,314,340,317,350,507,305,161,323,377,350,287,54,162,-108
877,130000,cc21c7e91a3b5a0c,5,0,575,563,517,521,590,551,574,797,453,434,572,723,648,576,151,138,13
764,410000,cc21c7e91a3b5a0c,5,0,609,620,657,647,687,548,872,1036,630,391,702,797,750,630,95,311,-216
1092,330000,cc21c7e91a3b5a0c,5,0,952,851,928,863,800,942,1151,1258,739,529,861,969,915,786,108,332,-224
822,420000,cc21c7e91a3b5a0c,5,0,857,1022,954,876,1065,918,1189,1511,963,454,719,775,747,649,56,265,-209
470,430000,cc21c7e91a3b5a0c,5,0,440,412,436,456,456,452,506,737,420,189,443,430,436,354,-13,254,-267
659,350000,cc21c7e91a3b5a0c,5,0,634,509,574,525,556,643,734,779,473,353,640,561,600,518,-79,287,-366
512,210000,cc21c7e91a3b5a0c,5,0,415,359,423,434,437,390,480,602,285,241,431,475,453,382,44,190,-146
153,500000,cc21c7e91a3b5a0c,5,0,153,256,232,218,203,186,200,305,185,95,179,155,167,143,-24,84,-108
346,610000,cc21c7e91a3b5a0c,5,0,291,238,303,301,293,309,345,496,293,157,234,292,263,228,58,77,-19
385,230000,cc21c7e91a3b5a0c,5,0,422,361,360,329,347,306,404,422,214,206,322,309,316,279,-13,116,-129
130,310000,7aab7fca2470987e,5,0,249,227,228,228,248,166,277,348,224,140,212,313,262,222,101,72,29
20,530000,7aab7fca2470987e,5,0,19,13,29,23,22,12,22,33,19,19,18,22,20,20,4,-1,5
17,150000,7aab7fca2470987e,5,0,32,22,34,26,20,16,19,22,21,19,29,36,32,28,7,10,-3
244,110000,7aab7fca2470987e,5,0,371,412,397,450,433,353,372,511,424,244,378,320,349,314,-58,134,-192
29,510000,7aab7fca2470987e,5,0,41,50,45,33,53,34,42,64,69,42,47,33,40,41,-14,5,-19
45,340000,7aab7fca2470987e,5,0,77,54,58,60,65,52,74,75,83,59,59,57,58,58,-2,0,-2
192,370000,7aab7fca2470987e,5,0,321,323,323,300,349,309,286,341,430,189,295,303,299,262,8,106,-98
62,140000,7aab7fca2470987e,5,0,85,61,83,86,76,58,62,78,105,64,83,78,80,75,-5,19,-24
579,440000,7aab7fca2470987e,5,0,929,824,845,827,959,887,972,1235,1009,443,848,749,798,680,-99,405,-504
20,450000,7aab7fca2470987e,5,0,33,22,15,35,23,23,13,26,34,17,20,12,16,16,-8,3,-11
241,320000,7aab7fca2470987e,5,0,372,366,390,384,352,323,380,481,397,258,351,301,326,303,-50,93,-143
25,360000,7aab7fca2470987e,5,0,28,35,34,41,44,29,35,37,61,16,26,40,33,27,14,10,4
218,130000,7aab7fca2470987e,5,0,221,251,231,259,229,234,231,316,308,172,236,271,254,226,35,64,-29
105,410000,7aab7fca2470987e,5,0,189,186,204,209,192,150,188,209,242,134,155,146,150,145,-9,21,-30
311,330000,7aab7fca2470987e,5,0,279,263,302,300,252,293,323,375,353,222,270,371,320,288,101,48,53
39,420000,7aab7fca2470987e,5,0,48,56,41,58,58,26,64,62,54,47,52,51,52,50,-1,5,-6
26,430000,7aab7fca2470987e,5,0,33,37,54,26,47,25,31,44,54,26,27,28,28,27,1,1,0
37,350000,7aab7fca2470987e,5,0,65,63,56,64,42,57,83,105,92,41,56,43,50,47,-13,15,-28
115,210000,7aab7fca2470987e,5,0,173,177,170,176,181,127,153,187,158,103,124,129,126,119,5,21,-16
19,500000,7aab7fca2470987e,5,0,16,43,25,22,19,17,12,27,22,12,27,12,20,17,-15,15,-30
27,610000,7aab7fca2470987e,5,0,50,39,32,34,19,25,29,46,61,16,38,37,38,30,-1,22,-23
37,230000,7aab7fca2470987e,5,0,117,107,90,78,77,62,61,65,66,41,61,62,62,55,1,20,-19
165,310000,fde95ea242abd896,5,0,244,231,222,233,237,260,331,369,161,142,190,140,165,157,-50,48,-98
292,530000,fde95ea242abd896,5,0,293,280,397,351,388,519,521,651,386,202,309,233,271,248,-76,107,-183
131,150000,fde95ea242abd896,5,0,173,112,115,149,181,185,190,234,146,90,139,127,133,119,-12,49,-61
153,110000,fde95ea242abd896,5,0,267,240,223,271,313,223,301,382,210,141,181,149,165,157,-32,40,-72
344,510000,fde95ea242abd896,5,0,401,386,408,384,645,492,617,839,509,240,360,342,351,314,-18,120,-138
293,340000,fde95ea242abd896,5,0,328,323,371,429,508,453,504,690,387,163,254,266,260,228,12,91,-79
555,370000,fde95ea242abd896,5,0,677,569,603,642,825,774,709,964,444,303,464,570,517,446,106,161,-55
221,140000,fde95ea242abd896,5,0,268,247,194,300,278,277,302,443,175,132,238,204,221,191,-34,106,-140
2996,440000,fde95ea242abd896,5,0,3407,3034,2769,3466,3967,4449,4901,5547,3229,1517,2906,3040,2973,2488,134,1389,-1255
278,450000,fde95ea242abd896,5,0,323,305,295,375,362,434,458,665,381,181,321,247,284,250,-74,140,-214
698,320000,fde95ea242abd896,5,0,886,740,767,910,875,888,974,1139,690,508,722,614,668,615,-108,214,-322
321,360000,fde95ea242abd896,5,0,296,306,326,283,440,408,499,625,381,184,276,300,288,253,24,92,-68
507,130000,fde95ea242abd896,5,0,518,437,434,560,591,602,602,830,407,320,433,514,474,422,81,113,-32
473,410000,fde95ea242abd896,5,0,451,445,414,574,666,620,614,920,507,247,499,530,514,425,31,252,-221
817,330000,fde95ea242abd896,5,0,954,959,917,968,1148,998,1169,1424,732,558,806,842,824,735,36,248,-212
504,420000,fde95ea242abd896,5,0,667,730,629,764,987,818,1066,1347,698,270,511,498,504,426,-13,241,-254
498,430000,fde95ea242abd896,5,0,567,522,526,503,752,630,700,988,570,203,418,421,420,347,3,215,-212
656,350000,fde95ea242abd896,5,0,633,509,603,671,676,754,796,1043,605,368,580,595,588,514,15,212,-197
363,210000,fde95ea242abd896,5,0,445,435,473,472,553,433,460,600,253,193,341,357,349,297,16,148,-132
127,500000,fde95ea242abd896,5,0,157,246,168,172,243,227,222,229,139,105,116,140,128,120,24,11,13
155,610000,fde95ea242abd896,5,0,179,148,148,164,191,253,229,293,140,96,140,126,133,121,-14,44,-58
232,230000,fde95ea242abd896,5,0,309,255,234,372,256,198,199,322,111,123,264,218,241,202,-46,141,-187
312,310000,97f15de12cfabbd5,5,0,212,242,279,368,455,354,457,516,264,193,369,368,368,310,-1,176,-177
120,530000,97f15de12cfabbd5,5,0,90,69,134,137,168,236,233,253,206,111,144,116,130,124,-28,33,-61
184,150000,97f15de12cfabbd5,5,0,161,112,170,148,180,212,200,238,219,114,172,145,158,144,-27,58,-85
375,110000,97f15de12cfabbd5,5,0,541,572,614,704,733,603,754,1094,601,390,482,397,440,423,-85,92,-177
251,510000,97f15de12cfabbd5,5,0,215,241,286,280,498,363,489,543,391,237,325,296,310,286,-29,88,-117
254,340000,97f15de12cfabbd5,5,0,222,253,319,361,472,444,568,578,495,153,185,233,209,190,48,32,16
791,370000,97f15de12cfabbd5,5,0,644,594,653,771,1001,1018,1094,1221,1031,476,846,727,786,683,-119,370,-489
297,140000,97f15de12cfabbd5,5,0,307,319,310,398,381,370,395,605,316,221,369,335,352,308,-34,148,-182
2143,440000,97f15de12cfabbd5,5,0,1775,1807,1926,2292,2762,3019,3563,3747,2666,1125,2377,2460,2418,1987,83,1252,-1169
114,450000,97f15de12cfabbd5,5,0,131,107,105,132,134,146,194,174,193,92,119,101,110,104,-18,27,-45
895,320000,97f15de12cfabbd5,5,0,791,789,884,1139,1155,1292,1491,1524,1070,552,1008,901,954,820,-107,456,-563
201,360000,97f15de12cfabbd5,5,0,135,142,163,206,280,258,340,409,346,81,166,179,172,142,13,85,-72
790,130000,97f15de12cfabbd5,5,0,560,621,573,819,812,975,971,1119,789,422,734,762,748,639,28,312,-284
450,410000,97f15de12cfabbd5,5,0,356,378,472,519,592,609,805,866,692,326,488,531,510,448,43,162,-119
1108,330000,97f15de12cfabbd5,5,0,729,797,1116,1100,1259,1371,1516,1515,1138,549,969,1010,990,843,41,420,-379
381,420000,97f15de12cfabbd5,5,0,306,462,346,475,707,729,779,906,749,253,446,434,440,378,-12,193,-205
430,430000,97f15de12cfabbd5,5,0,400,350,381,419,626,645,767,839,710,238,437,402,420,359,-35,199,-234
519,350000,97f15de12cfabbd5,5,0,309,251,400,389,434,571,612,638,509,288,542,508,525,446,-34,254,-288
971,210000,97f15de12cfabbd5,5,0,921,843,1057,1068,1256,1020,1269,1395,898,506,962,872,917,780,-90,456,-546
104,500000,97f15de12cfabbd5,5,0,164,243,183,190,183,170,200,213,159,106,164,130,147,133,-34,58,-92
179,610000,97f15de12cfabbd5,5,0,222,212,278,246,251,273,309,371,227,159,225,195,210,193,-30,66,-96
448,230000,97f15de12cfabbd5,5,0,459,440,381,659,536,422,639,783,366,217,537,358,448,371,-179,320,-499
218,310000,f5d69960089c3614,5,0,179,143,213,231,263,186,304,291,260,125,252,169,210,182,-83,127,-210
61,530000,f5d69960089c3614,5,0,47,40,86,70,45,62,97,95,78,48,59,48,54,52,-11,11,-22
69,150000,f5d69960089c3614,5,0,59,30,34,48,53,57,54,64,35,18,51,53,52,41,2,33,-31
391,110000,f5d69960089c3614,5,0,580,328,387,431,542,458,551,739,435,233,445,341,393,340,-104,212,-316
190,510000,f5d69960089c3614,5,0,189,198,208,192,406,218,246,296,270,133,178,212,195,174,34,45,-11
81,340000,f5d69960089c3614,5,0,77,68,83,102,108,119,125,125,156,59,89,69,79,72,-20,30,-50
226,370000,f5d69960089c3614,5,0,226,189,211,236,259,209,228,356,218,112,223,197,210,177,-26,111,-137
43,140000,f5d69960089c3614,5,0,34,37,39,38,29,27,53,51,47,21,35,29,32,28,-6,14,-20
338,440000,f5d69960089c3614,5,0,290,315,201,283,319,341,442,572,437,152,310,246,278,236,-64,158,-222
38,450000,f5d69960089c3614,5,0,40,44,25,47,48,35,38,46,44,34,25,32,28,30,7,-9,16
214,320000,f5d69960089c3614,5,0,199,160,179,202,235,218,248,301,251,138,200,177,188,172,-23,62,-85
76,360000,f5d69960089c3614,5,0,67,46,43,63,74,57,75,92,84,32,51,53,52,45,2,19,-17
144,130000,f5d69960089c3614,5,0,94,85,75,106,81,95,123,131,106,79,112,113,112,101,1,33,-32
108,410000,f5d69960089c3614,5,0,146,115,120,133,136,137,144,187,131,57,111,155,133,108,44,54,-10
108,330000,f5d69960089c3614,5,0,120,103,117,123,127,129,149,230,149,78,139,107,123,108,-32,61,-93
101,420000,f5d69960089c3614,5,0,133,83,100,88,128,132,148,184,148,61,111,94,102,89,-17,50,-67
108,430000,f5d69960089c3614,5,0,132,99,113,129,125,121,157,211,135,74,132,109,120,105,-23,58,-81
97,350000,f5d69960089c3614,5,0,110,85,91,79,63,93,111,124,108,57,77,71,74,68,-6,20,-26
107,210000,f5d69960089c3614,5,0,114,94,86,129,93,93,126,129,69,51,75,76,76,67,1,24,-23
87,500000,f5d69960089c3614,5,0,102,141,124,91,113,105,132,160,125,77,112,97,104,95,-15,35,-50
172,610000,f5d69960089c3614,5,0,132,93,101,114,118,176,150,182,148,77,137,111,124,108,-26,60,-86
50,230000,f5d69960089c3614,5,0,58,77,51,83,64,44,71,77,53,34,68,53,60,52,-15,34,-49
105,310000,5b1c11c3efed5312,5,0,137,100,120,182,195,186,244,388,154,85,126,92,109,101,-34,41,-75
77,530000,5b1c11c3efed5312,5,0,155,102,132,175,199,190,214,267,194,91,60,53,56,68,-7,-31,24
68,150000,5b1c11c3efed5312,5,0,123,90,86,129,117,180,167,259,127,62,61,62,62,62,1,-1,2
21,110000,5b1c11c3efed5312,5,0,135,132,124,189,195,143,181,370,71,41,51,25,38,39,-26,10,-36
118,510000,5b1c11c3efed5312,5,0,268,235,259,271,451,335,432,691,448,194,129,110,120,144,-19,-65,46
259,340000,5b1c11c3efed5312,5,0,511,409,457,615,665,719,699,1253,712,250,227,217,222,231,-10,-23,13
332,370000,5b1c11c3efed5312,5,0,759,542,525,598,799,850,792,1449,549,320,297,347,322,321,50,-23,73
114,140000,5b1c11c3efed5312,5,0,184,119,112,180,176,226,231,426,153,81,103,83,93,89,-20,22,-42
344,440000,5b1c11c3efed5312,5,0,656,557,570,682,810,953,1204,1628,496,168,342,246,294,252,-96,174,-270
39,450000,5b1c11c3efed5312,5,0,99,74,74,93,96,119,135,240,121,56,54,26,40,45,-28,-2,-26
487,320000,5b1c11c3efed5312,5,0,815,558,664,879,928,1050,1083,1908,768,543,404,402,403,450,-2,-139,137
191,360000,5b1c11c3efed5312,5,0,290,238,256,256,368,358,434,733,453,153,150,168,159,157,18,-3,21
350,130000,5b1c11c3efed5312,5,0,541,372,433,513,576,665,667,1158,476,272,257,300,278,276,43,-15,58
366,410000,5b1c11c3efed5312,5,0,670,565,604,728,823,894,1006,1883,910,372,312,380,346,355,68,-60,128
361,330000,5b1c11c3efed5312,5,0,772,623,618,806,968,1022,1202,2202,744,430,386,337,362,384,-49,-44,-5
145,420000,5b1c11c3efed5312,5,0,222,214,224,236,278,353,409,749,443,143,138,130,134,137,-8,-5,-3
138,430000,5b1c11c3efed5312,5,0,299,206,221,263,352,322,439,744,378,131,137,149,143,139,12,6,6
137,350000,5b1c11c3efed5312,5,0,224,163,185,197,242,345,391,594,265,149,173,130,152,151,-43,24,-67
84,210000,5b1c11c3efed5312,5,0,172,127,118,166,151,176,186,256,75,62,80,75,78,72,-5,18,-23
20,500000,5b1c11c3efed5312,5,0,60,103,92,81,101,86,92,172,124,38,29,23,26,30,-6,-9,3
97,610000,5b1c11c3efed5312,5,0,180,107,108,126,155,205,212,325,144,79,70,64,67,71,-6,-9,3
43,230000,5b1c11c3efed5312,5,0,116,90,66,138,116,107,126,152,43,36,52,38,45,42,-14,16,-30
5,310000,17363f08d683d52b,5,0,61,83,70,93,94,69,88,96,65,19,37,175,106,77,138,18,120
83,530000,17363f08d683d52b,5,0,150,145,260,181,192,214,209,182,216,75,82,86,84,81,4,7,-3
69,150000,17363f08d683d52b,5,0,189,132,152,130,174,176,130,141,132,46,66,45,56,52,-21,20,-41
29,110000,17363f08d683d52b,5,0,215,203,267,229,259,158,186,277,124,81,65,48,56,65,-17,-16,-1
81,510000,17363f08d683d52b,5,0,265,277,338,249,374,267,205,292,350,117,93,78,86,96,-15,-24,9
90,340000,17363f08d683d52b,5,0,334,403,369,409,407,332,341,384,513,121,108,92,100,107,-16,-13,-3
203,370000,17363f08d683d52b,5,0,501,534,578,578,669,572,480,596,555,214,153,209,181,192,56,-61,117
19,140000,17363f08d683d52b,5,0,84,72,80,105,82,89,70,67,66,26,12,22,17,20,10,-14,24
30,440000,17363f08d683d52b,5,0,205,161,153,130,99,91,101,84,62,19,63,37,50,40,-26,44,-70
6,450000,17363f08d683d52b,5,0,65,56,59,47,57,42,39,50,45,14,26,20,23,20,-6,12,-18
191,320000,17363f08d683d52b,5,0,511,498,540,652,534,502,474,569,538,214,216,188,202,206,-28,2,-30
90,360000,17363f08d683d52b,5,0,322,296,334,361,423,281,274,309,360,94,101,91,96,95,-10,7,-17
149,130000,17363f08d683d52b,5,0,423,331,415,474,378,372,326,383,353,154,150,162,156,155,12,-4,16
104,410000,17363f08d683d52b,5,0,458,439,537,516,505,471,372,457,538,139,100,129,114,123,29,-39,68
108,330000,17363f08d683d52b,5,0,481,523,527,619,525,437,429,453,388,129,152,151,152,144,-1,23,-24
158,420000,17363f08d683d52b,5,0,274,347,357,348,470,379,317,421,474,120,139,119,129,126,-20,19,-39
114,430000,17363f08d683d52b,5,0,285,332,369,394,455,353,348,428,459,95,148,114,131,119,-34,53,-87
55,350000,17363f08d683d52b,5,0,117,97,156,140,150,148,127,159,136,38,44,37,40,40,-7,6,-13
105,210000,17363f08d683d52b,5,0,224,186,211,236,239,216,174,238,151,59,93,137,115,96,44,34,10
19,500000,17363f08d683d52b,5,0,119,207,154,160,119,108,151,126,110,41,27,16,22,28,-11,-14,3
94,610000,17363f08d683d52b,5,0,295,195,243,241,219,279,210,288,180,80,67,82,74,76,15,-13,28
34,230000,17363f08d683d52b,5,0,155,119,135,185,126,121,118,156,75,46,57,45,51,49,-12,11,-23
219,310000,06880909932890ca,5,0,151,184,200,260,330,188,341,384,208,78,136,169,152,128,33,58,-25
116,530000,06880909932890ca,5,0,116,115,160,152,177,216,186,206,142,56,68,79,74,68,11,12,-1
72,150000,06880909932890ca,5,0,116,92,95,118,103,121,125,115,74,44,45,52,48,47,7,1,6
160,110000,06880909932890ca,5,0,502,404,587,598,646,461,553,771,253,139,206,162,184,169,-44,67,-111
396,510000,06880909932890ca,5,0,435,525,529,541,770,548,657,933,673,263,243,304,274,270,61,-20,81
526,340000,06880909932890ca,5,0,668,812,815,909,849,800,764,993,964,338,340,389,364,356,49,2,47
623,370000,06880909932890ca,5,0,912,798,955,1028,1068,979,957,1332,1011,383,430,537,484,450,107,47,60
136,140000,06880909932890ca,5,0,182,158,166,260,200,213,203,275,128,67,102,111,106,93,9,35,-26
734,440000,06880909932890ca,5,0,912,826,970,1165,1341,1182,1660,1546,767,278,638,579,608,498,-59,360,-419
125,450000,06880909932890ca,5,0,154,160,138,192,192,181,188,276,186,86,105,86,96,92,-19,19,-38
1356,320000,06880909932890ca,5,0,1690,1549,1784,2086,2054,2015,2022,2642,2094,991,984,1074,1029,1016,90,-7,97
326,360000,06880909932890ca,5,0,446,403,446,466,481,368,453,691,614,157,211,274,242,214,63,54,9
436,130000,06880909932890ca,5,0,571,550,679,797,728,665,667,773,530,290,330,342,336,321,12,40,-28
1055,410000,06880909932890ca,5,0,1156,1405,1588,1680,1676,1390,1577,2409,1865,640,650,891,770,727,241,10,231
913,330000,06880909932890ca,5,0,1198,1267,1405,1649,1572,1696,1832,2222,1022,501,663,715,689,626,52,162,-110
312,420000,06880909932890ca,5,0,378,470,475,562,525,475,492,661,605,178,211,256,234,215,45,33,12
352,430000,06880909932890ca,5,0,383,445,414,541,561,481,547,698,488,170,228,287,258,228,59,58,1
307,350000,06880909932890ca,5,0,311,284,350,418,427,469,556,601,361,197,246,246,246,230,0,49,-49
168,210000,06880909932890ca,5,0,287,226,287,309,335,246,211,328,161,100,120,120,120,113,0,20,-20
189,500000,06880909932890ca,5,0,287,447,415,439,445,330,373,430,326,140,158,145,152,148,-13,18,-31
210,610000,06880909932890ca,5,0,336,278,349,407,350,449,347,562,349,119,145,167,156,144,22,26,-4
62,230000,06880909932890ca,5,0,109,89,128,149,133,82,97,100,69,37,53,48,50,46,-5,16,-21
10,310000,9c1c7ee8ebdda299,5,0,27,22,13,27,10,4,41,46,32,19,54,17,36,30,-37,35,-72
62,530000,9c1c7ee8ebdda299,5,0,176,148,181,200,159,126,119,169,142,104,91,53,72,83,-38,-13,-25
176,150000,9c1c7ee8ebdda299,5,0,348,233,350,323,327,297,353,430,278,168,258,163,210,196,-95,90,-185
7,110000,9c1c7ee8ebdda299,5,0,167,151,170,121,96,46,78,112,52,38,30,13,22,27,-17,-8,-9
145,510000,9c1c7ee8ebdda299,5,0,701,834,869,836,723,408,517,641,617,336,250,134,192,240,-116,-86,-30
72,340000,9c1c7ee8ebdda299,5,0,330,322,293,261,211,71,198,190,278,146,119,59,89,108,-60,-27,-33
752,370000,9c1c7ee8ebdda299,5,0,1697,1542,1763,1885,1782,1445,1562,2281,1763,885,746,509,628,713,-237,-139,-98
317,140000,9c1c7ee8ebdda299,5,0,798,670,854,973,842,579,768,886,691,295,401,285,343,327,-116,106,-222
177,440000,9c1c7ee8ebdda299,5,0,797,730,793,791,821,619,710,1008,472,229,471,212,342,304,-259,242,-501
137,450000,9c1c7ee8ebdda299,5,0,170,190,169,185,191,132,192,308,251,110,119,55,87,95,-64,9,-73
111,320000,9c1c7ee8ebdda299,5,0,295,297,299,267,195,95,307,309,370,299,211,106,158,205,-105,-88,-17
42,360000,9c1c7ee8ebdda299,5,0,303,258,215,138,145,60,177,182,224,84,107,42,74,78,-65,23,-88
782,130000,9c1c7ee8ebdda299,5,0,1845,1547,1898,2125,1949,1092,1644,1840,1468,940,941,733,837,871,-208,1,-209
283,410000,9c1c7ee8ebdda299,5,0,772,817,797,693,546,306,774,911,1101,433,362,211,286,335,-151,-71,-80
241,330000,9c1c7ee8ebdda299,5,0,232,213,216,202,149,42,380,352,327,197,195,168,182,187,-27,-2,-25
39,420000,9c1c7ee8ebdda299,5,0,138,172,121,123,100,46,116,125,211,58,65,32,48,52,-33,7,-40
50,430000,9c1c7ee8ebdda299,5,0,204,207,195,142,140,74,141,165,230,105,87,42,64,78,-45,-18,-27
70,350000,9c1c7ee8ebdda299,5,0,254,259,254,219,159,110,281,215,204,105,130,66,98,100,-64,25,-89
215,210000,9c1c7ee8ebdda299,5,0,622,615,791,715,654,384,528,619,375,317,409,425,417,384,16,92,-76
34,500000,9c1c7ee8ebdda299,5,0,142,167,210,170,119,62,80,104,116,61,54,25,40,47,-29,-7,-22
123,610000,9c1c7ee8ebdda299,5,0,415,360,504,331,168,145,214,250,261,108,136,75,106,106,-61,28,-89
117,230000,9c1c7ee8ebdda299,5,0,349,289,307,328,302,291,350,342,207,144,192,137,164,158,-55,48,-103
200,310000,c6833cb891626c17,5,0,184,190,187,321,371,283,435,596,174,80,151,177,164,136,26,71,-45
241,530000,c6833cb891626c17,5,0,293,278,391,368,477,514,538,699,444,236,185,176,180,199,-9,-51,42
233,150000,c6833cb891626c17,5,0,231,182,278,328,337,354,323,485,221,94,125,138,132,119,13,31,-18
251,110000,c6833cb891626c17,5,0,557,512,616,785,877,636,879,1517,309,174,289,242,266,235,-47,115,-162
359,510000,c6833cb891626c17,5,0,498,519,553,602,1020,712,770,1305,743,339,285,287,286,304,2,-54,56
524,340000,c6833cb891626c17,5,0,556,596,658,834,1066,894,964,1597,855,344,344,422,383,370,78,0,78
829,370000,c6833cb891626c17,5,0,851,801,793,998,1278,1160,1107,1740,687,383,327,543,435,418,216,-56,272
207,140000,c6833cb891626c17,5,0,214,187,206,301,280,282,301,514,192,100,117,126,122,114,9,17,-8
460,440000,c6833cb891626c17,5,0,687,668,710,890,1382,1240,1586,1899,542,186,403,360,382,316,-43,217,-260
120,450000,c6833cb891626c17,5,0,186,226,201,232,277,266,309,514,260,96,110,81,96,96,-29,14,-43
899,320000,c6833cb891626c17,5,0,993,872,955,1345,1406,1396,1446,2279,939,574,593,645,619,604,52,19,33
302,360000,c6833cb891626c17,5,0,288,279,356,409,638,519,571,900,502,180,199,229,214,203,30,19,11
843,130000,c6833cb891626c17,5,0,727,602,725,929,1066,990,1108,1749,708,414,412,600,506,475,188,-2,190
1003,410000,c6833cb891626c17,5,0,926,1021,1208,1438,1525,1493,1622,2735,1331,509,557,792,674,619,235,48,187
899,330000,c6833cb891626c17,5,0,1069,1144,1284,1635,1804,1911,2130,3255,1119,581,616,676,646,624,60,35,25
309,420000,c6833cb891626c17,5,0,324,375,419,485,678,560,634,1014,597,202,210,256,233,223,46,8,38
280,430000,c6833cb891626c17,5,0,355,332,374,473,712,546,606,978,498,212,209,272,240,231,63,-3,66
214,350000,c6833cb891626c17,5,0,280,250,238,291,406,499,552,782,311,141,184,131,158,152,-53,43,-96
161,210000,c6833cb891626c17,5,0,243,206,229,283,315,299,258,424,127,80,97,131,114,103,34,17,17
126,500000,c6833cb891626c17,5,0,177,223,193,277,336,267,309,532,260,104,78,93,86,92,15,-26,41
263,610000,c6833cb891626c17,5,0,355,227,253,326,373,472,366,620,315,130,154,179,166,154,25,24,1
97,230000,c6833cb891626c17,5,0,191,155,137,237,206,170,232,274,80,52,66,71,68,63,5,14,-9
140,310000,3e21824be728cbec,5,0,176,192,187,249,257,239,345,396,369,177,174,163,168,171,-11,-3,-8
159,530000,3e21824be728cbec,5,0,206,289,300,344,358,406,373,334,203,134,207,159,183,167,-48,73,-121
40,150000,3e21824be728cbec,5,0,78,58,65,160,123,116,59,90,51,29,42,27,34,33,-15,13,-28
47,110000,3e21824be728cbec,5,0,119,141,164,139,203,168,222,242,93,60,87,42,64,63,-45,27,-72
333,510000,3e21824be728cbec,5,0,413,455,488,625,731,758,778,781,288,239,321,272,296,277,-49,82,-131
309,340000,3e21824be728cbec,5,0,349,370,347,570,630,644,607,661,309,266,301,237,269,268,-64,35,-99
433,370000,3e21824be728cbec,5,0,559,584,576,690,772,807,782,994,540,419,572,464,518,485,-108,153,-261
67,140000,3e21824be728cbec,5,0,140,127,162,287,240,200,132,201,88,44,87,60,74,64,-27,43,-70
394,440000,3e21824be728cbec,5,0,438,526,486,516,619,721,938,1135,331,231,477,411,444,373,-66,246,-312
131,450000,3e21824be728cbec,5,0,185,230,205,301,268,247,370,403,140,92,140,131,136,121,-9,48,-57
740,320000,3e21824be728cbec,5,0,765,791,837,1017,1020,1227,1286,1781,805,710,885,641,763,745,-244,175,-419
210,360000,3e21824be728cbec,5,0,276,230,221,285,391,438,444,431,157,97,173,170,172,147,-3,76,-79
455,130000,3e21824be728cbec,5,0,558,552,574,734,729,766,589,806,391,375,484,404,444,421,-80,109,-189
445,410000,3e21824be728cbec,5,0,632,668,840,854,777,834,729,896,363,334,528,418,473,427,-110,194,-304
466,330000,3e21824be728cbec,5,0,406,443,507,510,573,616,797,1044,341,386,475,363,419,408,-112,89,-201
150,420000,3e21824be728cbec,5,0,238,303,280,357,375,452,413,461,270,123,194,119,156,145,-75,71,-146
188,430000,3e21824be728cbec,5,0,235,250,255,292,394,414,458,478,157,99,182,167,174,149,-15,83,-98
283,350000,3e21824be728cbec,5,0,325,290,310,328,339,397,455,593,250,154,266,219,242,213,-47,112,-159
76,210000,3e21824be728cbec,5,0,118,118,139,151,144,114,136,149,45,36,75,66,70,59,-9,39,-48
160,500000,3e21824be728cbec,5,0,239,459,311,410,422,402,422,475,136,124,148,136,142,136,-12,24,-36
176,610000,3e21824be728cbec,5,0,382,320,375,494,446,595,355,464,194,145,188,141,164,158,-47,43,-90
34,230000,3e21824be728cbec,5,0,180,125,146,202,237,176,82,87,40,47,82,54,68,61,-28,35,-63
225,310000,f8a6975573af1b33,5,0,306,267,258,427,420,355,228,579,371,131,288,266,277,228,-22,157,-179
167,530000,f8a6975573af1b33,5,0,177,118,180,214,200,244,165,338,215,134,179,192,186,168,13,45,-32
53,150000,f8a6975573af1b33,5,0,58,32,43,34,40,41,43,48,41,28,59,37,48,41,-22,31,-53
70,110000,f8a6975573af1b33,5,0,264,181,202,267,304,268,372,383,131,61,110,108,109,93,-2,49,-51
456,510000,f8a6975573af1b33,5,0,410,336,352,370,632,431,484,820,550,286,428,433,430,382,5,142,-137
545,340000,f8a6975573af1b33,5,0,411,362,305,443,521,495,362,758,508,322,432,425,428,393,-7,110,-117
388,370000,f8a6975573af1b33,5,0,368,316,303,357,410,423,383,729,410,227,320,381,350,309,61,93,-32
47,140000,f8a6975573af1b33,5,0,71,48,59,51,78,61,91,136,74,57,53,62,58,57,9,-4,13
969,440000,f8a6975573af1b33,5,0,992,904,879,1153,1298,1305,1034,2232,1023,444,1072,1007,1040,841,-65,628,-693
178,450000,f8a6975573af1b33,5,0,201,169,192,217,237,215,191,328,208,107,160,131,146,133,-29,53,-82
969,320000,f8a6975573af1b33,5,0,1202,877,845,1153,1190,1239,807,1846,1142,747,1023,870,946,880,-153,276,-429
226,360000,f8a6975573af1b33,5,0,202,165,177,232,306,226,131,436,290,111,237,235,236,194,-2,126,-128
335,130000,f8a6975573af1b33,5,0,285,257,243,316,360,308,272,475,287,194,265,298,282,252,33,71,-38
513,410000,f8a6975573af1b33,5,0,424,404,405,509,554,543,420,747,459,249,457,513,485,406,56,208,-152
725,330000,f8a6975573af1b33,5,0,767,644,614,743,824,856,695,1454,752,503,780,679,730,654,-101,277,-378
251,420000,f8a6975573af1b33,5,0,213,257,205,250,304,278,190,481,312,158,246,258,252,221,12,88,-76
293,430000,f8a6975573af1b33,5,0,303,226,226,283,329,289,235,425,324,139,263,238,250,213,-25,124,-149
426,350000,f8a6975573af1b33,5,0,414,293,354,411,469,472,415,699,508,260,395,323,359,326,-72,135,-207
125,210000,f8a6975573af1b33,5,0,126,118,94,128,154,125,64,125,66,52,82,116,99,83,34,30,4
285,500000,f8a6975573af1b33,5,0,243,316,279,300,389,322,256,548,310,185,288,287,288,253,-1,103,-104
134,610000,f8a6975573af1b33,5,0,180,121,162,175,188,226,181,259,170,96,124,121,122,114,-3,28,-31
53,230000,f8a6975573af1b33,5,0,118,92,95,86,84,67,65,115,61,52,76,85,80,71,9,24,-15
272,310000,54fc07138d70374c,5,0,312,308,315,327,336,292,421,473,415,199,338,303,320,280,-35,139,-174
304,530000,54fc07138d70374c,5,0,239,271,381,320,316,363,485,535,500,259,353,295,324,302,-58,94,-152
191,150000,54fc07138d70374c,5,0,177,198,210,230,224,233,229,234,273,129,208,180,194,172,-28,79,-107
365,110000,54fc07138d70374c,5,0,374,335,454,424,442,429,500,681,534,295,402,398,400,365,-4,107,-111
508,510000,54fc07138d70374c,5,0,454,508,557,495,659,704,743,849,933,442,540,493,516,492,-47,98,-145
176,340000,54fc07138d70374c,5,0,207,204,219,249,314,271,334,368,404,198,210,162,186,190,-48,12,-60
558,370000,54fc07138d70374c,5,0,542,531,579,617,771,679,776,936,911,376,595,546,570,506,-49,219,-268
103,140000,54fc07138d70374c,5,0,125,128,113,131,135,142,208,244,213,113,141,101,121,118,-40,28,-68
905,440000,54fc07138d70374c,5,0,978,1056,1120,1145,1408,1392,1836,2078,1526,521,1068,875,972,821,-193,547,-740
189,450000,54fc07138d70374c,5,0,185,216,203,212,207,208,246,317,323,145,236,156,196,179,-80,91,-171
423,320000,54fc07138d70374c,5,0,502,513,553,616,611,660,847,820,821,461,589,458,524,503,-131,128,-259
133,360000,54fc07138d70374c,5,0,222,179,206,215,215,187,249,262,297,113,164,151,158,143,-13,51,-64
474,130000,54fc07138d70374c,5,0,448,411,475,528,576,625,746,750,758,431,483,470,476,461,-13,52,-65
493,410000,54fc07138d70374c,5,0,554,520,548,623,596,604,752,820,826,447,615,567,591,543,-48,168,-216
311,330000,54fc07138d70374c,5,0,309,330,357,379,387,524,623,684,550,252,401,254,328,302,-147,149,-296
238,420000,54fc07138d70374c,5,0,255,280,268,311,346,310,385,425,481,197,299,246,272,247,-53,102,-155
315,430000,54fc07138d70374c,5,0,349,338,350,384,424,364,460,493,505,239,383,321,352,314,-62,144,-206
161,350000,54fc07138d70374c,5,0,200,169,259,222,223,268,329,338,400,163,217,128,172,169,-89,54,-143
298,210000,54fc07138d70374c,5,0,303,292,281,324,364,303,369,450,249,117,274,320,297,237,46,157,-111
306,500000,54fc07138d70374c,5,0,346,440,402,372,406,400,540,575,576,284,403,314,358,334,-89,119,-208
266,610000,54fc07138d70374c,5,0,263,225,299,275,293,365,346,404,376,178,272,285,278,245,13,94,-81
239,230000,54fc07138d70374c,5,0,273,325,359,356,331,302,341,410,324,206,341,242,292,263,-99,135,-234
192,310000,212083a9246d2fd3,5,0,310,413,581,617,628,446,636,846,241,179,180,191,186,183,11,1,10
158,530000,212083a9246d2fd3,5,0,172,143,197,189,278,304,365,493,290,145,117,124,120,129,7,-28,35
119,150000,212083a9246d2fd3,5,0,155,125,168,136,222,206,310,562,284,123,119,71,95,104,-48,-4,-44
50,110000,212083a9246d2fd3,5,0,321,429,521,473,498,257,444,824,105,71,55,60,58,62,5,-16,21
380,510000,212083a9246d2fd3,5,0,603,636,717,777,1042,762,1080,1730,983,504,400,394,397,433,-6,-104,98
477,340000,212083a9246d2fd3,5,0,563,701,945,973,1078,1023,1260,2243,1186,528,593,566,580,562,-27,65,-92
645,370000,212083a9246d2fd3,5,0,1265,1160,1176,1294,1622,1536,1637,2998,1261,553,503,551,527,536,48,-50,98
178,140000,212083a9246d2fd3,5,0,203,154,257,272,308,299,372,645,313,178,140,164,152,161,24,-38,62
831,440000,212083a9246d2fd3,5,0,1027,923,1121,1670,1369,1274,1967,3191,905,337,855,959,907,717,104,518,-414
213,450000,212083a9246d2fd3,5,0,142,190,192,188,232,252,337,697,471,179,227,188,208,198,-39,48,-87
993,320000,212083a9246d2fd3,5,0,1592,1724,1702,2067,2163,1918,2283,3836,1631,972,777,763,770,837,-14,-195,181
283,360000,212083a9246d2fd3,5,0,345,361,411,440,542,547,676,1270,658,229,229,221,225,226,-8,0,-8
697,130000,212083a9246d2fd3,5,0,710,678,854,909,987,969,1064,2232,950,551,442,578,510,524,136,-109,245
1085,410000,212083a9246d2fd3,5,0,900,1091,1257,1337,1548,1431,1720,3243,1894,828,807,1011,909,882,204,-21,225
426,330000,212083a9246d2fd3,5,0,814,952,886,1003,1067,1140,1205,1850,574,328,328,361,344,339,33,0,33
222,420000,212083a9246d2fd3,5,0,349,502,356,435,576,710,866,1354,755,244,256,243,250,248,-13,12,-25
448,430000,212083a9246d2fd3,5,0,538,599,590,709,844,687,982,1756,938,322,403,371,387,365,-32,81,-113
304,350000,212083a9246d2fd3,5,0,268,357,422,486,645,645,746,1041,462,182,250,215,232,216,-35,68,-103
144,210000,212083a9246d2fd3,5,0,241,231,300,418,415,275,422,561,181,92,144,178,161,138,34,52,-18
189,500000,212083a9246d2fd3,5,0,484,631,758,749,722,571,643,1136,557,231,195,203,199,210,8,-36,44
369,610000,212083a9246d2fd3,5,0,399,506,811,726,652,682,805,1567,639,298,275,310,292,294,35,-23,58
93,230000,212083a9246d2fd3,5,0,163,123,259,159,164,109,207,305,102,62,72,62,67,65,-10,10,-20
18,310000,4f79773e600518a6,5,0,90,87,88,90,112,64,139,159,95,31,32,33,32,32,1,1,0
67,530000,4f79773e600518a6,5,0,108,54,102,103,88,129,116,195,181,91,58,50,54,66,-8,-33,25
126,150000,4f79773e600518a6,5,0,223,139,192,148,178,215,227,336,327,113,110,91,100,105,-19,-3,-16
28,110000,4f79773e600518a6,5,0,103,119,110,107,124,113,153,246,99,35,29,28,28,31,-1,-6,5
80,510000,4f79773e600518a6,5,0,201,164,169,165,260,194,267,387,398,155,108,95,102,119,-13,-47,34
118,340000,4f79773e600518a6,5,0,206,161,192,228,277,262,301,471,484,121,103,101,102,108,-2,-18,16
311,370000,4f79773e600518a6,5,0,604,450,433,565,670,629,591,961,723,263,300,312,306,292,12,37,-25
51,140000,4f79773e600518a6,5,0,114,81,88,106,92,114,133,167,149,66,59,57,58,61,-2,-7,5
31,440000,4f79773e600518a6,5,0,103,107,99,112,111,142,134,176,97,19,44,38,41,34,-6,25,-31
25,450000,4f79773e600518a6,5,0,59,61,36,46,27,44,52,62,66,20,31,15,23,22,-16,11,-27
101,320000,4f79773e600518a6,5,0,365,291,216,275,222,289,312,450,333,168,137,94,116,133,-43,-31,-12
82,360000,4f79773e600518a6,5,0,162,110,96,123,158,141,164,252,264,69,58,63,60,63,5,-11,16
205,130000,4f79773e600518a6,5,0,283,231,209,251,268,281,338,473,362,182,165,226,196,191,61,-17,78
206,410000,4f79773e600518a6,5,0,440,420,458,438,436,457,535,679,669,213,223,212,218,216,-11,10,-21
64,330000,4f79773e600518a6,5,0,165,119,117,144,152,167,161,255,131,59,54,69,62,61,15,-5,20
89,420000,4f79773e600518a6,5,0,217,211,166,169,231,258,278,385,450,105,110,104,107,106,-6,5,-11
257,430000,4f79773e600518a6,5,0,357,324,322,320,453,378,533,776,857,222,262,247,254,244,-15,40,-55
33,350000,4f79773e600518a6,5,0,60,45,47,38,50,51,83,65,41,21,20,20,20,20,0,-1,1
45,210000,4f79773e600518a6,5,0,118,82,101,115,152,128,129,166,109,50,66,72,69,63,6,16,-10
70,500000,4f79773e600518a6,5,0,156,162,125,149,157,175,189,306,256,58,77,65,71,67,-12,19,-31
193,610000,4f79773e600518a6,5,0,319,224,270,298,329,421,381,634,493,193,190,176,183,186,-14,-3,-11
62,230000,4f79773e600518a6,5,0,152,109,132,165,141,126,204,277,131,70,96,70,83,79,-26,26,-52
75,310000,fc32b1a017b34efe,5,0,165,139,164,176,188,167,211,361,138,71,95,74,84,80,-21,24,-45
276,530000,fc32b1a017b34efe,5,0,421,327,407,402,486,521,434,743,406,299,256,259,258,271,3,-43,46
248,150000,fc32b1a017b34efe,5,0,289,218,256,255,374,366,390,683,304,135,211,181,196,176,-30,76,-106
138,110000,fc32b1a017b34efe,5,0,391,298,365,388,458,302,357,675,173,56,121,79,100,85,-42,65,-107
814,510000,fc32b1a017b34efe,5,0,1243,1067,1135,1222,1530,1137,1318,2057,1186,681,782,644,713,702,-138,101,-239
307,340000,fc32b1a017b34efe,5,0,407,292,363,463,479,476,493,865,574,194,213,248,230,218,35,19,16
536,370000,fc32b1a017b34efe,5,0,935,718,720,875,922,870,894,1538,723,282,412,473,442,389,61,130,-69
509,140000,fc32b1a017b34efe,5,0,469,311,358,454,470,495,510,974,417,214,254,346,300,271,92,40,52
430,440000,fc32b1a017b34efe,5,0,703,576,557,610,730,702,768,1105,569,259,493,354,424,369,-139,234,-373
174,450000,fc32b1a017b34efe,5,0,242,164,182,175,217,208,212,406,260,101,165,105,135,124,-60,64,-124
495,320000,fc32b1a017b34efe,5,0,724,557,652,768,765,828,786,1332,698,402,409,494,452,435,85,7,78
216,360000,fc32b1a017b34efe,5,0,311,262,276,281,350,363,356,774,420,110,193,205,199,169,12,83,-71
990,130000,fc32b1a017b34efe,5,0,862,614,693,937,936,974,964,2069,891,397,516,929,722,614,413,119,294
645,410000,fc32b1a017b34efe,5,0,850,682,796,900,924,913,934,1916,1026,330,387,521,454,413,134,57,77
304,330000,fc32b1a017b34efe,5,0,581,492,491,561,604,663,556,982,370,195,281,311,296,262,30,86,-56
195,420000,fc32b1a017b34efe,5,0,276,303,276,301,385,300,389,721,401,105,159,186,172,150,27,54,-27
363,430000,fc32b1a017b34efe,5,0,562,511,551,548,722,567,687,1290,631,205,298,333,316,279,35,93,-58
150,350000,fc32b1a017b34efe,5,0,170,135,152,178,217,240,253,385,180,95,138,114,126,116,-24,43,-67
138,210000,fc32b1a017b34efe,5,0,223,208,212,251,209,211,226,330,135,104,181,144,162,143,-37,77,-114
481,500000,fc32b1a017b34efe,5,0,796,935,790,970,909,844,751,1420,661,420,464,477,470,454,13,44,-31
415,610000,fc32b1a017b34efe,5,0,671,425,496,540,574,623,639,1234,604,184,336,402,369,307,66,152,-86
108,230000,fc32b1a017b34efe,5,0,152,127,131,146,126,126,150,236,76,111,111,78,94,100,-33,0,-33
218,310000,feabbf46658382b9,5,0,291,237,275,484,500,412,620,805,357,95,198,187,192,160,-11,103,-114
470,530000,feabbf46658382b9,5,0,444,342,521,806,851,856,921,1249,829,418,522,444,483,461,-78,104,-182
461,150000,feabbf46658382b9,5,0,322,265,347,507,500,528,675,925,601,288,415,322,368,342,-93,127,-220
276,110000,feabbf46658382b9,5,0,455,384,534,743,672,532,779,1421,437,212,313,278,296,268,-35,101,-136
1042,510000,feabbf46658382b9,5,0,899,922,1077,1757,2178,1620,1861,2915,2183,903,1084,938,1011,975,-146,181,-327
356,340000,feabbf46658382b9,5,0,383,373,395,690,798,757,934,1307,1141,304,330,322,326,319,-8,26,-34
624,370000,feabbf46658382b9,5,0,689,593,668,1173,1160,1214,1192,1610,1006,389,569,611,590,523,42,180,-138
370,140000,feabbf46658382b9,5,0,304,235,316,582,505,511,601,970,406,198,368,305,336,290,-63,170,-233
785,440000,feabbf46658382b9,5,0,928,799,758,1347,1576,1507,1902,2685,1203,341,825,879,852,682,54,484,-430
197,450000,feabbf46658382b9,5,0,230,206,193,394,347,352,440,665,433,149,235,168,202,184,-67,86,-153
961,320000,feabbf46658382b9,5,0,951,861,1014,1794,1646,1598,1955,2752,1481,650,861,854,858,788,-7,211,-218
266,360000,feabbf46658382b9,5,0,281,260,281,443,510,475,511,802,624,159,229,268,248,219,39,70,-31
810,130000,feabbf46658382b9,5,0,653,522,624,985,1009,905,1021,1551,970,478,608,767,688,618,159,130,29
850,410000,feabbf46658382b9,5,0,747,679,846,1361,1342,1399,1530,2696,1928,502,672,701,686,625,29,170,-141
696,330000,feabbf46658382b9,5,0,710,572,720,1247,1320,1351,1499,2124,704,292,530,641,586,488,111,238,-127
347,420000,feabbf46658382b9,5,0,322,323,347,614,653,620,794,1252,837,201,313,330,322,281,17,112,-95
591,430000,feabbf46658382b9,5,0,623,625,741,1241,1383,1339,1478,2360,1657,503,671,579,625,584,-92,168,-260
281,350000,feabbf46658382b9,5,0,264,213,231,425,414,399,601,698,428,129,211,219,215,186,8,82,-74
250,210000,feabbf46658382b9,5,0,206,200,191,375,331,306,361,459,235,125,226,187,206,179,-39,101,-140
908,500000,feabbf46658382b9,5,0,877,1159,994,1592,1671,1487,1581,2727,1846,758,896,740,818,798,-156,138,-294
444,610000,feabbf46658382b9,5,0,634,391,538,758,764,827,896,1319,905,333,426,445,436,401,19,93,-74
143,230000,feabbf46658382b9,5,0,152,156,136,271,219,256,312,397,173,117,199,155,177,157,-44,82,-126
38,310000,f270f6a489c6a9d7,5,0,48,33,25,37,28,27,30,34,19,29,28,25,26,27,-3,-1,-2
815,530000,f270f6a489c6a9d7,5,0,1335,1170,1342,1395,1639,1736,1547,1939,1680,1190,1187,815,1001,1064,-372,-3,-369
70,150000,f270f6a489c6a9d7,5,0,80,81,79,74,107,93,105,108,54,78,117,71,94,89,-46,39,-85
110,110000,f270f6a489c6a9d7,5,0,214,173,229,238,282,198,305,504,106,118,157,120,138,132,-37,39,-76
472,510000,f270f6a489c6a9d7,5,0,875,682,620,742,717,655,773,955,603,645,678,519,598,614,-159,33,-192
153,340000,f270f6a489c6a9d7,5,0,216,207,172,194,197,214,225,272,216,223,191,165,178,193,-26,-32,6
400,370000,f270f6a489c6a9d7,5,0,659,545,644,631,622,551,636,1105,629,541,513,451,482,502,-62,-28,-34
117,140000,f270f6a489c6a9d7,5,0,157,114,131,103,137,118,161,233,166,115,127,118,122,120,-9,12,-21
503,440000,f270f6a489c6a9d7,5,0,890,830,568,627,644,624,713,866,346,505,757,513,635,592,-244,252,-496
57,450000,f270f6a489c6a9d7,5,0,104,62,69,50,93,63,75,97,92,50,85,53,69,63,-32,35,-67
558,320000,f270f6a489c6a9d7,5,0,727,654,653,752,766,763,871,1150,610,843,857,623,740,774,-234,14,-248
70,360000,f270f6a489c6a9d7,5,0,161,110,121,107,134,92,117,148,132,89,105,90,98,95,-15,16,-31
541,130000,f270f6a489c6a9d7,5,0,636,506,529,574,561,554,769,983,537,616,685,621,653,641,-64,69,-133
592,410000,f270f6a489c6a9d7,5,0,934,847,759,825,703,746,952,1314,922,778,753,612,682,714,-141,-25,-116
351,330000,f270f6a489c6a9d7,5,0,549,457,405,385,451,456,466,653,312,498,511,368,440,459,-143,13,-156
403,420000,f270f6a489c6a9d7,5,0,538,476,513,518,582,592,590,903,514,438,482,408,445,443,-74,44,-118
267,430000,f270f6a489c6a9d7,5,0,440,429,353,375,366,327,426,575,405,314,375,353,364,347,-22,61,-83
146,350000,f270f6a489c6a9d7,5,0,172,148,152,164,156,179,175,195,85,140,157,133,145,143,-24,17,-41
184,210000,f270f6a489c6a9d7,5,0,228,230,212,192,216,260,281,370,158,187,236,191,214,205,-45,49,-94
521,500000,f270f6a489c6a9d7,5,0,700,668,554,592,643,645,706,955,636,643,771,438,604,617,-333,128,-461
157,610000,f270f6a489c6a9d7,5,0,283,187,180,190,227,209,280,324,195,155,198,180,189,178,-18,43,-61
41,230000,f270f6a489c6a9d7,5,0,103,81,47,88,70,59,76,90,35,48,67,46,56,54,-21,19,-40
69,310000,d0f245b8781e3631,5,0,110,134,139,176,218,159,193,281,60,52,74,61,68,62,-13,22,-35
154,530000,d0f245b8781e3631,5,0,149,132,201,192,241,224,227,356,181,119,130,103,116,117,-27,11,-38
79,150000,d0f245b8781e3631,5,0,89,103,103,63,86,129,183,244,117,67,81,65,73,71,-16,14,-30
103,110000,d0f245b8781e3631,5,0,466,501,463,464,472,326,417,805,105,52,132,97,114,94,-35,80,-115
516,510000,d0f245b8781e3631,5,0,726,715,739,855,1133,824,910,1456,816,454,505,463,484,474,-42,51,-93
118,340000,d0f245b8781e3631,5,0,209,240,323,314,310,267,287,463,251,96,133,88,110,106,-45,37,-82
408,370000,d0f245b8781e3631,5,0,571,548,646,773,797,679,738,1182,600,283,311,395,353,330,84,28,56
169,140000,d0f245b8781e3631,5,0,199,121,199,221,226,243,264,497,192,96,135,117,126,116,-18,39,-57
258,440000,d0f245b8781e3631,5,0,351,384,378,429,596,574,615,869,297,127,271,262,266,220,-9,144,-153
135,450000,d0f245b8781e3631,5,0,140,126,161,139,167,205,233,425,254,71,136,107,122,105,-29,65,-94
373,320000,d0f245b8781e3631,5,0,521,545,683,706,761,731,749,1017,461,270,342,363,352,325,21,72,-51
68,360000,d0f245b8781e3631,5,0,110,128,145,145,229,198,198,315,211,60,84,84,84,76,0,24,-24
498,130000,d0f245b8781e3631,5,0,480,501,551,690,771,682,755,1430,754,390,398,481,440,423,83,8,75
363,410000,d0f245b8781e3631,5,0,534,645,779,871,851,876,865,1601,892,268,371,333,352,324,-38,103,-141
246,330000,d0f245b8781e3631,5,0,271,509,410,370,1437,406,420,845,174,81,170,192,181,148,22,89,-67
60,420000,d0f245b8781e3631,5,0,83,118,124,88,110,128,133,246,134,39,47,55,51,47,8,8,0
211,430000,d0f245b8781e3631,5,0,324,325,335,319,439,335,447,756,439,130,231,191,211,184,-40,101,-141
67,350000,d0f245b8781e3631,5,0,92,93,116,102,142,175,166,247,102,51,67,60,64,59,-7,16,-23
30,210000,d0f245b8781e3631,5,0,48,65,77,81,68,54,102,113,47,21,29,27,28,26,-2,8,-10
395,500000,d0f245b8781e3631,5,0,1791,780,781,1602,764,548,596,1578,630,283,298,337,318,306,39,15,24
236,610000,d0f245b8781e3631,5,0,349,347,435,453,455,455,558,938,498,189,261,260,260,237,-1,72,-73
20,230000,d0f245b8781e3631,5,0,19,35,25,28,17,16,45,45,7,10,21,11,16,14,-10,11,-21
233,310000,c6cd4e0e073f5ac2,5,0,1911,902,547,590,1049,393,448,746,228,125,223,190,206,179,-33,98,-131
70,530000,c6cd4e0e073f5ac2,5,0,299,183,317,301,410,266,224,235,105,67,68,72,70,69,4,1,3
75,150000,c6cd4e0e073f5ac2,5,0,205,129,178,248,263,289,273,340,208,63,95,64,80,74,-31,32,-63
50,110000,c6cd4e0e073f5ac2,5,0,2153,193,216,265,2528,156,179,362,72,29,64,61,62,51,-3,35,-38
230,510000,c6cd4e0e073f5ac2,5,0,918,779,942,1243,1666,730,631,1027,542,251,246,265,256,254,19,-5,24
344,340000,c6cd4e0e073f5ac2,5,0,609,647,742,968,961,755,678,1434,792,244,232,308,270,261,76,-12,88
371,370000,c6cd4e0e073f5ac2,5,0,2081,1738,2176,2848,2646,1380,1053,1685,823,326,341,453,397,373,112,15,97
182,140000,c6cd4e0e073f5ac2,5,0,466,412,468,657,660,386,479,604,321,126,162,162,162,150,0,36,-36
407,440000,c6cd4e0e073f5ac2,5,0,808,584,546,819,1623,936,1038,1493,451,130,374,366,370,290,-8,244,-252
136,450000,c6cd4e0e073f5ac2,5,0,206,200,234,316,360,349,312,543,250,76,136,99,118,104,-37,60,-97
807,320000,c6cd4e0e073f5ac2,5,0,2058,1654,1827,2527,2388,1650,1467,2828,1205,656,751,787,769,731,36,95,-59
262,360000,c6cd4e0e073f5ac2,5,0,462,351,450,511,752,626,577,1241,549,138,232,271,252,214,39,94,-55
351,130000,c6cd4e0e073f5ac2,5,0,940,856,987,1387,1606,840,561,1020,602,249,293,362,328,301,69,44,25
557,410000,c6cd4e0e073f5ac2,5,0,1242,1377,1416,1736,1669,959,1021,1584,992,320,512,660,586,497,148,192,-44
375,330000,c6cd4e0e073f5ac2,5,0,739,693,717,1019,1203,828,859,1272,386,193,342,341,342,292,-1,149,-150
270,420000,c6cd4e0e073f5ac2,5,0,602,550,430,713,769,691,751,1208,523,161,272,326,299,253,54,111,-57
222,430000,c6cd4e0e073f5ac2,5,0,595,580,641,816,847,522,619,891,508,132,232,212,222,192,-20,100,-120
121,350000,c6cd4e0e073f5ac2,5,0,204,142,221,243,304,268,291,431,173,74,106,104,105,95,-2,32,-34
66,210000,c6cd4e0e073f5ac2,5,0,277,157,228,366,291,139,186,225,91,51,75,101,88,76,26,24,2
65,500000,c6cd4e0e073f5ac2,5,0,174,226,215,324,310,182,148,242,128,33,53,51,52,46,-2,20,-22
155,610000,c6cd4e0e073f5ac2,5,0,533,558,687,656,661,278,275,432,182,64,143,136,140,114,-7,79,-86
48,230000,c6cd4e0e073f5ac2,5,0,111,89,97,146,137,83,61,140,53,29,33,28,30,30,-5,4,-9
108,310000,a9a43d1a7ecbe75d,5,0,134,134,141,138,161,113,162,163,142,84,128,99,114,104,-29,44,-73
84,530000,a9a43d1a7ecbe75d,5,0,86,94,141,123,111,95,152,131,146,84,119,80,100,94,-39,35,-74
86,150000,a9a43d1a7ecbe75d,5,0,107,75,84,71,81,97,81,90,83,41,62,87,74,63,25,21,4
62,110000,a9a43d1a7ecbe75d,5,0,95,97,119,87,131,79,100,123,88,65,74,70,72,70,-4,9,-13
224,510000,a9a43d1a7ecbe75d,5,0,215,255,232,227,447,284,279,330,341,184,223,201,212,203,-22,39,-61
152,340000,a9a43d1a7ecbe75d,5,0,161,145,138,167,182,170,183,198,254,107,149,150,150,135,1,42,-41
162,370000,a9a43d1a7ecbe75d,5,0,157,181,138,136,198,152,160,191,159,74,162,163,162,133,1,88,-87
28,140000,a9a43d1a7ecbe75d,5,0,37,27,30,36,34,32,31,28,41,25,46,41,44,37,-5,21,-26
410,440000,a9a43d1a7ecbe75d,5,0,479,470,487,435,593,541,658,638,568,264,527,387,457,393,-140,263,-403
163,450000,a9a43d1a7ecbe75d,5,0,164,160,151,154,208,163,172,213,297,121,197,152,174,157,-45,76,-121
345,320000,a9a43d1a7ecbe75d,5,0,360,325,317,361,402,385,402,439,430,213,408,324,366,315,-84,195,-279
71,360000,a9a43d1a7ecbe75d,5,0,75,70,82,64,94,87,76,120,103,50,101,76,88,76,-25,51,-76
137,130000,a9a43d1a7ecbe75d,5,0,88,94,88,102,92,82,85,95,109,50,116,95,106,87,-21,66,-87
90,410000,a9a43d1a7ecbe75d,5,0,117,126,120,123,153,141,134,164,130,78,142,114,128,111,-28,64,-92
322,330000,a9a43d1a7ecbe75d,5,0,301,272,322,299,308,339,364,397,466,185,307,317,312,270,10,122,-112
140,420000,a9a43d1a7ecbe75d,5,0,145,190,155,179,232,184,244,236,270,129,200,183,192,171,-17,71,-88
296,430000,a9a43d1a7ecbe75d,5,0,293,279,299,298,395,308,355,445,519,215,330,301,316,282,-29,115,-144
101,350000,a9a43d1a7ecbe75d,5,0,99,64,92,91,93,87,125,99,145,57,96,88,92,80,-8,39,-47
100,210000,a9a43d1a7ecbe75d,5,0,133,116,136,158,194,115,126,155,89,59,109,102,106,90,-7,50,-57
104,500000,a9a43d1a7ecbe75d,5,0,135,304,146,146,203,173,179,214,160,89,140,134,137,121,-6,51,-57
258,610000,a9a43d1a7ecbe75d,5,0,260,217,273,229,256,263,252,263,274,154,228,212,220,198,-16,74,-90
47,230000,a9a43d1a7ecbe75d,5,0,70,81,75,75,68,54,66,57,65,35,91,67,79,64,-24,56,-80
251,310000,3c974920a76ac9c1,6,0,235,260,162,265,228,369,374,305,193,309,264,241,252,271,-23,-45,22
230,530000,3c974920a76ac9c1,6,0,279,419,246,217,310,402,456,434,194,302,243,321,282,289,78,-59,137
155,150000,3c974920a76ac9c1,6,0,164,187,153,157,178,204,219,180,128,201,176,192,184,190,16,-25,41
314,110000,3c974920a76ac9c1,6,0,351,322,244,337,371,460,563,468,432,472,340,407,374,406,67,-132,199
336,510000,3c974920a76ac9c1,6,0,329,335,345,623,350,453,570,500,253,378,337,331,334,349,-6,-41,35
166,340000,3c974920a76ac9c1,6,0,138,108,127,159,136,179,226,198,76,132,155,144,150,144,-11,23,-34
432,370000,3c974920a76ac9c1,6,0,353,339,259,422,394,483,601,468,290,412,484,450,467,449,-34,72,-106
173,140000,3c974920a76ac9c1,6,0,166,178,189,194,233,215,260,248,146,249,182,251,216,227,69,-67,136
2696,440000,3c974920a76ac9c1,6,0,2187,2183,1804,2265,2711,3532,3800,2692,1680,2958,2368,2754,2561,2693,386,-590,976
293,450000,3c974920a76ac9c1,6,0,291,276,249,267,349,472,505,425,248,383,277,377,327,346,100,-106,206
689,320000,3c974920a76ac9c1,6,0,561,554,569,631,764,871,1010,800,486,817,617,720,668,718,103,-200,303
149,360000,3c974920a76ac9c1,6,0,149,136,95,156,166,204,262,236,78,191,154,186,170,177,32,-37,69
293,130000,3c974920a76ac9c1,6,0,252,227,235,225,228,291,305,260,190,297,311,328,320,312,17,14,3
297,410000,3c974920a76ac9c1,6,0,330,384,256,301,351,521,505,405,250,355,393,307,350,352,-86,38,-124
591,330000,3c974920a76ac9c1,6,0,453,457,422,545,702,660,865,633,409,621,561,562,562,581,1,-60,61
455,420000,3c974920a76ac9c1,6,0,440,329,325,381,447,480,474,497,228,445,423,403,413,424,-20,-22,2
259,430000,3c974920a76ac9c1,6,0,275,250,286,299,327,364,474,347,174,297,304,284,294,295,-20,7,-27
299,350000,3c974920a76ac9c1,6,0,223,276,226,258,368,331,404,292,181,307,209,324,266,280,115,-98,213
626,210000,3c974920a76ac9c1,6,0,645,700,556,721,769,941,997,650,566,775,692,738,715,735,46,-83,129
138,500000,3c974920a76ac9c1,6,0,181,131,111,101,120,155,199,115,72,126,107,119,113,117,12,-19,31
285,610000,3c974920a76ac9c1,6,0,206,262,204,187,324,393,440,305,219,295,292,328,310,305,36,-3,39
284,230000,3c974920a76ac9c1,6,0,288,194,351,302,310,458,461,292,234,401,305,324,314,343,19,-96,115
408,310000,3d7554f1f56dd664,6,0,376,356,410,417,271,639,518,268,263,442,321,383,352,382,62,-121,183
354,530000,3d7554f1f56dd664,6,0,259,337,266,368,334,609,519,292,264,403,325,415,370,381,90,-78,168
252,150000,3d7554f1f56dd664,6,0,175,231,216,208,216,370,337,175,149,316,260,258,259,278,-2,-56,54
352,110000,3d7554f1f56dd664,6,0,405,459,464,449,231,675,811,368,359,470,369,376,372,405,7,-101,108
724,510000,3d7554f1f56dd664,6,0,656,684,758,1227,469,1053,1125,657,560,806,700,679,690,728,-21,-106,85
352,340000,3d7554f1f56dd664,6,0,252,293,358,325,253,574,507,301,225,317,315,350,332,327,35,-2,37
1113,370000,3d7554f1f56dd664,6,0,862,990,917,1222,876,1567,1574,775,729,1060,1229,1119,1174,1136,-110,169,-279
335,140000,3d7554f1f56dd664,6,0,253,284,382,372,320,590,571,290,239,407,358,384,371,383,26,-49,75
9100,440000,3d7554f1f56dd664,6,0,8266,8709,10596,10140,6925,13598,11515,5136,4688,10371,8733,8990,8862,9365,257,-1638,1895
901,450000,3d7554f1f56dd664,6,0,723,792,866,969,642,1386,1258,750,559,1074,832,939,886,948,107,-242,349
1948,320000,3d7554f1f56dd664,6,0,1678,1827,2216,2075,1763,3112,2877,1445,1635,2184,1828,1916,1872,1976,88,-356,444
513,360000,3d7554f1f56dd664,6,0,344,400,420,535,356,595,741,435,311,545,463,483,473,497,20,-82,102
829,130000,3d7554f1f56dd664,6,0,520,604,569,722,520,1137,974,498,486,847,1025,993,1009,955,-32,178,-210
1043,410000,3d7554f1f56dd664,6,0,695,718,785,808,565,1273,1234,645,486,968,944,932,938,948,-12,-24,12
1847,330000,3d7554f1f56dd664,6,0,1420,1737,1785,1658,1293,2709,2467,1135,1205,1969,1744,1919,1832,1877,175,-225,400
876,420000,3d7554f1f56dd664,6,0,835,675,883,908,742,1001,1050,703,508,734,619,699,659,684,80,-115,195
707,430000,3d7554f1f56dd664,6,0,625,567,721,958,582,1112,1192,689,445,769,687,748,718,735,61,-82,143
1511,350000,3d7554f1f56dd664,6,0,1202,1533,1388,1310,817,2205,1578,856,899,1607,1181,1494,1338,1427,313,-426,739
1845,210000,3d7554f1f56dd664,6,0,1544,2253,2301,1915,1064,2892,2161,1110,1306,1905,1837,1784,1810,1842,-53,-68,15
371,500000,3d7554f1f56dd664,6,0,327,300,319,331,173,470,398,244,215,285,259,240,250,261,-19,-26,7
394,610000,3d7554f1f56dd664,6,0,412,553,492,462,375,582,607,340,260,369,435,466,450,423,31,66,-35
849,230000,3d7554f1f56dd664,6,0,687,670,1107,843,480,1076,1018,447,521,1186,639,827,733,884,188,-547,735
200,310000,2d0d2c3403909fdb,6,0,211,160,159,169,112,163,167,157,101,187,162,155,158,168,-7,-25,18
265,530000,2d0d2c3403909fdb,6,0,254,351,309,270,218,354,350,290,213,293,226,236,231,252,10,-67,77
251,150000,2d0d2c3403909fdb,6,0,237,261,246,234,155,184,233,279,174,228,241,255,248,241,14,13,1
503,110000,2d0d2c3403909fdb,6,0,552,633,554,583,457,611,677,549,387,627,524,389,456,513,-135,-103,-32
404,510000,2d0d2c3403909fdb,6,0,413,373,319,387,300,411,434,516,235,377,355,370,362,367,15,-22,37
142,340000,2d0d2c3403909fdb,6,0,126,118,108,157,129,128,138,176,83,127,116,129,122,124,13,-11,24
407,370000,2d0d2c3403909fdb,6,0,393,358,328,376,327,415,400,420,235,353,334,323,328,337,-11,-19,8
177,140000,2d0d2c3403909fdb,6,0,161,170,152,135,111,141,197,179,103,189,173,157,165,173,-16,-16,0
1833,440000,2d0d2c3403909fdb,6,0,1649,1691,1490,1683,1421,1989,1829,1713,1159,1738,1536,1581,1558,1618,45,-202,247
163,450000,2d0d2c3403909fdb,6,0,179,178,141,192,165,181,173,211,121,197,149,174,162,173,25,-48,73
444,320000,2d0d2c3403909fdb,6,0,417,373,340,401,333,437,427,470,296,446,386,375,380,402,-11,-60,49
126,360000,2d0d2c3403909fdb,6,0,89,94,84,108,90,107,109,126,55,113,112,112,112,112,0,-1,1
425,130000,2d0d2c3403909fdb,6,0,302,324,321,309,274,302,328,389,251,371,364,437,400,391,73,-7,80
396,410000,2d0d2c3403909fdb,6,0,340,309,300,327,262,352,337,377,202,331,306,338,322,325,32,-25,57
380,330000,2d0d2c3403909fdb,6,0,351,316,352,336,342,428,424,401,264,349,335,366,350,350,31,-14,45
322,420000,2d0d2c3403909fdb,6,0,268,203,201,303,211,267,280,321,189,271,255,230,242,252,-25,-16,-9
285,430000,2d0d2c3403909fdb,6,0,277,255,193,250,211,244,275,284,146,275,262,250,256,262,-12,-13,1
132,350000,2d0d2c3403909fdb,6,0,128,123,95,124,106,151,157,167,81,107,85,111,98,101,26,-22,48
457,210000,2d0d2c3403909fdb,6,0,501,506,466,488,346,464,567,506,316,529,433,489,461,484,56,-96,152
179,500000,2d0d2c3403909fdb,6,0,186,166,134,169,138,184,155,213,116,188,148,168,158,168,20,-40,60
277,610000,2d0d2c3403909fdb,6,0,255,273,253,271,195,252,267,297,206,288,291,280,286,286,-11,3,-14
317,230000,2d0d2c3403909fdb,6,0,324,293,304,239,208,258,336,315,155,306,267,240,254,271,-27,-39,12
142,310000,a28bb927b6fcb33c,6,0,282,229,249,216,166,212,210,117,96,135,131,161,146,142,30,-4,34
176,530000,a28bb927b6fcb33c,6,0,116,231,232,256,209,270,308,173,110,159,185,191,188,178,6,26,-20
117,150000,a28bb927b6fcb33c,6,0,97,118,134,193,128,165,176,89,72,136,148,139,144,141,-9,12,-21
85,110000,a28bb927b6fcb33c,6,0,267,308,309,286,179,246,342,136,109,179,166,96,131,147,-70,-13,-57
324,510000,a28bb927b6fcb33c,6,0,414,426,492,712,401,438,436,351,212,361,425,290,358,359,-135,64,-199
195,340000,a28bb927b6fcb33c,6,0,218,300,368,358,250,325,348,264,151,204,182,203,192,196,21,-22,43
285,370000,a28bb927b6fcb33c,6,0,407,399,489,606,454,468,556,225,175,357,467,449,458,424,-18,110,-128
127,140000,a28bb927b6fcb33c,6,0,127,123,233,187,181,144,181,92,70,148,181,165,173,165,-16,33,-49
3906,440000,a28bb927b6fcb33c,6,0,3624,4020,4618,5211,4012,4216,4195,2391,1639,3992,3988,3668,3828,3883,-320,-4,-316
344,450000,a28bb927b6fcb33c,6,0,329,360,409,444,331,432,386,248,166,443,418,434,426,432,16,-25,41
947,320000,a28bb927b6fcb33c,6,0,876,892,1148,1130,943,1033,1154,680,651,982,1039,1051,1045,1024,12,57,-45
271,360000,a28bb927b6fcb33c,6,0,210,194,288,380,260,302,351,208,96,254,328,298,313,293,-30,74,-104
345,130000,a28bb927b6fcb33c,6,0,480,475,550,584,385,397,419,248,284,584,570,485,528,546,-85,-14,-71
516,410000,a28bb927b6fcb33c,6,0,468,562,658,673,556,567,651,338,242,578,638,439,538,552,-199,60,-259
1131,330000,a28bb927b6fcb33c,6,0,1006,1138,1244,1296,1228,1343,1310,747,739,1438,1404,1200,1302,1347,-204,-34,-170
446,420000,a28bb927b6fcb33c,6,0,595,544,655,744,726,677,787,450,226,461,459,468,464,463,9,-2,11
548,430000,a28bb927b6fcb33c,6,0,494,503,610,619,436,474,674,394,223,436,554,554,554,515,0,118,-118
709,350000,a28bb927b6fcb33c,6,0,417,546,535,615,563,615,519,231,173,535,612,676,644,608,64,77,-13
459,210000,a28bb927b6fcb33c,6,0,803,867,1031,840,522,652,848,213,233,610,646,562,604,606,-84,36,-120
162,500000,a28bb927b6fcb33c,6,0,348,324,316,208,150,157,208,123,85,166,157,116,136,146,-41,-9,-32
226,610000,a28bb927b6fcb33c,6,0,237,272,274,262,219,225,317,148,105,202,242,221,232,222,-21,40,-61
205,230000,a28bb927b6fcb33c,6,0,248,232,335,334,222,288,303,90,85,233,244,241,242,239,-3,11,-14
170,310000,17bc272c93f19d56,6,0,234,212,256,234,168,249,477,199,177,267,169,193,181,210,24,-98,122
1995,530000,17bc272c93f19d56,6,0,2353,2868,2565,3307,3096,3216,4503,4785,3067,2754,2281,2227,2254,2421,-54,-473,419
356,150000,17bc272c93f19d56,6,0,329,346,368,502,360,520,675,504,451,680,487,440,464,536,-47,-193,146
112,110000,17bc272c93f19d56,6,0,163,179,202,242,199,305,514,151,92,197,124,132,128,151,8,-73,81
990,510000,17bc272c93f19d56,6,0,1118,1183,1230,1449,1007,1411,1954,1724,1537,1481,1090,1021,1056,1197,-69,-391,322
1165,340000,17bc272c93f19d56,6,0,1210,1260,1418,1458,1238,1535,2328,2152,1881,1518,1284,1266,1275,1356,-18,-234,216
2279,370000,17bc272c93f19d56,6,0,2963,3398,3600,3519,3268,3907,6576,4483,3060,2839,2545,2879,2712,2754,334,-294,628
955,140000,17bc272c93f19d56,6,0,1193,1334,1452,1749,1354,1585,2844,2093,1361,1353,1118,1259,1188,1243,141,-235,376
1682,440000,17bc272c93f19d56,6,0,1577,1457,1550,1999,1555,2007,3029,1611,1579,2180,1684,1684,1684,1849,0,-496,496
1343,450000,17bc272c93f19d56,6,0,1991,2051,2291,2515,2293,2687,4443,3084,1836,2310,1540,1616,1578,1822,76,-770,846
1375,320000,17bc272c93f19d56,6,0,1539,1776,1799,1764,1493,1942,3067,2165,2419,2029,1601,1578,1590,1736,-23,-428,405
536,360000,17bc272c93f19d56,6,0,892,885,890,1111,824,980,1510,1290,922,875,668,648,658,730,-20,-207,187
2522,130000,17bc272c93f19d56,6,0,2437,2748,3368,3303,2808,3641,6231,3870,3403,2945,3015,3119,3067,3026,104,70,34
2598,410000,17bc272c93f19d56,6,0,3302,3413,3591,3584,3821,4668,7650,5825,3564,3197,2704,2715,2710,2872,11,-493,504
1121,330000,17bc272c93f19d56,6,0,1213,1206,1016,1295,1112,1294,2062,1260,1629,1592,1156,1224,1190,1324,68,-436,504
835,420000,17bc272c93f19d56,6,0,954,900,992,1202,958,1353,2198,1919,1140,1262,895,1069,982,1075,174,-367,541
997,430000,17bc272c93f19d56,6,0,1491,1500,1678,1773,1354,1770,2693,2364,1506,1541,1174,1020,1097,1245,-154,-367,213
473,350000,17bc272c93f19d56,6,0,545,512,565,573,523,688,892,592,650,741,463,546,504,583,83,-278,361
854,210000,17bc272c93f19d56,6,0,1034,1023,1010,1135,824,1154,1710,924,939,1322,959,988,974,1090,29,-363,392
173,500000,17bc272c93f19d56,6,0,225,203,204,284,201,250,357,250,248,235,212,191,202,213,-21,-23,2
910,610000,17bc272c93f19d56,6,0,1083,1173,1245,1658,1590,1877,3217,2072,1105,1314,1222,1105,1164,1214,-117,-92,-25
602,230000,17bc272c93f19d56,6,0,776,785,835,795,518,816,982,506,518,806,657,585,621,683,-72,-149,77
289,310000,2a2ab41f8f6ff1cb,6,0,330,331,445,555,272,582,623,382,114,351,229,285,257,288,56,-122,178
390,530000,2a2ab41f8f6ff1cb,6,0,333,428,409,543,553,546,680,484,300,452,403,419,411,425,16,-49,65
525,150000,2a2ab41f8f6ff1cb,6,0,517,552,645,831,715,836,832,551,317,489,505,604,554,533,99,16,83
93,110000,2a2ab41f8f6ff1cb,6,0,331,345,369,502,362,440,598,212,102,180,142,124,133,149,-18,-38,20
870,510000,2a2ab41f8f6ff1cb,6,0,1004,1032,1165,1460,1050,1385,1850,1223,671,850,790,838,814,826,48,-60,108
1165,340000,2a2ab41f8f6ff1cb,6,0,1047,1058,1409,1565,1256,1491,1666,1515,717,1018,980,1077,1028,1025,97,-38,135
1983,370000,2a2ab41f8f6ff1cb,6,0,1575,1773,2139,2580,2061,2146,2737,1706,842,1734,1902,2031,1966,1889,129,168,-39
606,140000,2a2ab41f8f6ff1cb,6,0,430,532,655,690,724,762,993,533,312,595,582,569,576,582,-13,-13,0
5445,440000,2a2ab41f8f6ff1cb,6,0,5010,5237,6544,8215,6582,6734,6492,5607,2647,5713,4896,5717,5306,5442,821,-817,1638
532,450000,2a2ab41f8f6ff1cb,6,0,632,639,680,913,743,853,894,799,409,719,453,603,528,592,150,-266,416
1735,320000,2a2ab41f8f6ff1cb,6,0,1679,1859,2252,2410,2283,2584,2672,1728,1016,1729,1498,1701,1600,1643,203,-231,434
753,360000,2a2ab41f8f6ff1cb,6,0,704,848,964,1340,1065,1086,1291,1027,356,690,687,838,762,738,151,-3,154
2426,130000,2a2ab41f8f6ff1cb,6,0,1966,2293,2864,3253,2277,2327,2703,2119,1271,2126,2486,2863,2674,2492,377,360,17
2880,410000,2a2ab41f8f6ff1cb,6,0,2264,2690,3318,3446,2827,2797,3447,2952,1308,2514,2566,2841,2704,2640,275,52,223
1077,330000,2a2ab41f8f6ff1cb,6,0,928,974,1151,1369,1262,1632,1972,795,459,876,905,1141,1023,974,236,29,207
1133,420000,2a2ab41f8f6ff1cb,6,0,1207,1181,1412,1938,1686,1663,2151,1566,597,1095,1029,1047,1038,1057,18,-66,84
1382,430000,2a2ab41f8f6ff1cb,6,0,1605,1889,1918,2573,2247,1966,2770,1651,844,1487,1573,1636,1604,1565,63,86,-23
418,350000,2a2ab41f8f6ff1cb,6,0,259,301,348,390,371,447,476,264,148,314,267,427,347,336,160,-47,207
342,210000,2a2ab41f8f6ff1cb,6,0,261,323,369,397,317,403,513,241,211,360,293,362,328,338,69,-67,136
623,500000,2a2ab41f8f6ff1cb,6,0,806,750,810,888,646,803,1149,803,328,472,453,543,498,489,90,-19,109
436,610000,2a2ab41f8f6ff1cb,6,0,403,502,566,687,665,655,845,620,247,468,497,551,524,505,54,29,25
503,230000,2a2ab41f8f6ff1cb,6,0,570,602,652,669,544,740,1032,399,306,506,449,585,517,513,136,-57,193
1456,310000,c06a2a387c0ee510,6,0,945,1154,1068,958,710,977,1212,1265,890,1247,1119,1184,1152,1183,65,-128,193
248,530000,c06a2a387c0ee510,6,0,99,83,62,79,45,66,119,104,63,214,133,132,132,160,-1,-81,80
163,150000,c06a2a387c0ee510,6,0,85,56,51,54,43,56,75,86,64,154,131,164,148,150,33,-23,56
1670,110000,c06a2a387c0ee510,6,0,824,1014,976,1027,677,793,1627,1352,1114,1508,1132,1430,1281,1357,298,-376,674
285,510000,c06a2a387c0ee510,6,0,144,210,234,199,102,145,321,208,187,254,335,308,322,299,-27,81,-108
352,340000,c06a2a387c0ee510,6,0,149,157,167,182,145,176,251,253,175,322,340,315,328,326,-25,18,-43
1405,370000,c06a2a387c0ee510,6,0,644,701,698,710,494,739,1047,878,649,1303,1248,1216,1232,1256,-32,-55,23
242,140000,c06a2a387c0ee510,6,0,115,93,101,121,83,105,184,165,123,244,320,272,296,279,-48,76,-124
1038,440000,c06a2a387c0ee510,6,0,511,479,453,514,463,571,819,762,448,944,1100,1025,1062,1023,-75,156,-231
86,450000,c06a2a387c0ee510,6,0,27,46,65,36,87,45,96,92,54,103,134,119,126,119,-15,31,-46
1276,320000,c06a2a387c0ee510,6,0,664,704,653,923,563,731,1002,974,650,1188,1289,1048,1168,1175,-241,101,-342
162,360000,c06a2a387c0ee510,6,0,54,83,56,89,43,74,97,118,85,164,140,153,146,152,13,-24,37
569,130000,c06a2a387c0ee510,6,0,241,288,302,284,232,288,493,470,361,599,660,769,714,676,109,61,48
764,410000,c06a2a387c0ee510,6,0,374,353,356,387,282,366,596,517,345,763,731,685,708,726,-46,-32,-14
808,330000,c06a2a387c0ee510,6,0,390,895,578,350,278,533,736,534,424,754,915,865,890,845,-50,161,-211
234,420000,c06a2a387c0ee510,6,0,130,108,119,115,66,94,173,151,103,240,253,187,220,227,-66,13,-79
206,430000,c06a2a387c0ee510,6,0,59,68,91,68,60,83,119,101,59,203,163,182,172,183,19,-40,59
204,350000,c06a2a387c0ee510,6,0,103,107,123,99,106,97,170,123,106,206,303,187,245,232,-116,97,-213
378,210000,c06a2a387c0ee510,6,0,169,211,178,184,111,151,300,181,154,357,324,363,344,348,39,-33,72
151,500000,c06a2a387c0ee510,6,0,63,75,66,120,43,58,100,60,71,130,181,128,154,146,-53,51,-104
358,610000,c06a2a387c0ee510,6,0,156,195,228,164,136,164,313,234,179,320,305,340,322,322,35,-15,50
260,230000,c06a2a387c0ee510,6,0,65,102,113,130,76,95,177,129,74,323,185,255,220,254,70,-138,208
516,310000,7023efdab9cedc03,6,0,494,547,504,605,431,543,697,325,168,288,309,527,418,375,218,21,197
55,530000,7023efdab9cedc03,6,0,56,86,60,80,64,106,112,40,25,38,54,68,61,53,14,16,-2
51,150000,7023efdab9cedc03,6,0,55,54,65,50,48,60,75,31,18,29,46,51,48,42,5,17,-12
60,110000,7023efdab9cedc03,6,0,96,96,105,107,59,86,132,40,51,59,50,54,52,54,4,-9,13
259,510000,7023efdab9cedc03,6,0,185,192,194,379,187,278,408,216,117,192,175,229,202,199,54,-17,71
463,340000,7023efdab9cedc03,6,0,304,284,383,452,363,447,587,357,148,207,278,368,323,284,90,71,19
355,370000,7023efdab9cedc03,6,0,403,384,434,524,437,477,555,320,180,373,400,374,387,382,-26,27,-53
60,140000,7023efdab9cedc03,6,0,53,53,40,61,59,55,64,30,23,28,38,44,41,37,6,10,-4
185,440000,7023efdab9cedc03,6,0,225,205,191,284,225,342,408,121,39,166,158,211,184,178,53,-8,61
60,450000,7023efdab9cedc03,6,0,56,48,72,86,66,86,129,68,34,47,50,71,60,56,21,3,18
1002,320000,7023efdab9cedc03,6,0,881,934,1240,1311,1156,1271,1767,893,628,788,879,1067,973,911,188,91,97
170,360000,7023efdab9cedc03,6,0,167,187,201,205,175,224,302,169,92,161,188,202,195,184,14,27,-13
149,130000,7023efdab9cedc03,6,0,156,130,129,149,129,127,215,80,56,93,108,163,136,121,55,15,40
259,410000,7023efdab9cedc03,6,0,222,222,264,300,257,320,368,183,97,185,329,340,334,285,11,144,-133
845,330000,7023efdab9cedc03,6,0,638,611,791,867,742,941,1163,445,309,478,511,775,643,588,264,33,231
243,420000,7023efdab9cedc03,6,0,221,204,189,253,233,287,401,211,94,172,184,195,190,184,11,12,-1
189,430000,7023efdab9cedc03,6,0,177,169,202,213,182,259,315,201,83,173,167,198,182,179,31,-6,37
140,350000,7023efdab9cedc03,6,0,66,59,77,86,70,117,145,54,20,51,78,114,96,81,36,27,9
37,210000,7023efdab9cedc03,6,0,56,94,56,78,81,68,104,28,21,52,82,45,64,60,-37,30,-67
64,500000,7023efdab9cedc03,6,0,61,45,63,77,40,57,62,28,20,37,37,33,35,36,-4,0,-4
102,610000,7023efdab9cedc03,6,0,96,102,126,137,141,113,177,107,51,78,83,124,104,95,41,5,36
17,230000,7023efdab9cedc03,6,0,25,30,29,39,29,28,30,11,11,8,18,20,19,15,2,10,-8
933,310000,af6f4f548684e14d,6,0,835,829,878,839,851,1537,1734,940,540,957,807,919,863,894,112,-150,262
290,530000,af6f4f548684e14d,6,0,297,444,406,375,464,639,732,400,288,346,301,327,314,325,26,-45,71
302,150000,af6f4f548684e14d,6,0,288,345,346,426,433,493,573,322,195,323,333,363,348,340,30,10,20
532,110000,af6f4f548684e14d,6,0,593,551,572,648,532,915,1057,659,394,601,489,595,542,562,106,-112,218
800,510000,af6f4f548684e14d,6,0,754,816,821,1394,1020,1293,1876,1072,611,873,761,808,784,814,47,-112,159
751,340000,af6f4f548684e14d,6,0,648,689,782,938,1018,1287,1597,1015,457,773,664,769,716,735,105,-109,214
1019,370000,af6f4f548684e14d,6,0,1119,1240,1232,1497,1547,1722,2394,1077,522,1253,1236,1215,1226,1235,-21,-17,-4
335,140000,af6f4f548684e14d,6,0,359,317,365,407,489,581,742,375,248,450,310,404,357,388,94,-140,234
1062,440000,af6f4f548684e14d,6,0,904,1023,986,1197,1508,2163,2594,949,463,1024,892,976,934,964,84,-132,216
302,450000,af6f4f548684e14d,6,0,307,308,261,338,373,502,713,341,210,322,222,345,284,296,123,-100,223
1281,320000,af6f4f548684e14d,6,0,1195,1141,1497,1413,1635,2059,2647,1466,939,1519,1181,1355,1268,1352,174,-338,512
677,360000,af6f4f548684e14d,6,0,635,717,687,798,900,1083,1527,753,397,757,746,837,792,780,91,-11,102
655,130000,af6f4f548684e14d,6,0,660,609,745,771,828,1012,1235,691,404,655,694,773,734,707,79,39,40
937,410000,af6f4f548684e14d,6,0,899,929,998,1228,1191,1470,2122,1000,589,1119,1013,903,958,1012,-110,-106,-4
879,330000,af6f4f548684e14d,6,0,862,813,942,1042,1090,1626,2068,1003,537,978,796,1015,906,930,219,-182,401
949,420000,af6f4f548684e14d,6,0,966,785,977,1135,1284,1519,1632,1025,485,1058,873,1015,944,982,142,-185,327
875,430000,af6f4f548684e14d,6,0,902,924,1034,1175,1168,1619,2178,1217,467,1068,962,1084,1023,1038,122,-106,228
408,350000,af6f4f548684e14d,6,0,273,417,426,426,568,767,913,522,257,433,373,497,435,434,124,-60,184
263,210000,af6f4f548684e14d,6,0,316,315,365,365,407,443,594,254,172,277,329,290,310,299,-39,52,-91
387,500000,af6f4f548684e14d,6,0,407,357,329,386,354,500,762,420,252,342,321,324,322,329,3,-21,24
732,610000,af6f4f548684e14d,6,0,263,316,283,360,444,478,651,365,184,306,238,357,298,300,119,-68,187
186,230000,af6f4f548684e14d,6,0,202,213,233,201,203,289,372,142,121,207,187,231,209,208,44,-20,64
2596,310000,7cf283430b3b5e38,6,0,1353,1616,1715,1560,1261,1546,1428,635,513,975,1070,1137,1104,1061,67,95,-28
510,530000,7cf283430b3b5e38,6,0,298,451,462,412,350,412,626,249,167,333,316,408,362,352,92,-17,109
413,150000,7cf283430b3b5e38,6,0,328,313,335,434,451,516,701,285,178,320,330,439,384,363,109,10,99
335,110000,7cf283430b3b5e38,6,0,232,247,248,278,174,264,913,106,74,113,101,453,277,222,352,-12,364
1954,510000,7cf283430b3b5e38,6,0,1549,1800,1833,2351,1555,1783,2691,1134,763,1522,1501,1649,1575,1557,148,-21,169
2517,340000,7cf283430b3b5e38,6,0,1957,2071,2572,2578,2110,2138,2356,1607,968,1908,2068,2171,2120,2049,103,160,-57
3954,370000,7cf283430b3b5e38,6,0,2665,3185,3623,4079,3911,3787,4830,2048,1323,3138,3779,4223,4001,3713,444,641,-197
1085,140000,7cf283430b3b5e38,6,0,612,635,770,774,678,852,1073,317,283,629,610,883,746,707,273,-19,292
2203,440000,7cf283430b3b5e38,6,0,1841,2105,2230,2219,1912,2435,2500,695,488,1495,1512,1848,1680,1618,336,17,319
966,450000,7cf283430b3b5e38,6,0,509,467,597,723,646,783,869,475,293,738,554,830,692,707,276,-184,460
4995,320000,7cf283430b3b5e38,6,0,4119,4343,5439,5089,5170,5016,5865,2657,2401,4119,4083,4704,4394,4302,621,-36,657
1662,360000,7cf283430b3b5e38,6,0,997,1282,1228,1446,1175,1376,1737,923,549,1502,1828,1895,1862,1742,67,326,-259
2761,130000,7cf283430b3b5e38,6,0,1717,1730,2030,2166,1672,1926,2621,900,720,1379,2198,2809,2504,2129,611,819,-208
3400,410000,7cf283430b3b5e38,6,0,2124,2569,3033,2794,2644,2874,3243,1683,1042,2558,3199,3067,3133,2941,-132,641,-773
2778,330000,7cf283430b3b5e38,6,0,2635,2644,3079,3258,3003,3295,3490,1289,1038,1965,1876,2506,2191,2116,630,-89,719
1882,420000,7cf283430b3b5e38,6,0,1346,1388,1694,1779,1500,1547,1624,929,480,1234,1278,1437,1358,1316,159,44,115
1720,430000,7cf283430b3b5e38,6,0,1388,1464,1556,1793,1457,1585,1952,989,516,1513,1616,1696,1656,1608,80,103,-23
1184,350000,7cf283430b3b5e38,6,0,600,1040,913,859,836,1130,958,546,402,859,878,1319,1098,1019,441,19,422
571,210000,7cf283430b3b5e38,6,0,466,570,710,667,540,619,821,205,149,446,498,474,486,473,-24,52,-76
660,500000,7cf283430b3b5e38,6,0,487,446,463,501,422,419,597,296,163,296,401,429,415,375,28,105,-77
1688,610000,7cf283430b3b5e38,6,0,590,762,830,880,891,912,1151,413,242,475,689,883,786,682,194,214,-20
310,230000,7cf283430b3b5e38,6,0,233,247,332,298,250,347,415,118,130,301,193,254,224,249,61,-108,169
101,310000,d4efbebb087fd03f,6,0,121,130,170,225,144,225,270,79,27,45,95,103,99,81,8,50,-42
213,530000,d4efbebb087fd03f,6,0,124,141,193,215,192,267,384,296,172,285,192,231,212,236,39,-93,132
177,150000,d4efbebb087fd03f,6,0,155,165,211,257,237,359,450,248,124,211,203,178,190,197,-25,-8,-17
818,110000,d4efbebb087fd03f,6,0,764,635,596,755,684,938,1287,118,74,556,952,1106,1029,871,154,396,-242
734,510000,d4efbebb087fd03f,6,0,743,840,1135,1134,707,1002,2805,1326,797,891,676,702,689,756,26,-215,241
612,340000,d4efbebb087fd03f,6,0,427,626,807,752,716,977,1443,903,436,535,520,582,551,546,62,-15,77
1335,370000,d4efbebb087fd03f,6,0,1325,1510,2013,2253,1752,2198,3785,1878,1009,1343,1575,1488,1532,1469,-87,232,-319
426,140000,d4efbebb087fd03f,6,0,273,396,591,635,370,1993,2925,603,248,417,464,574,519,485,110,47,63
1215,440000,d4efbebb087fd03f,6,0,1183,1216,1851,1526,1065,2044,2419,914,399,1078,1095,1082,1088,1085,-13,17,-30
470,450000,d4efbebb087fd03f,6,0,389,373,565,452,368,493,935,666,303,492,403,512,458,469,109,-89,198
944,320000,d4efbebb087fd03f,6,0,971,1038,1263,1231,1184,1531,2308,910,648,752,1041,985,1013,926,-56,289,-345
561,360000,d4efbebb087fd03f,6,0,479,591,657,831,701,917,1377,999,364,509,561,555,558,542,-6,52,-58
876,130000,d4efbebb087fd03f,6,0,616,754,991,941,754,1144,2067,1110,641,741,953,1002,978,899,49,212,-163
1487,410000,d4efbebb087fd03f,6,0,1321,1528,1922,1491,1090,1965,3560,2272,888,1199,1423,1368,1396,1330,-55,224,-279
1882,330000,d4efbebb087fd03f,6,0,1900,1877,2534,1978,2287,3147,4324,1028,639,1114,1097,2340,1718,1517,1243,-17,1260
475,420000,d4efbebb087fd03f,6,0,475,487,636,528,521,941,1534,1004,347,476,456,410,433,447,-46,-20,-26
716,430000,d4efbebb087fd03f,6,0,885,1014,1148,1102,762,1142,1719,1133,438,685,688,650,669,674,-38,3,-41
722,350000,d4efbebb087fd03f,6,0,596,710,861,605,468,762,1967,434,268,656,565,712,638,644,147,-91,238
167,210000,d4efbebb087fd03f,6,0,242,328,373,319,239,291,520,199,149,205,202,188,195,198,-14,-3,-11
286,500000,d4efbebb087fd03f,6,0,352,383,500,317,253,326,532,432,291,409,310,302,306,340,-8,-99,91
580,610000,d4efbebb087fd03f,6,0,670,984,1191,1013,830,1010,1651,919,422,609,612,587,600,603,-25,3,-28
132,230000,d4efbebb087fd03f,6,0,96,114,179,154,114,204,257,135,104,114,128,104,116,115,-24,14,-38
46,310000,7245e0ee27b195cd,6,0,91,84,82,78,75,125,158,63,40,60,51,45,48,52,-6,-9,3
266,530000,7245e0ee27b195cd,6,0,212,242,297,409,425,375,535,421,246,288,240,252,246,260,12,-48,60
206,150000,7245e0ee27b195cd,6,0,141,155,186,321,287,448,676,363,164,250,212,180,196,214,-32,-38,6
61,110000,7245e0ee27b195cd,6,0,166,192,229,328,289,360,496,86,74,109,80,71,76,87,-9,-29,20
628,510000,7245e0ee27b195cd,6,0,542,612,740,894,870,831,1260,724,451,621,526,535,530,561,9,-95,104
346,340000,7245e0ee27b195cd,6,0,272,360,423,570,478,510,806,576,272,358,315,316,316,330,1,-43,44
958,370000,7245e0ee27b195cd,6,0,814,1067,1385,1544,1660,1778,2915,1529,762,977,1071,1025,1048,1024,-46,94,-140
543,140000,7245e0ee27b195cd,6,0,304,387,526,657,689,668,1092,615,366,578,543,590,566,570,47,-35,82
867,440000,7245e0ee27b195cd,6,0,706,726,1003,987,1170,1384,1437,718,363,821,836,734,785,797,-102,15,-117
316,450000,7245e0ee27b195cd,6,0,215,205,275,336,321,463,659,452,233,370,288,292,290,317,4,-82,86
448,320000,7245e0ee27b195cd,6,0,417,424,503,619,691,743,1008,543,405,518,460,406,433,461,-54,-58,4
301,360000,7245e0ee27b195cd,6,0,321,323,384,576,518,577,816,634,247,323,301,331,316,318,30,-22,52
930,130000,7245e0ee27b195cd,6,0,796,976,1190,1442,1308,1432,2365,1304,951,1023,1070,1210,1140,1101,140,47,93
850,410000,7245e0ee27b195cd,6,0,796,921,1180,1362,1148,1406,2228,1526,717,888,888,823,856,866,-65,0,-65
507,330000,7245e0ee27b195cd,6,0,497,546,656,656,660,874,1121,438,306,511,460,520,490,497,60,-51,111
362,420000,7245e0ee27b195cd,6,0,308,353,445,594,534,655,903,635,255,364,342,325,334,344,-17,-22,5
517,430000,7245e0ee27b195cd,6,0,570,561,665,852,609,763,1216,773,321,479,531,540,536,517,9,52,-43
248,350000,7245e0ee27b195cd,6,0,203,218,279,280,218,239,420,249,153,274,195,252,224,240,57,-79,136
247,210000,7245e0ee27b195cd,6,0,253,308,361,450,328,514,641,287,222,321,326,279,302,309,-47,5,-52
232,500000,7245e0ee27b195cd,6,0,221,263,289,325,272,292,402,296,142,238,207,233,220,226,26,-31,57
471,610000,7245e0ee27b195cd,6,0,383,562,667,705,729,755,1158,815,410,484,484,492,488,487,8,0,8
216,230000,7245e0ee27b195cd,6,0,141,189,179,249,176,328,336,166,145,205,161,183,172,183,22,-44,66
92,310000,8c915fe4632fb9fa,6,0,130,143,149,181,158,314,461,180,102,190,125,145,135,153,20,-65,85
486,530000,8c915fe4632fb9fa,6,0,248,387,336,447,627,757,1396,1059,575,778,650,682,666,703,32,-128,160
356,150000,8c915fe4632fb9fa,6,0,174,186,216,287,324,527,720,520,270,473,409,472,440,451,63,-64,127
78,110000,8c915fe4632fb9fa,6,0,100,137,177,237,199,242,487,101,86,162,127,117,122,135,-10,-35,25
925,510000,8c915fe4632fb9fa,6,0,618,741,845,1263,1243,1605,2433,1860,1194,1302,1156,1192,1174,1217,36,-146,182
738,340000,8c915fe4632fb9fa,6,0,546,651,840,1069,1269,1370,2298,1440,720,878,861,934,898,891,73,-17,90
1321,370000,8c915fe4632fb9fa,6,0,768,927,999,1485,1686,2126,3804,2217,1109,1504,1812,1956,1884,1757,144,308,-164
531,140000,8c915fe4632fb9fa,6,0,224,271,379,496,642,748,1215,772,404,591,661,732,696,661,71,70,1
854,440000,8c915fe4632fb9fa,6,0,502,550,650,835,848,1467,2021,1040,446,977,1064,948,1006,996,-116,87,-203
385,450000,8c915fe4632fb9fa,6,0,240,225,284,342,388,511,880,738,330,660,454,586,520,567,132,-206,338
930,320000,8c915fe4632fb9fa,6,0,678,762,1001,1116,1451,1816,2525,1540,1130,1441,1246,1265,1256,1317,19,-195,214
491,360000,8c915fe4632fb9fa,6,0,377,409,440,725,733,889,1320,1015,377,598,631,632,632,620,1,33,-32
1518,130000,8c915fe4632fb9fa,6,0,785,958,1014,1437,1548,2026,3281,1882,1126,1456,2041,2368,2204,1955,327,585,-258
1135,410000,8c915fe4632fb9fa,6,0,719,857,953,1313,1473,1843,2975,2324,1002,1413,1518,1509,1514,1480,-9,105,-114
697,330000,8c915fe4632fb9fa,6,0,723,731,805,1089,1175,1502,2235,958,565,880,893,948,920,907,55,13,42
663,420000,8c915fe4632fb9fa,6,0,489,505,669,868,924,1339,1557,1148,463,782,723,758,740,754,35,-59,94
498,430000,8c915fe4632fb9fa,6,0,399,407,438,633,772,835,1281,1235,439,733,664,655,660,684,-9,-69,60
380,350000,8c915fe4632fb9fa,6,0,178,234,282,307,414,622,877,518,365,529,461,541,501,510,80,-68,148
266,210000,8c915fe4632fb9fa,6,0,191,236,231,291,296,396,542,311,224,349,397,405,401,384,8,48,-40
358,500000,8c915fe4632fb9fa,6,0,227,218,259,311,316,419,666,489,274,346,334,368,351,349,34,-12,46
405,610000,8c915fe4632fb9fa,6,0,271,303,362,519,627,715,1549,1036,394,463,535,597,566,532,62,72,-10
526,230000,8c915fe4632fb9fa,6,0,319,336,422,442,411,616,998,401,372,684,679,736,708,700,57,-5,62
429,310000,6155b214590c66e6,6,0,422,464,522,661,472,781,1047,423,192,279,354,355,354,329,1,75,-74
955,530000,6155b214590c66e6,6,0,706,939,877,1084,1148,1159,1879,1354,680,631,992,1295,1144,973,303,361,-58
724,150000,6155b214590c66e6,6,0,433,551,578,725,701,941,1442,814,347,566,786,1042,914,798,256,220,36
386,110000,6155b214590c66e6,6,0,391,454,496,664,474,569,1295,274,176,281,280,376,328,312,96,-1,97
1412,510000,6155b214590c66e6,6,0,1306,1417,1488,2289,1556,2162,4188,2540,1081,1111,1488,1668,1578,1422,180,377,-197
1360,340000,6155b214590c66e6,6,0,1295,1412,1803,1996,1889,2073,3650,2495,863,893,1218,1582,1400,1231,364,325,39
2666,370000,6155b214590c66e6,6,0,2168,2583,2886,3461,3252,3594,6275,3467,1356,2002,3249,3444,3346,2898,195,1247,-1052
720,140000,6155b214590c66e6,6,0,509,619,652,805,800,914,1576,743,357,500,790,998,894,763,208,290,-82
2247,440000,6155b214590c66e6,6,0,1866,1837,2246,2808,2902,3269,4342,1784,653,1364,1722,2162,1942,1749,440,358,82
574,450000,6155b214590c66e6,6,0,477,518,574,670,621,739,1316,892,381,556,538,802,670,632,264,-18,282
2604,320000,6155b214590c66e6,6,0,2468,2600,3230,3453,3560,3776,5864,3032,1760,2316,2607,3244,2926,2722,637,291,346
811,360000,6155b214590c66e6,6,0,839,839,860,1325,1195,1285,2160,1579,453,603,962,960,961,842,-2,359,-361
2213,130000,6155b214590c66e6,6,0,1774,2024,2258,2481,2298,2594,4551,2375,1231,1427,2467,3049,2758,2314,582,1040,-458
2701,410000,6155b214590c66e6,6,0,2539,3103,3396,3571,3427,4047,8018,5309,1586,1915,2716,3025,2870,2552,309,801,-492
1899,330000,6155b214590c66e6,6,0,1905,1897,2229,2579,2724,3014,4336,1679,826,1161,1890,2275,2082,1775,385,729,-344
1264,420000,6155b214590c66e6,6,0,1236,1304,1341,1747,1512,1848,3179,2049,551,906,1028,1278,1153,1071,250,122,128
1288,430000,6155b214590c66e6,6,0,1450,1536,1679,2187,1872,2355,3747,2461,732,1157,1395,1621,1508,1391,226,238,-12
757,350000,6155b214590c66e6,6,0,519,626,618,738,859,1140,1306,596,364,463,616,759,688,613,143,153,-10
969,210000,6155b214590c66e6,6,0,846,1022,1132,1218,970,1188,1784,769,415,765,1227,1203,1215,1065,-24,462,-486
627,500000,6155b214590c66e6,6,0,695,635,655,770,622,761,1417,877,373,399,529,594,562,507,65,130,-65
661,610000,6155b214590c66e6,6,0,468,587,654,727,899,841,1546,1008,303,361,648,917,782,642,269,287,-18
831,230000,6155b214590c66e6,6,0,573,663,777,675,517,944,1290,579,365,604,725,778,752,702,53,121,-68
689,310000,28e29f2c03dcd84c,6,0,680,680,720,820,623,807,1293,851,433,764,667,727,697,719,60,-97,157
414,530000,28e29f2c03dcd84c,6,0,242,468,405,456,394,535,639,509,300,415,361,462,412,413,101,-54,155
528,150000,28e29f2c03dcd84c,6,0,340,407,480,482,477,451,580,494,276,556,527,562,544,548,35,-29,64
1096,110000,28e29f2c03dcd84c,6,0,1019,1062,1143,1276,969,1288,2146,1327,923,1308,982,1002,992,1097,20,-326,346
651,510000,28e29f2c03dcd84c,6,0,487,585,715,1123,634,781,1105,856,454,680,597,621,609,633,24,-83,107
706,340000,28e29f2c03dcd84c,6,0,422,472,667,840,774,803,1070,953,364,644,584,685,634,638,101,-60,161
1141,370000,28e29f2c03dcd84c,6,0,988,988,1162,1315,1224,1513,1837,1329,778,1244,1284,1298,1291,1275,14,40,-26
660,140000,28e29f2c03dcd84c,6,0,598,604,750,729,770,798,1203,945,474,746,713,727,720,729,14,-33,47
696,440000,28e29f2c03dcd84c,6,0,335,313,351,438,425,536,825,423,180,427,549,477,513,484,-72,122,-194
151,450000,28e29f2c03dcd84c,6,0,114,93,121,141,135,160,243,179,71,140,141,183,162,155,42,1,41
1313,320000,28e29f2c03dcd84c,6,0,1215,1276,1793,1838,1848,1951,2643,1820,1058,1565,1288,1340,1314,1398,52,-277,329
293,360000,28e29f2c03dcd84c,6,0,274,321,334,419,377,424,571,408,151,325,301,312,306,313,11,-24,35
1539,130000,28e29f2c03dcd84c,6,0,961,977,1321,1377,1264,1433,1923,1604,884,1377,1523,1631,1577,1510,108,146,-38
1052,410000,28e29f2c03dcd84c,6,0,738,834,1010,1081,952,1113,1482,1178,548,1003,1062,1044,1053,1036,-18,59,-77
616,330000,28e29f2c03dcd84c,6,0,464,536,601,733,722,894,1112,767,352,679,681,651,666,670,-30,2,-32
275,420000,28e29f2c03dcd84c,6,0,317,260,295,373,329,377,483,446,164,271,261,296,278,276,35,-10,45
383,430000,28e29f2c03dcd84c,6,0,333,339,383,464,438,477,783,487,262,452,359,428,394,413,69,-93,162
297,350000,28e29f2c03dcd84c,6,0,158,212,189,235,212,345,456,397,140,227,217,291,254,245,74,-10,84
255,210000,28e29f2c03dcd84c,6,0,279,277,296,261,247,251,310,270,165,356,218,179,198,251,-39,-138,99
462,500000,28e29f2c03dcd84c,6,0,482,408,414,486,426,491,644,555,263,408,381,378,380,389,-3,-27,24
499,610000,28e29f2c03dcd84c,6,0,348,388,413,568,617,622,758,719,361,603,579,645,612,609,66,-24,90
121,230000,28e29f2c03dcd84c,6,0,115,124,187,159,142,152,169,104,79,149,106,141,124,132,35,-43,78
151,310000,37aa9169b575ef79,6,0,39,46,46,41,395,67,117,63,37,86,109,100,104,98,-9,23,-32
765,530000,37aa9169b575ef79,6,0,971,1395,1426,1254,988,1142,1590,946,692,1035,755,884,820,891,129,-280,409
629,150000,37aa9169b575ef79,6,0,690,744,864,895,802,945,982,602,413,714,724,743,734,727,19,10,9
292,110000,37aa9169b575ef79,6,0,717,716,794,737,477,625,985,300,271,404,282,274,278,320,-8,-122,114
2398,510000,37aa9169b575ef79,6,0,2651,2620,2791,2955,1733,2221,3340,1470,1639,3175,2405,2457,2431,2679,52,-770,822
452,340000,37aa9169b575ef79,6,0,479,502,552,488,424,410,575,248,260,384,279,286,282,316,7,-105,112
2420,370000,37aa9169b575ef79,6,0,2812,3126,3130,3837,3617,3662,4024,1903,1708,2748,2376,2932,2654,2685,556,-372,928
815,140000,37aa9169b575ef79,6,0,828,993,1217,1561,1243,1188,1616,679,442,672,792,892,842,785,100,120,-20
1936,440000,37aa9169b575ef79,6,0,1654,1766,1963,2010,1906,2111,2398,1196,1075,2249,1558,2005,1782,1937,447,-691,1138
523,450000,37aa9169b575ef79,6,0,331,405,319,409,384,459,435,440,301,449,664,501,582,538,-163,215,-378
670,320000,37aa9169b575ef79,6,0,786,701,745,840,781,777,930,527,626,655,605,586,596,615,-19,-50,31
296,360000,37aa9169b575ef79,6,0,292,330,358,538,488,482,540,354,189,356,270,359,314,328,89,-86,175
2856,130000,37aa9169b575ef79,6,0,3221,3102,3388,3910,3483,3233,4206,2068,1780,2633,2656,3148,2902,2812,492,23,469
1506,410000,37aa9169b575ef79,6,0,1974,2200,2100,2323,1931,2018,2962,1570,1050,1823,1515,1509,1512,1616,-6,-308,302
538,330000,37aa9169b575ef79,6,0,820,769,777,723,606,634,886,424,422,628,555,606,580,596,51,-73,124
403,420000,37aa9169b575ef79,6,0,623,595,715,725,585,544,920,483,270,442,304,376,340,374,72,-138,210
1076,430000,37aa9169b575ef79,6,0,1358,1456,1533,1680,1444,1489,2336,1714,653,1232,835,1023,929,1030,188,-397,585
428,350000,37aa9169b575ef79,6,0,487,627,773,710,690,597,622,308,292,460,424,486,455,457,62,-36,98
1237,210000,37aa9169b575ef79,6,0,1498,1804,1815,1871,1308,1478,1878,681,691,1319,1119,1215,1167,1218,96,-200,296
176,500000,37aa9169b575ef79,6,0,370,530,502,347,184,172,247,131,105,125,160,126,143,137,-34,35,-69
560,610000,37aa9169b575ef79,6,0,479,874,1106,695,580,634,1051,558,384,605,487,577,532,556,90,-118,208
1463,230000,37aa9169b575ef79,6,0,1253,1193,1427,1562,1308,1636,1781,730,952,1556,1254,1336,1295,1382,82,-302,384
4181,310000,63065128401bb3ff,6,0,2462,1180,1500,2397,1674,2362,3060,1909,501,2672,4039,883,2461,2531,-3156,1367,-4523
827,530000,63065128401bb3ff,6,0,551,884,974,1076,1038,1033,1402,656,504,651,603,785,694,680,182,-48,230
491,150000,63065128401bb3ff,6,0,344,410,446,541,468,630,827,268,214,376,413,543,478,444,130,37,93
361,110000,63065128401bb3ff,6,0,971,995,1118,835,516,1494,2145,217,200,2331,1550,280,915,1387,-1270,-781,-489
1459,510000,63065128401bb3ff,6,0,1533,1662,1864,2707,1708,2119,2450,1355,937,1478,2078,1399,1738,1652,-679,600,-1279
1598,340000,63065128401bb3ff,6,0,1799,2028,2809,2863,2529,2927,3132,1460,775,1436,1362,1591,1476,1463,229,-74,303
2569,370000,63065128401bb3ff,6,0,2715,3147,4018,4409,4129,4087,5401,1885,1225,2010,2269,2615,2442,2298,346,259,87
1135,140000,63065128401bb3ff,6,0,977,1223,1490,1510,1452,1547,2066,692,491,877,974,1192,1083,1014,218,97,121
1544,440000,63065128401bb3ff,6,0,1796,1715,2112,2192,2036,2188,2519,625,462,1475,1506,1216,1361,1399,-290,31,-321
451,450000,63065128401bb3ff,6,0,379,413,503,589,568,596,616,308,176,366,289,407,348,354,118,-77,195
3307,320000,63065128401bb3ff,6,0,3219,3369,4854,5016,4475,5007,5643,2143,1862,2644,2631,3008,2820,2761,377,-13,390
1009,360000,63065128401bb3ff,6,0,1233,1308,1681,2044,1627,1981,2357,973,442,916,895,1031,963,947,136,-21,157
2611,130000,63065128401bb3ff,6,0,2587,2964,3829,3951,3277,3711,5424,1723,1261,2043,2652,2981,2816,2559,329,609,-280
3091,410000,63065128401bb3ff,6,0,2702,3421,4398,4500,3793,4237,5119,2463,1238,2429,2562,2723,2642,2571,161,133,28
1474,330000,63065128401bb3ff,6,0,1953,2021,2513,2777,2324,2401,2755,895,768,1359,1321,1533,1427,1404,212,-38,250
1085,420000,63065128401bb3ff,6,0,1213,1120,1591,1818,1296,1466,1985,1002,357,841,848,822,835,837,-26,7,-33
1328,430000,63065128401bb3ff,6,0,1517,1583,1906,2187,1670,2078,2533,1085,531,1104,1014,1204,1109,1107,190,-90,280
973,350000,63065128401bb3ff,6,0,843,1055,1347,1279,1170,1218,1549,440,400,775,721,1235,978,910,514,-54,568
690,210000,63065128401bb3ff,6,0,586,702,806,897,700,869,1098,268,212,386,587,555,571,509,-32,201,-233
800,500000,63065128401bb3ff,6,0,1013,987,1230,1171,824,938,1120,617,359,603,607,619,613,610,12,4,8
1735,610000,63065128401bb3ff,6,0,861,1113,1278,1300,1165,1199,1748,631,397,661,1831,842,1336,1111,-989,1170,-2159
452,230000,63065128401bb3ff,6,0,327,303,404,404,286,466,480,162,156,276,218,323,270,272,105,-58,163
300,310000,ea489c253676aafc,6,0,629,425,535,502,314,574,754,315,362,767,319,351,335,479,32,-448,480
442,530000,ea489c253676aafc,6,0,461,551,450,435,635,692,866,452,295,448,404,525,464,459,121,-44,165
476,150000,ea489c253676aafc,6,0,440,380,452,427,495,612,941,427,254,591,556,550,553,566,-6,-35,29
114,110000,ea489c253676aafc,6,0,301,382,397,346,199,341,546,125,89,159,100,115,108,125,15,-59,74
1056,510000,ea489c253676aafc,6,0,1055,1379,1197,903,838,1187,1812,1017,704,1344,1235,1081,1158,1220,-154,-109,-45
694,340000,ea489c253676aafc,6,0,869,1109,958,734,813,952,1669,741,475,869,701,638,670,736,-63,-168,105
2558,370000,ea489c253676aafc,6,0,2787,3450,3299,2451,2995,3812,5496,2330,1515,2865,2841,2834,2838,2847,-7,-24,17
1329,140000,ea489c253676aafc,6,0,1270,1462,1588,1052,1126,1234,2626,1165,641,1247,1425,1531,1478,1401,106,178,-72
805,440000,ea489c253676aafc,6,0,460,457,448,529,384,525,1055,368,255,433,540,513,526,495,-27,107,-134
405,450000,ea489c253676aafc,6,0,352,363,291,255,362,355,448,365,155,240,485,249,367,325,-236,245,-481
792,320000,ea489c253676aafc,6,0,1368,1353,1085,864,1310,1728,2261,1167,1028,1507,1281,827,1054,1205,-454,-226,-228
238,360000,ea489c253676aafc,6,0,315,365,335,301,356,946,847,641,223,316,236,253,244,268,17,-80,97
2524,130000,ea489c253676aafc,6,0,2715,3210,3609,2265,2586,3058,5478,1932,1551,2981,3513,3250,3382,3248,-263,532,-795
1487,410000,ea489c253676aafc,6,0,1469,1701,1452,1141,1472,1941,3092,1731,893,1695,1504,1408,1456,1536,-96,-191,95
446,330000,ea489c253676aafc,6,0,1016,1000,913,659,638,706,1205,504,467,741,598,514,556,618,-84,-143,59
164,420000,ea489c253676aafc,6,0,353,277,263,202,272,348,657,298,154,273,222,166,194,220,-56,-51,-5
373,430000,ea489c253676aafc,6,0,769,962,701,698,568,587,1351,576,253,448,437,409,423,431,-28,-11,-17
199,350000,ea489c253676aafc,6,0,225,356,355,342,307,452,617,215,148,255,232,240,236,242,8,-23,31
679,210000,ea489c253676aafc,6,0,589,621,716,684,572,853,1026,394,408,768,721,776,748,755,55,-47,102
207,500000,ea489c253676aafc,6,0,413,558,474,304,408,379,694,353,248,346,329,249,289,308,-80,-17,-63
553,610000,ea489c253676aafc,6,0,723,667,832,623,693,804,1400,754,418,791,600,553,576,648,-47,-191,144
466,230000,ea489c253676aafc,6,0,283,369,508,307,324,496,710,280,266,503,464,518,491,495,54,-39,93
328,310000,cd5841d44fd7625e,6,0,228,201,232,150,148,312,359,339,177,321,249,248,248,273,-1,-72,71
347,530000,cd5841d44fd7625e,6,0,330,388,290,304,344,442,485,409,248,357,375,412,394,381,37,18,19
484,150000,cd5841d44fd7625e,6,0,262,398,348,325,432,401,434,519,319,522,443,583,513,516,140,-79,219
1033,110000,cd5841d44fd7625e,6,0,1039,990,1183,1150,795,1121,1802,1263,877,1267,1047,1549,1298,1288,502,-220,722
794,510000,cd5841d44fd7625e,6,0,596,623,519,741,610,732,1083,1390,565,951,827,852,840,877,25,-124,149
570,340000,cd5841d44fd7625e,6,0,403,381,360,323,440,519,629,667,315,471,534,553,544,519,19,63,-44
1554,370000,cd5841d44fd7625e,6,0,1162,1256,1311,1391,1370,1666,1642,1861,878,1578,1694,1792,1743,1688,98,116,-18
395,140000,cd5841d44fd7625e,6,0,264,316,332,330,480,421,414,426,317,451,395,445,420,430,50,-56,106
804,440000,cd5841d44fd7625e,6,0,537,509,516,523,704,995,1243,727,322,827,693,791,742,770,98,-134,232
190,450000,cd5841d44fd7625e,6,0,102,97,101,156,159,192,214,225,119,204,139,193,166,179,54,-65,119
1241,320000,cd5841d44fd7625e,6,0,925,785,871,1280,881,1099,1374,1336,868,1301,1124,1278,1201,1234,154,-177,331
278,360000,cd5841d44fd7625e,6,0,191,199,169,178,237,276,329,364,141,291,237,315,276,281,78,-54,132
1714,130000,cd5841d44fd7625e,6,0,1391,1238,1360,1115,1052,1461,1615,1768,1165,1697,1805,2074,1940,1859,269,108,161
1413,410000,cd5841d44fd7625e,6,0,913,957,1047,1104,1357,1223,1443,1429,856,1325,1403,1419,1411,1382,16,78,-62
646,330000,cd5841d44fd7625e,6,0,492,475,404,404,512,747,863,742,356,707,633,707,670,682,74,-74,148
482,420000,cd5841d44fd7625e,6,0,337,298,379,393,374,473,566,558,262,443,396,470,433,436,74,-47,121
379,430000,cd5841d44fd7625e,6,0,277,273,291,253,248,418,494,519,230,424,383,397,390,401,14,-41,55
301,350000,cd5841d44fd7625e,6,0,216,229,183,186,285,325,402,404,188,330,251,340,296,307,89,-79,168
790,210000,cd5841d44fd7625e,6,0,769,652,721,569,738,644,1082,704,546,870,783,781,782,811,-2,-87,85
436,500000,cd5841d44fd7625e,6,0,314,254,213,262,251,282,391,433,202,335,319,317,318,324,-2,-16,14
393,610000,cd5841d44fd7625e,6,0,312,356,360,419,276,346,497,487,257,378,390,460,425,409,70,12,58
970,230000,cd5841d44fd7625e,6,0,828,639,929,731,657,664,964,785,666,1198,1070,1179,1124,1149,109,-128,237
632,310000,b25c4e2e3856af22,6,0,1141,897,946,1150,1010,1563,1504,815,447,731,532,612,572,625,80,-199,279
368,530000,b25c4e2e3856af22,6,0,373,681,595,570,759,692,785,585,277,403,310,422,366,378,112,-93,205
153,150000,b25c4e2e3856af22,6,0,254,296,333,327,407,342,430,303,110,229,177,183,180,196,6,-52,58
336,110000,b25c4e2e3856af22,6,0,998,675,772,925,740,925,1127,376,284,427,371,462,416,420,91,-56,147
772,510000,b25c4e2e3856af22,6,0,903,990,1085,1885,1100,1320,1775,1096,562,764,657,680,668,700,23,-107,130
605,340000,b25c4e2e3856af22,6,0,725,769,980,1023,1001,1064,1490,952,364,600,581,589,585,590,8,-19,27
836,370000,b25c4e2e3856af22,6,0,1082,1134,1323,1432,1303,1408,1739,940,501,805,813,957,885,858,144,8,136
107,140000,b25c4e2e3856af22,6,0,221,257,295,289,333,332,371,229,113,151,138,130,134,140,-8,-13,5
947,440000,b25c4e2e3856af22,6,0,1114,1097,1195,1320,1463,1644,2216,854,451,986,862,846,854,898,-16,-124,108
163,450000,b25c4e2e3856af22,6,0,223,187,218,240,280,255,372,218,114,237,155,197,176,196,42,-82,124
1068,320000,b25c4e2e3856af22,6,0,1433,1571,1947,1897,1872,2263,3132,1586,987,1345,1015,1158,1086,1173,143,-330,473
444,360000,b25c4e2e3856af22,6,0,661,681,684,855,798,870,1144,754,284,498,430,503,466,477,73,-68,141
543,130000,b25c4e2e3856af22,6,0,622,676,985,861,883,944,1218,652,442,599,687,716,702,667,29,88,-59
669,410000,b25c4e2e3856af22,6,0,866,965,1056,1067,1021,1121,1578,856,471,700,719,644,682,688,-75,19,-94
1037,330000,b25c4e2e3856af22,6,0,1826,1921,2037,2367,2323,2703,3371,1749,893,1369,1150,1156,1153,1225,6,-219,225
600,420000,b25c4e2e3856af22,6,0,798,730,829,920,1033,988,1333,941,363,579,523,593,558,565,70,-56,126
562,430000,b25c4e2e3856af22,6,0,770,811,908,1056,973,1081,1561,1003,386,716,610,659,634,662,49,-106,155
372,350000,b25c4e2e3856af22,6,0,587,681,684,714,853,905,1102,667,370,551,387,534,460,491,147,-164,311
203,210000,b25c4e2e3856af22,6,0,332,444,478,491,437,403,555,253,188,258,212,206,209,225,-6,-46,40
303,500000,b25c4e2e3856af22,6,0,448,421,422,477,428,496,740,452,184,293,290,264,277,282,-26,-3,-23
233,610000,b25c4e2e3856af22,6,0,335,338,351,433,450,479,533,395,223,292,216,328,272,279,112,-76,188
239,230000,b25c4e2e3856af22,6,0,399,362,461,359,320,352,428,213,219,281,217,259,238,252,42,-64,106
427,310000,4a103c30d593fbbe,6,0,464,464,563,552,450,685,688,275,231,396,369,368,368,378,-1,-27,26
368,530000,4a103c30d593fbbe,6,0,509,837,743,640,687,714,1001,409,321,443,427,437,432,436,10,-16,26
460,150000,4a103c30d593fbbe,6,0,393,509,544,557,650,671,789,370,239,440,455,525,490,473,70,15,55
491,110000,4a103c30d593fbbe,6,0,1018,1021,1288,1431,1045,1332,1807,402,360,619,496,497,496,537,1,-123,124
1666,510000,4a103c30d593fbbe,6,0,1748,1887,2009,2921,2017,2913,3590,1589,1106,1523,1538,1537,1538,1533,-1,15,-16
1070,340000,4a103c30d593fbbe,6,0,1110,1307,1431,1596,1491,1717,1968,921,593,995,1124,1199,1162,1106,75,129,-54
1738,370000,4a103c30d593fbbe,6,0,1895,2003,2387,2615,2547,2776,3299,1329,945,1856,2083,2108,2096,2016,25,227,-202
526,140000,4a103c30d593fbbe,6,0,589,641,800,787,813,782,1130,401,261,510,549,610,580,556,61,39,22
1235,440000,4a103c30d593fbbe,6,0,1093,1029,1303,1438,1702,2171,2397,475,354,1081,908,1044,976,1011,136,-173,309
274,450000,4a103c30d593fbbe,6,0,295,287,282,358,395,493,595,225,179,348,224,290,257,287,66,-124,190
2155,320000,4a103c30d593fbbe,6,0,2334,2394,3107,2962,3228,3579,4302,1623,1477,2234,2129,2434,2282,2266,305,-105,410
548,360000,4a103c30d593fbbe,6,0,503,672,641,755,781,885,1016,398,230,537,551,590,570,559,39,14,25
2705,130000,4a103c30d593fbbe,6,0,2392,2559,2979,2860,2877,2989,3954,1565,1311,2239,2725,3260,2992,2741,535,486,49
1780,410000,4a103c30d593fbbe,6,0,1841,2115,2398,2493,2358,2638,3291,1489,872,1684,1948,1801,1874,1811,-147,264,-411
1417,330000,4a103c30d593fbbe,6,0,1550,1572,1914,1992,2163,2458,2897,961,793,1491,1417,1453,1435,1454,36,-74,110
762,420000,4a103c30d593fbbe,6,0,848,789,996,1142,948,1247,1304,805,357,634,667,656,662,652,-11,33,-44
563,430000,4a103c30d593fbbe,6,0,696,720,817,950,757,948,1222,427,264,565,544,561,552,557,17,-21,38
444,350000,4a103c30d593fbbe,6,0,495,680,640,694,837,946,924,385,327,518,415,620,518,518,205,-103,308
707,210000,4a103c30d593fbbe,6,0,717,904,1088,1057,1007,1160,1513,414,423,828,916,847,882,864,-69,88,-157
388,500000,4a103c30d593fbbe,6,0,378,375,374,365,407,493,612,296,209,288,300,336,318,308,36,12,24
452,610000,4a103c30d593fbbe,6,0,472,701,761,801,945,946,1143,404,239,410,468,587,528,488,119,58,61
690,230000,4a103c30d593fbbe,6,0,774,757,1154,914,753,1190,1198,462,436,1058,713,772,742,848,59,-345,404
740,310000,7a7885e2d7c00bcf,6,0,553,600,670,690,633,790,925,325,455,653,555,624,590,611,69,-98,167
211,530000,7a7885e2d7c00bcf,6,0,317,493,447,408,431,527,546,194,218,317,270,316,293,301,46,-47,93
266,150000,7a7885e2d7c00bcf,6,0,301,313,341,355,371,359,418,168,163,287,292,335,314,305,43,5,38
664,110000,7a7885e2d7c00bcf,6,0,826,879,911,1074,915,1162,1615,471,523,831,698,714,706,748,16,-133,149
630,510000,7a7885e2d7c00bcf,6,0,715,745,722,1155,772,961,1167,445,516,738,665,640,652,681,-25,-73,48
565,340000,7a7885e2d7c00bcf,6,0,656,677,767,841,878,933,1003,374,418,658,653,606,630,639,-47,-5,-42
1420,370000,7a7885e2d7c00bcf,6,0,1685,1638,1852,2308,2307,2370,2766,875,984,1739,1860,1899,1880,1833,39,121,-82
225,140000,7a7885e2d7c00bcf,6,0,275,285,300,313,320,355,484,139,184,247,243,229,236,240,-14,-4,-10
826,440000,7a7885e2d7c00bcf,6,0,912,937,951,992,1092,1209,1464,402,402,896,629,772,700,766,143,-267,410
215,450000,7a7885e2d7c00bcf,6,0,233,260,262,246,259,290,384,118,109,224,157,222,190,201,65,-67,132
1909,320000,7a7885e2d7c00bcf,6,0,2016,2112,2209,2679,2595,2801,3241,1057,1612,2234,1953,2227,2090,2138,274,-281,555
273,360000,7a7885e2d7c00bcf,6,0,347,434,393,442,498,481,511,213,176,385,307,351,329,348,44,-78,122
1571,130000,7a7885e2d7c00bcf,6,0,1298,1298,1461,1525,1603,1929,2115,754,885,1533,1690,1813,1752,1679,123,157,-34
967,410000,7a7885e2d7c00bcf,6,0,959,1096,1283,1383,1309,1461,1740,591,724,1200,1228,1058,1143,1162,-170,28,-198
1525,330000,7a7885e2d7c00bcf,6,0,1671,1999,1697,1991,2033,2127,2662,818,1237,1764,1676,1729,1702,1723,53,-88,141
412,420000,7a7885e2d7c00bcf,6,0,574,499,596,611,603,616,685,305,279,470,356,444,400,423,88,-114,202
341,430000,7a7885e2d7c00bcf,6,0,442,503,514,645,501,559,768,256,278,497,347,424,386,423,77,-150,227
326,350000,7a7885e2d7c00bcf,6,0,373,503,451,397,473,480,608,216,257,389,262,395,328,349,133,-127,260
321,210000,7a7885e2d7c00bcf,6,0,420,483,505,553,489,516,595,169,217,412,408,386,397,402,-22,-4,-18
180,500000,7a7885e2d7c00bcf,6,0,198,189,145,189,159,216,258,69,99,133,100,129,114,121,29,-33,62
301,610000,7a7885e2d7c00bcf,6,0,321,402,487,425,510,487,657,185,238,361,306,395,350,354,89,-55,144
359,230000,7a7885e2d7c00bcf,6,0,454,420,611,511,443,413,533,157,228,535,404,398,401,446,-6,-131,125
52,310000,346393c2c6305fb1,6,0,113,83,134,126,104,114,215,76,41,45,61,38,50,48,-23,16,-39
58,530000,346393c2c6305fb1,6,0,89,141,121,133,139,121,182,95,41,34,36,31,34,34,-5,2,-7
76,150000,346393c2c6305fb1,6,0,111,114,92,121,108,174,205,99,66,95,76,72,74,81,-4,-19,15
27,110000,346393c2c6305fb1,6,0,149,201,202,250,161,243,439,74,40,54,53,41,47,49,-12,-1,-11
150,510000,346393c2c6305fb1,6,0,301,284,317,459,291,297,513,309,153,136,133,149,141,139,16,-3,19
314,340000,346393c2c6305fb1,6,0,526,633,733,655,600,692,1047,578,273,312,307,331,319,317,24,-5,29
544,370000,346393c2c6305fb1,6,0,855,1000,1063,1138,1097,1099,1844,902,381,538,572,675,624,595,103,34,69
217,140000,346393c2c6305fb1,6,0,143,212,261,250,277,308,545,238,158,237,226,236,231,233,10,-11,21
96,440000,346393c2c6305fb1,6,0,223,291,295,282,277,289,373,126,71,118,103,101,102,107,-2,-15,13
40,450000,346393c2c6305fb1,6,0,100,108,107,108,100,115,162,93,53,69,35,53,44,52,18,-34,52
203,320000,346393c2c6305fb1,6,0,403,402,461,370,406,397,621,300,168,197,206,183,194,195,-23,9,-32
40,360000,346393c2c6305fb1,6,0,121,141,112,150,164,143,266,151,36,61,68,60,64,63,-8,7,-15
401,130000,346393c2c6305fb1,6,0,455,575,645,742,699,808,1460,748,389,430,459,518,488,469,59,29,30
254,410000,346393c2c6305fb1,6,0,453,477,544,566,471,617,1100,524,174,251,240,290,265,260,50,-11,61
90,330000,346393c2c6305fb1,6,0,161,194,181,198,211,191,260,101,55,63,66,67,66,65,1,3,-2
138,420000,346393c2c6305fb1,6,0,285,274,266,326,324,313,534,275,79,103,125,96,110,108,-29,22,-51
139,430000,346393c2c6305fb1,6,0,205,282,273,347,286,335,535,308,119,163,126,142,134,144,16,-37,53
42,350000,346393c2c6305fb1,6,0,88,101,114,102,89,87,129,60,25,51,31,35,33,39,4,-20,24
132,210000,346393c2c6305fb1,6,0,234,252,331,280,278,265,371,149,91,133,121,130,126,128,9,-12,21
88,500000,346393c2c6305fb1,6,0,222,247,251,250,189,199,335,168,84,69,66,80,73,72,14,-3,17
84,610000,346393c2c6305fb1,6,0,113,180,161,167,197,186,360,209,62,83,76,106,91,88,30,-7,37
86,230000,346393c2c6305fb1,6,0,206,165,264,248,169,223,312,126,95,154,101,143,122,133,42,-53,95
772,310000,02aab221aabc03b9,6,0,527,653,687,651,489,558,362,679,494,731,600,672,636,668,72,-131,203
194,530000,02aab221aabc03b9,6,0,185,247,209,201,174,160,155,229,130,223,186,188,187,199,2,-37,39
83,150000,02aab221aabc03b9,6,0,106,108,130,97,99,82,59,106,63,136,99,113,106,116,14,-37,51
618,110000,02aab221aabc03b9,6,0,646,748,847,831,642,654,521,798,532,838,575,694,634,702,119,-263,382
614,510000,02aab221aabc03b9,6,0,486,460,559,615,471,430,474,703,394,653,524,606,565,594,82,-129,211
346,340000,02aab221aabc03b9,6,0,244,244,344,348,248,228,187,338,203,372,311,341,326,341,30,-61,91
548,370000,02aab221aabc03b9,6,0,443,584,549,525,474,421,353,610,362,607,527,608,568,581,81,-80,161
152,140000,02aab221aabc03b9,6,0,101,121,154,121,105,117,105,129,94,160,139,138,138,146,-1,-21,20
1219,440000,02aab221aabc03b9,6,0,1160,1083,1238,1180,1049,976,1007,1207,847,1361,1093,1267,1180,1240,174,-268,442
153,450000,02aab221aabc03b9,6,0,129,142,161,151,126,138,119,159,102,172,121,154,138,149,33,-51,84
1639,320000,02aab221aabc03b9,6,0,1469,1509,1821,1585,1270,1186,1077,1735,1066,1713,1523,1554,1538,1597,31,-190,221
253,360000,02aab221aabc03b9,6,0,165,198,224,232,164,154,152,242,146,291,216,232,224,246,16,-75,91
327,130000,02aab221aabc03b9,6,0,337,350,330,362,307,254,182,340,242,360,379,362,370,367,-17,19,-36
320,410000,02aab221aabc03b9,6,0,291,353,389,339,239,284,223,320,199,311,289,319,304,306,30,-22,52
1501,330000,02aab221aabc03b9,6,0,1210,1486,1568,1439,1239,1136,1024,1529,973,1602,1326,1507,1416,1478,181,-276,457
369,420000,02aab221aabc03b9,6,0,300,346,383,407,272,273,274,370,238,369,296,339,318,335,43,-73,116
289,430000,02aab221aabc03b9,6,0,229,257,270,285,213,205,215,305,186,346,275,278,276,300,3,-71,74
528,350000,02aab221aabc03b9,6,0,354,394,437,448,353,321,324,518,242,572,350,498,424,473,148,-222,370
252,210000,02aab221aabc03b9,6,0,254,291,346,299,229,207,174,292,205,321,225,242,234,263,17,-96,113
232,500000,02aab221aabc03b9,6,0,232,259,222,255,197,217,217,267,199,277,240,244,242,254,4,-37,41
250,610000,02aab221aabc03b9,6,0,241,238,319,283,263,205,197,285,151,281,203,248,226,244,45,-78,123
113,230000,02aab221aabc03b9,6,0,80,75,119,71,81,63,53,93,68,133,85,82,84,100,-3,-48,45
314,310000,5d7fb682edd0f937,6,0,272,297,303,281,281,247,225,315,160,297,263,287,275,282,24,-34,58
126,530000,5d7fb682edd0f937,6,0,143,190,187,165,167,133,176,164,108,164,133,153,143,150,20,-31,51
97,150000,5d7fb682edd0f937,6,0,109,112,117,120,96,85,86,86,62,103,111,102,106,105,-9,8,-17
257,110000,5d7fb682edd0f937,6,0,362,331,427,429,308,324,417,323,190,356,270,290,280,305,20,-86,106
316,510000,5d7fb682edd0f937,6,0,380,359,376,389,305,301,337,483,166,411,313,351,332,358,38,-98,136
172,340000,5d7fb682edd0f937,6,0,187,156,227,205,162,169,174,188,119,173,183,210,196,189,27,10,17
234,370000,5d7fb682edd0f937,6,0,309,263,302,292,265,227,253,339,160,306,297,331,314,311,34,-9,43
84,140000,5d7fb682edd0f937,6,0,91,82,103,99,83,81,91,111,56,97,101,97,99,98,-4,4,-8
562,440000,5d7fb682edd0f937,6,0,522,480,565,575,462,510,512,581,314,531,409,540,474,493,131,-122,253
114,450000,5d7fb682edd0f937,6,0,124,96,117,108,102,103,109,128,57,103,59,104,82,89,45,-44,89
643,320000,5d7fb682edd0f937,6,0,698,733,823,757,642,661,734,807,456,741,678,793,736,737,115,-63,178
118,360000,5d7fb682edd0f937,6,0,139,120,153,155,115,129,138,165,79,158,126,152,139,145,26,-32,58
175,130000,5d7fb682edd0f937,6,0,197,195,219,226,184,180,178,203,126,201,195,251,223,216,56,-6,62
156,410000,5d7fb682edd0f937,6,0,189,189,186,187,161,189,173,186,103,191,191,194,192,192,3,0,3
647,330000,5d7fb682edd0f937,6,0,565,645,709,620,587,599,595,656,382,738,625,720,672,694,95,-113,208
256,420000,5d7fb682edd0f937,6,0,292,242,319,331,219,258,266,270,142,257,214,255,234,242,41,-43,84
162,430000,5d7fb682edd0f937,6,0,169,164,219,179,160,168,191,210,114,205,161,191,176,186,30,-44,74
239,350000,5d7fb682edd0f937,6,0,256,240,260,259,202,201,205,241,127,267,183,283,233,244,100,-84,184
146,210000,5d7fb682edd0f937,6,0,154,152,161,165,130,138,128,140,90,113,125,138,132,125,13,12,1
130,500000,5d7fb682edd0f937,6,0,142,148,158,109,123,106,134,131,54,117,102,136,119,118,34,-15,49
144,610000,5d7fb682edd0f937,6,0,168,161,205,192,172,135,145,159,85,142,119,156,138,139,37,-23,60
70,230000,5d7fb682edd0f937,6,0,70,67,99,74,50,53,61,68,34,78,65,79,72,74,14,-13,27
644,310000,a207df29ec9583f0,6,0,551,438,559,478,428,493,474,835,424,592,562,626,594,593,64,-30,94
223,530000,a207df29ec9583f0,6,0,222,190,240,237,204,210,215,310,178,234,223,203,213,220,-20,-11,-9
105,150000,a207df29ec9583f0,6,0,81,74,115,91,72,82,74,139,87,116,104,125,114,115,21,-12,33
726,110000,a207df29ec9583f0,6,0,717,674,824,853,604,747,817,1033,648,841,763,792,778,799,29,-78,107
507,510000,a207df29ec9583f0,6,0,494,344,458,388,382,361,382,695,383,524,456,456,456,479,0,-68,68
223,340000,a207df29ec9583f0,6,0,188,148,226,228,183,176,177,354,152,225,259,222,240,235,-37,34,-71
451,370000,a207df29ec9583f0,6,0,346,365,453,344,338,348,336,608,328,530,488,475,482,498,-13,-42,29
142,140000,a207df29ec9583f0,6,0,102,105,108,108,84,93,100,165,96,130,118,97,108,115,-21,-12,-9
962,440000,a207df29ec9583f0,6,0,769,689,886,875,627,766,825,1178,690,1101,964,1020,992,1028,56,-137,193
136,450000,a207df29ec9583f0,6,0,100,90,105,124,72,100,114,160,106,163,133,138,136,145,5,-30,35
1033,320000,a207df29ec9583f0,6,0,962,857,1124,918,791,915,1007,1591,766,1115,1026,1072,1049,1071,46,-89,135
168,360000,a207df29ec9583f0,6,0,125,115,140,155,101,129,108,227,115,167,214,182,198,188,-32,47,-79
301,130000,a207df29ec9583f0,6,0,229,221,266,200,202,203,219,376,209,316,289,290,290,298,1,-27,28
256,410000,a207df29ec9583f0,6,0,207,254,276,252,194,283,262,357,201,287,304,275,290,289,-29,17,-46
954,330000,a207df29ec9583f0,6,0,810,824,880,834,733,849,908,1436,623,970,967,965,966,967,-2,-3,1
393,420000,a207df29ec9583f0,6,0,260,260,327,326,230,315,356,436,202,366,316,282,299,321,-34,-50,16
219,430000,a207df29ec9583f0,6,0,200,157,190,184,143,174,192,302,179,246,255,226,240,242,-29,9,-38
330,350000,a207df29ec9583f0,6,0,265,234,296,266,197,227,256,500,212,338,297,357,327,331,60,-41,101
263,210000,a207df29ec9583f0,6,0,254,215,281,225,176,194,227,304,176,286,261,241,251,263,-20,-25,5
223,500000,a207df29ec9583f0,6,0,164,192,184,176,151,174,194,265,152,205,197,174,186,192,-23,-8,-15
252,610000,a207df29ec9583f0,6,0,206,235,213,228,210,194,216,307,140,222,205,251,228,226,46,-17,63
127,230000,a207df29ec9583f0,6,0,97,59,106,77,74,83,85,102,84,125,116,121,118,121,5,-9,14
142,310000,b4be3a4917289c82,6,0,149,152,203,190,188,201,262,80,97,160,113,154,134,142,41,-47,88
51,530000,b4be3a4917289c82,6,0,43,35,60,52,76,100,59,26,35,34,50,78,64,54,28,16,12
21,150000,b4be3a4917289c82,6,0,23,35,33,31,42,40,37,22,17,26,37,25,31,29,-12,11,-23
94,110000,b4be3a4917289c82,6,0,192,172,203,232,200,230,226,93,117,153,137,139,138,143,2,-16,18
128,510000,b4be3a4917289c82,6,0,94,121,152,216,166,240,223,57,76,90,137,164,150,130,27,47,-20
76,340000,b4be3a4917289c82,6,0,85,90,104,106,110,130,121,57,59,72,81,74,78,76,-7,9,-16
149,370000,b4be3a4917289c82,6,0,203,199,232,258,215,231,199,113,137,218,152,167,160,179,15,-66,81
22,140000,b4be3a4917289c82,6,0,28,32,37,31,31,28,33,16,10,28,22,76,49,42,54,-6,60
188,440000,b4be3a4917289c82,6,0,209,182,223,290,309,396,384,120,115,231,223,244,234,233,21,-8,29
31,450000,b4be3a4917289c82,6,0,23,25,29,35,34,41,40,20,18,18,25,33,29,25,8,7,1
329,320000,b4be3a4917289c82,6,0,345,389,471,447,420,635,591,225,325,414,342,390,366,382,48,-72,120
37,360000,b4be3a4917289c82,6,0,31,41,43,50,52,66,85,10,18,37,40,39,40,39,-1,3,-4
71,130000,b4be3a4917289c82,6,0,119,127,130,145,141,166,161,78,99,131,131,102,116,121,-29,0,-29
84,410000,b4be3a4917289c82,6,0,88,93,86,118,117,128,163,57,77,90,88,75,82,84,-13,-2,-11
355,330000,b4be3a4917289c82,6,0,297,361,382,415,422,523,567,168,290,344,386,300,343,343,-86,42,-128
69,420000,b4be3a4917289c82,6,0,72,79,106,110,92,120,142,48,54,76,88,66,77,77,-22,12,-34
46,430000,b4be3a4917289c82,6,0,48,45,64,96,79,112,124,41,43,61,74,75,74,70,1,13,-12
58,350000,b4be3a4917289c82,6,0,59,50,84,61,85,108,127,23,28,50,51,59,55,53,8,1,7
40,210000,b4be3a4917289c82,6,0,61,82,88,87,77,106,83,28,38,67,45,65,55,59,20,-22,42
37,500000,b4be3a4917289c82,6,0,28,26,35,47,43,77,67,17,20,19,34,34,34,29,0,15,-15
56,610000,b4be3a4917289c82,6,0,52,57,82,79,83,68,82,41,52,48,66,99,82,71,33,18,15
28,230000,b4be3a4917289c82,6,0,50,44,61,42,40,48,45,18,18,48,30,46,38,41,16,-18,34
498,310000,ef76a85c4b39f693,6,0,736,581,360,145,129,306,492,378,283,374,311,427,369,371,116,-63,179
192,530000,ef76a85c4b39f693,6,0,237,221,153,83,75,142,154,140,101,145,149,178,164,157,29,4,25
140,150000,ef76a85c4b39f693,6,0,131,165,105,47,48,67,109,121,79,109,124,169,146,134,45,15,30
543,110000,ef76a85c4b39f693,6,0,881,663,502,321,175,311,576,511,299,438,522,580,551,513,58,84,-26
529,510000,ef76a85c4b39f693,6,0,609,554,488,356,206,340,526,495,291,361,444,497,470,434,53,83,-30
331,340000,ef76a85c4b39f693,6,0,319,309,208,104,111,219,307,304,148,259,319,271,295,283,-48,60,-108
520,370000,ef76a85c4b39f693,6,0,672,573,446,246,241,312,378,406,284,400,479,557,518,479,78,79,-1
99,140000,ef76a85c4b39f693,6,0,145,138,80,47,46,58,83,94,61,99,97,93,95,96,-4,-2,-2
764,440000,ef76a85c4b39f693,6,0,973,869,740,398,282,593,912,598,355,607,642,701,672,650,59,35,24
104,450000,ef76a85c4b39f693,6,0,120,85,95,39,30,50,68,74,33,77,72,113,92,87,41,-5,46
1085,320000,ef76a85c4b39f693,6,0,1500,1116,610,270,351,609,1028,993,652,891,910,1046,978,949,136,19,117
152,360000,ef76a85c4b39f693,6,0,194,175,130,47,59,107,208,200,69,151,150,175,162,159,25,-1,26
423,130000,ef76a85c4b39f693,6,0,506,429,351,172,141,298,340,342,250,323,382,440,411,382,58,59,-1
356,410000,ef76a85c4b39f693,6,0,442,406,206,143,136,170,239,290,184,293,341,325,333,320,-16,48,-64
1284,330000,ef76a85c4b39f693,6,0,1826,1257,815,643,498,965,1300,996,708,969,1088,1209,1148,1089,121,119,2
303,420000,ef76a85c4b39f693,6,0,346,286,253,116,101,212,331,334,134,250,279,305,292,278,26,29,-3
267,430000,ef76a85c4b39f693,6,0,344,325,229,78,92,180,310,284,146,251,271,354,312,292,83,20,63
221,350000,ef76a85c4b39f693,6,0,285,288,200,69,95,138,176,229,97,153,164,270,217,196,106,11,95
370,210000,ef76a85c4b39f693,6,0,459,433,291,193,157,189,261,256,190,274,317,341,329,311,24,43,-19
209,500000,ef76a85c4b39f693,6,0,225,158,135,51,35,76,157,115,82,120,97,175,136,131,78,-23,101
199,610000,ef76a85c4b39f693,6,0,315,249,241,115,96,127,205,223,136,166,239,247,243,217,8,73,-65
157,230000,ef76a85c4b39f693,6,0,211,111,123,58,56,108,145,104,92,153,138,145,142,145,7,-15,22
387,310000,bb9fbec9a2833839,6,0,327,408,528,494,298,341,507,266,214,347,256,335,296,313,79,-91,170
176,530000,bb9fbec9a2833839,6,0,108,198,213,197,180,169,225,142,99,142,158,164,161,155,6,16,-10
136,150000,bb9fbec9a2833839,6,0,136,178,178,174,157,121,169,76,74,105,133,145,139,128,12,28,-16
279,110000,bb9fbec9a2833839,6,0,332,388,450,529,355,417,450,177,170,259,234,290,262,261,56,-25,81
319,510000,bb9fbec9a2833839,6,0,406,440,533,641,403,433,394,242,224,324,333,361,347,339,28,9,19
227,340000,bb9fbec9a2833839,6,0,223,244,297,328,172,256,310,160,139,211,231,217,224,220,-14,20,-34
398,370000,bb9fbec9a2833839,6,0,378,352,487,582,453,469,507,305,251,332,402,428,415,387,26,70,-44
100,140000,bb9fbec9a2833839,6,0,114,132,168,143,117,124,97,55,43,101,86,111,98,99,25,-15,40
694,440000,bb9fbec9a2833839,6,0,684,704,813,867,710,821,895,435,271,630,599,641,620,623,42,-31,73
99,450000,bb9fbec9a2833839,6,0,120,108,129,137,85,114,124,79,66,108,95,119,107,107,24,-13,37
879,320000,bb9fbec9a2833839,6,0,854,952,1272,1166,688,937,1154,552,589,835,807,903,855,848,96,-28,124
146,360000,bb9fbec9a2833839,6,0,151,183,202,193,186,189,178,106,91,145,142,176,159,154,34,-3,37
290,130000,bb9fbec9a2833839,6,0,275,310,427,423,324,327,378,179,188,251,302,319,310,291,17,51,-34
212,410000,bb9fbec9a2833839,6,0,257,301,336,420,237,276,308,156,143,260,258,238,248,252,-20,-2,-18
995,330000,bb9fbec9a2833839,6,0,971,1162,1196,1045,917,1072,1169,550,543,759,841,892,866,831,51,82,-31
264,420000,bb9fbec9a2833839,6,0,352,315,395,429,270,308,378,261,177,285,262,281,272,276,19,-23,42
222,430000,bb9fbec9a2833839,6,0,286,268,360,359,193,226,309,145,129,251,238,285,262,258,47,-13,60
233,350000,bb9fbec9a2833839,6,0,238,244,281,263,253,214,293,168,110,183,202,270,236,218,68,19,49
140,210000,bb9fbec9a2833839,6,0,149,191,241,242,174,177,213,86,85,121,151,164,158,145,13,30,-17
131,500000,bb9fbec9a2833839,6,0,135,121,146,128,96,89,130,65,59,92,68,101,84,87,33,-24,57
137,610000,bb9fbec9a2833839,6,0,148,200,229,215,165,164,174,112,81,131,150,180,165,154,30,19,11
78,230000,bb9fbec9a2833839,6,0,121,92,130,140,82,95,85,44,40,74,82,95,88,84,13,8,5
485,310000,da457d15788fe8ee,6,0,576,421,521,504,402,593,748,538,251,456,315,445,380,405,130,-141,271
290,530000,da457d15788fe8ee,6,0,204,306,266,231,316,323,344,263,166,191,198,263,230,217,65,7,58
178,150000,da457d15788fe8ee,6,0,169,162,217,201,207,206,200,197,109,152,165,213,189,177,48,13,35
754,110000,da457d15788fe8ee,6,0,1008,845,898,731,715,939,1050,755,424,693,651,781,716,708,130,-42,172
547,510000,da457d15788fe8ee,6,0,748,554,658,1072,583,560,641,624,348,443,468,502,485,471,34,25,9
317,340000,da457d15788fe8ee,6,0,300,257,346,329,282,331,409,330,200,229,256,264,260,250,8,27,-19
523,370000,da457d15788fe8ee,6,0,623,481,543,678,438,630,646,659,309,458,540,534,537,511,-6,82,-88
128,140000,da457d15788fe8ee,6,0,127,114,155,143,139,142,103,120,44,90,120,136,128,115,16,30,-14
1203,440000,da457d15788fe8ee,6,0,1303,1074,1237,1342,1295,1408,1829,1269,499,1006,894,1099,996,1000,205,-112,317
149,450000,da457d15788fe8ee,6,0,161,124,125,189,162,142,255,213,82,152,117,156,136,142,39,-35,74
955,320000,da457d15788fe8ee,6,0,1078,842,1106,1255,1040,1108,1430,1304,649,954,933,1003,968,963,70,-21,91
203,360000,da457d15788fe8ee,6,0,228,177,230,275,218,275,247,282,85,186,198,229,214,204,31,12,19
405,130000,da457d15788fe8ee,6,0,442,396,476,471,407,417,527,425,254,337,412,434,423,394,22,75,-53
372,410000,da457d15788fe8ee,6,0,472,400,422,469,405,382,502,442,251,354,426,325,376,368,-101,72,-173
1178,330000,da457d15788fe8ee,6,0,1251,1000,1181,1241,932,1214,1500,938,567,836,888,1017,952,914,129,52,77
445,420000,da457d15788fe8ee,6,0,467,358,427,529,447,473,526,572,259,428,363,377,370,389,14,-65,79
366,430000,da457d15788fe8ee,6,0,451,322,451,476,369,391,505,374,207,342,370,431,400,381,61,28,33
238,350000,da457d15788fe8ee,6,0,272,282,266,282,298,320,358,335,144,206,194,282,238,227,88,-12,100
277,210000,da457d15788fe8ee,6,0,340,365,459,418,357,335,454,281,156,268,293,330,312,297,37,25,12
284,500000,da457d15788fe8ee,6,0,291,189,230,259,188,209,244,199,108,153,121,186,154,153,65,-32,97
236,610000,da457d15788fe8ee,6,0,302,281,312,352,366,242,346,325,174,210,225,299,262,245,74,15,59
149,230000,da457d15788fe8ee,6,0,224,175,240,219,123,190,198,139,94,144,137,133,135,138,-4,-7,3
633,310000,6858d6dfe680bdf7,6,0,547,444,607,438,357,513,576,543,384,696,487,649,568,611,162,-209,371
249,530000,6858d6dfe680bdf7,6,0,183,177,213,139,117,236,257,243,199,312,234,314,274,287,80,-78,158
93,150000,6858d6dfe680bdf7,6,0,52,46,43,47,37,60,80,54,43,84,76,64,70,75,-12,-8,-4
587,110000,6858d6dfe680bdf7,6,0,595,494,449,410,328,585,816,536,311,688,527,617,572,611,90,-161,251
603,510000,6858d6dfe680bdf7,6,0,569,444,445,455,290,447,593,591,337,640,478,571,524,563,93,-162,255
362,340000,6858d6dfe680bdf7,6,0,284,251,265,236,233,275,385,322,230,435,350,391,370,392,41,-85,126
498,370000,6858d6dfe680bdf7,6,0,386,382,358,297,285,401,440,468,289,622,538,593,566,584,55,-84,139
70,140000,6858d6dfe680bdf7,6,0,61,45,60,31,30,61,103,57,64,78,79,91,85,83,12,1,11
1469,440000,6858d6dfe680bdf7,6,0,1023,972,1033,800,773,983,1319,1274,618,1449,1061,1394,1228,1301,333,-388,721
156,450000,6858d6dfe680bdf7,6,0,110,112,99,93,94,126,167,115,84,164,123,176,150,154,53,-41,94
1269,320000,6858d6dfe680bdf7,6,0,879,894,893,729,862,988,1160,1203,919,1681,1193,1428,1310,1434,235,-488,723
201,360000,6858d6dfe680bdf7,6,0,160,175,134,144,96,129,200,185,89,224,198,224,211,215,26,-26,52
423,130000,6858d6dfe680bdf7,6,0,287,249,266,194,192,281,283,417,232,460,496,484,490,480,-12,36,-48
397,410000,6858d6dfe680bdf7,6,0,315,276,272,209,174,237,350,258,224,388,425,429,427,414,4,37,-33
1650,330000,6858d6dfe680bdf7,6,0,1389,1189,1547,1208,929,1465,1724,1540,1004,2273,1596,1876,1736,1915,280,-677,957
353,420000,6858d6dfe680bdf7,6,0,266,203,235,199,144,218,283,271,143,325,266,300,283,297,34,-59,93
363,430000,6858d6dfe680bdf7,6,0,336,258,251,209,203,255,374,375,195,380,321,402,362,368,81,-59,140
307,350000,6858d6dfe680bdf7,6,0,252,323,276,236,214,251,346,352,161,369,304,419,362,364,115,-65,180
240,210000,6858d6dfe680bdf7,6,0,205,195,187,133,91,159,186,215,146,225,256,285,270,255,29,31,-2
315,500000,6858d6dfe680bdf7,6,0,227,183,189,132,105,200,253,198,131,290,195,274,234,253,79,-95,174
212,610000,6858d6dfe680bdf7,6,0,182,135,163,159,132,134,174,188,135,235,193,286,240,238,93,-42,135
90,230000,6858d6dfe680bdf7,6,0,66,52,57,23,28,58,76,70,44,104,104,97,100,102,-7,0,-7
208,310000,79de4e4b24c35b04,6,0,256,328,379,426,299,501,825,333,136,253,217,192,204,221,-25,-36,11
559,530000,79de4e4b24c35b04,6,0,552,695,707,913,926,928,1393,1050,634,598,559,552,556,570,-7,-39,32
128,150000,79de4e4b24c35b04,6,0,99,134,132,200,230,272,405,185,132,207,141,156,148,168,15,-66,81
132,110000,79de4e4b24c35b04,6,0,194,240,313,370,330,446,852,178,127,199,127,128,128,151,1,-72,73
387,510000,79de4e4b24c35b04,6,0,569,778,755,971,792,934,1509,1063,565,512,413,385,399,437,-28,-99,71
842,340000,79de4e4b24c35b04,6,0,790,1052,1349,1421,1263,1461,2601,1965,1072,936,771,749,760,819,-22,-165,143
1539,370000,79de4e4b24c35b04,6,0,1628,2244,2677,2814,2975,3077,5360,2858,1598,1729,1694,1756,1725,1726,62,-35,97
390,140000,79de4e4b24c35b04,6,0,353,542,640,778,791,803,1442,701,396,447,437,462,450,449,25,-10,35
2779,440000,79de4e4b24c35b04,6,0,2768,3295,4086,5098,5032,5800,8421,3465,1872,3263,2465,2754,2610,2827,289,-798,1087
1326,450000,79de4e4b24c35b04,6,0,1690,1981,2497,3110,3025,3479,6171,2981,1510,1845,1206,1444,1325,1498,238,-639,877
1251,320000,79de4e4b24c35b04,6,0,1272,1577,1829,2045,1978,2153,3757,2028,1542,1465,1325,1301,1313,1364,-24,-140,116
393,360000,79de4e4b24c35b04,6,0,410,598,635,806,703,736,1319,827,443,434,359,341,350,378,-18,-75,57
1072,130000,79de4e4b24c35b04,6,0,888,1184,1505,1631,1500,1789,2863,1366,1047,1021,1146,1168,1157,1112,22,125,-103
2603,410000,79de4e4b24c35b04,6,0,3020,3796,4302,4617,4700,5194,9539,6024,2842,2528,2423,2523,2473,2491,100,-105,205
621,330000,79de4e4b24c35b04,6,0,799,1096,1291,1435,1528,1653,2646,934,580,745,680,733,706,719,53,-65,118
397,420000,79de4e4b24c35b04,6,0,488,678,753,891,696,982,1629,1137,521,524,406,468,437,466,62,-118,180
657,430000,79de4e4b24c35b04,6,0,747,984,1113,1544,1234,1513,2352,1658,771,808,663,615,639,695,-48,-145,97
319,350000,79de4e4b24c35b04,6,0,360,626,548,706,724,738,1086,453,316,456,314,359,336,376,45,-142,187
534,210000,79de4e4b24c35b04,6,0,376,528,616,644,644,694,1039,408,313,505,468,482,475,485,14,-37,51
158,500000,79de4e4b24c35b04,6,0,287,297,277,359,279,304,514,324,210,169,172,136,154,159,-36,3,-39
436,610000,79de4e4b24c35b04,6,0,358,538,648,785,855,1045,1704,937,403,499,452,488,470,480,36,-47,83
565,230000,79de4e4b24c35b04,6,0,475,643,791,839,638,832,1045,394,365,562,482,469,476,504,-13,-80,67
608,310000,12f8b7e14947c34d,6,0,835,1350,1065,2065,1032,1283,1483,389,338,505,521,647,584,558,126,16,110
198,530000,12f8b7e14947c34d,6,0,208,404,346,402,396,360,567,208,160,208,214,226,220,216,12,6,6
355,150000,12f8b7e14947c34d,6,0,415,569,575,712,648,698,789,413,215,340,311,387,349,346,76,-29,105
87,110000,12f8b7e14947c34d,6,0,346,429,397,451,276,389,488,143,102,126,84,102,93,104,18,-42,60
581,510000,12f8b7e14947c34d,6,0,695,682,820,1286,786,820,1117,531,374,577,521,559,540,552,38,-56,94
285,340000,12f8b7e14947c34d,6,0,357,477,644,726,594,615,705,385,198,241,246,257,252,248,11,5,6
824,370000,12f8b7e14947c34d,6,0,1075,1292,1454,1777,1435,1352,1707,803,424,738,843,928,886,836,85,105,-20
178,140000,12f8b7e14947c34d,6,0,259,310,346,391,347,352,464,131,87,174,169,231,200,191,62,-5,67
246,440000,12f8b7e14947c34d,6,0,296,248,286,326,342,407,475,130,117,221,195,239,217,218,44,-26,70
79,450000,12f8b7e14947c34d,6,0,153,106,135,181,167,158,231,93,43,77,54,89,72,73,35,-23,58
1090,320000,12f8b7e14947c34d,6,0,1504,1598,2024,2099,1880,1868,2181,991,782,1094,1007,1280,1144,1127,273,-87,360
188,360000,12f8b7e14947c34d,6,0,268,290,349,532,430,438,495,251,128,183,180,217,198,193,37,-3,40
611,130000,12f8b7e14947c34d,6,0,713,769,1026,1153,782,978,1229,546,360,592,598,847,722,679,249,6,243
586,410000,12f8b7e14947c34d,6,0,595,849,951,954,750,835,1053,508,259,492,410,471,440,458,61,-82,143
576,330000,12f8b7e14947c34d,6,0,655,723,773,920,884,1063,1213,348,291,556,450,632,541,546,182,-106,288
236,420000,12f8b7e14947c34d,6,0,303,273,340,406,336,358,440,200,80,136,138,174,156,149,36,2,34
284,430000,12f8b7e14947c34d,6,0,388,473,550,688,528,670,749,385,150,254,224,307,266,262,83,-30,113
240,350000,12f8b7e14947c34d,6,0,207,297,275,314,302,385,408,188,136,178,176,297,236,217,121,-2,123
71,210000,12f8b7e14947c34d,6,0,151,156,254,246,156,195,210,53,54,81,84,109,96,91,25,3,22
161,500000,12f8b7e14947c34d,6,0,218,192,205,240,178,181,295,131,85,113,117,117,117,116,0,4,-4
548,610000,12f8b7e14947c34d,6,0,666,1062,1276,1109,958,1012,1286,412,280,531,610,649,630,597,39,79,-40
105,230000,12f8b7e14947c34d,6,0,200,199,236,256,202,210,228,66,80,160,104,150,127,138,46,-56,102
231,310000,04e66e578f653ab9,6,0,293,265,342,422,337,524,679,950,175,263,226,214,220,234,-12,-37,25
85,530000,04e66e578f653ab9,6,0,88,123,129,142,173,215,293,131,118,135,108,106,107,116,-2,-27,25
45,150000,04e66e578f653ab9,6,0,57,63,80,87,94,102,118,60,38,63,48,62,55,58,14,-15,29
108,110000,04e66e578f653ab9,6,0,157,165,158,241,166,231,280,180,87,167,105,117,111,130,12,-62,74
156,510000,04e66e578f653ab9,6,0,134,135,208,419,226,291,404,151,140,210,163,126,144,166,-37,-47,10
96,340000,04e66e578f653ab9,6,0,105,84,146,172,127,176,201,116,64,85,74,80,77,80,6,-11,17
243,370000,04e66e578f653ab9,6,0,208,207,253,405,274,383,451,230,146,276,296,237,266,270,-59,20,-79
37,140000,04e66e578f653ab9,6,0,47,58,68,104,75,85,95,42,23,68,34,43,38,48,9,-34,43
106,440000,04e66e578f653ab9,6,0,119,105,149,140,175,225,268,104,54,144,101,111,106,119,10,-43,53
31,450000,04e66e578f653ab9,6,0,35,28,43,42,39,42,71,30,28,32,17,42,30,30,25,-15,40
289,320000,04e66e578f653ab9,6,0,326,286,477,566,501,644,669,334,279,388,278,361,320,342,83,-110,193
44,360000,04e66e578f653ab9,6,0,55,61,72,97,83,104,86,64,32,40,53,58,56,50,5,13,-8
159,130000,04e66e578f653ab9,6,0,117,113,185,186,192,206,272,140,97,162,151,190,170,168,39,-11,50
159,410000,04e66e578f653ab9,6,0,115,109,191,156,169,219,319,144,90,156,142,133,138,144,-9,-14,5
184,330000,04e66e578f653ab9,6,0,199,216,262,293,289,400,452,190,120,235,179,236,208,217,57,-56,113
47,420000,04e66e578f653ab9,6,0,47,45,58,71,47,81,82,146,33,61,41,44,42,49,3,-20,23
92,430000,04e66e578f653ab9,6,0,93,121,118,158,115,135,228,105,59,115,89,71,80,92,-18,-26,8
55,350000,04e66e578f653ab9,6,0,80,72,82,93,107,132,139,77,43,64,62,76,69,67,14,-2,16
46,210000,04e66e578f653ab9,6,0,22,42,64,69,52,62,81,42,40,28,19,48,34,32,29,-9,38
81,500000,04e66e578f653ab9,6,0,68,61,42,66,46,77,87,44,31,56,52,34,43,47,-18,-4,-14
99,610000,04e66e578f653ab9,6,0,92,109,169,208,170,201,238,124,83,169,151,120,136,147,-31,-18,-13
34,230000,04e66e578f653ab9,6,0,30,38,60,45,45,56,48,22,17,60,50,40,45,50,-10,-10,0
247,310000,dff803b4024d261d,6,0,138,110,96,130,129,206,317,238,124,175,178,198,188,184,20,3,17
74,530000,dff803b4024d261d,6,0,62,53,48,150,68,61,94,64,55,50,58,59,58,56,1,8,-7
93,150000,dff803b4024d261d,6,0,104,115,80,59,69,77,114,119,58,88,84,113,98,95,29,-4,33
405,110000,dff803b4024d261d,6,0,362,522,549,341,411,466,954,488,303,463,422,404,413,430,-18,-41,23
356,510000,dff803b4024d261d,6,0,313,287,213,226,219,270,560,493,212,308,310,321,316,313,11,2,9
181,340000,dff803b4024d261d,6,0,112,137,105,226,131,164,192,238,108,126,152,161,156,146,9,26,-17
732,370000,dff803b4024d261d,6,0,583,483,376,451,391,462,714,609,352,736,802,743,772,760,-59,66,-125
155,140000,dff803b4024d261d,6,0,121,88,87,81,104,152,230,168,75,152,133,162,148,149,29,-19,48
1506,440000,dff803b4024d261d,6,0,1204,796,688,783,887,1988,1893,1283,554,1157,1342,1371,1356,1290,29,185,-156
209,450000,dff803b4024d261d,6,0,302,238,333,211,167,204,333,316,132,218,179,232,206,210,53,-39,92
696,320000,dff803b4024d261d,6,0,633,614,701,409,489,602,865,785,520,701,575,790,682,689,215,-126,341
185,360000,dff803b4024d261d,6,0,199,120,104,272,168,194,280,264,100,195,178,199,188,191,21,-17,38
470,130000,dff803b4024d261d,6,0,271,278,358,279,275,250,454,387,248,489,372,444,408,435,72,-117,189
252,410000,dff803b4024d261d,6,0,225,287,201,184,168,191,300,319,141,195,250,224,237,223,-26,55,-81
668,330000,dff803b4024d261d,6,0,536,359,406,355,572,795,787,577,391,567,562,623,592,584,61,-5,66
475,420000,dff803b4024d261d,6,0,422,178,222,287,394,374,566,545,193,390,310,389,350,363,79,-80,159
341,430000,dff803b4024d261d,6,0,267,270,181,332,203,423,412,412,410,531,262,352,307,382,90,-269,359
517,350000,dff803b4024d261d,6,0,255,324,353,331,397,363,562,555,242,485,658,692,675,612,34,173,-139
286,210000,dff803b4024d261d,6,0,263,240,234,219,239,228,340,230,163,328,229,232,230,263,3,-99,102
499,500000,dff803b4024d261d,6,0,467,292,184,281,158,348,846,378,203,261,239,256,248,252,17,-22,39
139,610000,dff803b4024d261d,6,0,82,202,64,63,62,99,126,138,68,103,103,121,112,109,18,0,18
95,230000,dff803b4024d261d,6,0,81,71,56,91,46,89,107,57,72,88,195,88,142,124,-107,107,-214
219,310000,61e73e32ad101892,6,0,259,263,265,263,222,276,374,264,140,173,111,133,122,139,22,-62,84
251,530000,61e73e32ad101892,6,0,259,444,328,322,420,444,423,403,246,278,240,349,294,289,109,-38,147
446,150000,61e73e32ad101892,6,0,415,527,467,541,608,505,619,534,251,398,363,397,380,386,34,-35,69
648,110000,61e73e32ad101892,6,0,776,823,803,1019,845,1016,1441,741,459,672,521,645,583,613,124,-151,275
696,510000,61e73e32ad101892,6,0,668,723,668,1080,712,743,1078,940,507,616,610,516,563,581,-94,-6,-88
178,340000,61e73e32ad101892,6,0,209,143,177,210,217,212,273,247,107,152,149,170,160,157,21,-3,24
628,370000,61e73e32ad101892,6,0,666,592,643,866,764,681,1011,688,350,548,657,631,644,612,-26,109,-135
224,140000,61e73e32ad101892,6,0,232,228,276,283,280,288,348,274,115,219,218,272,245,236,54,-1,55
1898,440000,61e73e32ad101892,6,0,1676,1516,1456,1686,2097,2144,2562,1849,777,1549,1067,1547,1307,1388,480,-482,962
248,450000,61e73e32ad101892,6,0,312,289,221,333,376,342,443,364,194,278,172,226,199,225,54,-106,160
534,320000,61e73e32ad101892,6,0,594,521,656,670,713,682,857,658,425,546,407,545,476,499,138,-139,277
230,360000,61e73e32ad101892,6,0,228,226,207,304,324,277,382,334,121,180,176,242,209,199,66,-4,70
721,130000,61e73e32ad101892,6,0,655,636,756,829,875,790,1042,804,407,572,721,849,785,714,128,149,-21
484,410000,61e73e32ad101892,6,0,478,457,520,525,514,567,656,654,303,427,422,450,436,433,28,-5,33
544,330000,61e73e32ad101892,6,0,696,609,628,658,707,687,970,632,338,464,407,503,455,458,96,-57,153
1121,420000,61e73e32ad101892,6,0,1189,812,879,1194,1234,1296,1458,1429,526,890,740,929,834,853,189,-150,339
496,430000,61e73e32ad101892,6,0,432,433,504,586,532,579,879,712,262,444,376,475,426,432,99,-68,167
355,350000,61e73e32ad101892,6,0,254,309,324,331,423,388,523,387,223,336,237,399,318,324,162,-99,261
583,210000,61e73e32ad101892,6,0,717,778,859,919,871,786,1105,571,424,658,595,611,603,621,16,-63,79
544,500000,61e73e32ad101892,6,0,863,400,378,452,406,568,732,616,327,364,351,290,320,335,-61,-13,-48
419,610000,61e73e32ad101892,6,0,401,428,429,480,618,464,618,561,288,381,522,505,514,469,-17,141,-158
331,230000,61e73e32ad101892,6,0,379,393,463,364,346,348,497,267,165,333,307,314,310,318,7,-26,33
46,310000,a432c483b5beb856,6,0,95,119,125,135,111,242,237,68,37,61,48,42,45,50,-6,-13,7
92,530000,a432c483b5beb856,6,0,110,141,143,170,165,182,271,140,100,100,97,72,84,90,-25,-3,-22
84,150000,a432c483b5beb856,6,0,140,118,135,135,144,149,195,78,54,74,78,87,82,80,9,4,5
45,110000,a432c483b5beb856,6,0,156,136,151,163,97,128,205,34,44,59,36,32,34,42,-4,-23,19
197,510000,a432c483b5beb856,6,0,297,273,290,355,284,276,560,275,186,178,154,123,138,152,-31,-24,-7
125,340000,a432c483b5beb856,6,0,164,187,210,258,234,289,496,209,109,109,97,103,100,103,6,-12,18
211,370000,a432c483b5beb856,6,0,398,297,370,455,430,397,599,241,156,188,181,193,187,187,12,-7,19
81,140000,a432c483b5beb856,6,0,136,138,154,165,187,192,226,67,52,65,70,76,73,70,6,5,1
568,440000,a432c483b5beb856,6,0,957,908,969,966,1096,1273,1753,510,290,467,429,504,466,467,75,-38,113
103,450000,a432c483b5beb856,6,0,145,121,133,163,183,209,314,161,76,113,66,89,78,89,23,-47,70
364,320000,a432c483b5beb856,6,0,524,494,659,663,720,808,1176,484,399,360,358,395,376,371,37,-2,39
138,360000,a432c483b5beb856,6,0,179,156,182,243,282,281,556,258,99,139,120,123,122,127,3,-19,22
178,130000,a432c483b5beb856,6,0,278,240,275,311,284,290,435,164,126,133,165,184,174,161,19,32,-13
248,410000,a432c483b5beb856,6,0,353,273,313,316,283,364,562,252,130,136,161,188,174,162,27,25,2
451,330000,a432c483b5beb856,6,0,578,536,581,660,738,799,1102,332,255,331,293,293,293,306,0,-38,38
129,420000,a432c483b5beb856,6,0,274,204,230,271,257,362,526,267,110,92,100,79,90,90,-21,8,-29
133,430000,a432c483b5beb856,6,0,184,208,271,292,260,313,627,286,115,133,96,119,108,116,23,-37,60
134,350000,a432c483b5beb856,6,0,218,246,274,282,315,340,500,185,128,160,130,141,136,144,11,-30,41
127,210000,a432c483b5beb856,6,0,300,311,310,311,260,209,299,101,86,133,111,127,119,124,16,-22,38
101,500000,a432c483b5beb856,6,0,215,160,199,165,151,159,317,179,87,70,59,80,70,70,21,-11,32
48,610000,a432c483b5beb856,6,0,143,116,126,114,163,141,242,89,58,62,55,62,58,60,7,-7,14
78,230000,a432c483b5beb856,6,0,146,135,155,139,103,121,126,60,44,65,66,61,64,64,-5,1,-6
280,310000,0797526c057dcf5b,6,0,401,321,346,427,336,1289,571,175,135,300,320,311,316,310,-9,20,-29
208,530000,0797526c057dcf5b,6,0,186,247,218,226,257,285,393,160,154,201,154,174,164,176,20,-47,67
354,150000,0797526c057dcf5b,6,0,185,198,218,291,326,339,631,236,164,278,287,352,320,306,65,9,56
344,110000,0797526c057dcf5b,6,0,663,697,743,797,664,656,980,232,253,315,319,299,309,311,-20,4,-24
870,510000,0797526c057dcf5b,6,0,808,786,904,1230,923,1016,1536,609,478,708,677,703,690,696,26,-31,57
474,340000,0797526c057dcf5b,6,0,304,319,476,565,666,550,750,358,257,522,447,450,448,473,3,-75,78
2046,370000,0797526c057dcf5b,6,0,1935,1835,2200,2915,3148,3502,5481,1788,1203,1635,2012,1985,1998,1877,-27,377,-404
870,140000,0797526c057dcf5b,6,0,496,521,585,792,899,919,1474,502,371,567,626,775,700,656,149,59,90
8612,440000,0797526c057dcf5b,6,0,8587,8085,9999,11167,12710,12394,15317,5306,3718,8079,6812,7957,7384,7616,1145,-1267,2412
1613,450000,0797526c057dcf5b,6,0,1046,1010,1186,1639,1709,1789,2693,1195,777,1366,1087,1463,1275,1305,376,-279,655
2343,320000,0797526c057dcf5b,6,0,1362,1273,1726,2274,2226,2622,3296,1247,1529,2148,2087,2259,2173,2165,172,-61,233
1050,360000,0797526c057dcf5b,6,0,595,606,715,1083,1277,1265,1764,857,484,797,835,979,907,870,144,38,106
1815,130000,0797526c057dcf5b,6,0,1117,1091,1516,1988,2221,2449,3796,1214,995,1259,1697,1832,1764,1596,135,438,-303
1525,410000,0797526c057dcf5b,6,0,918,1151,1553,1783,1739,1951,3130,1278,848,1290,1492,1391,1442,1391,-101,202,-303
1644,330000,0797526c057dcf5b,6,0,1050,1140,1443,1709,2001,2019,2088,700,801,1246,1369,1509,1439,1375,140,123,17
1061,420000,0797526c057dcf5b,6,0,851,689,870,1071,1120,1425,1562,736,376,772,827,842,834,814,15,55,-40
1476,430000,0797526c057dcf5b,6,0,1265,1384,1668,1721,1444,1769,3168,1244,677,1105,1093,1503,1298,1234,410,-12,422
1163,350000,0797526c057dcf5b,6,0,978,991,1227,1477,1846,1591,1981,769,598,1058,945,1316,1130,1106,371,-113,484
1822,210000,0797526c057dcf5b,6,0,2351,2715,3298,3035,2443,2622,3705,1059,1132,1642,1541,1606,1574,1596,65,-101,166
708,500000,0797526c057dcf5b,6,0,592,510,660,624,494,548,828,333,235,331,330,400,365,354,70,-1,71
299,610000,0797526c057dcf5b,6,0,408,480,451,462,457,402,722,289,175,287,284,326,305,299,42,-3,45
621,230000,0797526c057dcf5b,6,0,426,421,630,651,605,913,1064,350,347,604,509,589,549,567,80,-95,175
131,310000,936168bd4850913d,6,0,232,275,253,330,234,241,272,250,161,224,213,175,194,204,-38,-11,-27
209,530000,936168bd4850913d,6,0,237,317,281,288,285,282,383,494,162,297,298,329,314,308,31,1,30
232,150000,936168bd4850913d,6,0,278,346,325,397,353,331,374,412,213,364,399,353,376,372,-46,35,-81
135,110000,936168bd4850913d,6,0,454,541,459,651,432,527,798,336,255,324,347,230,288,300,-117,23,-140
108,510000,936168bd4850913d,6,0,365,374,356,560,353,364,502,560,198,280,354,296,325,310,-58,74,-132
86,340000,936168bd4850913d,6,0,321,347,370,464,369,339,449,378,228,339,365,359,362,354,-6,26,-32
369,370000,936168bd4850913d,6,0,1036,1063,896,1347,1014,1020,1083,1132,648,948,1214,1085,1150,1082,-129,266,-395
137,140000,936168bd4850913d,6,0,319,311,334,462,394,347,454,373,276,370,403,345,374,373,-58,33,-91
1566,440000,936168bd4850913d,6,0,2474,2478,2391,3040,2810,2842,3119,2859,1337,2735,2621,2524,2572,2627,-97,-114,17
140,450000,936168bd4850913d,6,0,260,273,237,346,287,279,316,376,154,306,255,297,276,286,42,-51,93
405,320000,936168bd4850913d,6,0,898,914,919,1153,908,905,1057,1012,579,905,787,820,804,837,33,-118,151
151,360000,936168bd4850913d,6,0,321,370,350,407,325,334,414,397,195,355,439,342,390,379,-97,84,-181
374,130000,936168bd4850913d,6,0,619,623,691,837,696,646,778,797,602,842,1066,971,1018,960,-95,224,-319
330,410000,936168bd4850913d,6,0,860,976,801,1165,786,979,1154,954,596,986,1159,919,1039,1021,-240,173,-413
277,330000,936168bd4850913d,6,0,619,746,631,767,611,709,819,752,388,650,682,669,676,667,-13,32,-45
674,420000,936168bd4850913d,6,0,1321,1289,1127,1463,1111,1292,1497,1405,549,1164,1131,1057,1094,1117,-74,-33,-41
218,430000,936168bd4850913d,6,0,693,656,726,776,563,649,953,623,341,556,689,570,630,605,-119,133,-252
226,350000,936168bd4850913d,6,0,554,655,558,641,586,610,611,627,347,556,479,612,546,549,133,-77,210
387,210000,936168bd4850913d,6,0,579,727,667,816,696,727,851,758,485,709,730,631,680,690,-99,21,-120
35,500000,936168bd4850913d,6,0,215,222,181,222,152,145,208,248,87,111,125,128,126,121,3,14,-11
198,610000,936168bd4850913d,6,0,335,362,360,429,415,400,482,463,229,331,386,360,373,359,-26,55,-81
268,230000,936168bd4850913d,6,0,545,503,567,621,450,630,549,617,346,607,485,461,473,518,-24,-122,98
259,310000,cc21c7e91a3b5a0c,6,0,242,256,281,287,238,345,456,114,153,205,172,211,192,196,39,-33,72
359,530000,cc21c7e91a3b5a0c,6,0,270,381,345,327,285,338,442,406,203,364,347,383,365,365,36,-17,53
324,150000,cc21c7e91a3b5a0c,6,0,238,235,267,246,282,331,382,195,193,311,298,379,338,329,81,-13,94
127,110000,cc21c7e91a3b5a0c,6,0,251,253,208,303,262,356,580,121,115,186,128,156,142,157,28,-58,86
472,510000,cc21c7e91a3b5a0c,6,0,461,453,451,636,487,569,804,459,234,390,378,467,422,412,89,-12,101
530,340000,cc21c7e91a3b5a0c,6,0,364,377,400,439,428,489,503,403,244,376,434,485,460,432,51,58,-7
900,370000,cc21c7e91a3b5a0c,6,0,768,778,692,815,855,912,1164,554,505,703,953,906,930,854,-47,250,-297
314,140000,cc21c7e91a3b5a0c,6,0,230,226,277,310,284,316,428,223,193,301,299,310,304,303,11,-2,13
3003,440000,cc21c7e91a3b5a0c,6,0,2317,2288,2219,2478,2450,3345,3730,1930,1262,2615,2284,2880,2582,2593,596,-331,927
332,450000,cc21c7e91a3b5a0c,6,0,262,277,270,290,313,377,417,266,187,309,304,370,337,328,66,-5,71
1239,320000,cc21c7e91a3b5a0c,6,0,1053,1035,1139,1193,1114,1454,1527,877,754,1069,1130,1243,1186,1147,113,61,52
498,360000,cc21c7e91a3b5a0c,6,0,324,354,314,340,317,350,507,305,161,323,377,500,438,400,123,54,69
842,130000,cc21c7e91a3b5a0c,6,0,563,517,521,590,551,574,797,453,434,572,723,877,800,724,154,151,3
826,410000,cc21c7e91a3b5a0c,6,0,620,657,647,687,548,872,1036,630,391,702,797,764,780,754,-33,95,-128
1188,330000,cc21c7e91a3b5a0c,6,0,851,928,863,800,942,1151,1258,739,529,861,969,1092,1030,974,123,108,15
1002,420000,cc21c7e91a3b5a0c,6,0,1022,954,876,1065,918,1189,1511,963,454,719,775,822,798,772,47,56,-9
484,430000,cc21c7e91a3b5a0c,6,0,412,436,456,456,452,506,737,420,189,443,430,470,450,448,40,-13,53
677,350000,cc21c7e91a3b5a0c,6,0,509,574,525,556,643,734,779,473,353,640,561,659,610,620,98,-79,177
466,210000,cc21c7e91a3b5a0c,6,0,359,423,434,437,390,480,602,285,241,431,475,512,494,473,37,44,-7
233,500000,cc21c7e91a3b5a0c,6,0,256,232,218,203,186,200,305,185,95,179,155,153,154,162,-2,-24,22
246,610000,cc21c7e91a3b5a0c,6,0,238,303,301,293,309,345,496,293,157,234,292,346,319,291,54,58,-4
388,230000,cc21c7e91a3b5a0c,6,0,361,360,329,347,306,404,422,214,206,322,309,385,347,339,76,-13,89
176,310000,7aab7fca2470987e,6,0,227,228,228,248,166,277,348,224,140,212,313,130,222,218,-183,101,-284
12,530000,7aab7fca2470987e,6,0,13,29,23,22,12,22,33,19,19,18,22,20,21,20,-2,4,-6
19,150000,7aab7fca2470987e,6,0,22,34,26,20,16,19,22,21,19,29,36,17,26,27,-19,7,-26
260,110000,7aab7fca2470987e,6,0,412,397,450,433,353,372,511,424,244,378,320,244,282,314,-76,-58,-18
34,510000,7aab7fca2470987e,6,0,50,45,33,53,34,42,64,69,42,47,33,29,31,36,-4,-14,10
62,340000,7aab7fca2470987e,6,0,54,58,60,65,52,74,75,83,59,59,57,45,51,54,-12,-2,-10
237,370000,7aab7fca2470987e,6,0,323,323,300,349,309,286,341,430,189,295,303,192,248,263,-111,8,-119
75,140000,7aab7fca2470987e,6,0,61,83,86,76,58,62,78,105,64,83,78,62,70,74,-16,-5,-11
865,440000,7aab7fca2470987e,6,0,824,845,827,959,887,972,1235,1009,443,848,749,579,664,725,-170,-99,-71
22,450000,7aab7fca2470987e,6,0,22,15,35,23,23,13,26,34,17,20,12,20,16,17,8,-8,16
305,320000,7aab7fca2470987e,6,0,366,390,384,352,323,380,481,397,258,351,301,241,271,298,-60,-50,-10
30,360000,7aab7fca2470987e,6,0,35,34,41,44,29,35,37,61,16,26,40,25,32,30,-15,14,-29
215,130000,7aab7fca2470987e,6,0,251,231,259,229,234,231,316,308,172,236,271,218,244,242,-53,35,-88
140,410000,7aab7fca2470987e,6,0,186,204,209,192,150,188,209,242,134,155,146,105,126,135,-41,-9,-32
449,330000,7aab7fca2470987e,6,0,263,302,300,252,293,323,375,353,222,270,371,311,341,317,-60,101,-161
64,420000,7aab7fca2470987e,6,0,56,41,58,58,26,64,62,54,47,52,51,39,45,47,-12,-1,-11
30,430000,7aab7fca2470987e,6,0,37,54,26,47,25,31,44,54,26,27,28,26,27,27,-2,1,-3
75,350000,7aab7fca2470987e,6,0,63,56,64,42,57,83,105,92,41,56,43,37,40,45,-6,-13,7
148,210000,7aab7fca2470987e,6,0,177,170,176,181,127,153,187,158,103,124,129,115,122,123,-14,5,-19
15,500000,7aab7fca2470987e,6,0,43,25,22,19,17,12,27,22,12,27,12,19,16,19,7,-15,22
23,610000,7aab7fca2470987e,6,0,39,32,34,19,25,29,46,61,16,38,37,27,32,34,-10,-1,-9
56,230000,7aab7fca2470987e,6,0,107,90,78,77,62,61,65,66,41,61,62,37,50,53,-25,1,-26
214,310000,fde95ea242abd896,6,0,231,222,233,237,260,331,369,161,142,190,140,165,152,165,25,-50,75
232,530000,fde95ea242abd896,6,0,280,397,351,388,519,521,651,386,202,309,233,292,262,278,59,-76,135
111,150000,fde95ea242abd896,6,0,112,115,149,181,185,190,234,146,90,139,127,131,129,132,4,-12,16
130,110000,fde95ea242abd896,6,0,240,223,271,313,223,301,382,210,141,181,149,153,151,161,4,-32,36
334,510000,fde95ea242abd896,6,0,386,408,384,645,492,617,839,509,240,360,342,344,343,349,2,-18,20
273,340000,fde95ea242abd896,6,0,323,371,429,508,453,504,690,387,163,254,266,293,280,271,27,12,15
507,370000,fde95ea242abd896,6,0,569,603,642,825,774,709,964,444,303,464,570,555,562,530,-15,106,-121
191,140000,fde95ea242abd896,6,0,247,194,300,278,277,302,443,175,132,238,204,221,212,221,17,-34,51
3064,440000,fde95ea242abd896,6,0,3034,2769,3466,3967,4449,4901,5547,3229,1517,2906,3040,2996,3018,2981,-44,134,-178
230,450000,fde95ea242abd896,6,0,305,295,375,362,434,458,665,381,181,321,247,278,262,282,31,-74,105
656,320000,fde95ea242abd896,6,0,740,767,910,875,888,974,1139,690,508,722,614,698,656,678,84,-108,192
252,360000,fde95ea242abd896,6,0,306,326,283,440,408,499,625,381,184,276,300,321,310,299,21,24,-3
400,130000,fde95ea242abd896,6,0,437,434,560,591,602,602,830,407,320,433,514,507,510,485,-7,81,-88
405,410000,fde95ea242abd896,6,0,445,414,574,666,620,614,920,507,247,499,530,473,502,501,-57,31,-88
859,330000,fde95ea242abd896,6,0,959,917,968,1148,998,1169,1424,732,558,806,842,817,830,822,-25,36,-61
540,420000,fde95ea242abd896,6,0,730,629,764,987,818,1066,1347,698,270,511,498,504,501,504,6,-13,19
401,430000,fde95ea242abd896,6,0,522,526,503,752,630,700,988,570,203,418,421,498,460,446,77,3,74
635,350000,fde95ea242abd896,6,0,509,603,671,676,754,796,1043,605,368,580,595,656,626,610,61,15,46
293,210000,fde95ea242abd896,6,0,435,473,472,553,433,460,600,253,193,341,357,363,360,354,6,16,-10
159,500000,fde95ea242abd896,6,0,246,168,172,243,227,222,229,139,105,116,140,127,134,128,-13,24,-37
135,610000,fde95ea242abd896,6,0,148,148,164,191,253,229,293,140,96,140,126,155,140,140,29,-14,43
182,230000,fde95ea242abd896,6,0,255,234,372,256,198,199,322,111,123,264,218,232,225,238,14,-46,60
223,310000,97f15de12cfabbd5,6,0,242,279,368,455,354,457,516,264,193,369,368,312,340,350,-56,-1,-55
119,530000,97f15de12cfabbd5,6,0,69,134,137,168,236,233,253,206,111,144,116,120,118,127,4,-28,32
185,150000,97f15de12cfabbd5,6,0,112,170,148,180,212,200,238,219,114,172,145,184,164,167,39,-27,66
385,110000,97f15de12cfabbd5,6,0,572,614,704,733,603,754,1094,601,390,482,397,375,386,418,-22,-85,63
270,510000,97f15de12cfabbd5,6,0,241,286,280,498,363,489,543,391,237,325,296,251,274,291,-45,-29,-16
279,340000,97f15de12cfabbd5,6,0,253,319,361,472,444,568,578,495,153,185,233,254,244,224,21,48,-27
753,370000,97f15de12cfabbd5,6,0,594,653,771,1001,1018,1094,1221,1031,476,846,727,791,759,788,64,-119,183
249,140000,97f15de12cfabbd5,6,0,319,310,398,381,370,395,605,316,221,369,335,297,316,334,-38,-34,-4
2250,440000,97f15de12cfabbd5,6,0,1807,1926,2292,2762,3019,3563,3747,2666,1125,2377,2460,2143,2302,2327,-317,83,-400
104,450000,97f15de12cfabbd5,6,0,107,105,132,134,146,194,174,193,92,119,101,114,108,111,13,-18,31
803,320000,97f15de12cfabbd5,6,0,789,884,1139,1155,1292,1491,1524,1070,552,1008,901,895,898,935,-6,-107,101
165,360000,97f15de12cfabbd5,6,0,142,163,206,280,258,340,409,346,81,166,179,201,190,182,22,13,9
652,130000,97f15de12cfabbd5,6,0,621,573,819,812,975,971,1119,789,422,734,762,790,776,762,28,28,0
448,410000,97f15de12cfabbd5,6,0,378,472,519,592,609,805,866,692,326,488,531,450,490,490,-81,43,-124
1385,330000,97f15de12cfabbd5,6,0,797,1116,1100,1259,1371,1516,1515,1138,549,969,1010,1108,1059,1029,98,41,57
436,420000,97f15de12cfabbd5,6,0,462,346,475,707,729,779,906,749,253,446,434,381,408,420,-53,-12,-41
431,430000,97f15de12cfabbd5,6,0,350,381,419,626,645,767,839,710,238,437,402,430,416,423,28,-35,63
527,350000,97f15de12cfabbd5,6,0,251,400,389,434,571,612,638,509,288,542,508,519,514,523,11,-34,45
851,210000,97f15de12cfabbd5,6,0,843,1057,1068,1256,1020,1269,1395,898,506,962,872,971,922,935,99,-90,189
160,500000,97f15de12cfabbd5,6,0,243,183,190,183,170,200,213,159,106,164,130,104,117,133,-26,-34,8
129,610000,97f15de12cfabbd5,6,0,212,278,246,251,273,309,371,227,159,225,195,179,187,200,-16,-30,14
306,230000,97f15de12cfabbd5,6,0,440,381,659,536,422,639,783,366,217,537,358,448,403,448,90,-179,269
208,310000,f5d69960089c3614,6,0,143,213,231,263,186,304,291,260,125,252,169,218,194,213,49,-83,132
43,530000,f5d69960089c3614,6,0,40,86,70,45,62,97,95,78,48,59,48,61,54,56,13,-11,24
55,150000,f5d69960089c3614,6,0,30,34,48,53,57,54,64,35,18,51,53,69,61,58,16,2,14
396,110000,f5d69960089c3614,6,0,328,387,431,542,458,551,739,435,233,445,341,391,366,392,50,-104,154
231,510000,f5d69960089c3614,6,0,198,208,192,406,218,246,296,270,133,178,212,190,201,193,-22,34,-56
70,340000,f5d69960089c3614,6,0,68,83,102,108,119,125,125,156,59,89,69,81,75,80,12,-20,32
179,370000,f5d69960089c3614,6,0,189,211,236,259,209,228,356,218,112,223,197,226,212,215,29,-26,55
35,140000,f5d69960089c3614,6,0,37,39,38,29,27,53,51,47,21,35,29,43,36,36,14,-6,20
497,440000,f5d69960089c3614,6,0,315,201,283,319,341,442,572,437,152,310,246,338,292,298,92,-64,156
35,450000,f5d69960089c3614,6,0,44,25,47,48,35,38,46,44,34,25,32,38,35,32,6,7,-1
189,320000,f5d69960089c3614,6,0,160,179,202,235,218,248,301,251,138,200,177,214,196,197,37,-23,60
51,360000,f5d69960089c3614,6,0,46,43,63,74,57,75,92,84,32,51,53,76,64,60,23,2,21
111,130000,f5d69960089c3614,6,0,85,75,106,81,95,123,131,106,79,112,113,144,128,123,31,1,30
118,410000,f5d69960089c3614,6,0,115,120,133,136,137,144,187,131,57,111,155,108,132,125,-47,44,-91
142,330000,f5d69960089c3614,6,0,103,117,123,127,129,149,230,149,78,139,107,108,108,118,1,-32,33
110,420000,f5d69960089c3614,6,0,83,100,88,128,132,148,184,148,61,111,94,101,98,102,7,-17,24
118,430000,f5d69960089c3614,6,0,99,113,129,125,121,157,211,135,74,132,109,108,108,116,-1,-23,22
95,350000,f5d69960089c3614,6,0,85,91,79,63,93,111,124,108,57,77,71,97,84,82,26,-6,32
67,210000,f5d69960089c3614,6,0,94,86,129,93,93,126,129,69,51,75,76,107,92,86,31,1,30
149,500000,f5d69960089c3614,6,0,141,124,91,113,105,132,160,125,77,112,97,87,92,99,-10,-15,5
117,610000,f5d69960089c3614,6,0,93,101,114,118,176,150,182,148,77,137,111,172,142,140,61,-26,87
51,230000,f5d69960089c3614,6,0,77,51,83,64,44,71,77,53,34,68,53,50,52,57,-3,-15,12
104,310000,5b1c11c3efed5312,6,0,100,120,182,195,186,244,388,154,85,126,92,105,98,108,13,-34,47
69,530000,5b1c11c3efed5312,6,0,102,132,175,199,190,214,267,194,91,60,53,77,65,63,24,-7,31
40,150000,5b1c11c3efed5312,6,0,90,86,129,117,180,167,259,127,62,61,62,68,65,64,6,1,5
23,110000,5b1c11c3efed5312,6,0,132,124,189,195,143,181,370,71,41,51,25,21,23,32,-4,-26,22
105,510000,5b1c11c3efed5312,6,0,235,259,271,451,335,432,691,448,194,129,110,118,114,119,8,-19,27
222,340000,5b1c11c3efed5312,6,0,409,457,615,665,719,699,1253,712,250,227,217,259,238,234,42,-10,52
246,370000,5b1c11c3efed5312,6,0,542,525,598,799,850,792,1449,549,320,297,347,332,340,325,-15,50,-65
108,140000,5b1c11c3efed5312,6,0,119,112,180,176,226,231,426,153,81,103,83,114,98,100,31,-20,51
349,440000,5b1c11c3efed5312,6,0,557,570,682,810,953,1204,1628,496,168,342,246,344,295,311,98,-96,194
23,450000,5b1c11c3efed5312,6,0,74,74,93,96,119,135,240,121,56,54,26,39,32,40,13,-28,41
371,320000,5b1c11c3efed5312,6,0,558,664,879,928,1050,1083,1908,768,543,404,402,487,444,431,85,-2,87
126,360000,5b1c11c3efed5312,6,0,238,256,256,368,358,434,733,453,153,150,168,191,180,170,23,18,5
276,130000,5b1c11c3efed5312,6,0,372,433,513,576,665,667,1158,476,272,257,300,350,325,302,50,43,7
295,410000,5b1c11c3efed5312,6,0,565,604,728,823,894,1006,1883,910,372,312,380,366,373,353,-14,68,-82
407,330000,5b1c11c3efed5312,6,0,623,618,806,968,1022,1202,2202,744,430,386,337,361,349,361,24,-49,73
146,420000,5b1c11c3efed5312,6,0,214,224,236,278,353,409,749,443,143,138,130,145,138,138,15,-8,23
134,430000,5b1c11c3efed5312,6,0,206,221,263,352,322,439,744,378,131,137,149,138,144,141,-11,12,-23
127,350000,5b1c11c3efed5312,6,0,163,185,197,242,345,391,594,265,149,173,130,137,134,147,7,-43,50
47,210000,5b1c11c3efed5312,6,0,127,118,166,151,176,186,256,75,62,80,75,84,80,80,9,-5,14
27,500000,5b1c11c3efed5312,6,0,103,92,81,101,86,92,172,124,38,29,23,20,22,24,-3,-6,3
57,610000,5b1c11c3efed5312,6,0,107,108,126,155,205,212,325,144,79,70,64,97,80,77,33,-6,39
41,230000,5b1c11c3efed5312,6,0,90,66,138,116,107,126,152,43,36,52,38,43,40,44,5,-14,19
12,310000,17363f08d683d52b,6,0,83,70,93,94,69,88,96,65,19,37,175,5,90,72,-170,138,-308
57,530000,17363f08d683d52b,6,0,145,260,181,192,214,209,182,216,75,82,86,83,84,84,-3,4,-7
41,150000,17363f08d683d52b,6,0,132,152,130,174,176,130,141,132,46,66,45,69,57,60,24,-21,45
26,110000,17363f08d683d52b,6,0,203,267,229,259,158,186,277,124,81,65,48,29,38,47,-19,-17,-2
64,510000,17363f08d683d52b,6,0,277,338,249,374,267,205,292,350,117,93,78,81,80,84,3,-15,18
118,340000,17363f08d683d52b,6,0,403,369,409,407,332,341,384,513,121,108,92,90,91,97,-2,-16,14
175,370000,17363f08d683d52b,6,0,534,578,578,669,572,480,596,555,214,153,209,203,206,188,-6,56,-62
12,140000,17363f08d683d52b,6,0,72,80,105,82,89,70,67,66,26,12,22,19,20,18,-3,10,-13
29,440000,17363f08d683d52b,6,0,161,153,130,99,91,101,84,62,19,63,37,30,34,43,-7,-26,19
2,450000,17363f08d683d52b,6,0,56,59,47,57,42,39,50,45,14,26,20,6,13,17,-14,-6,-8
134,320000,17363f08d683d52b,6,0,498,540,652,534,502,474,569,538,214,216,188,191,190,198,3,-28,31
79,360000,17363f08d683d52b,6,0,296,334,361,423,281,274,309,360,94,101,91,90,90,94,-1,-10,9
131,130000,17363f08d683d52b,6,0,331,415,474,378,372,326,383,353,154,150,162,149,156,154,-13,12,-25
87,410000,17363f08d683d52b,6,0,439,537,516,505,471,372,457,538,139,100,129,104,116,111,-25,29,-54
106,330000,17363f08d683d52b,6,0,523,527,619,525,437,429,453,388,129,152,151,108,130,137,-43,-1,-42
186,420000,17363f08d683d52b,6,0,347,357,348,470,379,317,421,474,120,139,119,158,138,139,39,-20,59
115,430000,17363f08d683d52b,6,0,332,369,394,455,353,348,428,459,95,148,114,114,114,125,0,-34,34
51,350000,17363f08d683d52b,6,0,97,156,140,150,148,127,159,136,38,44,37,55,46,45,18,-7,25
53,210000,17363f08d683d52b,6,0,186,211,236,239,216,174,238,151,59,93,137,105,121,112,-32,44,-76
16,500000,17363f08d683d52b,6,0,207,154,160,119,108,151,126,110,41,27,16,19,18,21,3,-11,14
70,610000,17363f08d683d52b,6,0,195,243,241,219,279,210,288,180,80,67,82,94,88,81,12,15,-3
22,230000,17363f08d683d52b,6,0,119,135,185,126,121,118,156,75,46,57,45,34,40,45,-11,-12,1
267,310000,06880909932890ca,6,0,184,200,260,330,188,341,384,208,78,136,169,219,194,175,50,33,17
111,530000,06880909932890ca,6,0,115,160,152,177,216,186,206,142,56,68,79,116,98,88,37,11,26
39,150000,06880909932890ca,6,0,92,95,118,103,121,125,115,74,44,45,52,72,62,56,20,7,13
198,110000,06880909932890ca,6,0,404,587,598,646,461,553,771,253,139,206,162,160,161,176,-2,-44,42
459,510000,06880909932890ca,6,0,525,529,541,770,548,657,933,673,263,243,304,396,350,314,92,61,31
609,340000,06880909932890ca,6,0,812,815,909,849,800,764,993,964,338,340,389,526,458,418,137,49,88
546,370000,06880909932890ca,6,0,798,955,1028,1068,979,957,1332,1011,383,430,537,623,580,530,86,107,-21
137,140000,06880909932890ca,6,0,158,166,260,200,213,203,275,128,67,102,111,136,124,116,25,9,16
773,440000,06880909932890ca,6,0,826,970,1165,1341,1182,1660,1546,767,278,638,579,734,656,650,155,-59,214
135,450000,06880909932890ca,6,0,160,138,192,192,181,188,276,186,86,105,86,125,106,105,39,-19,58
1448,320000,06880909932890ca,6,0,1549,1784,2086,2054,2015,2022,2642,2094,991,984,1074,1356,1215,1138,282,90,192
317,360000,06880909932890ca,6,0,403,446,466,481,368,453,691,614,157,211,274,326,300,270,52,63,-11
385,130000,06880909932890ca,6,0,550,679,797,728,665,667,773,530,290,330,342,436,389,369,94,12,82
1267,410000,06880909932890ca,6,0,1405,1588,1680,1676,1390,1577,2409,1865,640,650,891,1055,973,865,164,241,-77
1088,330000,06880909932890ca,6,0,1267,1405,1649,1572,1696,1832,2222,1022,501,663,715,913,814,764,198,52,146
333,420000,06880909932890ca,6,0,470,475,562,525,475,492,661,605,178,211,256,312,284,260,56,45,11
372,430000,06880909932890ca,6,0,445,414,541,561,481,547,698,488,170,228,287,352,320,289,65,59,6
332,350000,06880909932890ca,6,0,284,350,418,427,469,556,601,361,197,246,246,307,276,266,61,0,61
137,210000,06880909932890ca,6,0,226,287,309,335,246,211,328,161,100,120,120,168,144,136,48,0,48
295,500000,06880909932890ca,6,0,447,415,439,445,330,373,430,326,140,158,145,189,167,164,44,-13,57
170,610000,06880909932890ca,6,0,278,349,407,350,449,347,562,349,119,145,167,210,188,174,43,22,21
47,230000,06880909932890ca,6,0,89,128,149,133,82,97,100,69,37,53,48,62,55,54,14,-5,19
12,310000,9c1c7ee8ebdda299,6,0,22,13,27,10,4,41,46,32,19,54,17,10,14,27,-7,-37,30
66,530000,9c1c7ee8ebdda299,6,0,148,181,200,159,126,119,169,142,104,91,53,62,58,69,9,-38,47
174,150000,9c1c7ee8ebdda299,6,0,233,350,323,327,297,353,430,278,168,258,163,176,170,199,13,-95,108
12,110000,9c1c7ee8ebdda299,6,0,151,170,121,96,46,78,112,52,38,30,13,7,10,17,-6,-17,11
143,510000,9c1c7ee8ebdda299,6,0,834,869,836,723,408,517,641,617,336,250,134,145,140,176,11,-116,127
88,340000,9c1c7ee8ebdda299,6,0,322,293,261,211,71,198,190,278,146,119,59,72,66,83,13,-60,73
650,370000,9c1c7ee8ebdda299,6,0,1542,1763,1885,1782,1445,1562,2281,1763,885,746,509,752,630,669,243,-237,480
252,140000,9c1c7ee8ebdda299,6,0,670,854,973,842,579,768,886,691,295,401,285,317,301,334,32,-116,148
139,440000,9c1c7ee8ebdda299,6,0,730,793,791,821,619,710,1008,472,229,471,212,177,194,287,-35,-259,224
102,450000,9c1c7ee8ebdda299,6,0,190,169,185,191,132,192,308,251,110,119,55,137,96,104,82,-64,146
126,320000,9c1c7ee8ebdda299,6,0,297,299,267,195,95,307,309,370,299,211,106,111,108,143,5,-105,110
52,360000,9c1c7ee8ebdda299,6,0,258,215,138,145,60,177,182,224,84,107,42,42,42,64,0,-65,65
635,130000,9c1c7ee8ebdda299,6,0,1547,1898,2125,1949,1092,1644,1840,1468,940,941,733,782,758,819,49,-208,257
281,410000,9c1c7ee8ebdda299,6,0,817,797,693,546,306,774,911,1101,433,362,211,283,247,285,72,-151,223
204,330000,9c1c7ee8ebdda299,6,0,213,216,202,149,42,380,352,327,197,195,168,241,204,201,73,-27,100
46,420000,9c1c7ee8ebdda299,6,0,172,121,123,100,46,116,125,211,58,65,32,39,36,45,7,-33,40
62,430000,9c1c7ee8ebdda299,6,0,207,195,142,140,74,141,165,230,105,87,42,50,46,60,8,-45,53
71,350000,9c1c7ee8ebdda299,6,0,259,254,219,159,110,281,215,204,105,130,66,70,68,89,4,-64,68
168,210000,9c1c7ee8ebdda299,6,0,615,791,715,654,384,528,619,375,317,409,425,215,320,350,-210,16,-226
33,500000,9c1c7ee8ebdda299,6,0,167,210,170,119,62,80,104,116,61,54,25,34,30,38,9,-29,38
125,610000,9c1c7ee8ebdda299,6,0,360,504,331,168,145,214,250,261,108,136,75,123,99,111,48,-61,109
137,230000,9c1c7ee8ebdda299,6,0,289,307,328,302,291,350,342,207,144,192,137,117,127,149,-20,-55,35
272,310000,c6833cb891626c17,6,0,190,187,321,371,283,435,596,174,80,151,177,200,188,176,23,26,-3
235,530000,c6833cb891626c17,6,0,278,391,368,477,514,538,699,444,236,185,176,241,208,201,65,-9,74
182,150000,c6833cb891626c17,6,0,182,278,328,337,354,323,485,221,94,125,138,233,186,165,95,13,82
279,110000,c6833cb891626c17,6,0,512,616,785,877,636,879,1517,309,174,289,242,251,246,261,9,-47,56
363,510000,c6833cb891626c17,6,0,519,553,602,1020,712,770,1305,743,339,285,287,359,323,310,72,2,70
660,340000,c6833cb891626c17,6,0,596,658,834,1066,894,964,1597,855,344,344,422,524,473,430,102,78,24
670,370000,c6833cb891626c17,6,0,801,793,998,1278,1160,1107,1740,687,383,327,543,829,686,566,286,216,70
172,140000,c6833cb891626c17,6,0,187,206,301,280,282,301,514,192,100,117,126,207,166,150,81,9,72
604,440000,c6833cb891626c17,6,0,668,710,890,1382,1240,1586,1899,542,186,403,360,460,410,408,100,-43,143
111,450000,c6833cb891626c17,6,0,226,201,232,277,266,309,514,260,96,110,81,120,100,104,39,-29,68
941,320000,c6833cb891626c17,6,0,872,955,1345,1406,1396,1446,2279,939,574,593,645,899,772,712,254,52,202
289,360000,c6833cb891626c17,6,0,279,356,409,638,519,571,900,502,180,199,229,302,266,243,73,30,43
768,130000,c6833cb891626c17,6,0,602,725,929,1066,990,1108,1749,708,414,412,600,843,722,618,243,188,55
1139,410000,c6833cb891626c17,6,0,1021,1208,1438,1525,1493,1622,2735,1331,509,557,792,1003,898,784,211,235,-24
1179,330000,c6833cb891626c17,6,0,1144,1284,1635,1804,1911,2130,3255,1119,581,616,676,899,788,730,223,60,163
467,420000,c6833cb891626c17,6,0,375,419,485,678,560,634,1014,597,202,210,256,309,282,258,53,46,7
287,430000,c6833cb891626c17,6,0,332,374,473,712,546,606,978,498,212,209,272,280,276,254,8,63,-55
223,350000,c6833cb891626c17,6,0,250,238,291,406,499,552,782,311,141,184,131,214,172,176,83,-53,136
165,210000,c6833cb891626c17,6,0,206,229,283,315,299,258,424,127,80,97,131,161,146,130,30,34,-4
161,500000,c6833cb891626c17,6,0,223,193,277,336,267,309,532,260,104,78,93,126,110,99,33,15,18
204,610000,c6833cb891626c17,6,0,227,253,326,373,472,366,620,315,130,154,179,263,221,199,84,25,59
87,230000,c6833cb891626c17,6,0,155,137,237,206,170,232,274,80,52,66,71,97,84,78,26,5,21
140,310000,3e21824be728cbec,6,0,192,187,249,257,239,345,396,369,177,174,163,140,152,159,-23,-11,-12
199,530000,3e21824be728cbec,6,0,289,300,344,358,406,373,334,203,134,207,159,159,159,175,0,-48,48
31,150000,3e21824be728cbec,6,0,58,65,160,123,116,59,90,51,29,42,27,40,34,36,13,-15,28
47,110000,3e21824be728cbec,6,0,141,164,139,203,168,222,242,93,60,87,42,47,44,59,5,-45,50
406,510000,3e21824be728cbec,6,0,455,488,625,731,758,778,781,288,239,321,272,333,302,309,61,-49,110
289,340000,3e21824be728cbec,6,0,370,347,570,630,644,607,661,309,266,301,237,309,273,282,72,-64,136
395,370000,3e21824be728cbec,6,0,584,576,690,772,807,782,994,540,419,572,464,433,448,490,-31,-108,77
72,140000,3e21824be728cbec,6,0,127,162,287,240,200,132,201,88,44,87,60,67,64,71,7,-27,34
418,440000,3e21824be728cbec,6,0,526,486,516,619,721,938,1135,331,231,477,411,394,402,427,-17,-66,49
161,450000,3e21824be728cbec,6,0,230,205,301,268,247,370,403,140,92,140,131,131,131,134,0,-9,9
693,320000,3e21824be728cbec,6,0,791,837,1017,1020,1227,1286,1781,805,710,885,641,740,690,755,99,-244,343
195,360000,3e21824be728cbec,6,0,230,221,285,391,438,444,431,157,97,173,170,210,190,184,40,-3,43
438,130000,3e21824be728cbec,6,0,552,574,734,729,766,589,806,391,375,484,404,455,430,448,51,-80,131
554,410000,3e21824be728cbec,6,0,668,840,854,777,834,729,896,363,334,528,418,445,432,464,27,-110,137
458,330000,3e21824be728cbec,6,0,443,507,510,573,616,797,1044,341,386,475,363,466,414,435,103,-112,215
177,420000,3e21824be728cbec,6,0,303,280,357,375,452,413,461,270,123,194,119,150,134,154,31,-75,106
184,430000,3e21824be728cbec,6,0,250,255,292,394,414,458,478,157,99,182,167,188,178,179,21,-15,36
228,350000,3e21824be728cbec,6,0,290,310,328,339,397,455,593,250,154,266,219,283,251,256,64,-47,111
84,210000,3e21824be728cbec,6,0,118,139,151,144,114,136,149,45,36,75,66,76,71,72,10,-9,19
225,500000,3e21824be728cbec,6,0,459,311,410,422,402,422,475,136,124,148,136,160,148,148,24,-12,36
186,610000,3e21824be728cbec,6,0,320,375,494,446,595,355,464,194,145,188,141,176,158,168,35,-47,82
48,230000,3e21824be728cbec,6,0,125,146,202,237,176,82,87,40,47,82,54,34,44,57,-20,-28,8
283,310000,f8a6975573af1b33,6,0,267,258,427,420,355,228,579,371,131,288,266,225,246,260,-41,-22,-19
169,530000,f8a6975573af1b33,6,0,118,180,214,200,244,165,338,215,134,179,192,167,180,179,-25,13,-38
61,150000,f8a6975573af1b33,6,0,32,43,34,40,41,43,48,41,28,59,37,53,45,50,16,-22,38
103,110000,f8a6975573af1b33,6,0,181,202,267,304,268,372,383,131,61,110,108,70,89,96,-38,-2,-36
497,510000,f8a6975573af1b33,6,0,336,352,370,632,431,484,820,550,286,428,433,456,444,439,23,5,18
563,340000,f8a6975573af1b33,6,0,362,305,443,521,495,362,758,508,322,432,425,545,485,467,120,-7,127
394,370000,f8a6975573af1b33,6,0,316,303,357,410,423,383,729,410,227,320,381,388,384,363,7,61,-54
59,140000,f8a6975573af1b33,6,0,48,59,51,78,61,91,136,74,57,53,62,47,54,54,-15,9,-24
1190,440000,f8a6975573af1b33,6,0,904,879,1153,1298,1305,1034,2232,1023,444,1072,1007,969,988,1016,-38,-65,27
209,450000,f8a6975573af1b33,6,0,169,192,217,237,215,191,328,208,107,160,131,178,154,156,47,-29,76
1040,320000,f8a6975573af1b33,6,0,877,845,1153,1190,1239,807,1846,1142,747,1023,870,969,920,954,99,-153,252
237,360000,f8a6975573af1b33,6,0,165,177,232,306,226,131,436,290,111,237,235,226,230,233,-9,-2,-7
339,130000,f8a6975573af1b33,6,0,257,243,316,360,308,272,475,287,194,265,298,335,316,299,37,33,4
571,410000,f8a6975573af1b33,6,0,404,405,509,554,543,420,747,459,249,457,513,513,513,494,0,56,-56
759,330000,f8a6975573af1b33,6,0,644,614,743,824,856,695,1454,752,503,780,679,725,702,728,46,-101,147
428,420000,f8a6975573af1b33,6,0,257,205,250,304,278,190,481,312,158,246,258,251,254,252,-7,12,-19
308,430000,f8a6975573af1b33,6,0,226,226,283,329,289,235,425,324,139,263,238,293,266,265,55,-25,80
506,350000,f8a6975573af1b33,6,0,293,354,411,469,472,415,699,508,260,395,323,426,374,381,103,-72,175
102,210000,f8a6975573af1b33,6,0,118,94,128,154,125,64,125,66,52,82,116,125,120,108,9,34,-25
378,500000,f8a6975573af1b33,6,0,316,279,300,389,322,256,548,310,185,288,287,285,286,287,-2,-1,-1
165,610000,f8a6975573af1b33,6,0,121,162,175,188,226,181,259,170,96,124,121,134,128,126,13,-3,16
52,230000,f8a6975573af1b33,6,0,92,95,86,84,67,65,115,61,52,76,85,53,69,71,-32,9,-41
297,310000,54fc07138d70374c,6,0,308,315,327,336,292,421,473,415,199,338,303,272,288,304,-31,-35,4
293,530000,54fc07138d70374c,6,0,271,381,320,316,363,485,535,500,259,353,295,304,300,317,9,-58,67
167,150000,54fc07138d70374c,6,0,198,210,230,224,233,229,234,273,129,208,180,191,186,193,11,-28,39
374,110000,54fc07138d70374c,6,0,335,454,424,442,429,500,681,534,295,402,398,365,382,388,-33,-4,-29
553,510000,54fc07138d70374c,6,0,508,557,495,659,704,743,849,933,442,540,493,508,500,514,15,-47,62
206,340000,54fc07138d70374c,6,0,204,219,249,314,271,334,368,404,198,210,162,176,169,183,14,-48,62
596,370000,54fc07138d70374c,6,0,531,579,617,771,679,776,936,911,376,595,546,558,552,566,12,-49,61
104,140000,54fc07138d70374c,6,0,128,113,131,135,142,208,244,213,113,141,101,103,102,115,2,-40,42
1067,440000,54fc07138d70374c,6,0,1056,1120,1145,1408,1392,1836,2078,1526,521,1068,875,905,890,949,30,-193,223
166,450000,54fc07138d70374c,6,0,216,203,212,207,208,246,317,323,145,236,156,189,172,194,33,-80,113
545,320000,54fc07138d70374c,6,0,513,553,616,611,660,847,820,821,461,589,458,423,440,490,-35,-131,96
139,360000,54fc07138d70374c,6,0,179,206,215,215,187,249,262,297,113,164,151,133,142,149,-18,-13,-5
415,130000,54fc07138d70374c,6,0,411,475,528,576,625,746,750,758,431,483,470,474,472,476,4,-13,17
543,410000,54fc07138d70374c,6,0,520,548,623,596,604,752,820,826,447,615,567,493,530,558,-74,-48,-26
325,330000,54fc07138d70374c,6,0,330,357,379,387,524,623,684,550,252,401,254,311,282,322,57,-147,204
274,420000,54fc07138d70374c,6,0,280,268,311,346,310,385,425,481,197,299,246,238,242,261,-8,-53,45
341,430000,54fc07138d70374c,6,0,338,350,384,424,364,460,493,505,239,383,321,315,318,340,-6,-62,56
123,350000,54fc07138d70374c,6,0,169,259,222,223,268,329,338,400,163,217,128,161,144,169,33,-89,122
258,210000,54fc07138d70374c,6,0,292,281,324,364,303,369,450,249,117,274,320,298,309,297,-22,46,-68
439,500000,54fc07138d70374c,6,0,440,402,372,406,400,540,575,576,284,403,314,306,310,341,-8,-89,81
201,610000,54fc07138d70374c,6,0,225,299,275,293,365,346,404,376,178,272,285,266,276,274,-19,13,-32
273,230000,54fc07138d70374c,6,0,325,359,356,331,302,341,410,324,206,341,242,239,240,274,-3,-99,96
253,310000,212083a9246d2fd3,6,0,413,581,617,628,446,636,846,241,179,180,191,192,192,188,1,11,-10
128,530000,212083a9246d2fd3,6,0,143,197,189,278,304,365,493,290,145,117,124,158,141,133,34,7,27
101,150000,212083a9246d2fd3,6,0,125,168,136,222,206,310,562,284,123,119,71,119,95,103,48,-48,96
59,110000,212083a9246d2fd3,6,0,429,521,473,498,257,444,824,105,71,55,60,50,55,55,-10,5,-15
436,510000,212083a9246d2fd3,6,0,636,717,777,1042,762,1080,1730,983,504,400,394,380,387,391,-14,-6,-8
521,340000,212083a9246d2fd3,6,0,701,945,973,1078,1023,1260,2243,1186,528,593,566,477,522,545,-89,-27,-62
651,370000,212083a9246d2fd3,6,0,1160,1176,1294,1622,1536,1637,2998,1261,553,503,551,645,598,566,94,48,46
173,140000,212083a9246d2fd3,6,0,154,257,272,308,299,372,645,313,178,140,164,178,171,161,14,24,-10
614,440000,212083a9246d2fd3,6,0,923,1121,1670,1369,1274,1967,3191,905,337,855,959,831,895,882,-128,104,-232
224,450000,212083a9246d2fd3,6,0,190,192,188,232,252,337,697,471,179,227,188,213,200,209,25,-39,64
802,320000,212083a9246d2fd3,6,0,1724,1702,2067,2163,1918,2283,3836,1631,972,777,763,993,878,844,230,-14,244
227,360000,212083a9246d2fd3,6,0,361,411,440,542,547,676,1270,658,229,229,221,283,252,244,62,-8,70
555,130000,212083a9246d2fd3,6,0,678,854,909,987,969,1064,2232,950,551,442,578,697,638,572,119,136,-17
1013,410000,212083a9246d2fd3,6,0,1091,1257,1337,1548,1431,1720,3243,1894,828,807,1011,1085,1048,968,74,204,-130
423,330000,212083a9246d2fd3,6,0,952,886,1003,1067,1140,1205,1850,574,328,328,361,426,394,372,65,33,32
247,420000,212083a9246d2fd3,6,0,502,356,435,576,710,866,1354,755,244,256,243,222,232,240,-21,-13,-8
412,430000,212083a9246d2fd3,6,0,599,590,709,844,687,982,1756,938,322,403,371,448,410,407,77,-32,109
238,350000,212083a9246d2fd3,6,0,357,422,486,645,645,746,1041,462,182,250,215,304,260,256,89,-35,124
111,210000,212083a9246d2fd3,6,0,231,300,418,415,275,422,561,181,92,144,178,144,161,155,-34,34,-68
260,500000,212083a9246d2fd3,6,0,631,758,749,722,571,643,1136,557,231,195,203,189,196,196,-14,8,-22
282,610000,212083a9246d2fd3,6,0,506,811,726,652,682,805,1567,639,298,275,310,369,340,318,59,35,24
71,230000,212083a9246d2fd3,6,0,123,259,159,164,109,207,305,102,62,72,62,93,78,76,31,-10,41
19,310000,4f79773e600518a6,6,0,87,88,90,112,64,139,159,95,31,32,33,18,26,28,-15,1,-16
48,530000,4f79773e600518a6,6,0,54,102,103,88,129,116,195,181,91,58,50,67,58,58,17,-8,25
86,150000,4f79773e600518a6,6,0,139,192,148,178,215,227,336,327,113,110,91,126,108,109,35,-19,54
17,110000,4f79773e600518a6,6,0,119,110,107,124,113,153,246,99,35,29,28,28,28,28,0,-1,1
69,510000,4f79773e600518a6,6,0,164,169,165,260,194,267,387,398,155,108,95,80,88,94,-15,-13,-2
103,340000,4f79773e600518a6,6,0,161,192,228,277,262,301,471,484,121,103,101,118,110,107,17,-2,19
242,370000,4f79773e600518a6,6,0,450,433,565,670,629,591,961,723,263,300,312,311,312,308,-1,12,-13
58,140000,4f79773e600518a6,6,0,81,88,106,92,114,133,167,149,66,59,57,51,54,56,-6,-2,-4
35,440000,4f79773e600518a6,6,0,107,99,112,111,142,134,176,97,19,44,38,31,34,38,-7,-6,-1
9,450000,4f79773e600518a6,6,0,61,36,46,27,44,52,62,66,20,31,15,25,20,24,10,-16,26
95,320000,4f79773e600518a6,6,0,291,216,275,222,289,312,450,333,168,137,94,101,98,111,7,-43,50
66,360000,4f79773e600518a6,6,0,110,96,123,158,141,164,252,264,69,58,63,82,72,68,19,5,14
142,130000,4f79773e600518a6,6,0,231,209,251,268,281,338,473,362,182,165,226,205,216,199,-21,61,-82
190,410000,4f79773e600518a6,6,0,420,458,438,436,457,535,679,669,213,223,212,206,209,214,-6,-11,5
57,330000,4f79773e600518a6,6,0,119,117,144,152,167,161,255,131,59,54,69,64,66,62,-5,15,-20
90,420000,4f79773e600518a6,6,0,211,166,169,231,258,278,385,450,105,110,104,89,96,101,-15,-6,-9
219,430000,4f79773e600518a6,6,0,324,322,320,453,378,533,776,857,222,262,247,257,252,255,10,-15,25
19,350000,4f79773e600518a6,6,0,45,47,38,50,51,83,65,41,21,20,20,33,26,24,13,0,13
46,210000,4f79773e600518a6,6,0,82,101,115,152,128,129,166,109,50,66,72,45,58,61,-27,6,-33
84,500000,4f79773e600518a6,6,0,162,125,149,157,175,189,306,256,58,77,65,70,68,71,5,-12,17
161,610000,4f79773e600518a6,6,0,224,270,298,329,421,381,634,493,193,190,176,193,184,186,17,-14,31
54,230000,4f79773e600518a6,6,0,109,132,165,141,126,204,277,131,70,96,70,62,66,76,-8,-26,18
111,310000,fc32b1a017b34efe,6,0,139,164,176,188,167,211,361,138,71,95,74,75,74,81,1,-21,22
323,530000,fc32b1a017b34efe,6,0,327,407,402,486,521,434,743,406,299,256,259,276,268,264,17,3,14
260,150000,fc32b1a017b34efe,6,0,218,256,255,374,366,390,683,304,135,211,181,248,214,213,67,-30,97
89,110000,fc32b1a017b34efe,6,0,298,365,388,458,302,357,675,173,56,121,79,138,108,113,59,-42,101
979,510000,fc32b1a017b34efe,6,0,1067,1135,1222,1530,1137,1318,2057,1186,681,782,644,814,729,747,170,-138,308
345,340000,fc32b1a017b34efe,6,0,292,363,463,479,476,493,865,574,194,213,248,307,278,256,59,35,24
614,370000,fc32b1a017b34efe,6,0,718,720,875,922,870,894,1538,723,282,412,473,536,504,474,63,61,2
560,140000,fc32b1a017b34efe,6,0,311,358,454,470,495,510,974,417,214,254,346,509,428,370,163,92,71
585,440000,fc32b1a017b34efe,6,0,576,557,610,730,702,768,1105,569,259,493,354,430,392,426,76,-139,215
218,450000,fc32b1a017b34efe,6,0,164,182,175,217,208,212,406,260,101,165,105,174,140,148,69,-60,129
557,320000,fc32b1a017b34efe,6,0,557,652,768,765,828,786,1332,698,402,409,494,495,494,466,1,85,-84
298,360000,fc32b1a017b34efe,6,0,262,276,281,350,363,356,774,420,110,193,205,216,210,205,11,12,-1
983,130000,fc32b1a017b34efe,6,0,614,693,937,936,974,964,2069,891,397,516,929,990,960,812,61,413,-352
908,410000,fc32b1a017b34efe,6,0,682,796,900,924,913,934,1916,1026,330,387,521,645,583,518,124,134,-10
395,330000,fc32b1a017b34efe,6,0,492,491,561,604,663,556,982,370,195,281,311,304,308,299,-7,30,-37
272,420000,fc32b1a017b34efe,6,0,303,276,301,385,300,389,721,401,105,159,186,195,190,180,9,27,-18
464,430000,fc32b1a017b34efe,6,0,511,551,548,722,567,687,1290,631,205,298,333,363,348,331,30,35,-5
154,350000,fc32b1a017b34efe,6,0,135,152,178,217,240,253,385,180,95,138,114,150,132,134,36,-24,60
167,210000,fc32b1a017b34efe,6,0,208,212,251,209,211,226,330,135,104,181,144,138,141,154,-6,-37,31
631,500000,fc32b1a017b34efe,6,0,935,790,970,909,844,751,1420,661,420,464,477,481,479,474,4,13,-9
468,610000,fc32b1a017b34efe,6,0,425,496,540,574,623,639,1234,604,184,336,402,415,408,384,13,66,-53
134,230000,fc32b1a017b34efe,6,0,127,131,146,126,126,150,236,76,111,111,78,108,93,99,30,-33,63
252,310000,feabbf46658382b9,6,0,237,275,484,500,412,620,805,357,95,198,187,218,202,201,31,-11,42
542,530000,feabbf46658382b9,6,0,342,521,806,851,856,921,1249,829,418,522,444,470,457,479,26,-78,104
499,150000,feabbf46658382b9,6,0,265,347,507,500,528,675,925,601,288,415,322,461,392,399,139,-93,232
253,110000,feabbf46658382b9,6,0,384,534,743,672,532,779,1421,437,212,313,278,276,277,289,-2,-35,33
1247,510000,feabbf46658382b9,6,0,922,1077,1757,2178,1620,1861,2915,2183,903,1084,938,1042,990,1021,104,-146,250
545,340000,feabbf46658382b9,6,0,373,395,690,798,757,934,1307,1141,304,330,322,356,339,336,34,-8,42
776,370000,feabbf46658382b9,6,0,593,668,1173,1160,1214,1192,1610,1006,389,569,611,624,618,601,13,42,-29
503,140000,feabbf46658382b9,6,0,235,316,582,505,511,601,970,406,198,368,305,370,338,348,65,-63,128
1142,440000,feabbf46658382b9,6,0,799,758,1347,1576,1507,1902,2685,1203,341,825,879,785,832,830,-94,54,-148
226,450000,feabbf46658382b9,6,0,206,193,394,347,352,440,665,433,149,235,168,197,182,200,29,-67,96
1280,320000,feabbf46658382b9,6,0,861,1014,1794,1646,1598,1955,2752,1481,650,861,854,961,908,892,107,-7,114
354,360000,feabbf46658382b9,6,0,260,281,443,510,475,511,802,624,159,229,268,266,267,254,-2,39,-41
890,130000,feabbf46658382b9,6,0,522,624,985,1009,905,1021,1551,970,478,608,767,810,788,728,43,159,-116
1415,410000,feabbf46658382b9,6,0,679,846,1361,1342,1399,1530,2696,1928,502,672,701,850,776,741,149,29,120
932,330000,feabbf46658382b9,6,0,572,720,1247,1320,1351,1499,2124,704,292,530,641,696,668,622,55,111,-56
462,420000,feabbf46658382b9,6,0,323,347,614,653,620,794,1252,837,201,313,330,347,338,330,17,17,0
827,430000,feabbf46658382b9,6,0,625,741,1241,1383,1339,1478,2360,1657,503,671,579,591,585,614,12,-92,104
359,350000,feabbf46658382b9,6,0,213,231,425,414,399,601,698,428,129,211,219,281,250,237,62,8,54
248,210000,feabbf46658382b9,6,0,200,191,375,331,306,361,459,235,125,226,187,250,218,221,63,-39,102
1151,500000,feabbf46658382b9,6,0,1159,994,1592,1671,1487,1581,2727,1846,758,896,740,908,824,848,168,-156,324
565,610000,feabbf46658382b9,6,0,391,538,758,764,827,896,1319,905,333,426,445,444,444,438,-1,19,-20
190,230000,feabbf46658382b9,6,0,156,136,271,219,256,312,397,173,117,199,155,143,149,166,-12,-44,32
29,310000,f270f6a489c6a9d7,6,0,33,25,37,28,27,30,34,19,29,28,25,38,32,30,13,-3,16
786,530000,f270f6a489c6a9d7,6,0,1170,1342,1395,1639,1736,1547,1939,1680,1190,1187,815,815,815,939,0,-372,372
60,150000,f270f6a489c6a9d7,6,0,81,79,74,107,93,105,108,54,78,117,71,70,70,86,-1,-46,45
104,110000,f270f6a489c6a9d7,6,0,173,229,238,282,198,305,504,106,118,157,120,110,115,129,-10,-37,27
474,510000,f270f6a489c6a9d7,6,0,682,620,742,717,655,773,955,603,645,678,519,472,496,556,-47,-159,112
149,340000,f270f6a489c6a9d7,6,0,207,172,194,197,214,225,272,216,223,191,165,153,159,170,-12,-26,14
375,370000,f270f6a489c6a9d7,6,0,545,644,631,622,551,636,1105,629,541,513,451,400,426,455,-51,-62,11
113,140000,f270f6a489c6a9d7,6,0,114,131,103,137,118,161,233,166,115,127,118,117,118,121,-1,-9,8
519,440000,f270f6a489c6a9d7,6,0,830,568,627,644,624,713,866,346,505,757,513,503,508,591,-10,-244,234
36,450000,f270f6a489c6a9d7,6,0,62,69,50,93,63,75,97,92,50,85,53,57,55,65,4,-32,36
495,320000,f270f6a489c6a9d7,6,0,654,653,752,766,763,871,1150,610,843,857,623,558,590,679,-65,-234,169
62,360000,f270f6a489c6a9d7,6,0,110,121,107,134,92,117,148,132,89,105,90,70,80,88,-20,-15,-5
500,130000,f270f6a489c6a9d7,6,0,506,529,574,561,554,769,983,537,616,685,621,541,581,616,-80,-64,-16
519,410000,f270f6a489c6a9d7,6,0,847,759,825,703,746,952,1314,922,778,753,612,592,602,652,-20,-141,121
319,330000,f270f6a489c6a9d7,6,0,457,405,385,451,456,466,653,312,498,511,368,351,360,410,-17,-143,126
314,420000,f270f6a489c6a9d7,6,0,476,513,518,582,592,590,903,514,438,482,408,403,406,431,-5,-74,69
377,430000,f270f6a489c6a9d7,6,0,429,353,375,366,327,426,575,405,314,375,353,267,310,332,-86,-22,-64
133,350000,f270f6a489c6a9d7,6,0,148,152,164,156,179,175,195,85,140,157,133,146,140,145,13,-24,37
170,210000,f270f6a489c6a9d7,6,0,230,212,192,216,260,281,370,158,187,236,191,184,188,204,-7,-45,38
498,500000,f270f6a489c6a9d7,6,0,668,554,592,643,645,706,955,636,643,771,438,521,480,577,83,-333,416
132,610000,f270f6a489c6a9d7,6,0,187,180,190,227,209,280,324,195,155,198,180,157,168,178,-23,-18,-5
40,230000,f270f6a489c6a9d7,6,0,81,47,88,70,59,76,90,35,48,67,46,41,44,51,-5,-21,16
81,310000,d0f245b8781e3631,6,0,134,139,176,218,159,193,281,60,52,74,61,69,65,68,8,-13,21
125,530000,d0f245b8781e3631,6,0,132,201,192,241,224,227,356,181,119,130,103,154,128,129,51,-27,78
55,150000,d0f245b8781e3631,6,0,103,103,63,86,129,183,244,117,67,81,65,79,72,75,14,-16,30
144,110000,d0f245b8781e3631,6,0,501,463,464,472,326,417,805,105,52,132,97,103,100,111,6,-35,41
491,510000,d0f245b8781e3631,6,0,715,739,855,1133,824,910,1456,816,454,505,463,516,490,495,53,-42,95
91,340000,d0f245b8781e3631,6,0,240,323,314,310,267,287,463,251,96,133,88,118,103,113,30,-45,75
271,370000,d0f245b8781e3631,6,0,548,646,773,797,679,738,1182,600,283,311,395,408,402,371,13,84,-71
144,140000,d0f245b8781e3631,6,0,121,199,221,226,243,264,497,192,96,135,117,169,143,140,52,-18,70
278,440000,d0f245b8781e3631,6,0,384,378,429,596,574,615,869,297,127,271,262,258,260,264,-4,-9,5
145,450000,d0f245b8781e3631,6,0,126,161,139,167,205,233,425,254,71,136,107,135,121,126,28,-29,57
289,320000,d0f245b8781e3631,6,0,545,683,706,761,731,749,1017,461,270,342,363,373,368,359,10,21,-11
64,360000,d0f245b8781e3631,6,0,128,145,145,229,198,198,315,211,60,84,84,68,76,79,-16,0,-16
419,130000,d0f245b8781e3631,6,0,501,551,690,771,682,755,1430,754,390,398,481,498,490,459,17,83,-66
396,410000,d0f245b8781e3631,6,0,645,779,871,851,876,865,1601,892,268,371,333,363,348,356,30,-38,68
204,330000,d0f245b8781e3631,6,0,509,410,370,1437,406,420,845,174,81,170,192,246,219,203,54,22,32
48,420000,d0f245b8781e3631,6,0,118,124,88,110,128,133,246,134,39,47,55,60,58,54,5,8,-3
178,430000,d0f245b8781e3631,6,0,325,335,319,439,335,447,756,439,130,231,191,211,201,211,20,-40,60
91,350000,d0f245b8781e3631,6,0,93,116,102,142,175,166,247,102,51,67,60,67,64,65,7,-7,14
22,210000,d0f245b8781e3631,6,0,65,77,81,68,54,102,113,47,21,29,27,30,28,29,3,-2,5
444,500000,d0f245b8781e3631,6,0,780,781,1602,764,548,596,1578,630,283,298,337,395,366,343,58,39,19
226,610000,d0f245b8781e3631,6,0,347,435,453,455,455,558,938,498,189,261,260,236,248,252,-24,-1,-23
18,230000,d0f245b8781e3631,6,0,35,25,28,17,16,45,45,7,10,21,11,20,16,17,9,-10,19
237,310000,c6cd4e0e073f5ac2,6,0,902,547,590,1049,393,448,746,228,125,223,190,233,212,215,43,-33,76
100,530000,c6cd4e0e073f5ac2,6,0,183,317,301,410,266,224,235,105,67,68,72,70,71,70,-2,4,-6
89,150000,c6cd4e0e073f5ac2,6,0,129,178,248,263,289,273,340,208,63,95,64,75,70,78,11,-31,42
56,110000,c6cd4e0e073f5ac2,6,0,193,216,265,2528,156,179,362,72,29,64,61,50,56,58,-11,-3,-8
226,510000,c6cd4e0e073f5ac2,6,0,779,942,1243,1666,730,631,1027,542,251,246,265,230,248,247,-35,19,-54
363,340000,c6cd4e0e073f5ac2,6,0,647,742,968,961,755,678,1434,792,244,232,308,344,326,295,36,76,-40
362,370000,c6cd4e0e073f5ac2,6,0,1738,2176,2848,2646,1380,1053,1685,823,326,341,453,371,412,388,-82,112,-194
154,140000,c6cd4e0e073f5ac2,6,0,412,468,657,660,386,479,604,321,126,162,162,182,172,169,20,0,20
481,440000,c6cd4e0e073f5ac2,6,0,584,546,819,1623,936,1038,1493,451,130,374,366,407,386,382,41,-8,49
130,450000,c6cd4e0e073f5ac2,6,0,200,234,316,360,349,312,543,250,76,136,99,136,118,124,37,-37,74
758,320000,c6cd4e0e073f5ac2,6,0,1654,1827,2527,2388,1650,1467,2828,1205,656,751,787,807,797,782,20,36,-16
250,360000,c6cd4e0e073f5ac2,6,0,351,450,511,752,626,577,1241,549,138,232,271,262,266,255,-9,39,-48
329,130000,c6cd4e0e073f5ac2,6,0,856,987,1387,1606,840,561,1020,602,249,293,362,351,356,335,-11,69,-80
721,410000,c6cd4e0e073f5ac2,6,0,1377,1416,1736,1669,959,1021,1584,992,320,512,660,557,608,576,-103,148,-251
377,330000,c6cd4e0e073f5ac2,6,0,693,717,1019,1203,828,859,1272,386,193,342,341,375,358,353,34,-1,35
280,420000,c6cd4e0e073f5ac2,6,0,550,430,713,769,691,751,1208,523,161,272,326,270,298,289,-56,54,-110
268,430000,c6cd4e0e073f5ac2,6,0,580,641,816,847,522,619,891,508,132,232,212,222,217,222,10,-20,30
115,350000,c6cd4e0e073f5ac2,6,0,142,221,243,304,268,291,431,173,74,106,104,121,112,110,17,-2,19
42,210000,c6cd4e0e073f5ac2,6,0,157,228,366,291,139,186,225,91,51,75,101,66,84,81,-35,26,-61
76,500000,c6cd4e0e073f5ac2,6,0,226,215,324,310,182,148,242,128,33,53,51,65,58,56,14,-2,16
142,610000,c6cd4e0e073f5ac2,6,0,558,687,656,661,278,275,432,182,64,143,136,155,146,145,19,-7,26
27,230000,c6cd4e0e073f5ac2,6,0,89,97,146,137,83,61,140,53,29,33,28,48,38,36,20,-5,25
102,310000,a9a43d1a7ecbe75d,6,0,134,141,138,161,113,162,163,142,84,128,99,108,104,112,9,-29,38
87,530000,a9a43d1a7ecbe75d,6,0,94,141,123,111,95,152,131,146,84,119,80,84,82,94,4,-39,43
67,150000,a9a43d1a7ecbe75d,6,0,75,84,71,81,97,81,90,83,41,62,87,86,86,78,-1,25,-26
63,110000,a9a43d1a7ecbe75d,6,0,97,119,87,131,79,100,123,88,65,74,70,62,66,69,-8,-4,-4
188,510000,a9a43d1a7ecbe75d,6,0,255,232,227,447,284,279,330,341,184,223,201,224,212,216,23,-22,45
146,340000,a9a43d1a7ecbe75d,6,0,145,138,167,182,170,183,198,254,107,149,150,152,151,150,2,1,1
117,370000,a9a43d1a7ecbe75d,6,0,181,138,136,198,152,160,191,159,74,162,163,162,162,162,-1,1,-2
30,140000,a9a43d1a7ecbe75d,6,0,27,30,36,34,32,31,28,41,25,46,41,28,34,38,-13,-5,-8
437,440000,a9a43d1a7ecbe75d,6,0,470,487,435,593,541,658,638,568,264,527,387,410,398,441,23,-140,163
152,450000,a9a43d1a7ecbe75d,6,0,160,151,154,208,163,172,213,297,121,197,152,163,158,171,11,-45,56
284,320000,a9a43d1a7ecbe75d,6,0,325,317,361,402,385,402,439,430,213,408,324,345,334,359,21,-84,105
82,360000,a9a43d1a7ecbe75d,6,0,70,82,64,94,87,76,120,103,50,101,76,71,74,83,-5,-25,20
104,130000,a9a43d1a7ecbe75d,6,0,94,88,102,92,82,85,95,109,50,116,95,137,116,116,42,-21,63
124,410000,a9a43d1a7ecbe75d,6,0,126,120,123,153,141,134,164,130,78,142,114,90,102,115,-24,-28,4
277,330000,a9a43d1a7ecbe75d,6,0,272,322,299,308,339,364,397,466,185,307,317,322,320,315,5,10,-5
190,420000,a9a43d1a7ecbe75d,6,0,190,155,179,232,184,244,236,270,129,200,183,140,162,174,-43,-17,-26
262,430000,a9a43d1a7ecbe75d,6,0,279,299,298,395,308,355,445,519,215,330,301,296,298,309,-5,-29,24
91,350000,a9a43d1a7ecbe75d,6,0,64,92,91,93,87,125,99,145,57,96,88,101,94,95,13,-8,21
85,210000,a9a43d1a7ecbe75d,6,0,116,136,158,194,115,126,155,89,59,109,102,100,101,104,-2,-7,5
264,500000,a9a43d1a7ecbe75d,6,0,304,146,146,203,173,179,214,160,89,140,134,104,119,126,-30,-6,-24
163,610000,a9a43d1a7ecbe75d,6,0,217,273,229,256,263,252,263,274,154,228,212,258,235,233,46,-16,62
50,230000,a9a43d1a7ecbe75d,6,0,81,75,75,68,54,66,57,65,35,91,67,47,57,68,-20,-24,4
240,310000,3c974920a76ac9c1,7,0,260,162,265,228,369,374,305,193,309,264,241,251,246,252,10,-23,33
362,530000,3c974920a76ac9c1,7,0,419,246,217,310,402,456,434,194,302,243,321,230,276,265,-91,78,-169
199,150000,3c974920a76ac9c1,7,0,187,153,157,178,204,219,180,128,201,176,192,155,174,174,-37,16,-53
302,110000,3c974920a76ac9c1,7,0,322,244,337,371,460,563,468,432,472,340,407,314,360,354,-93,67,-160
304,510000,3c974920a76ac9c1,7,0,335,345,623,350,453,570,500,253,378,337,331,336,334,335,5,-6,11
155,340000,3c974920a76ac9c1,7,0,108,127,159,136,179,226,198,76,132,155,144,166,155,155,22,-11,33
449,370000,3c974920a76ac9c1,7,0,339,259,422,394,483,601,468,290,412,484,450,432,441,455,-18,-34,16
213,140000,3c974920a76ac9c1,7,0,178,189,194,233,215,260,248,146,249,182,251,173,212,202,-78,69,-147
2582,440000,3c974920a76ac9c1,7,0,2183,1804,2265,2711,3532,3800,2692,1680,2958,2368,2754,2696,2725,2606,-58,386,-444
309,450000,3c974920a76ac9c1,7,0,276,249,267,349,472,505,425,248,383,277,377,293,335,316,-84,100,-184
718,320000,3c974920a76ac9c1,7,0,554,569,631,764,871,1010,800,486,817,617,720,689,704,675,-31,103,-134
156,360000,3c974920a76ac9c1,7,0,136,95,156,166,204,262,236,78,191,154,186,149,168,163,-37,32,-69
325,130000,3c974920a76ac9c1,7,0,227,235,225,228,291,305,260,190,297,311,328,293,310,311,-35,17,-52
380,410000,3c974920a76ac9c1,7,0,384,256,301,351,521,505,405,250,355,393,307,297,302,332,-10,-86,76
624,330000,3c974920a76ac9c1,7,0,457,422,545,702,660,865,633,409,621,561,562,591,576,571,29,1,28
424,420000,3c974920a76ac9c1,7,0,329,325,381,447,480,474,497,228,445,423,403,455,429,427,52,-20,72
316,430000,3c974920a76ac9c1,7,0,250,286,299,327,364,474,347,174,297,304,284,259,272,282,-25,-20,-5
311,350000,3c974920a76ac9c1,7,0,276,226,258,368,331,404,292,181,307,209,324,299,312,277,-25,115,-140
805,210000,3c974920a76ac9c1,7,0,700,556,721,769,941,997,650,566,775,692,738,626,682,685,-112,46,-158
135,500000,3c974920a76ac9c1,7,0,131,111,101,120,155,199,115,72,126,107,119,138,128,121,19,12,7
305,610000,3c974920a76ac9c1,7,0,262,204,187,324,393,440,305,219,295,292,328,285,306,302,-43,36,-79
313,230000,3c974920a76ac9c1,7,0,194,351,302,310,458,461,292,234,401,305,324,284,304,304,-40,19,-59
481,310000,3d7554f1f56dd664,7,0,356,410,417,271,639,518,268,263,442,321,383,408,396,371,25,62,-37
487,530000,3d7554f1f56dd664,7,0,337,266,368,334,609,519,292,264,403,325,415,354,384,365,-61,90,-151
263,150000,3d7554f1f56dd664,7,0,231,216,208,216,370,337,175,149,316,260,258,252,255,257,-6,-2,-4
396,110000,3d7554f1f56dd664,7,0,459,464,449,231,675,811,368,359,470,369,376,352,364,366,-24,7,-31
721,510000,3d7554f1f56dd664,7,0,684,758,1227,469,1053,1125,657,560,806,700,679,724,702,701,45,-21,66
460,340000,3d7554f1f56dd664,7,0,293,358,325,253,574,507,301,225,317,315,350,352,351,339,2,35,-33
1342,370000,3d7554f1f56dd664,7,0,990,917,1222,876,1567,1574,775,729,1060,1229,1119,1113,1116,1154,-6,-110,104
452,140000,3d7554f1f56dd664,7,0,284,382,372,320,590,571,290,239,407,358,384,335,360,359,-49,26,-75
9110,440000,3d7554f1f56dd664,7,0,8709,10596,10140,6925,13598,11515,5136,4688,10371,8733,8990,9100,9045,8941,110,257,-147
1075,450000,3d7554f1f56dd664,7,0,792,866,969,642,1386,1258,750,559,1074,832,939,901,920,891,-38,107,-145
2090,320000,3d7554f1f56dd664,7,0,1827,2216,2075,1763,3112,2877,1445,1635,2184,1828,1916,1948,1932,1897,32,88,-56
576,360000,3d7554f1f56dd664,7,0,400,420,535,356,595,741,435,311,545,463,483,513,498,486,30,20,10
1052,130000,3d7554f1f56dd664,7,0,604,569,722,520,1137,974,498,486,847,1025,993,829,911,949,-164,-32,-132
1153,410000,3d7554f1f56dd664,7,0,718,785,808,565,1273,1234,645,486,968,944,932,1043,988,973,111,-12,123
2165,330000,3d7554f1f56dd664,7,0,1737,1785,1658,1293,2709,2467,1135,1205,1969,1744,1919,1847,1883,1837,-72,175,-247
984,420000,3d7554f1f56dd664,7,0,675,883,908,742,1001,1050,703,508,734,619,699,876,788,731,177,80,97
821,430000,3d7554f1f56dd664,7,0,567,721,958,582,1112,1192,689,445,769,687,748,707,728,714,-41,61,-102
1522,350000,3d7554f1f56dd664,7,0,1533,1388,1310,817,2205,1578,856,899,1607,1181,1494,1511,1502,1395,17,313,-296
2218,210000,3d7554f1f56dd664,7,0,2253,2301,1915,1064,2892,2161,1110,1306,1905,1837,1784,1845,1814,1822,61,-53,114
328,500000,3d7554f1f56dd664,7,0,300,319,331,173,470,398,244,215,285,259,240,371,306,290,131,-19,150
526,610000,3d7554f1f56dd664,7,0,553,492,462,375,582,607,340,260,369,435,466,394,430,432,-72,31,-103
957,230000,3d7554f1f56dd664,7,0,670,1107,843,480,1076,1018,447,521,1186,639,827,849,838,772,22,188,-166
158,310000,2d0d2c3403909fdb,7,0,160,159,169,112,163,167,157,101,187,162,155,200,178,172,45,-7,52
410,530000,2d0d2c3403909fdb,7,0,351,309,270,218,354,350,290,213,293,226,236,265,250,242,29,10,19
306,150000,2d0d2c3403909fdb,7,0,261,246,234,155,184,233,279,174,228,241,255,251,253,249,-4,14,-18
552,110000,2d0d2c3403909fdb,7,0,633,554,583,457,611,677,549,387,627,524,389,503,446,472,114,-135,249
481,510000,2d0d2c3403909fdb,7,0,373,319,387,300,411,434,516,235,377,355,370,404,387,376,34,15,19
151,340000,2d0d2c3403909fdb,7,0,118,108,157,129,128,138,176,83,127,116,129,142,136,129,13,13,0
400,370000,2d0d2c3403909fdb,7,0,358,328,376,327,415,400,420,235,353,334,323,407,365,355,84,-11,95
211,140000,2d0d2c3403909fdb,7,0,170,152,135,111,141,197,179,103,189,173,157,177,167,169,20,-16,36
1828,440000,2d0d2c3403909fdb,7,0,1691,1490,1683,1421,1989,1829,1713,1159,1738,1536,1581,1833,1707,1650,252,45,207
216,450000,2d0d2c3403909fdb,7,0,178,141,192,165,181,173,211,121,197,149,174,163,168,162,-11,25,-36
454,320000,2d0d2c3403909fdb,7,0,373,340,401,333,437,427,470,296,446,386,375,444,410,402,69,-11,80
130,360000,2d0d2c3403909fdb,7,0,94,84,108,90,107,109,126,55,113,112,112,126,119,117,14,0,14
531,130000,2d0d2c3403909fdb,7,0,324,321,309,274,302,328,389,251,371,364,437,425,431,409,-12,73,-85
390,410000,2d0d2c3403909fdb,7,0,309,300,327,262,352,337,377,202,331,306,338,396,367,347,58,32,26
435,330000,2d0d2c3403909fdb,7,0,316,352,336,342,428,424,401,264,349,335,366,380,373,360,14,31,-17
292,420000,2d0d2c3403909fdb,7,0,203,201,303,211,267,280,321,189,271,255,230,322,276,269,92,-25,117
292,430000,2d0d2c3403909fdb,7,0,255,193,250,211,244,275,284,146,275,262,250,285,268,266,35,-12,47
133,350000,2d0d2c3403909fdb,7,0,123,95,124,106,151,157,167,81,107,85,111,132,122,109,21,26,-5
606,210000,2d0d2c3403909fdb,7,0,506,466,488,346,464,567,506,316,529,433,489,457,473,460,-32,56,-88
203,500000,2d0d2c3403909fdb,7,0,166,134,169,138,184,155,213,116,188,148,168,179,174,165,11,20,-9
346,610000,2d0d2c3403909fdb,7,0,273,253,271,195,252,267,297,206,288,291,280,277,278,283,-3,-11,8
304,230000,2d0d2c3403909fdb,7,0,293,304,239,208,258,336,315,155,306,267,240,317,278,275,77,-27,104
167,310000,a28bb927b6fcb33c,7,0,229,249,216,166,212,210,117,96,135,131,161,142,152,145,-19,30,-49
253,530000,a28bb927b6fcb33c,7,0,231,232,256,209,270,308,173,110,159,185,191,176,184,184,-15,6,-21
145,150000,a28bb927b6fcb33c,7,0,118,134,193,128,165,176,89,72,136,148,139,117,128,135,-22,-9,-13
131,110000,a28bb927b6fcb33c,7,0,308,309,286,179,246,342,136,109,179,166,96,85,90,116,-11,-70,59
427,510000,a28bb927b6fcb33c,7,0,426,492,712,401,438,436,351,212,361,425,290,324,307,346,34,-135,169
266,340000,a28bb927b6fcb33c,7,0,300,368,358,250,325,348,264,151,204,182,203,195,199,193,-8,21,-29
377,370000,a28bb927b6fcb33c,7,0,399,489,606,454,468,556,225,175,357,467,449,285,367,400,-164,-18,-146
190,140000,a28bb927b6fcb33c,7,0,123,233,187,181,144,181,92,70,148,181,165,127,146,158,-38,-16,-22
4522,440000,a28bb927b6fcb33c,7,0,4020,4618,5211,4012,4216,4195,2391,1639,3992,3988,3668,3906,3787,3854,238,-320,558
461,450000,a28bb927b6fcb33c,7,0,360,409,444,331,432,386,248,166,443,418,434,344,389,399,-90,16,-106
1072,320000,a28bb927b6fcb33c,7,0,892,1148,1130,943,1033,1154,680,651,982,1039,1051,947,999,1012,-104,12,-116
331,360000,a28bb927b6fcb33c,7,0,194,288,380,260,302,351,208,96,254,328,298,271,284,299,-27,-30,3
559,130000,a28bb927b6fcb33c,7,0,475,550,584,385,397,419,248,284,584,570,485,345,415,467,-140,-85,-55
644,410000,a28bb927b6fcb33c,7,0,562,658,673,556,567,651,338,242,578,638,439,516,478,531,77,-199,276
1522,330000,a28bb927b6fcb33c,7,0,1138,1244,1296,1228,1343,1310,747,739,1438,1404,1200,1131,1166,1245,-69,-204,135
524,420000,a28bb927b6fcb33c,7,0,544,655,744,726,677,787,450,226,461,459,468,446,457,458,-22,9,-31
663,430000,a28bb927b6fcb33c,7,0,503,610,619,436,474,674,394,223,436,554,554,548,551,552,-6,0,-6
737,350000,a28bb927b6fcb33c,7,0,546,535,615,563,615,519,231,173,535,612,676,709,692,666,33,64,-31
596,210000,a28bb927b6fcb33c,7,0,867,1031,840,522,652,848,213,233,610,646,562,459,510,556,-103,-84,-19
140,500000,a28bb927b6fcb33c,7,0,324,316,208,150,157,208,123,85,166,157,116,162,139,145,46,-41,87
279,610000,a28bb927b6fcb33c,7,0,272,274,262,219,225,317,148,105,202,242,221,226,224,230,5,-21,26
236,230000,a28bb927b6fcb33c,7,0,232,335,334,222,288,303,90,85,233,244,241,205,223,230,-36,-3,-33
168,310000,17bc272c93f19d56,7,0,212,256,234,168,249,477,199,177,267,169,193,170,182,177,-23,24,-47
2206,530000,17bc272c93f19d56,7,0,2868,2565,3307,3096,3216,4503,4785,3067,2754,2281,2227,1995,2111,2168,-232,-54,-178
384,150000,17bc272c93f19d56,7,0,346,368,502,360,520,675,504,451,680,487,440,356,398,428,-84,-47,-37
101,110000,17bc272c93f19d56,7,0,179,202,242,199,305,514,151,92,197,124,132,112,122,123,-20,8,-28
1018,510000,17bc272c93f19d56,7,0,1183,1230,1449,1007,1411,1954,1724,1537,1481,1090,1021,990,1006,1034,-31,-69,38
1072,340000,17bc272c93f19d56,7,0,1260,1418,1458,1238,1535,2328,2152,1881,1518,1284,1266,1165,1216,1238,-101,-18,-83
2583,370000,17bc272c93f19d56,7,0,3398,3600,3519,3268,3907,6576,4483,3060,2839,2545,2879,2279,2579,2568,-600,334,-934
1154,140000,17bc272c93f19d56,7,0,1334,1452,1749,1354,1585,2844,2093,1361,1353,1118,1259,955,1107,1111,-304,141,-445
1409,440000,17bc272c93f19d56,7,0,1457,1550,1999,1555,2007,3029,1611,1579,2180,1684,1684,1682,1683,1683,-2,0,-2
1308,450000,17bc272c93f19d56,7,0,2051,2291,2515,2293,2687,4443,3084,1836,2310,1540,1616,1343,1480,1500,-273,76,-349
1523,320000,17bc272c93f19d56,7,0,1776,1799,1764,1493,1942,3067,2165,2419,2029,1601,1578,1375,1476,1518,-203,-23,-180
537,360000,17bc272c93f19d56,7,0,885,890,1111,824,980,1510,1290,922,875,668,648,536,592,617,-112,-20,-92
2789,130000,17bc272c93f19d56,7,0,2748,3368,3303,2808,3641,6231,3870,3403,2945,3015,3119,2522,2820,2885,-597,104,-701
2658,410000,17bc272c93f19d56,7,0,3413,3591,3584,3821,4668,7650,5825,3564,3197,2704,2715,2598,2656,2672,-117,11,-128
1218,330000,17bc272c93f19d56,7,0,1206,1016,1295,1112,1294,2062,1260,1629,1592,1156,1224,1121,1172,1167,-103,68,-171
836,420000,17bc272c93f19d56,7,0,900,992,1202,958,1353,2198,1919,1140,1262,895,1069,835,952,933,-234,174,-408
939,430000,17bc272c93f19d56,7,0,1500,1678,1773,1354,1770,2693,2364,1506,1541,1174,1020,997,1008,1064,-23,-154,131
389,350000,17bc272c93f19d56,7,0,512,565,573,523,688,892,592,650,741,463,546,473,510,494,-73,83,-156
912,210000,17bc272c93f19d56,7,0,1023,1010,1135,824,1154,1710,924,939,1322,959,988,854,921,934,-134,29,-163
197,500000,17bc272c93f19d56,7,0,203,204,284,201,250,357,250,248,235,212,191,173,182,192,-18,-21,3
1051,610000,17bc272c93f19d56,7,0,1173,1245,1658,1590,1877,3217,2072,1105,1314,1222,1105,910,1008,1079,-195,-117,-78
530,230000,17bc272c93f19d56,7,0,785,835,795,518,816,982,506,518,806,657,585,602,594,615,17,-72,89
234,310000,2a2ab41f8f6ff1cb,7,0,331,445,555,272,582,623,382,114,351,229,285,289,287,268,4,56,-52
633,530000,2a2ab41f8f6ff1cb,7,0,428,409,543,553,546,680,484,300,452,403,419,390,404,404,-29,16,-45
595,150000,2a2ab41f8f6ff1cb,7,0,552,645,831,715,836,832,551,317,489,505,604,525,564,545,-79,99,-178
130,110000,2a2ab41f8f6ff1cb,7,0,345,369,502,362,440,598,212,102,180,142,124,93,108,120,-31,-18,-13
1020,510000,2a2ab41f8f6ff1cb,7,0,1032,1165,1460,1050,1385,1850,1223,671,850,790,838,870,854,833,32,48,-16
1206,340000,2a2ab41f8f6ff1cb,7,0,1058,1409,1565,1256,1491,1666,1515,717,1018,980,1077,1165,1121,1074,88,97,-9
2192,370000,2a2ab41f8f6ff1cb,7,0,1773,2139,2580,2061,2146,2737,1706,842,1734,1902,2031,1983,2007,1972,-48,129,-177
683,140000,2a2ab41f8f6ff1cb,7,0,532,655,690,724,762,993,533,312,595,582,569,606,588,586,37,-13,50
4899,440000,2a2ab41f8f6ff1cb,7,0,5237,6544,8215,6582,6734,6492,5607,2647,5713,4896,5717,5445,5581,5353,-272,821,-1093
611,450000,2a2ab41f8f6ff1cb,7,0,639,680,913,743,853,894,799,409,719,453,603,532,568,529,-71,150,-221
1850,320000,2a2ab41f8f6ff1cb,7,0,1859,2252,2410,2283,2584,2672,1728,1016,1729,1498,1701,1735,1718,1645,34,203,-169
813,360000,2a2ab41f8f6ff1cb,7,0,848,964,1340,1065,1086,1291,1027,356,690,687,838,753,796,759,-85,151,-236
2914,130000,2a2ab41f8f6ff1cb,7,0,2293,2864,3253,2277,2327,2703,2119,1271,2126,2486,2863,2426,2644,2592,-437,377,-814
3363,410000,2a2ab41f8f6ff1cb,7,0,2690,3318,3446,2827,2797,3447,2952,1308,2514,2566,2841,2880,2860,2762,39,275,-236
1165,330000,2a2ab41f8f6ff1cb,7,0,974,1151,1369,1262,1632,1972,795,459,876,905,1141,1077,1109,1041,-64,236,-300
1293,420000,2a2ab41f8f6ff1cb,7,0,1181,1412,1938,1686,1663,2151,1566,597,1095,1029,1047,1133,1090,1070,86,18,68
1564,430000,2a2ab41f8f6ff1cb,7,0,1889,1918,2573,2247,1966,2770,1651,844,1487,1573,1636,1382,1509,1530,-254,63,-317
348,350000,2a2ab41f8f6ff1cb,7,0,301,348,390,371,447,476,264,148,314,267,427,418,422,371,-9,160,-169
372,210000,2a2ab41f8f6ff1cb,7,0,323,369,397,317,403,513,241,211,360,293,362,342,352,332,-20,69,-89
549,500000,2a2ab41f8f6ff1cb,7,0,750,810,888,646,803,1149,803,328,472,453,543,623,583,540,80,90,-10
566,610000,2a2ab41f8f6ff1cb,7,0,502,566,687,665,655,845,620,247,468,497,551,436,494,495,-115,54,-169
512,230000,2a2ab41f8f6ff1cb,7,0,602,652,669,544,740,1032,399,306,506,449,585,503,544,512,-82,136,-218
1316,310000,c06a2a387c0ee510,7,0,1154,1068,958,710,977,1212,1265,890,1247,1119,1184,1456,1320,1253,272,65,207
173,530000,c06a2a387c0ee510,7,0,83,62,79,45,66,119,104,63,214,133,132,248,190,171,116,-1,117
146,150000,c06a2a387c0ee510,7,0,56,51,54,43,56,75,86,64,154,131,164,163,164,153,-1,33,-34
1367,110000,c06a2a387c0ee510,7,0,1014,976,1027,677,793,1627,1352,1114,1508,1132,1430,1670,1550,1411,240,298,-58
276,510000,c06a2a387c0ee510,7,0,210,234,199,102,145,321,208,187,254,335,308,285,296,309,-23,-27,4
311,340000,c06a2a387c0ee510,7,0,157,167,182,145,176,251,253,175,322,340,315,352,334,336,37,-25,62
1283,370000,c06a2a387c0ee510,7,0,701,698,710,494,739,1047,878,649,1303,1248,1216,1405,1310,1290,189,-32,221
233,140000,c06a2a387c0ee510,7,0,93,101,121,83,105,184,165,123,244,320,272,242,257,278,-30,-48,18
994,440000,c06a2a387c0ee510,7,0,479,453,514,463,571,819,762,448,944,1100,1025,1038,1032,1054,13,-75,88
123,450000,c06a2a387c0ee510,7,0,46,65,36,87,45,96,92,54,103,134,119,86,102,113,-33,-15,-18
1137,320000,c06a2a387c0ee510,7,0,704,653,923,563,731,1002,974,650,1188,1289,1048,1276,1162,1204,228,-241,469
165,360000,c06a2a387c0ee510,7,0,83,56,89,43,74,97,118,85,164,140,153,162,158,152,9,13,-4
656,130000,c06a2a387c0ee510,7,0,288,302,284,232,288,493,470,361,599,660,769,569,669,666,-200,109,-309
754,410000,c06a2a387c0ee510,7,0,353,356,387,282,366,596,517,345,763,731,685,764,724,727,79,-46,125
908,330000,c06a2a387c0ee510,7,0,895,578,350,278,533,736,534,424,754,915,865,808,836,863,-57,-50,-7
272,420000,c06a2a387c0ee510,7,0,108,119,115,66,94,173,151,103,240,253,187,234,210,225,47,-66,113
192,430000,c06a2a387c0ee510,7,0,68,91,68,60,83,119,101,59,203,163,182,206,194,184,24,19,5
204,350000,c06a2a387c0ee510,7,0,107,123,99,106,97,170,123,106,206,303,187,204,196,231,17,-116,133
413,210000,c06a2a387c0ee510,7,0,211,178,184,111,151,300,181,154,357,324,363,378,370,355,15,39,-24
124,500000,c06a2a387c0ee510,7,0,75,66,120,43,58,100,60,71,130,181,128,151,140,153,23,-53,76
313,610000,c06a2a387c0ee510,7,0,195,228,164,136,164,313,234,179,320,305,340,358,349,334,18,35,-17
224,230000,c06a2a387c0ee510,7,0,102,113,130,76,95,177,129,74,323,185,255,260,258,233,5,70,-65
379,310000,7023efdab9cedc03,7,0,547,504,605,431,543,697,325,168,288,309,527,516,522,451,-11,218,-229
75,530000,7023efdab9cedc03,7,0,86,60,80,64,106,112,40,25,38,54,68,55,62,59,-13,14,-27
61,150000,7023efdab9cedc03,7,0,54,65,50,48,60,75,31,18,29,46,51,51,51,49,0,5,-5
151,110000,7023efdab9cedc03,7,0,96,105,107,59,86,132,40,51,59,50,54,60,57,55,6,4,2
209,510000,7023efdab9cedc03,7,0,192,194,379,187,278,408,216,117,192,175,229,259,244,221,30,54,-24
445,340000,7023efdab9cedc03,7,0,284,383,452,363,447,587,357,148,207,278,368,463,416,370,95,90,5
402,370000,7023efdab9cedc03,7,0,384,434,524,437,477,555,320,180,373,400,374,355,364,376,-19,-26,7
71,140000,7023efdab9cedc03,7,0,53,40,61,59,55,64,30,23,28,38,44,60,52,47,16,6,10
222,440000,7023efdab9cedc03,7,0,205,191,284,225,342,408,121,39,166,158,211,185,198,185,-26,53,-79
56,450000,7023efdab9cedc03,7,0,48,72,86,66,86,129,68,34,47,50,71,60,66,60,-11,21,-32
995,320000,7023efdab9cedc03,7,0,934,1240,1311,1156,1271,1767,893,628,788,879,1067,1002,1034,983,-65,188,-253
233,360000,7023efdab9cedc03,7,0,187,201,205,175,224,302,169,92,161,188,202,170,186,187,-32,14,-46
199,130000,7023efdab9cedc03,7,0,130,129,149,129,127,215,80,56,93,108,163,149,156,140,-14,55,-69
262,410000,7023efdab9cedc03,7,0,222,264,300,257,320,368,183,97,185,329,340,259,300,309,-81,11,-92
706,330000,7023efdab9cedc03,7,0,611,791,867,742,941,1163,445,309,478,511,775,845,810,710,70,264,-194
185,420000,7023efdab9cedc03,7,0,204,189,253,233,287,401,211,94,172,184,195,243,219,207,48,11,37
202,430000,7023efdab9cedc03,7,0,169,202,213,182,259,315,201,83,173,167,198,189,194,185,-9,31,-40
134,350000,7023efdab9cedc03,7,0,59,77,86,70,117,145,54,20,51,78,114,140,127,111,26,36,-10
92,210000,7023efdab9cedc03,7,0,94,56,78,81,68,104,28,21,52,82,45,37,41,55,-8,-37,29
92,500000,7023efdab9cedc03,7,0,45,63,77,40,57,62,28,20,37,37,33,64,48,45,31,-4,35
102,610000,7023efdab9cedc03,7,0,102,126,137,141,113,177,107,51,78,83,124,102,113,103,-22,41,-63
27,230000,7023efdab9cedc03,7,0,30,29,39,29,28,30,11,11,8,18,20,17,18,18,-3,2,-5
755,310000,af6f4f548684e14d,7,0,829,878,839,851,1537,1734,940,540,957,807,919,933,926,886,14,112,-98
401,530000,af6f4f548684e14d,7,0,444,406,375,464,639,732,400,288,346,301,327,290,308,306,-37,26,-63
240,150000,af6f4f548684e14d,7,0,345,346,426,433,493,573,322,195,323,333,363,302,332,333,-61,30,-91
503,110000,af6f4f548684e14d,7,0,551,572,648,532,915,1057,659,394,601,489,595,532,564,539,-63,106,-169
793,510000,af6f4f548684e14d,7,0,816,821,1394,1020,1293,1876,1072,611,873,761,808,800,804,790,-8,47,-55
688,340000,af6f4f548684e14d,7,0,689,782,938,1018,1287,1597,1015,457,773,664,769,751,760,728,-18,105,-123
955,370000,af6f4f548684e14d,7,0,1240,1232,1497,1547,1722,2394,1077,522,1253,1236,1215,1019,1117,1157,-196,-21,-175
340,140000,af6f4f548684e14d,7,0,317,365,407,489,581,742,375,248,450,310,404,335,370,350,-69,94,-163
838,440000,af6f4f548684e14d,7,0,1023,986,1197,1508,2163,2594,949,463,1024,892,976,1062,1019,977,86,84,2
257,450000,af6f4f548684e14d,7,0,308,261,338,373,502,713,341,210,322,222,345,302,324,290,-43,123,-166
1072,320000,af6f4f548684e14d,7,0,1141,1497,1413,1635,2059,2647,1466,939,1519,1181,1355,1281,1318,1272,-74,174,-248
745,360000,af6f4f548684e14d,7,0,717,687,798,900,1083,1527,753,397,757,746,837,677,757,753,-160,91,-251
680,130000,af6f4f548684e14d,7,0,609,745,771,828,1012,1235,691,404,655,694,773,655,714,707,-118,79,-197
951,410000,af6f4f548684e14d,7,0,929,998,1228,1191,1470,2122,1000,589,1119,1013,903,937,920,951,34,-110,144
797,330000,af6f4f548684e14d,7,0,813,942,1042,1090,1626,2068,1003,537,978,796,1015,879,947,897,-136,219,-355
835,420000,af6f4f548684e14d,7,0,785,977,1135,1284,1519,1632,1025,485,1058,873,1015,949,982,946,-66,142,-208
893,430000,af6f4f548684e14d,7,0,924,1034,1175,1168,1619,2178,1217,467,1068,962,1084,875,980,974,-209,122,-331
356,350000,af6f4f548684e14d,7,0,417,426,426,568,767,913,522,257,433,373,497,408,452,426,-89,124,-213
262,210000,af6f4f548684e14d,7,0,315,365,365,407,443,594,254,172,277,329,290,263,276,294,-27,-39,12
329,500000,af6f4f548684e14d,7,0,357,329,386,354,500,762,420,252,342,321,324,387,356,344,63,3,60
447,610000,af6f4f548684e14d,7,0,316,283,360,444,478,651,365,184,306,238,357,732,544,442,375,119,256
143,230000,af6f4f548684e14d,7,0,213,233,201,203,289,372,142,121,207,187,231,186,208,201,-45,44,-89
1172,310000,7cf283430b3b5e38,7,0,1616,1715,1560,1261,1546,1428,635,513,975,1070,1137,2596,1866,1601,1459,67,1392
602,530000,7cf283430b3b5e38,7,0,451,462,412,350,412,626,249,167,333,316,408,510,459,411,102,92,10
440,150000,7cf283430b3b5e38,7,0,313,335,434,451,516,701,285,178,320,330,439,413,426,394,-26,109,-135
314,110000,7cf283430b3b5e38,7,0,247,248,278,174,264,913,106,74,113,101,453,335,394,296,-118,352,-470
1996,510000,7cf283430b3b5e38,7,0,1800,1833,2351,1555,1783,2691,1134,763,1522,1501,1649,1954,1802,1701,305,148,157
2384,340000,7cf283430b3b5e38,7,0,2071,2572,2578,2110,2138,2356,1607,968,1908,2068,2171,2517,2344,2252,346,103,243
4263,370000,7cf283430b3b5e38,7,0,3185,3623,4079,3911,3787,4830,2048,1323,3138,3779,4223,3954,4088,3985,-269,444,-713
1017,140000,7cf283430b3b5e38,7,0,635,770,774,678,852,1073,317,283,629,610,883,1085,984,859,202,273,-71
1964,440000,7cf283430b3b5e38,7,0,2105,2230,2219,1912,2435,2500,695,488,1495,1512,1848,2203,2026,1854,355,336,19
1021,450000,7cf283430b3b5e38,7,0,467,597,723,646,783,869,475,293,738,554,830,966,898,783,136,276,-140
4877,320000,7cf283430b3b5e38,7,0,4343,5439,5089,5170,5016,5865,2657,2401,4119,4083,4704,4995,4850,4594,291,621,-330
1811,360000,7cf283430b3b5e38,7,0,1282,1228,1446,1175,1376,1737,923,549,1502,1828,1895,1662,1778,1795,-233,67,-300
2856,130000,7cf283430b3b5e38,7,0,1730,2030,2166,1672,1926,2621,900,720,1379,2198,2809,2761,2785,2589,-48,611,-659
3871,410000,7cf283430b3b5e38,7,0,2569,3033,2794,2644,2874,3243,1683,1042,2558,3199,3067,3400,3234,3222,333,-132,465
3135,330000,7cf283430b3b5e38,7,0,2644,3079,3258,3003,3295,3490,1289,1038,1965,1876,2506,2778,2642,2387,272,630,-358
1699,420000,7cf283430b3b5e38,7,0,1388,1694,1779,1500,1547,1624,929,480,1234,1278,1437,1882,1660,1532,445,159,286
1686,430000,7cf283430b3b5e38,7,0,1464,1556,1793,1457,1585,1952,989,516,1513,1616,1696,1720,1708,1677,24,80,-56
1258,350000,7cf283430b3b5e38,7,0,1040,913,859,836,1130,958,546,402,859,878,1319,1184,1252,1127,-135,441,-576
727,210000,7cf283430b3b5e38,7,0,570,710,667,540,619,821,205,149,446,498,474,571,522,514,97,-24,121
507,500000,7cf283430b3b5e38,7,0,446,463,501,422,419,597,296,163,296,401,429,660,544,497,231,28,203
1091,610000,7cf283430b3b5e38,7,0,762,830,880,891,912,1151,413,242,475,689,883,1688,1286,1087,805,194,611
279,230000,7cf283430b3b5e38,7,0,247,332,298,250,347,415,118,130,301,193,254,310,282,252,56,61,-5
83,310000,d4efbebb087fd03f,7,0,130,170,225,144,225,270,79,27,45,95,103,101,102,100,-2,8,-10
247,530000,d4efbebb087fd03f,7,0,141,193,215,192,267,384,296,172,285,192,231,213,222,212,-18,39,-57
181,150000,d4efbebb087fd03f,7,0,165,211,257,237,359,450,248,124,211,203,178,177,178,186,-1,-25,24
968,110000,d4efbebb087fd03f,7,0,635,596,755,684,938,1287,118,74,556,952,1106,818,962,959,-288,154,-442
761,510000,d4efbebb087fd03f,7,0,840,1135,1134,707,1002,2805,1326,797,891,676,702,734,718,704,32,26,6
532,340000,d4efbebb087fd03f,7,0,626,807,752,716,977,1443,903,436,535,520,582,612,597,571,30,62,-32
1337,370000,d4efbebb087fd03f,7,0,1510,2013,2253,1752,2198,3785,1878,1009,1343,1575,1488,1335,1412,1466,-153,-87,-66
448,140000,d4efbebb087fd03f,7,0,396,591,635,370,1993,2925,603,248,417,464,574,426,500,488,-148,110,-258
1038,440000,d4efbebb087fd03f,7,0,1216,1851,1526,1065,2044,2419,914,399,1078,1095,1082,1215,1148,1131,133,-13,146
474,450000,d4efbebb087fd03f,7,0,373,565,452,368,493,935,666,303,492,403,512,470,491,462,-42,109,-151
821,320000,d4efbebb087fd03f,7,0,1038,1263,1231,1184,1531,2308,910,648,752,1041,985,944,964,990,-41,-56,15
469,360000,d4efbebb087fd03f,7,0,591,657,831,701,917,1377,999,364,509,561,555,561,558,559,6,-6,12
936,130000,d4efbebb087fd03f,7,0,754,991,941,754,1144,2067,1110,641,741,953,1002,876,939,944,-126,49,-175
1652,410000,d4efbebb087fd03f,7,0,1528,1922,1491,1090,1965,3560,2272,888,1199,1423,1368,1487,1428,1426,119,-55,174
1700,330000,d4efbebb087fd03f,7,0,1877,2534,1978,2287,3147,4324,1028,639,1114,1097,2340,1882,2111,1773,-458,1243,-1701
460,420000,d4efbebb087fd03f,7,0,487,636,528,521,941,1534,1004,347,476,456,410,475,442,447,65,-46,111
659,430000,d4efbebb087fd03f,7,0,1014,1148,1102,762,1142,1719,1133,438,685,688,650,716,683,685,66,-38,104
602,350000,d4efbebb087fd03f,7,0,710,861,605,468,762,1967,434,268,656,565,712,722,717,666,10,147,-137
160,210000,d4efbebb087fd03f,7,0,328,373,319,239,291,520,199,149,205,202,188,167,178,186,-21,-14,-7
280,500000,d4efbebb087fd03f,7,0,383,500,317,253,326,532,432,291,409,310,302,286,294,299,-16,-8,-8
1155,610000,d4efbebb087fd03f,7,0,984,1191,1013,830,1010,1651,919,422,609,612,587,580,584,593,-7,-25,18
112,230000,d4efbebb087fd03f,7,0,114,179,154,114,204,257,135,104,114,128,104,132,118,121,28,-24,52
45,310000,7245e0ee27b195cd,7,0,84,82,78,75,125,158,63,40,60,51,45,46,46,47,1,-6,7
378,530000,7245e0ee27b195cd,7,0,242,297,409,425,375,535,421,246,288,240,252,266,259,253,14,12,2
169,150000,7245e0ee27b195cd,7,0,155,186,321,287,448,676,363,164,250,212,180,206,193,199,26,-32,58
54,110000,7245e0ee27b195cd,7,0,192,229,328,289,360,496,86,74,109,80,71,61,66,71,-10,-9,-1
654,510000,7245e0ee27b195cd,7,0,612,740,894,870,831,1260,724,451,621,526,535,628,582,563,93,9,84
322,340000,7245e0ee27b195cd,7,0,360,423,570,478,510,806,576,272,358,315,316,346,331,326,30,1,29
930,370000,7245e0ee27b195cd,7,0,1067,1385,1544,1660,1778,2915,1529,762,977,1071,1025,958,992,1018,-67,-46,-21
530,140000,7245e0ee27b195cd,7,0,387,526,657,689,668,1092,615,366,578,543,590,543,566,559,-47,47,-94
743,440000,7245e0ee27b195cd,7,0,726,1003,987,1170,1384,1437,718,363,821,836,734,867,800,812,133,-102,235
346,450000,7245e0ee27b195cd,7,0,205,275,336,321,463,659,452,233,370,288,292,316,304,299,24,4,20
428,320000,7245e0ee27b195cd,7,0,424,503,619,691,743,1008,543,405,518,460,406,448,427,438,42,-54,96
285,360000,7245e0ee27b195cd,7,0,323,384,576,518,577,816,634,247,323,301,331,301,316,311,-30,30,-60
1140,130000,7245e0ee27b195cd,7,0,976,1190,1442,1308,1432,2365,1304,951,1023,1070,1210,930,1070,1070,-280,140,-420
1053,410000,7245e0ee27b195cd,7,0,921,1180,1362,1148,1406,2228,1526,717,888,888,823,850,836,854,27,-65,92
491,330000,7245e0ee27b195cd,7,0,546,656,656,660,874,1121,438,306,511,460,520,507,514,496,-13,60,-73
407,420000,7245e0ee27b195cd,7,0,353,445,594,534,655,903,635,255,364,342,325,362,344,343,37,-17,54
429,430000,7245e0ee27b195cd,7,0,561,665,852,609,763,1216,773,321,479,531,540,517,528,529,-23,9,-32
212,350000,7245e0ee27b195cd,7,0,218,279,280,218,239,420,249,153,274,195,252,248,250,232,-4,57,-61
251,210000,7245e0ee27b195cd,7,0,308,361,450,328,514,641,287,222,321,326,279,247,263,284,-32,-47,15
240,500000,7245e0ee27b195cd,7,0,263,289,325,272,292,402,296,142,238,207,233,232,232,224,-1,26,-27
470,610000,7245e0ee27b195cd,7,0,562,667,705,729,755,1158,815,410,484,484,492,471,482,482,-21,8,-29
199,230000,7245e0ee27b195cd,7,0,189,179,249,176,328,336,166,145,205,161,183,216,200,187,33,22,11
77,310000,8c915fe4632fb9fa,7,0,143,149,181,158,314,461,180,102,190,125,145,92,118,121,-53,20,-73
654,530000,8c915fe4632fb9fa,7,0,387,336,447,627,757,1396,1059,575,778,650,682,486,584,606,-196,32,-228
344,150000,8c915fe4632fb9fa,7,0,186,216,287,324,527,720,520,270,473,409,472,356,414,412,-116,63,-179
41,110000,8c915fe4632fb9fa,7,0,137,177,237,199,242,487,101,86,162,127,117,78,98,107,-39,-10,-29
872,510000,8c915fe4632fb9fa,7,0,741,845,1263,1243,1605,2433,1860,1194,1302,1156,1192,925,1058,1091,-267,36,-303
651,340000,8c915fe4632fb9fa,7,0,651,840,1069,1269,1370,2298,1440,720,878,861,934,738,836,844,-196,73,-269
1432,370000,8c915fe4632fb9fa,7,0,927,999,1485,1686,2126,3804,2217,1109,1504,1812,1956,1321,1638,1696,-635,144,-779
562,140000,8c915fe4632fb9fa,7,0,271,379,496,642,748,1215,772,404,591,661,732,531,632,641,-201,71,-272
663,440000,8c915fe4632fb9fa,7,0,550,650,835,848,1467,2021,1040,446,977,1064,948,854,901,955,-94,-116,22
399,450000,8c915fe4632fb9fa,7,0,225,284,342,388,511,880,738,330,660,454,586,385,486,475,-201,132,-333
913,320000,8c915fe4632fb9fa,7,0,762,1001,1116,1451,1816,2525,1540,1130,1441,1246,1265,930,1098,1147,-335,19,-354
445,360000,8c915fe4632fb9fa,7,0,409,440,725,733,889,1320,1015,377,598,631,632,491,562,585,-141,1,-142
1714,130000,8c915fe4632fb9fa,7,0,958,1014,1437,1548,2026,3281,1882,1126,1456,2041,2368,1518,1943,1976,-850,327,-1177
1362,410000,8c915fe4632fb9fa,7,0,857,953,1313,1473,1843,2975,2324,1002,1413,1518,1509,1135,1322,1387,-374,-9,-365
814,330000,8c915fe4632fb9fa,7,0,731,805,1089,1175,1502,2235,958,565,880,893,948,697,822,846,-251,55,-306
696,420000,8c915fe4632fb9fa,7,0,505,669,868,924,1339,1557,1148,463,782,723,758,663,710,715,-95,35,-130
506,430000,8c915fe4632fb9fa,7,0,407,438,633,772,835,1281,1235,439,733,664,655,498,576,606,-157,-9,-148
328,350000,8c915fe4632fb9fa,7,0,234,282,307,414,622,877,518,365,529,461,541,380,460,461,-161,80,-241
303,210000,8c915fe4632fb9fa,7,0,236,231,291,296,396,542,311,224,349,397,405,266,336,356,-139,8,-147
284,500000,8c915fe4632fb9fa,7,0,218,259,311,316,419,666,489,274,346,334,368,358,363,353,-10,34,-44
487,610000,8c915fe4632fb9fa,7,0,303,362,519,627,715,1549,1036,394,463,535,597,405,501,512,-192,62,-254
592,230000,8c915fe4632fb9fa,7,0,336,422,442,411,616,998,401,372,684,679,736,526,631,647,-210,57,-267
362,310000,6155b214590c66e6,7,0,464,522,661,472,781,1047,423,192,279,354,355,429,392,379,74,1,73
1148,530000,6155b214590c66e6,7,0,939,877,1084,1148,1159,1879,1354,680,631,992,1295,955,1125,1081,-340,303,-643
802,150000,6155b214590c66e6,7,0,551,578,725,701,941,1442,814,347,566,786,1042,724,883,851,-318,256,-574
433,110000,6155b214590c66e6,7,0,454,496,664,474,569,1295,274,176,281,280,376,386,381,347,10,96,-86
1619,510000,6155b214590c66e6,7,0,1417,1488,2289,1556,2162,4188,2540,1081,1111,1488,1668,1412,1540,1523,-256,180,-436
1404,340000,6155b214590c66e6,7,0,1412,1803,1996,1889,2073,3650,2495,863,893,1218,1582,1360,1471,1387,-222,364,-586
3057,370000,6155b214590c66e6,7,0,2583,2886,3461,3252,3594,6275,3467,1356,2002,3249,3444,2666,3055,3120,-778,195,-973
798,140000,6155b214590c66e6,7,0,619,652,805,800,914,1576,743,357,500,790,998,720,859,836,-278,208,-486
2038,440000,6155b214590c66e6,7,0,1837,2246,2808,2902,3269,4342,1784,653,1364,1722,2162,2247,2204,2044,85,440,-355
699,450000,6155b214590c66e6,7,0,518,574,670,621,739,1316,892,381,556,538,802,574,688,638,-228,264,-492
2564,320000,6155b214590c66e6,7,0,2600,3230,3453,3560,3776,5864,3032,1760,2316,2607,3244,2604,2924,2818,-640,637,-1277
902,360000,6155b214590c66e6,7,0,839,860,1325,1195,1285,2160,1579,453,603,962,960,811,886,911,-149,-2,-147
2567,130000,6155b214590c66e6,7,0,2024,2258,2481,2298,2594,4551,2375,1231,1427,2467,3049,2213,2631,2576,-836,582,-1418
2930,410000,6155b214590c66e6,7,0,3103,3396,3571,3427,4047,8018,5309,1586,1915,2716,3025,2701,2863,2814,-324,309,-633
2230,330000,6155b214590c66e6,7,0,1897,2229,2579,2724,3014,4336,1679,826,1161,1890,2275,1899,2087,2021,-376,385,-761
1359,420000,6155b214590c66e6,7,0,1304,1341,1747,1512,1848,3179,2049,551,906,1028,1278,1264,1271,1190,-14,250,-264
1479,430000,6155b214590c66e6,7,0,1536,1679,2187,1872,2355,3747,2461,732,1157,1395,1621,1288,1454,1435,-333,226,-559
740,350000,6155b214590c66e6,7,0,626,618,738,859,1140,1306,596,364,463,616,759,757,758,711,-2,143,-145
1200,210000,6155b214590c66e6,7,0,1022,1132,1218,970,1188,1784,769,415,765,1227,1203,969,1086,1133,-234,-24,-210
619,500000,6155b214590c66e6,7,0,635,655,770,622,761,1417,877,373,399,529,594,627,610,583,33,65,-32
790,610000,6155b214590c66e6,7,0,587,654,727,899,841,1546,1008,303,361,648,917,661,789,742,-256,269,-525
876,230000,6155b214590c66e6,7,0,663,777,675,517,944,1290,579,365,604,725,778,831,804,778,53,53,0
522,310000,28e29f2c03dcd84c,7,0,680,720,820,623,807,1293,851,433,764,667,727,689,708,694,-38,60,-98
443,530000,28e29f2c03dcd84c,7,0,468,405,456,394,535,639,509,300,415,361,462,414,438,412,-48,101,-149
446,150000,28e29f2c03dcd84c,7,0,407,480,482,477,451,580,494,276,556,527,562,528,545,539,-34,35,-69
834,110000,28e29f2c03dcd84c,7,0,1062,1143,1276,969,1288,2146,1327,923,1308,982,1002,1096,1049,1027,94,20,74
776,510000,28e29f2c03dcd84c,7,0,585,715,1123,634,781,1105,856,454,680,597,621,651,636,623,30,24,6
708,340000,28e29f2c03dcd84c,7,0,472,667,840,774,803,1070,953,364,644,584,685,706,696,658,21,101,-80
1319,370000,28e29f2c03dcd84c,7,0,988,1162,1315,1224,1513,1837,1329,778,1244,1284,1298,1141,1220,1241,-157,14,-171
639,140000,28e29f2c03dcd84c,7,0,604,750,729,770,798,1203,945,474,746,713,727,660,694,700,-67,14,-81
389,440000,28e29f2c03dcd84c,7,0,313,351,438,425,536,825,423,180,427,549,477,696,586,574,219,-72,291
137,450000,28e29f2c03dcd84c,7,0,93,121,141,135,160,243,179,71,140,141,183,151,167,158,-32,42,-74
1263,320000,28e29f2c03dcd84c,7,0,1276,1793,1838,1848,1951,2643,1820,1058,1565,1288,1340,1313,1326,1314,-27,52,-79
255,360000,28e29f2c03dcd84c,7,0,321,334,419,377,424,571,408,151,325,301,312,293,302,302,-19,11,-30
1425,130000,28e29f2c03dcd84c,7,0,977,1321,1377,1264,1433,1923,1604,884,1377,1523,1631,1539,1585,1564,-92,108,-200
1125,410000,28e29f2c03dcd84c,7,0,834,1010,1081,952,1113,1482,1178,548,1003,1062,1044,1052,1048,1053,8,-18,26
628,330000,28e29f2c03dcd84c,7,0,536,601,733,722,894,1112,767,352,679,681,651,616,634,649,-35,-30,-5
330,420000,28e29f2c03dcd84c,7,0,260,295,373,329,377,483,446,164,271,261,296,275,286,277,-21,35,-56
395,430000,28e29f2c03dcd84c,7,0,339,383,464,438,477,783,487,262,452,359,428,383,406,390,-45,69,-114
182,350000,28e29f2c03dcd84c,7,0,212,189,235,212,345,456,397,140,227,217,291,297,294,268,6,74,-68
221,210000,28e29f2c03dcd84c,7,0,277,296,261,247,251,310,270,165,356,218,179,255,217,217,76,-39,115
374,500000,28e29f2c03dcd84c,7,0,408,414,486,426,491,644,555,263,408,381,378,462,420,407,84,-3,87
553,610000,28e29f2c03dcd84c,7,0,388,413,568,617,622,758,719,361,603,579,645,499,572,574,-146,66,-212
123,230000,28e29f2c03dcd84c,7,0,124,187,159,142,152,169,104,79,149,106,141,121,131,123,-20,35,-55
123,310000,37aa9169b575ef79,7,0,46,46,41,395,67,117,63,37,86,109,100,151,126,120,51,-9,60
1277,530000,37aa9169b575ef79,7,0,1395,1426,1254,988,1142,1590,946,692,1035,755,884,765,824,801,-119,129,-248
652,150000,37aa9169b575ef79,7,0,744,864,895,802,945,982,602,413,714,724,743,629,686,699,-114,19,-133
278,110000,37aa9169b575ef79,7,0,716,794,737,477,625,985,300,271,404,282,274,292,283,283,18,-8,26
2530,510000,37aa9169b575ef79,7,0,2620,2791,2955,1733,2221,3340,1470,1639,3175,2405,2457,2398,2428,2420,-59,52,-111
366,340000,37aa9169b575ef79,7,0,502,552,488,424,410,575,248,260,384,279,286,452,369,339,166,7,159
2797,370000,37aa9169b575ef79,7,0,3126,3130,3837,3617,3662,4024,1903,1708,2748,2376,2932,2420,2676,2576,-512,556,-1068
1028,140000,37aa9169b575ef79,7,0,993,1217,1561,1243,1188,1616,679,442,672,792,892,815,854,833,-77,100,-177
1682,440000,37aa9169b575ef79,7,0,1766,1963,2010,1906,2111,2398,1196,1075,2249,1558,2005,1936,1970,1833,-69,447,-516
446,450000,37aa9169b575ef79,7,0,405,319,409,384,459,435,440,301,449,664,501,523,512,563,22,-163,185
623,320000,37aa9169b575ef79,7,0,701,745,840,781,777,930,527,626,655,605,586,670,628,620,84,-19,103
244,360000,37aa9169b575ef79,7,0,330,358,538,488,482,540,354,189,356,270,359,296,328,308,-63,89,-152
3242,130000,37aa9169b575ef79,7,0,3102,3388,3910,3483,3233,4206,2068,1780,2633,2656,3148,2856,3002,2887,-292,492,-784
1785,410000,37aa9169b575ef79,7,0,2200,2100,2323,1931,2018,2962,1570,1050,1823,1515,1509,1506,1508,1510,-3,-6,3
517,330000,37aa9169b575ef79,7,0,769,777,723,606,634,886,424,422,628,555,606,538,572,566,-68,51,-119
430,420000,37aa9169b575ef79,7,0,595,715,725,585,544,920,483,270,442,304,376,403,390,361,27,72,-45
1149,430000,37aa9169b575ef79,7,0,1456,1533,1680,1444,1489,2336,1714,653,1232,835,1023,1076,1050,978,53,188,-135
470,350000,37aa9169b575ef79,7,0,627,773,710,690,597,622,308,292,460,424,486,428,457,446,-58,62,-120
1419,210000,37aa9169b575ef79,7,0,1804,1815,1871,1308,1478,1878,681,691,1319,1119,1215,1237,1226,1190,22,96,-74
161,500000,37aa9169b575ef79,7,0,530,502,347,184,172,247,131,105,125,160,126,176,151,154,50,-34,84
603,610000,37aa9169b575ef79,7,0,874,1106,695,580,634,1051,558,384,605,487,577,560,568,541,-17,90,-107
1649,230000,37aa9169b575ef79,7,0,1193,1427,1562,1308,1636,1781,730,952,1556,1254,1336,1463,1400,1351,127,82,45
1421,310000,63065128401bb3ff,7,0,1180,1500,2397,1674,2362,3060,1909,501,2672,4039,883,4181,2532,3034,3298,-3156,6454
1300,530000,63065128401bb3ff,7,0,884,974,1076,1038,1033,1402,656,504,651,603,785,827,806,738,42,182,-140
575,150000,63065128401bb3ff,7,0,410,446,541,468,630,827,268,214,376,413,543,491,517,482,-52,130,-182
498,110000,63065128401bb3ff,7,0,995,1118,835,516,1494,2145,217,200,2331,1550,280,361,320,730,81,-1270,1351
1801,510000,63065128401bb3ff,7,0,1662,1864,2707,1708,2119,2450,1355,937,1478,2078,1399,1459,1429,1645,60,-679,739
1947,340000,63065128401bb3ff,7,0,2028,2809,2863,2529,2927,3132,1460,775,1436,1362,1591,1598,1594,1517,7,229,-222
3263,370000,63065128401bb3ff,7,0,3147,4018,4409,4129,4087,5401,1885,1225,2010,2269,2615,2569,2592,2484,-46,346,-392
1670,140000,63065128401bb3ff,7,0,1223,1490,1510,1452,1547,2066,692,491,877,974,1192,1135,1164,1100,-57,218,-275
1515,440000,63065128401bb3ff,7,0,1715,2112,2192,2036,2188,2519,625,462,1475,1506,1216,1544,1380,1422,328,-290,618
518,450000,63065128401bb3ff,7,0,413,503,589,568,596,616,308,176,366,289,407,451,429,382,44,118,-74
4299,320000,63065128401bb3ff,7,0,3369,4854,5016,4475,5007,5643,2143,1862,2644,2631,3008,3307,3158,2982,299,377,-78
1333,360000,63065128401bb3ff,7,0,1308,1681,2044,1627,1981,2357,973,442,916,895,1031,1009,1020,978,-22,136,-158
4091,130000,63065128401bb3ff,7,0,2964,3829,3951,3277,3711,5424,1723,1261,2043,2652,2981,2611,2796,2748,-370,329,-699
4009,410000,63065128401bb3ff,7,0,3421,4398,4500,3793,4237,5119,2463,1238,2429,2562,2723,3091,2907,2792,368,161,207
1767,330000,63065128401bb3ff,7,0,2021,2513,2777,2324,2401,2755,895,768,1359,1321,1533,1474,1504,1443,-59,212,-271
1431,420000,63065128401bb3ff,7,0,1120,1591,1818,1296,1466,1985,1002,357,841,848,822,1085,954,918,263,-26,289
1663,430000,63065128401bb3ff,7,0,1583,1906,2187,1670,2078,2533,1085,531,1104,1014,1204,1328,1266,1182,124,190,-66
1141,350000,63065128401bb3ff,7,0,1055,1347,1279,1170,1218,1549,440,400,775,721,1235,973,1104,976,-262,514,-776
977,210000,63065128401bb3ff,7,0,702,806,897,700,869,1098,268,212,386,587,555,690,622,611,135,-32,167
1027,500000,63065128401bb3ff,7,0,987,1230,1171,824,938,1120,617,359,603,607,619,800,710,675,181,12,169
1691,610000,63065128401bb3ff,7,0,1113,1278,1300,1165,1199,1748,631,397,661,1831,842,1735,1288,1469,893,-989,1882
354,230000,63065128401bb3ff,7,0,303,404,404,286,466,480,162,156,276,218,323,452,388,331,129,105,24
314,310000,ea489c253676aafc,7,0,425,535,502,314,574,754,315,362,767,319,351,300,326,323,-51,32,-83
543,530000,ea489c253676aafc,7,0,551,450,435,635,692,866,452,295,448,404,525,442,484,457,-83,121,-204
504,150000,ea489c253676aafc,7,0,380,452,427,495,612,941,427,254,591,556,550,476,513,527,-74,-6,-68
150,110000,ea489c253676aafc,7,0,382,397,346,199,341,546,125,89,159,100,115,114,114,110,-1,15,-16
878,510000,ea489c253676aafc,7,0,1379,1197,903,838,1187,1812,1017,704,1344,1235,1081,1056,1068,1124,-25,-154,129
733,340000,ea489c253676aafc,7,0,1109,958,734,813,952,1669,741,475,869,701,638,694,666,678,56,-63,119
2825,370000,ea489c253676aafc,7,0,3450,3299,2451,2995,3812,5496,2330,1515,2865,2841,2834,2558,2696,2744,-276,-7,-269
1557,140000,ea489c253676aafc,7,0,1462,1588,1052,1126,1234,2626,1165,641,1247,1425,1531,1329,1430,1428,-202,106,-308
467,440000,ea489c253676aafc,7,0,457,448,529,384,525,1055,368,255,433,540,513,805,659,619,292,-27,319
222,450000,ea489c253676aafc,7,0,363,291,255,362,355,448,365,155,240,485,249,405,327,380,156,-236,392
892,320000,ea489c253676aafc,7,0,1353,1085,864,1310,1728,2261,1167,1028,1507,1281,827,792,810,967,-35,-454,419
242,360000,ea489c253676aafc,7,0,365,335,301,356,946,847,641,223,316,236,253,238,246,242,-15,17,-32
3284,130000,ea489c253676aafc,7,0,3210,3609,2265,2586,3058,5478,1932,1551,2981,3513,3250,2524,2887,3096,-726,-263,-463
1714,410000,ea489c253676aafc,7,0,1701,1452,1141,1472,1941,3092,1731,893,1695,1504,1408,1487,1448,1466,79,-96,175
578,330000,ea489c253676aafc,7,0,1000,913,659,638,706,1205,504,467,741,598,514,446,480,519,-68,-84,16
170,420000,ea489c253676aafc,7,0,277,263,202,272,348,657,298,154,273,222,166,164,165,184,-2,-56,54
484,430000,ea489c253676aafc,7,0,962,701,698,568,587,1351,576,253,448,437,409,373,391,406,-36,-28,-8
231,350000,ea489c253676aafc,7,0,356,355,342,307,452,617,215,148,255,232,240,199,220,224,-41,8,-49
667,210000,ea489c253676aafc,7,0,621,716,684,572,853,1026,394,408,768,721,776,679,728,725,-97,55,-152
249,500000,ea489c253676aafc,7,0,558,474,304,408,379,694,353,248,346,329,249,207,228,262,-42,-80,38
625,610000,ea489c253676aafc,7,0,667,832,623,693,804,1400,754,418,791,600,553,553,553,569,0,-47,47
471,230000,ea489c253676aafc,7,0,369,508,307,324,496,710,280,266,503,464,518,466,492,483,-52,54,-106
254,310000,cd5841d44fd7625e,7,0,201,232,150,148,312,359,339,177,321,249,248,328,288,275,80,-1,81
430,530000,cd5841d44fd7625e,7,0,388,290,304,344,442,485,409,248,357,375,412,347,380,378,-65,37,-102
431,150000,cd5841d44fd7625e,7,0,398,348,325,432,401,434,519,319,522,443,583,484,534,503,-99,140,-239
967,110000,cd5841d44fd7625e,7,0,990,1183,1150,795,1121,1802,1263,877,1267,1047,1549,1033,1291,1210,-516,502,-1018
845,510000,cd5841d44fd7625e,7,0,623,519,741,610,732,1083,1390,565,951,827,852,794,823,824,-58,25,-83
581,340000,cd5841d44fd7625e,7,0,381,360,323,440,519,629,667,315,471,534,553,570,562,552,17,19,-2
1627,370000,cd5841d44fd7625e,7,0,1256,1311,1391,1370,1666,1642,1861,878,1578,1694,1792,1554,1673,1680,-238,98,-336
431,140000,cd5841d44fd7625e,7,0,316,332,330,480,421,414,426,317,451,395,445,395,420,412,-50,50,-100
769,440000,cd5841d44fd7625e,7,0,509,516,523,704,995,1243,727,322,827,693,791,804,798,763,13,98,-85
168,450000,cd5841d44fd7625e,7,0,97,101,156,159,192,214,225,119,204,139,193,190,192,174,-3,54,-57
1197,320000,cd5841d44fd7625e,7,0,785,871,1280,881,1099,1374,1336,868,1301,1124,1278,1241,1260,1214,-37,154,-191
285,360000,cd5841d44fd7625e,7,0,199,169,178,237,276,329,364,141,291,237,315,278,296,277,-37,78,-115
1806,130000,cd5841d44fd7625e,7,0,1238,1360,1115,1052,1461,1615,1768,1165,1697,1805,2074,1714,1894,1864,-360,269,-629
1478,410000,cd5841d44fd7625e,7,0,957,1047,1104,1357,1223,1443,1429,856,1325,1403,1419,1413,1416,1412,-6,16,-22
663,330000,cd5841d44fd7625e,7,0,475,404,404,512,747,863,742,356,707,633,707,646,676,662,-61,74,-135
493,420000,cd5841d44fd7625e,7,0,298,379,393,374,473,566,558,262,443,396,470,482,476,449,12,74,-62
387,430000,cd5841d44fd7625e,7,0,273,291,253,248,418,494,519,230,424,383,397,379,388,386,-18,14,-32
284,350000,cd5841d44fd7625e,7,0,229,183,186,285,325,402,404,188,330,251,340,301,320,297,-39,89,-128
785,210000,cd5841d44fd7625e,7,0,652,721,569,738,644,1082,704,546,870,783,781,790,786,785,9,-2,11
335,500000,cd5841d44fd7625e,7,0,254,213,262,251,282,391,433,202,335,319,317,436,376,357,119,-2,121
519,610000,cd5841d44fd7625e,7,0,356,360,419,276,346,497,487,257,378,390,460,393,426,414,-67,70,-137
890,230000,cd5841d44fd7625e,7,0,639,929,731,657,664,964,785,666,1198,1070,1179,970,1074,1073,-209,109,-318
552,310000,b25c4e2e3856af22,7,0,897,946,1150,1010,1563,1504,815,447,731,532,612,632,622,592,20,80,-60
501,530000,b25c4e2e3856af22,7,0,681,595,570,759,692,785,585,277,403,310,422,368,395,367,-54,112,-166
136,150000,b25c4e2e3856af22,7,0,296,333,327,407,342,430,303,110,229,177,183,153,168,171,-30,6,-36
275,110000,b25c4e2e3856af22,7,0,675,772,925,740,925,1127,376,284,427,371,462,336,399,390,-126,91,-217
616,510000,b25c4e2e3856af22,7,0,990,1085,1885,1100,1320,1775,1096,562,764,657,680,772,726,703,92,23,69
632,340000,b25c4e2e3856af22,7,0,769,980,1023,1001,1064,1490,952,364,600,581,589,605,597,592,16,8,8
892,370000,b25c4e2e3856af22,7,0,1134,1323,1432,1303,1408,1739,940,501,805,813,957,836,896,869,-121,144,-265
102,140000,b25c4e2e3856af22,7,0,257,295,289,333,332,371,229,113,151,138,130,107,118,125,-23,-8,-15
768,440000,b25c4e2e3856af22,7,0,1097,1195,1320,1463,1644,2216,854,451,986,862,846,947,896,885,101,-16,117
181,450000,b25c4e2e3856af22,7,0,187,218,240,280,255,372,218,114,237,155,197,163,180,172,-34,42,-76
1086,320000,b25c4e2e3856af22,7,0,1571,1947,1897,1872,2263,3132,1586,987,1345,1015,1158,1068,1113,1080,-90,143,-233
457,360000,b25c4e2e3856af22,7,0,681,684,855,798,870,1144,754,284,498,430,503,444,474,459,-59,73,-132
668,130000,b25c4e2e3856af22,7,0,676,985,861,883,944,1218,652,442,599,687,716,543,630,649,-173,29,-202
703,410000,b25c4e2e3856af22,7,0,965,1056,1067,1021,1121,1578,856,471,700,719,644,669,656,677,25,-75,100
1172,330000,b25c4e2e3856af22,7,0,1921,2037,2367,2323,2703,3371,1749,893,1369,1150,1156,1037,1096,1114,-119,6,-125
621,420000,b25c4e2e3856af22,7,0,730,829,920,1033,988,1333,941,363,579,523,593,600,596,572,7,70,-63
594,430000,b25c4e2e3856af22,7,0,811,908,1056,973,1081,1561,1003,386,716,610,659,562,610,610,-97,49,-146
366,350000,b25c4e2e3856af22,7,0,681,684,714,853,905,1102,667,370,551,387,534,372,453,431,-162,147,-309
265,210000,b25c4e2e3856af22,7,0,444,478,491,437,403,555,253,188,258,212,206,203,204,207,-3,-6,3
274,500000,b25c4e2e3856af22,7,0,421,422,477,428,496,740,452,184,293,290,264,303,284,286,39,-26,65
285,610000,b25c4e2e3856af22,7,0,338,351,433,450,479,533,395,223,292,216,328,233,280,259,-95,112,-207
210,230000,b25c4e2e3856af22,7,0,362,461,359,320,352,428,213,219,281,217,259,239,249,238,-20,42,-62
353,310000,4a103c30d593fbbe,7,0,464,563,552,450,685,688,275,231,396,369,368,427,398,388,59,-1,60
556,530000,4a103c30d593fbbe,7,0,837,743,640,687,714,1001,409,321,443,427,437,368,402,411,-69,10,-79
522,150000,4a103c30d593fbbe,7,0,509,544,557,650,671,789,370,239,440,455,525,460,492,480,-65,70,-135
482,110000,4a103c30d593fbbe,7,0,1021,1288,1431,1045,1332,1807,402,360,619,496,497,491,494,495,-6,1,-7
1861,510000,4a103c30d593fbbe,7,0,1887,2009,2921,2017,2913,3590,1589,1106,1523,1538,1537,1666,1602,1580,129,-1,130
1346,340000,4a103c30d593fbbe,7,0,1307,1431,1596,1491,1717,1968,921,593,995,1124,1199,1070,1134,1131,-129,75,-204
2082,370000,4a103c30d593fbbe,7,0,2003,2387,2615,2547,2776,3299,1329,945,1856,2083,2108,1738,1923,1976,-370,25,-395
688,140000,4a103c30d593fbbe,7,0,641,800,787,813,782,1130,401,261,510,549,610,526,568,562,-84,61,-145
994,440000,4a103c30d593fbbe,7,0,1029,1303,1438,1702,2171,2397,475,354,1081,908,1044,1235,1140,1062,191,136,55
316,450000,4a103c30d593fbbe,7,0,287,282,358,395,493,595,225,179,348,224,290,274,282,263,-16,66,-82
2485,320000,4a103c30d593fbbe,7,0,2394,3107,2962,3228,3579,4302,1623,1477,2234,2129,2434,2155,2294,2239,-279,305,-584
652,360000,4a103c30d593fbbe,7,0,672,641,755,781,885,1016,398,230,537,551,590,548,569,563,-42,39,-81
3344,130000,4a103c30d593fbbe,7,0,2559,2979,2860,2877,2989,3954,1565,1311,2239,2725,3260,2705,2982,2897,-555,535,-1090
2489,410000,4a103c30d593fbbe,7,0,2115,2398,2493,2358,2638,3291,1489,872,1684,1948,1801,1780,1790,1843,-21,-147,126
1645,330000,4a103c30d593fbbe,7,0,1572,1914,1992,2163,2458,2897,961,793,1491,1417,1453,1417,1435,1429,-36,36,-72
898,420000,4a103c30d593fbbe,7,0,789,996,1142,948,1247,1304,805,357,634,667,656,762,709,695,106,-11,117
728,430000,4a103c30d593fbbe,7,0,720,817,950,757,948,1222,427,264,565,544,561,563,562,556,2,17,-15
541,350000,4a103c30d593fbbe,7,0,680,640,694,837,946,924,385,327,518,415,620,444,532,493,-176,205,-381
895,210000,4a103c30d593fbbe,7,0,904,1088,1057,1007,1160,1513,414,423,828,916,847,707,777,823,-140,-69,-71
329,500000,4a103c30d593fbbe,7,0,375,374,365,407,493,612,296,209,288,300,336,388,362,341,52,36,16
654,610000,4a103c30d593fbbe,7,0,701,761,801,945,946,1143,404,239,410,468,587,452,520,502,-135,119,-254
729,230000,4a103c30d593fbbe,7,0,757,1154,914,753,1190,1198,462,436,1058,713,772,690,731,725,-82,59,-141
612,310000,7a7885e2d7c00bcf,7,0,600,670,690,633,790,925,325,455,653,555,624,740,682,640,116,69,47
290,530000,7a7885e2d7c00bcf,7,0,493,447,408,431,527,546,194,218,317,270,316,211,264,266,-105,46,-151
288,150000,7a7885e2d7c00bcf,7,0,313,341,355,371,359,418,168,163,287,292,335,266,300,298,-69,43,-112
617,110000,7a7885e2d7c00bcf,7,0,879,911,1074,915,1162,1615,471,523,831,698,714,664,689,692,-50,16,-66
656,510000,7a7885e2d7c00bcf,7,0,745,722,1155,772,961,1167,445,516,738,665,640,630,635,645,-10,-25,15
618,340000,7a7885e2d7c00bcf,7,0,677,767,841,878,933,1003,374,418,658,653,606,565,586,608,-41,-47,6
1615,370000,7a7885e2d7c00bcf,7,0,1638,1852,2308,2307,2370,2766,875,984,1739,1860,1899,1420,1660,1726,-479,39,-518
247,140000,7a7885e2d7c00bcf,7,0,285,300,313,320,355,484,139,184,247,243,229,225,227,232,-4,-14,10
680,440000,7a7885e2d7c00bcf,7,0,937,951,992,1092,1209,1464,402,402,896,629,772,826,799,742,54,143,-89
154,450000,7a7885e2d7c00bcf,7,0,260,262,246,259,290,384,118,109,224,157,222,215,218,198,-7,65,-72
2048,320000,7a7885e2d7c00bcf,7,0,2112,2209,2679,2595,2801,3241,1057,1612,2234,1953,2227,1909,2068,2030,-318,274,-592
345,360000,7a7885e2d7c00bcf,7,0,434,393,442,498,481,511,213,176,385,307,351,273,312,310,-78,44,-122
1661,130000,7a7885e2d7c00bcf,7,0,1298,1461,1525,1603,1929,2115,754,885,1533,1690,1813,1571,1692,1691,-242,123,-365
1158,410000,7a7885e2d7c00bcf,7,0,1096,1283,1383,1309,1461,1740,591,724,1200,1228,1058,967,1012,1084,-91,-170,79
1884,330000,7a7885e2d7c00bcf,7,0,1999,1697,1991,2033,2127,2662,818,1237,1764,1676,1729,1525,1627,1643,-204,53,-257
438,420000,7a7885e2d7c00bcf,7,0,499,596,611,603,616,685,305,279,470,356,444,412,428,404,-32,88,-120
409,430000,7a7885e2d7c00bcf,7,0,503,514,645,501,559,768,256,278,497,347,424,341,382,371,-83,77,-160
356,350000,7a7885e2d7c00bcf,7,0,503,451,397,473,480,608,216,257,389,262,395,326,360,328,-69,133,-202
346,210000,7a7885e2d7c00bcf,7,0,483,505,553,489,516,595,169,217,412,408,386,321,354,372,-65,-22,-43
126,500000,7a7885e2d7c00bcf,7,0,189,145,189,159,216,258,69,99,133,100,129,180,154,136,51,29,22
417,610000,7a7885e2d7c00bcf,7,0,402,487,425,510,487,657,185,238,361,306,395,301,348,334,-94,89,-183
345,230000,7a7885e2d7c00bcf,7,0,420,611,511,443,413,533,157,228,535,404,398,359,378,387,-39,-6,-33
37,310000,346393c2c6305fb1,7,0,83,134,126,104,114,215,76,41,45,61,38,52,45,50,14,-23,37
44,530000,346393c2c6305fb1,7,0,141,121,133,139,121,182,95,41,34,36,31,58,44,42,27,-5,32
74,150000,346393c2c6305fb1,7,0,114,92,121,108,174,205,99,66,95,76,72,76,74,75,4,-4,8
32,110000,346393c2c6305fb1,7,0,201,202,250,161,243,439,74,40,54,53,41,27,34,40,-14,-12,-2
134,510000,346393c2c6305fb1,7,0,284,317,459,291,297,513,309,153,136,133,149,150,150,144,1,16,-15
279,340000,346393c2c6305fb1,7,0,633,733,655,600,692,1047,578,273,312,307,331,314,322,317,-17,24,-41
536,370000,346393c2c6305fb1,7,0,1000,1063,1138,1097,1099,1844,902,381,538,572,675,544,610,597,-131,103,-234
178,140000,346393c2c6305fb1,7,0,212,261,250,277,308,545,238,158,237,226,236,217,226,226,-19,10,-29
92,440000,346393c2c6305fb1,7,0,291,295,282,277,289,373,126,71,118,103,101,96,98,100,-5,-2,-3
48,450000,346393c2c6305fb1,7,0,108,107,108,100,115,162,93,53,69,35,53,40,46,43,-13,18,-31
185,320000,346393c2c6305fb1,7,0,402,461,370,406,397,621,300,168,197,206,183,203,193,197,20,-23,43
53,360000,346393c2c6305fb1,7,0,141,112,150,164,143,266,151,36,61,68,60,40,50,56,-20,-8,-12
452,130000,346393c2c6305fb1,7,0,575,645,742,699,808,1460,748,389,430,459,518,401,460,459,-117,59,-176
290,410000,346393c2c6305fb1,7,0,477,544,566,471,617,1100,524,174,251,240,290,254,272,261,-36,50,-86
77,330000,346393c2c6305fb1,7,0,194,181,198,211,191,260,101,55,63,66,67,90,78,74,23,1,22
125,420000,346393c2c6305fb1,7,0,274,266,326,324,313,534,275,79,103,125,96,138,117,120,42,-29,71
138,430000,346393c2c6305fb1,7,0,282,273,347,286,335,535,308,119,163,126,142,139,140,136,-3,16,-19
33,350000,346393c2c6305fb1,7,0,101,114,102,89,87,129,60,25,51,31,35,42,38,36,7,4,3
148,210000,346393c2c6305fb1,7,0,252,331,280,278,265,371,149,91,133,121,130,132,131,128,2,9,-7
67,500000,346393c2c6305fb1,7,0,247,251,250,189,199,335,168,84,69,66,80,88,84,78,8,14,-6
83,610000,346393c2c6305fb1,7,0,180,161,167,197,186,360,209,62,83,76,106,84,95,89,-22,30,-52
105,230000,346393c2c6305fb1,7,0,165,264,248,169,223,312,126,95,154,101,143,86,114,110,-57,42,-99
704,310000,02aab221aabc03b9,7,0,653,687,651,489,558,362,679,494,731,600,672,772,722,681,100,72,28
250,530000,02aab221aabc03b9,7,0,247,209,201,174,160,155,229,130,223,186,188,194,191,189,6,2,4
99,150000,02aab221aabc03b9,7,0,108,130,97,99,82,59,106,63,136,99,113,83,98,98,-30,14,-44
670,110000,02aab221aabc03b9,7,0,748,847,831,642,654,521,798,532,838,575,694,618,656,629,-76,119,-195
549,510000,02aab221aabc03b9,7,0,460,559,615,471,430,474,703,394,653,524,606,614,610,581,8,82,-74
340,340000,02aab221aabc03b9,7,0,244,344,348,248,228,187,338,203,372,311,341,346,344,333,5,30,-25
531,370000,02aab221aabc03b9,7,0,584,549,525,474,421,353,610,362,607,527,608,548,578,561,-60,81,-141
130,140000,02aab221aabc03b9,7,0,121,154,121,105,117,105,129,94,160,139,138,152,145,143,14,-1,15
1095,440000,02aab221aabc03b9,7,0,1083,1238,1180,1049,976,1007,1207,847,1361,1093,1267,1219,1243,1193,-48,174,-222
137,450000,02aab221aabc03b9,7,0,142,161,151,126,138,119,159,102,172,121,154,153,154,143,-1,33,-34
1493,320000,02aab221aabc03b9,7,0,1509,1821,1585,1270,1186,1077,1735,1066,1713,1523,1554,1639,1596,1572,85,31,54
206,360000,02aab221aabc03b9,7,0,198,224,232,164,154,152,242,146,291,216,232,253,242,234,21,16,5
372,130000,02aab221aabc03b9,7,0,350,330,362,307,254,182,340,242,360,379,362,327,344,356,-35,-17,-18
350,410000,02aab221aabc03b9,7,0,353,389,339,239,284,223,320,199,311,289,319,320,320,309,1,30,-29
1473,330000,02aab221aabc03b9,7,0,1486,1568,1439,1239,1136,1024,1529,973,1602,1326,1507,1501,1504,1445,-6,181,-187
331,420000,02aab221aabc03b9,7,0,346,383,407,272,273,274,370,238,369,296,339,369,354,335,30,43,-13
275,430000,02aab221aabc03b9,7,0,257,270,285,213,205,215,305,186,346,275,278,289,284,281,11,3,8
403,350000,02aab221aabc03b9,7,0,394,437,448,353,321,324,518,242,572,350,498,528,513,459,30,148,-118
295,210000,02aab221aabc03b9,7,0,291,346,299,229,207,174,292,205,321,225,242,252,247,240,10,17,-7
258,500000,02aab221aabc03b9,7,0,259,222,255,197,217,217,267,199,277,240,244,232,238,239,-12,4,-16
270,610000,02aab221aabc03b9,7,0,238,319,283,263,205,197,285,151,281,203,248,250,249,234,2,45,-43
113,230000,02aab221aabc03b9,7,0,75,119,71,81,63,53,93,68,133,85,82,113,98,93,31,-3,34
230,310000,5d7fb682edd0f937,7,0,297,303,281,281,247,225,315,160,297,263,287,314,300,288,27,24,3
180,530000,5d7fb682edd0f937,7,0,190,187,165,167,133,176,164,108,164,133,153,126,140,137,-27,20,-47
88,150000,5d7fb682edd0f937,7,0,112,117,120,96,85,86,86,62,103,111,102,97,100,103,-5,-9,4
234,110000,5d7fb682edd0f937,7,0,331,427,429,308,324,417,323,190,356,270,290,257,274,272,-33,20,-53
288,510000,5d7fb682edd0f937,7,0,359,376,389,305,301,337,483,166,411,313,351,316,334,327,-35,38,-73
186,340000,5d7fb682edd0f937,7,0,156,227,205,162,169,174,188,119,173,183,210,172,191,188,-38,27,-65
253,370000,5d7fb682edd0f937,7,0,263,302,292,265,227,253,339,160,306,297,331,234,282,287,-97,34,-131
91,140000,5d7fb682edd0f937,7,0,82,103,99,83,81,91,111,56,97,101,97,84,90,94,-13,-4,-9
422,440000,5d7fb682edd0f937,7,0,480,565,575,462,510,512,581,314,531,409,540,562,551,504,22,131,-109
85,450000,5d7fb682edd0f937,7,0,96,117,108,102,103,109,128,57,103,59,104,114,109,92,10,45,-35
655,320000,5d7fb682edd0f937,7,0,733,823,757,642,661,734,807,456,741,678,793,643,718,705,-150,115,-265
104,360000,5d7fb682edd0f937,7,0,120,153,155,115,129,138,165,79,158,126,152,118,135,132,-34,26,-60
165,130000,5d7fb682edd0f937,7,0,195,219,226,184,180,178,203,126,201,195,251,175,213,207,-76,56,-132
186,410000,5d7fb682edd0f937,7,0,189,186,187,161,189,173,186,103,191,191,194,156,175,180,-38,3,-41
584,330000,5d7fb682edd0f937,7,0,645,709,620,587,599,595,656,382,738,625,720,647,684,664,-73,95,-168
231,420000,5d7fb682edd0f937,7,0,242,319,331,219,258,266,270,142,257,214,255,256,256,242,1,41,-40
167,430000,5d7fb682edd0f937,7,0,164,219,179,160,168,191,210,114,205,161,191,162,176,171,-29,30,-59
197,350000,5d7fb682edd0f937,7,0,240,260,259,202,201,205,241,127,267,183,283,239,261,235,-44,100,-144
129,210000,5d7fb682edd0f937,7,0,152,161,165,130,138,128,140,90,113,125,138,146,142,136,8,13,-5
124,500000,5d7fb682edd0f937,7,0,148,158,109,123,106,134,131,54,117,102,136,130,133,123,-6,34,-40
123,610000,5d7fb682edd0f937,7,0,161,205,192,172,135,145,159,85,142,119,156,144,150,140,-12,37,-49
61,230000,5d7fb682edd0f937,7,0,67,99,74,50,53,61,68,34,78,65,79,70,74,71,-9,14,-23
634,310000,a207df29ec9583f0,7,0,438,559,478,428,493,474,835,424,592,562,626,644,635,611,18,64,-46
258,530000,a207df29ec9583f0,7,0,190,240,237,204,210,215,310,178,234,223,203,223,213,216,20,-20,40
116,150000,a207df29ec9583f0,7,0,74,115,91,72,82,74,139,87,116,104,125,105,115,111,-20,21,-41
727,110000,a207df29ec9583f0,7,0,674,824,853,604,747,817,1033,648,841,763,792,726,759,760,-66,29,-95
479,510000,a207df29ec9583f0,7,0,344,458,388,382,361,382,695,383,524,456,456,507,482,473,51,0,51
254,340000,a207df29ec9583f0,7,0,148,226,228,183,176,177,354,152,225,259,222,223,222,235,1,-37,38
429,370000,a207df29ec9583f0,7,0,365,453,344,338,348,336,608,328,530,488,475,451,463,471,-24,-13,-11
140,140000,a207df29ec9583f0,7,0,105,108,108,84,93,100,165,96,130,118,97,142,120,119,45,-21,66
1084,440000,a207df29ec9583f0,7,0,689,886,875,627,766,825,1178,690,1101,964,1020,962,991,982,-58,56,-114
134,450000,a207df29ec9583f0,7,0,90,105,124,72,100,114,160,106,163,133,138,136,137,136,-2,5,-7
982,320000,a207df29ec9583f0,7,0,857,1124,918,791,915,1007,1591,766,1115,1026,1072,1033,1052,1044,-39,46,-85
165,360000,a207df29ec9583f0,7,0,115,140,155,101,129,108,227,115,167,214,182,168,175,188,-14,-32,18
301,130000,a207df29ec9583f0,7,0,221,266,200,202,203,219,376,209,316,289,290,301,296,293,11,1,10
289,410000,a207df29ec9583f0,7,0,254,276,252,194,283,262,357,201,287,304,275,256,266,278,-19,-29,10
954,330000,a207df29ec9583f0,7,0,824,880,834,733,849,908,1436,623,970,967,965,954,960,962,-11,-2,-9
360,420000,a207df29ec9583f0,7,0,260,327,326,230,315,356,436,202,366,316,282,393,338,330,111,-34,145
246,430000,a207df29ec9583f0,7,0,157,190,184,143,174,192,302,179,246,255,226,219,222,233,-7,-29,22
288,350000,a207df29ec9583f0,7,0,234,296,266,197,227,256,500,212,338,297,357,330,344,328,-27,60,-87
276,210000,a207df29ec9583f0,7,0,215,281,225,176,194,227,304,176,286,261,241,263,252,255,22,-20,42
187,500000,a207df29ec9583f0,7,0,192,184,176,151,174,194,265,152,205,197,174,223,198,198,49,-23,72
248,610000,a207df29ec9583f0,7,0,235,213,228,210,194,216,307,140,222,205,251,252,252,236,1,46,-45
86,230000,a207df29ec9583f0,7,0,59,106,77,74,83,85,102,84,125,116,121,127,124,121,6,5,1
142,310000,b4be3a4917289c82,7,0,152,203,190,188,201,262,80,97,160,113,154,142,148,136,-12,41,-53
74,530000,b4be3a4917289c82,7,0,35,60,52,76,100,59,26,35,34,50,78,51,64,60,-27,28,-55
17,150000,b4be3a4917289c82,7,0,35,33,31,42,40,37,22,17,26,37,25,21,23,28,-4,-12,8
88,110000,b4be3a4917289c82,7,0,172,203,232,200,230,226,93,117,153,137,139,94,116,123,-45,2,-47
144,510000,b4be3a4917289c82,7,0,121,152,216,166,240,223,57,76,90,137,164,128,146,143,-36,27,-63
100,340000,b4be3a4917289c82,7,0,90,104,106,110,130,121,57,59,72,81,74,76,75,77,2,-7,9
160,370000,b4be3a4917289c82,7,0,199,232,258,215,231,199,113,137,218,152,167,149,158,156,-18,15,-33
26,140000,b4be3a4917289c82,7,0,32,37,31,31,28,33,16,10,28,22,76,22,49,40,-54,54,-108
202,440000,b4be3a4917289c82,7,0,182,223,290,309,396,384,120,115,231,223,244,188,216,218,-56,21,-77
30,450000,b4be3a4917289c82,7,0,25,29,35,34,41,40,20,18,18,25,33,31,32,30,-2,8,-10
340,320000,b4be3a4917289c82,7,0,389,471,447,420,635,591,225,325,414,342,390,329,360,354,-61,48,-109
38,360000,b4be3a4917289c82,7,0,41,43,50,52,66,85,10,18,37,40,39,37,38,39,-2,-1,-1
97,130000,b4be3a4917289c82,7,0,127,130,145,141,166,161,78,99,131,131,102,71,86,101,-31,-29,-2
92,410000,b4be3a4917289c82,7,0,93,86,118,117,128,163,57,77,90,88,75,84,80,82,9,-13,22
415,330000,b4be3a4917289c82,7,0,361,382,415,422,523,567,168,290,344,386,300,355,328,347,55,-86,141
75,420000,b4be3a4917289c82,7,0,79,106,110,92,120,142,48,54,76,88,66,69,68,74,3,-22,25
72,430000,b4be3a4917289c82,7,0,45,64,96,79,112,124,41,43,61,74,75,46,60,65,-29,1,-30
62,350000,b4be3a4917289c82,7,0,50,84,61,85,108,127,23,28,50,51,59,58,58,56,-1,8,-9
54,210000,b4be3a4917289c82,7,0,82,88,87,77,106,83,28,38,67,45,65,40,52,50,-25,20,-45
30,500000,b4be3a4917289c82,7,0,26,35,47,43,77,67,17,20,19,34,34,37,36,35,3,0,3
51,610000,b4be3a4917289c82,7,0,57,82,79,83,68,82,41,52,48,66,99,56,78,74,-43,33,-76
19,230000,b4be3a4917289c82,7,0,44,61,42,40,48,45,18,18,48,30,46,28,37,35,-18,16,-34
475,310000,ef76a85c4b39f693,7,0,581,360,145,129,306,492,378,283,374,311,427,498,462,412,71,116,-45
272,530000,ef76a85c4b39f693,7,0,221,153,83,75,142,154,140,101,145,149,178,192,185,173,14,29,-15
135,150000,ef76a85c4b39f693,7,0,165,105,47,48,67,109,121,79,109,124,169,140,154,144,-29,45,-74
591,110000,ef76a85c4b39f693,7,0,663,502,321,175,311,576,511,299,438,522,580,543,562,548,-37,58,-95
571,510000,ef76a85c4b39f693,7,0,554,488,356,206,340,526,495,291,361,444,497,529,513,490,32,53,-21
363,340000,ef76a85c4b39f693,7,0,309,208,104,111,219,307,304,148,259,319,271,331,301,307,60,-48,108
550,370000,ef76a85c4b39f693,7,0,573,446,246,241,312,378,406,284,400,479,557,520,538,519,-37,78,-115
121,140000,ef76a85c4b39f693,7,0,138,80,47,46,58,83,94,61,99,97,93,99,96,96,6,-4,10
756,440000,ef76a85c4b39f693,7,0,869,740,398,282,593,912,598,355,607,642,701,764,732,702,63,59,4
139,450000,ef76a85c4b39f693,7,0,85,95,39,30,50,68,74,33,77,72,113,104,108,96,-9,41,-50
1159,320000,ef76a85c4b39f693,7,0,1116,610,270,351,609,1028,993,652,891,910,1046,1085,1066,1014,39,136,-97
209,360000,ef76a85c4b39f693,7,0,175,130,47,59,107,208,200,69,151,150,175,152,164,159,-23,25,-48
438,130000,ef76a85c4b39f693,7,0,429,351,172,141,298,340,342,250,323,382,440,423,432,415,-17,58,-75
405,410000,ef76a85c4b39f693,7,0,406,206,143,136,170,239,290,184,293,341,325,356,340,341,31,-16,47
1524,330000,ef76a85c4b39f693,7,0,1257,815,643,498,965,1300,996,708,969,1088,1209,1284,1246,1194,75,121,-46
339,420000,ef76a85c4b39f693,7,0,286,253,116,101,212,331,334,134,250,279,305,303,304,296,-2,26,-28
331,430000,ef76a85c4b39f693,7,0,325,229,78,92,180,310,284,146,251,271,354,267,310,297,-87,83,-170
253,350000,ef76a85c4b39f693,7,0,288,200,69,95,138,176,229,97,153,164,270,221,246,218,-49,106,-155
440,210000,ef76a85c4b39f693,7,0,433,291,193,157,189,261,256,190,274,317,341,370,356,343,29,24,5
162,500000,ef76a85c4b39f693,7,0,158,135,51,35,76,157,115,82,120,97,175,209,192,160,34,78,-44
284,610000,ef76a85c4b39f693,7,0,249,241,115,96,127,205,223,136,166,239,247,199,223,228,-48,8,-56
161,230000,ef76a85c4b39f693,7,0,111,123,58,56,108,145,104,92,153,138,145,157,151,147,12,7,5
323,310000,bb9fbec9a2833839,7,0,408,528,494,298,341,507,266,214,347,256,335,387,361,326,52,79,-27
231,530000,bb9fbec9a2833839,7,0,198,213,197,180,169,225,142,99,142,158,164,176,170,166,12,6,6
151,150000,bb9fbec9a2833839,7,0,178,178,174,157,121,169,76,74,105,133,145,136,140,138,-9,12,-21
265,110000,bb9fbec9a2833839,7,0,388,450,529,355,417,450,177,170,259,234,290,279,284,268,-11,56,-67
358,510000,bb9fbec9a2833839,7,0,440,533,641,403,433,394,242,224,324,333,361,319,340,338,-42,28,-70
254,340000,bb9fbec9a2833839,7,0,244,297,328,172,256,310,160,139,211,231,217,227,222,225,10,-14,24
413,370000,bb9fbec9a2833839,7,0,352,487,582,453,469,507,305,251,332,402,428,398,413,409,-30,26,-56
106,140000,bb9fbec9a2833839,7,0,132,168,143,117,124,97,55,43,101,86,111,100,106,99,-11,25,-36
710,440000,bb9fbec9a2833839,7,0,704,813,867,710,821,895,435,271,630,599,641,694,668,645,53,42,11
124,450000,bb9fbec9a2833839,7,0,108,129,137,85,114,124,79,66,108,95,119,99,109,104,-20,24,-44
877,320000,bb9fbec9a2833839,7,0,952,1272,1166,688,937,1154,552,589,835,807,903,879,891,863,-24,96,-120
152,360000,bb9fbec9a2833839,7,0,183,202,193,186,189,178,106,91,145,142,176,146,161,155,-30,34,-64
307,130000,bb9fbec9a2833839,7,0,310,427,423,324,327,378,179,188,251,302,319,290,304,304,-29,17,-46
252,410000,bb9fbec9a2833839,7,0,301,336,420,237,276,308,156,143,260,258,238,212,225,236,-26,-20,-6
1035,330000,bb9fbec9a2833839,7,0,1162,1196,1045,917,1072,1169,550,543,759,841,892,995,944,909,103,51,52
324,420000,bb9fbec9a2833839,7,0,315,395,429,270,308,378,261,177,285,262,281,264,272,269,-17,19,-36
261,430000,bb9fbec9a2833839,7,0,268,360,359,193,226,309,145,129,251,238,285,222,254,248,-63,47,-110
236,350000,bb9fbec9a2833839,7,0,244,281,263,253,214,293,168,110,183,202,270,233,252,235,-37,68,-105
139,210000,bb9fbec9a2833839,7,0,191,241,242,174,177,213,86,85,121,151,164,140,152,152,-24,13,-37
82,500000,bb9fbec9a2833839,7,0,121,146,128,96,89,130,65,59,92,68,101,131,116,100,30,33,-3
151,610000,bb9fbec9a2833839,7,0,200,229,215,165,164,174,112,81,131,150,180,137,158,156,-43,30,-73
104,230000,bb9fbec9a2833839,7,0,92,130,140,82,95,85,44,40,74,82,95,78,86,85,-17,13,-30
411,310000,da457d15788fe8ee,7,0,421,521,504,402,593,748,538,251,456,315,445,485,465,415,40,130,-90
341,530000,da457d15788fe8ee,7,0,306,266,231,316,323,344,263,166,191,198,263,290,276,250,27,65,-38
177,150000,da457d15788fe8ee,7,0,162,217,201,207,206,200,197,109,152,165,213,178,196,185,-35,48,-83
805,110000,da457d15788fe8ee,7,0,845,898,731,715,939,1050,755,424,693,651,781,754,768,729,-27,130,-157
611,510000,da457d15788fe8ee,7,0,554,658,1072,583,560,641,624,348,443,468,502,547,524,506,45,34,11
284,340000,da457d15788fe8ee,7,0,257,346,329,282,331,409,330,200,229,256,264,317,290,279,53,8,45
541,370000,da457d15788fe8ee,7,0,481,543,678,438,630,646,659,309,458,540,534,523,528,532,-11,-6,-5
136,140000,da457d15788fe8ee,7,0,114,155,143,139,142,103,120,44,90,120,136,128,132,128,-8,16,-24
1068,440000,da457d15788fe8ee,7,0,1074,1237,1342,1295,1408,1829,1269,499,1006,894,1099,1203,1151,1065,104,205,-101
174,450000,da457d15788fe8ee,7,0,124,125,189,162,142,255,213,82,152,117,156,149,152,141,-7,39,-46
1112,320000,da457d15788fe8ee,7,0,842,1106,1255,1040,1108,1430,1304,649,954,933,1003,955,979,964,-48,70,-118
249,360000,da457d15788fe8ee,7,0,177,230,275,218,275,247,282,85,186,198,229,203,216,210,-26,31,-57
458,130000,da457d15788fe8ee,7,0,396,476,471,407,417,527,425,254,337,412,434,405,420,417,-29,22,-51
375,410000,da457d15788fe8ee,7,0,400,422,469,405,382,502,442,251,354,426,325,372,348,374,47,-101,148
1317,330000,da457d15788fe8ee,7,0,1000,1181,1241,932,1214,1500,938,567,836,888,1017,1178,1098,1028,161,129,32
438,420000,da457d15788fe8ee,7,0,358,427,529,447,473,526,572,259,428,363,377,445,411,395,68,14,54
451,430000,da457d15788fe8ee,7,0,322,451,476,369,391,505,374,207,342,370,431,366,398,389,-65,61,-126
262,350000,da457d15788fe8ee,7,0,282,266,282,298,320,358,335,144,206,194,282,238,260,238,-44,88,-132
371,210000,da457d15788fe8ee,7,0,365,459,418,357,335,454,281,156,268,293,330,277,304,300,-53,37,-90
146,500000,da457d15788fe8ee,7,0,189,230,259,188,209,244,199,108,153,121,186,284,235,197,98,65,33
330,610000,da457d15788fe8ee,7,0,281,312,352,366,242,346,325,174,210,225,299,236,268,253,-63,74,-137
128,230000,da457d15788fe8ee,7,0,175,240,219,123,190,198,139,94,144,137,133,149,141,140,16,-4,20
685,310000,6858d6dfe680bdf7,7,0,444,607,438,357,513,576,543,384,696,487,649,633,641,590,-16,162,-178
292,530000,6858d6dfe680bdf7,7,0,177,213,139,117,236,257,243,199,312,234,314,249,282,266,-65,80,-145
74,150000,6858d6dfe680bdf7,7,0,46,43,47,37,60,80,54,43,84,76,64,93,78,78,29,-12,41
668,110000,6858d6dfe680bdf7,7,0,494,449,410,328,585,816,536,311,688,527,617,587,602,577,-30,90,-120
551,510000,6858d6dfe680bdf7,7,0,444,445,455,290,447,593,591,337,640,478,571,603,587,551,32,93,-61
386,340000,6858d6dfe680bdf7,7,0,251,265,236,233,275,385,322,230,435,350,391,362,376,368,-29,41,-70
535,370000,6858d6dfe680bdf7,7,0,382,358,297,285,401,440,468,289,622,538,593,498,546,543,-95,55,-150
76,140000,6858d6dfe680bdf7,7,0,45,60,31,30,61,103,57,64,78,79,91,70,80,80,-21,12,-33
1265,440000,6858d6dfe680bdf7,7,0,972,1033,800,773,983,1319,1274,618,1449,1061,1394,1469,1432,1308,75,333,-258
157,450000,6858d6dfe680bdf7,7,0,112,99,93,94,126,167,115,84,164,123,176,156,166,152,-20,53,-73
1375,320000,6858d6dfe680bdf7,7,0,894,893,729,862,988,1160,1203,919,1681,1193,1428,1269,1348,1297,-159,235,-394
206,360000,6858d6dfe680bdf7,7,0,175,134,144,96,129,200,185,89,224,198,224,201,212,208,-23,26,-49
463,130000,6858d6dfe680bdf7,7,0,249,266,194,192,281,283,417,232,460,496,484,423,454,468,-61,-12,-49
410,410000,6858d6dfe680bdf7,7,0,276,272,209,174,237,350,258,224,388,425,429,397,413,417,-32,4,-36
1852,330000,6858d6dfe680bdf7,7,0,1189,1547,1208,929,1465,1724,1540,1004,2273,1596,1876,1650,1763,1707,-226,280,-506
314,420000,6858d6dfe680bdf7,7,0,203,235,199,144,218,283,271,143,325,266,300,353,326,306,53,34,19
372,430000,6858d6dfe680bdf7,7,0,258,251,209,203,255,374,375,195,380,321,402,363,382,362,-39,81,-120
353,350000,6858d6dfe680bdf7,7,0,323,276,236,214,251,346,352,161,369,304,419,307,363,343,-112,115,-227
260,210000,6858d6dfe680bdf7,7,0,195,187,133,91,159,186,215,146,225,256,285,240,262,260,-45,29,-74
277,500000,6858d6dfe680bdf7,7,0,183,189,132,105,200,253,198,131,290,195,274,315,294,261,41,79,-38
215,610000,6858d6dfe680bdf7,7,0,135,163,159,132,134,174,188,135,235,193,286,212,249,230,-74,93,-167
78,230000,6858d6dfe680bdf7,7,0,52,57,23,28,58,76,70,44,104,104,97,90,94,97,-7,-7,0
169,310000,79de4e4b24c35b04,7,0,328,379,426,299,501,825,333,136,253,217,192,208,200,206,16,-25,41
568,530000,79de4e4b24c35b04,7,0,695,707,913,926,928,1393,1050,634,598,559,552,559,556,557,7,-7,14
146,150000,79de4e4b24c35b04,7,0,134,132,200,230,272,405,185,132,207,141,156,128,142,142,-28,15,-43
116,110000,79de4e4b24c35b04,7,0,240,313,370,330,446,852,178,127,199,127,128,132,130,129,4,1,3
456,510000,79de4e4b24c35b04,7,0,778,755,971,792,934,1509,1063,565,512,413,385,387,386,395,2,-28,30
897,340000,79de4e4b24c35b04,7,0,1052,1349,1421,1263,1461,2601,1965,1072,936,771,749,842,796,787,93,-22,115
1936,370000,79de4e4b24c35b04,7,0,2244,2677,2814,2975,3077,5360,2858,1598,1729,1694,1756,1539,1648,1663,-217,62,-279
470,140000,79de4e4b24c35b04,7,0,542,640,778,791,803,1442,701,396,447,437,462,390,426,430,-72,25,-97
2551,440000,79de4e4b24c35b04,7,0,3295,4086,5098,5032,5800,8421,3465,1872,3263,2465,2754,2779,2766,2666,25,289,-264
1376,450000,79de4e4b24c35b04,7,0,1981,2497,3110,3025,3479,6171,2981,1510,1845,1206,1444,1326,1385,1325,-118,238,-356
1387,320000,79de4e4b24c35b04,7,0,1577,1829,2045,1978,2153,3757,2028,1542,1465,1325,1301,1251,1276,1292,-50,-24,-26
389,360000,79de4e4b24c35b04,7,0,598,635,806,703,736,1319,827,443,434,359,341,393,367,364,52,-18,70
1294,130000,79de4e4b24c35b04,7,0,1184,1505,1631,1500,1789,2863,1366,1047,1021,1146,1168,1072,1120,1129,-96,22,-118
3162,410000,79de4e4b24c35b04,7,0,3796,4302,4617,4700,5194,9539,6024,2842,2528,2423,2523,2603,2563,2516,80,100,-20
813,330000,79de4e4b24c35b04,7,0,1096,1291,1435,1528,1653,2646,934,580,745,680,733,621,677,678,-112,53,-165
454,420000,79de4e4b24c35b04,7,0,678,753,891,696,982,1629,1137,521,524,406,468,397,432,424,-71,62,-133
743,430000,79de4e4b24c35b04,7,0,984,1113,1544,1234,1513,2352,1658,771,808,663,615,657,636,645,42,-48,90
319,350000,79de4e4b24c35b04,7,0,626,548,706,724,738,1086,453,316,456,314,359,319,339,331,-40,45,-85
500,210000,79de4e4b24c35b04,7,0,528,616,644,644,694,1039,408,313,505,468,482,534,508,495,52,14,38
183,500000,79de4e4b24c35b04,7,0,297,277,359,279,304,514,324,210,169,172,136,158,147,155,22,-36,58
535,610000,79de4e4b24c35b04,7,0,538,648,785,855,1045,1704,937,403,499,452,488,436,462,459,-52,36,-88
521,230000,79de4e4b24c35b04,7,0,643,791,839,638,832,1045,394,365,562,482,469,565,517,505,96,-13,109
619,310000,12f8b7e14947c34d,7,0,1350,1065,2065,1032,1283,1483,389,338,505,521,647,608,628,592,-39,126,-165
297,530000,12f8b7e14947c34d,7,0,404,346,402,396,360,567,208,160,208,214,226,198,212,213,-28,12,-40
326,150000,12f8b7e14947c34d,7,0,569,575,712,648,698,789,413,215,340,311,387,355,371,351,-32,76,-108
71,110000,12f8b7e14947c34d,7,0,429,397,451,276,389,488,143,102,126,84,102,87,94,91,-15,18,-33
527,510000,12f8b7e14947c34d,7,0,682,820,1286,786,820,1117,531,374,577,521,559,581,570,554,22,38,-16
305,340000,12f8b7e14947c34d,7,0,477,644,726,594,615,705,385,198,241,246,257,285,271,263,28,11,17
912,370000,12f8b7e14947c34d,7,0,1292,1454,1777,1435,1352,1707,803,424,738,843,928,824,876,865,-104,85,-189
188,140000,12f8b7e14947c34d,7,0,310,346,391,347,352,464,131,87,174,169,231,178,204,193,-53,62,-115
184,440000,12f8b7e14947c34d,7,0,248,286,326,342,407,475,130,117,221,195,239,246,242,227,7,44,-37
95,450000,12f8b7e14947c34d,7,0,106,135,181,167,158,231,93,43,77,54,89,79,84,74,-10,35,-45
1058,320000,12f8b7e14947c34d,7,0,1598,2024,2099,1880,1868,2181,991,782,1094,1007,1280,1090,1185,1126,-190,273,-463
232,360000,12f8b7e14947c34d,7,0,290,349,532,430,438,495,251,128,183,180,217,188,202,195,-29,37,-66
670,130000,12f8b7e14947c34d,7,0,769,1026,1153,782,978,1229,546,360,592,598,847,611,729,685,-236,249,-485
659,410000,12f8b7e14947c34d,7,0,849,951,954,750,835,1053,508,259,492,410,471,586,528,489,115,61,54
610,330000,12f8b7e14947c34d,7,0,723,773,920,884,1063,1213,348,291,556,450,632,576,604,553,-56,182,-238
210,420000,12f8b7e14947c34d,7,0,273,340,406,336,358,440,200,80,136,138,174,236,205,183,62,36,26
328,430000,12f8b7e14947c34d,7,0,473,550,688,528,670,749,385,150,254,224,307,284,296,272,-23,83,-106
200,350000,12f8b7e14947c34d,7,0,297,275,314,302,385,408,188,136,178,176,297,240,268,238,-57,121,-178
94,210000,12f8b7e14947c34d,7,0,156,254,246,156,195,210,53,54,81,84,109,71,90,88,-38,25,-63
107,500000,12f8b7e14947c34d,7,0,192,205,240,178,181,295,131,85,113,117,117,161,139,132,44,0,44
736,610000,12f8b7e14947c34d,7,0,1062,1276,1109,958,1012,1286,412,280,531,610,649,548,598,602,-101,39,-140
113,230000,12f8b7e14947c34d,7,0,199,236,256,202,210,228,66,80,160,104,150,105,128,120,-45,46,-91
1376,310000,04e66e578f653ab9,7,0,265,342,422,337,524,679,950,175,263,226,214,231,222,224,17,-12,29
183,530000,04e66e578f653ab9,7,0,123,129,142,173,215,293,131,118,135,108,106,85,96,100,-21,-2,-19
54,150000,04e66e578f653ab9,7,0,63,80,87,94,102,118,60,38,63,48,62,45,54,52,-17,14,-31
135,110000,04e66e578f653ab9,7,0,165,158,241,166,231,280,180,87,167,105,117,108,112,110,-9,12,-21
158,510000,04e66e578f653ab9,7,0,135,208,419,226,291,404,151,140,210,163,126,156,141,148,30,-37,67
91,340000,04e66e578f653ab9,7,0,84,146,172,127,176,201,116,64,85,74,80,96,88,83,16,6,10
266,370000,04e66e578f653ab9,7,0,207,253,405,274,383,451,230,146,276,296,237,243,240,259,6,-59,65
45,140000,04e66e578f653ab9,7,0,58,68,104,75,85,95,42,23,68,34,43,37,40,38,-6,9,-15
100,440000,04e66e578f653ab9,7,0,105,149,140,175,225,268,104,54,144,101,111,106,108,106,-5,10,-15
35,450000,04e66e578f653ab9,7,0,28,43,42,39,42,71,30,28,32,17,42,31,36,30,-11,25,-36
335,320000,04e66e578f653ab9,7,0,286,477,566,501,644,669,334,279,388,278,361,289,325,309,-72,83,-155
58,360000,04e66e578f653ab9,7,0,61,72,97,83,104,86,64,32,40,53,58,44,51,52,-14,5,-19
151,130000,04e66e578f653ab9,7,0,113,185,186,192,206,272,140,97,162,151,190,159,174,167,-31,39,-70
150,410000,04e66e578f653ab9,7,0,109,191,156,169,219,319,144,90,156,142,133,159,146,145,26,-9,35
200,330000,04e66e578f653ab9,7,0,216,262,293,289,400,452,190,120,235,179,236,184,210,200,-52,57,-109
128,420000,04e66e578f653ab9,7,0,45,58,71,47,81,82,146,33,61,41,44,47,46,44,3,3,0
97,430000,04e66e578f653ab9,7,0,121,118,158,115,135,228,105,59,115,89,71,92,82,84,21,-18,39
207,350000,04e66e578f653ab9,7,0,72,82,93,107,132,139,77,43,64,62,76,55,66,64,-21,14,-35
42,210000,04e66e578f653ab9,7,0,42,64,69,52,62,81,42,40,28,19,48,46,47,38,-2,29,-31
74,500000,04e66e578f653ab9,7,0,61,42,66,46,77,87,44,31,56,52,34,81,58,56,47,-18,65
145,610000,04e66e578f653ab9,7,0,109,169,208,170,201,238,124,83,169,151,120,99,110,123,-21,-31,10
50,230000,04e66e578f653ab9,7,0,38,60,45,45,56,48,22,17,60,50,40,34,37,41,-6,-10,4
172,310000,dff803b4024d261d,7,0,110,96,130,129,206,317,238,124,175,178,198,247,222,208,49,20,29
82,530000,dff803b4024d261d,7,0,53,48,150,68,61,94,64,55,50,58,59,74,66,64,15,1,14
124,150000,dff803b4024d261d,7,0,115,80,59,69,77,114,119,58,88,84,113,93,103,97,-20,29,-49
524,110000,dff803b4024d261d,7,0,522,549,341,411,466,954,488,303,463,422,404,405,404,410,1,-18,19
354,510000,dff803b4024d261d,7,0,287,213,226,219,270,560,493,212,308,310,321,356,338,329,35,11,24
221,340000,dff803b4024d261d,7,0,137,105,226,131,164,192,238,108,126,152,161,181,171,165,20,9,11
752,370000,dff803b4024d261d,7,0,483,376,451,391,462,714,609,352,736,802,743,732,738,759,-11,-59,48
176,140000,dff803b4024d261d,7,0,88,87,81,104,152,230,168,75,152,133,162,155,158,150,-7,29,-36
1365,440000,dff803b4024d261d,7,0,796,688,783,887,1988,1893,1283,554,1157,1342,1371,1506,1438,1406,135,29,106
214,450000,dff803b4024d261d,7,0,238,333,211,167,204,333,316,132,218,179,232,209,220,207,-23,53,-76
727,320000,dff803b4024d261d,7,0,614,701,409,489,602,865,785,520,701,575,790,696,743,687,-94,215,-309
190,360000,dff803b4024d261d,7,0,120,104,272,168,194,280,264,100,195,178,199,185,192,187,-14,21,-35
561,130000,dff803b4024d261d,7,0,278,358,279,275,250,454,387,248,489,372,444,470,457,429,26,72,-46
313,410000,dff803b4024d261d,7,0,287,201,184,168,191,300,319,141,195,250,224,252,238,242,28,-26,54
663,330000,dff803b4024d261d,7,0,359,406,355,572,795,787,577,391,567,562,623,668,646,618,45,61,-16
504,420000,dff803b4024d261d,7,0,178,222,287,394,374,566,545,193,390,310,389,475,432,391,86,79,7
399,430000,dff803b4024d261d,7,0,270,181,332,203,423,412,412,410,531,262,352,341,346,318,-11,90,-101
589,350000,dff803b4024d261d,7,0,324,353,331,397,363,562,555,242,485,658,692,517,604,622,-175,34,-209
261,210000,dff803b4024d261d,7,0,240,234,219,239,228,340,230,163,328,229,232,286,259,249,54,3,51
348,500000,dff803b4024d261d,7,0,292,184,281,158,348,846,378,203,261,239,256,499,378,331,243,17,226
167,610000,dff803b4024d261d,7,0,202,64,63,62,99,126,138,68,103,103,121,139,130,121,18,18,0
117,230000,dff803b4024d261d,7,0,71,56,91,46,89,107,57,72,88,195,88,95,92,126,7,-107,114
252,310000,61e73e32ad101892,7,0,263,265,263,222,276,374,264,140,173,111,133,219,176,154,86,22,64
370,530000,61e73e32ad101892,7,0,444,328,322,420,444,423,403,246,278,240,349,251,300,280,-98,109,-207
439,150000,61e73e32ad101892,7,0,527,467,541,608,505,619,534,251,398,363,397,446,422,402,49,34,15
738,110000,61e73e32ad101892,7,0,823,803,1019,845,1016,1441,741,459,672,521,645,648,646,605,3,124,-121
747,510000,61e73e32ad101892,7,0,723,668,1080,712,743,1078,940,507,616,610,516,696,606,607,180,-94,274
202,340000,61e73e32ad101892,7,0,143,177,210,217,212,273,247,107,152,149,170,178,174,166,8,21,-13
667,370000,61e73e32ad101892,7,0,592,643,866,764,681,1011,688,350,548,657,631,628,630,639,-3,-26,23
246,140000,61e73e32ad101892,7,0,228,276,283,280,288,348,274,115,219,218,272,224,248,238,-48,54,-102
1873,440000,61e73e32ad101892,7,0,1516,1456,1686,2097,2144,2562,1849,777,1549,1067,1547,1898,1722,1504,351,480,-129
272,450000,61e73e32ad101892,7,0,289,221,333,376,342,443,364,194,278,172,226,248,237,215,22,54,-32
592,320000,61e73e32ad101892,7,0,521,656,670,713,682,857,658,425,546,407,545,534,540,495,-11,138,-149
289,360000,61e73e32ad101892,7,0,226,207,304,324,277,382,334,121,180,176,242,230,236,216,-12,66,-78
962,130000,61e73e32ad101892,7,0,636,756,829,875,790,1042,804,407,572,721,849,721,785,764,-128,128,-256
638,410000,61e73e32ad101892,7,0,457,520,525,514,567,656,654,303,427,422,450,484,467,452,34,28,6
617,330000,61e73e32ad101892,7,0,609,628,658,707,687,970,632,338,464,407,503,544,524,485,41,96,-55
1218,420000,61e73e32ad101892,7,0,812,879,1194,1234,1296,1458,1429,526,890,740,929,1121,1025,930,192,189,3
530,430000,61e73e32ad101892,7,0,433,504,586,532,579,879,712,262,444,376,475,496,486,449,21,99,-78
340,350000,61e73e32ad101892,7,0,309,324,331,423,388,523,387,223,336,237,399,355,377,330,-44,162,-206
678,210000,61e73e32ad101892,7,0,778,859,919,871,786,1105,571,424,658,595,611,583,597,596,-28,16,-44
368,500000,61e73e32ad101892,7,0,400,378,452,406,568,732,616,327,364,351,290,544,417,395,254,-61,315
505,610000,61e73e32ad101892,7,0,428,429,480,618,464,618,561,288,381,522,505,419,462,482,-86,-17,-69
413,230000,61e73e32ad101892,7,0,393,463,364,346,348,497,267,165,333,307,314,331,322,317,17,7,10
60,310000,a432c483b5beb856,7,0,119,125,135,111,242,237,68,37,61,48,42,46,44,45,4,-6,10
101,530000,a432c483b5beb856,7,0,141,143,170,165,182,271,140,100,100,97,72,92,82,87,20,-25,45
89,150000,a432c483b5beb856,7,0,118,135,135,144,149,195,78,54,74,78,87,84,86,83,-3,9,-12
41,110000,a432c483b5beb856,7,0,136,151,163,97,128,205,34,44,59,36,32,45,38,38,13,-4,17
155,510000,a432c483b5beb856,7,0,273,290,355,284,276,560,275,186,178,154,123,197,160,158,74,-31,105
123,340000,a432c483b5beb856,7,0,187,210,258,234,289,496,209,109,109,97,103,125,114,108,22,6,16
187,370000,a432c483b5beb856,7,0,297,370,455,430,397,599,241,156,188,181,193,211,202,195,18,12,6
82,140000,a432c483b5beb856,7,0,138,154,165,187,192,226,67,52,65,70,76,81,78,76,5,6,-1
492,440000,a432c483b5beb856,7,0,908,969,966,1096,1273,1753,510,290,467,429,504,568,536,500,64,75,-11
111,450000,a432c483b5beb856,7,0,121,133,163,183,209,314,161,76,113,66,89,103,96,86,14,23,-9
346,320000,a432c483b5beb856,7,0,494,659,663,720,808,1176,484,399,360,358,395,364,380,372,-31,37,-68
130,360000,a432c483b5beb856,7,0,156,182,243,282,281,556,258,99,139,120,123,138,130,127,15,3,12
191,130000,a432c483b5beb856,7,0,240,275,311,284,290,435,164,126,133,165,184,178,181,176,-6,19,-25
234,410000,a432c483b5beb856,7,0,273,313,316,283,364,562,252,130,136,161,188,248,218,199,60,27,33
433,330000,a432c483b5beb856,7,0,536,581,660,738,799,1102,332,255,331,293,293,451,372,346,158,0,158
117,420000,a432c483b5beb856,7,0,204,230,271,257,362,526,267,110,92,100,79,129,104,103,50,-21,71
162,430000,a432c483b5beb856,7,0,208,271,292,260,313,627,286,115,133,96,119,133,126,116,14,23,-9
138,350000,a432c483b5beb856,7,0,246,274,282,315,340,500,185,128,160,130,141,134,138,135,-7,11,-18
138,210000,a432c483b5beb856,7,0,311,310,311,260,209,299,101,86,133,111,127,127,127,122,0,16,-16
84,500000,a432c483b5beb856,7,0,160,199,165,151,159,317,179,87,70,59,80,101,90,80,21,21,0
76,610000,a432c483b5beb856,7,0,116,126,114,163,141,242,89,58,62,55,62,48,55,55,-14,7,-21
87,230000,a432c483b5beb856,7,0,135,155,139,103,121,126,60,44,65,66,61,78,70,68,17,-5,22
332,310000,0797526c057dcf5b,7,0,321,346,427,336,1289,571,175,135,300,320,311,280,296,304,-31,-9,-22
237,530000,0797526c057dcf5b,7,0,247,218,226,257,285,393,160,154,201,154,174,208,191,179,34,20,14
352,150000,0797526c057dcf5b,7,0,198,218,291,326,339,631,236,164,278,287,352,354,353,331,2,65,-63
411,110000,0797526c057dcf5b,7,0,697,743,797,664,656,980,232,253,315,319,299,344,322,321,45,-20,65
874,510000,0797526c057dcf5b,7,0,786,904,1230,923,1016,1536,609,478,708,677,703,870,786,750,167,26,141
531,340000,0797526c057dcf5b,7,0,319,476,565,666,550,750,358,257,522,447,450,474,462,457,24,3,21
2150,370000,0797526c057dcf5b,7,0,1835,2200,2915,3148,3502,5481,1788,1203,1635,2012,1985,2046,2016,2014,61,-27,88
822,140000,0797526c057dcf5b,7,0,521,585,792,899,919,1474,502,371,567,626,775,870,822,757,95,149,-54
8119,440000,0797526c057dcf5b,7,0,8085,9999,11167,12710,12394,15317,5306,3718,8079,6812,7957,8612,8284,7794,655,1145,-490
1736,450000,0797526c057dcf5b,7,0,1010,1186,1639,1709,1789,2693,1195,777,1366,1087,1463,1613,1538,1388,150,376,-226
2472,320000,0797526c057dcf5b,7,0,1273,1726,2274,2226,2622,3296,1247,1529,2148,2087,2259,2343,2301,2230,84,172,-88
1189,360000,0797526c057dcf5b,7,0,606,715,1083,1277,1265,1764,857,484,797,835,979,1050,1014,955,71,144,-73
2279,130000,0797526c057dcf5b,7,0,1091,1516,1988,2221,2449,3796,1214,995,1259,1697,1832,1815,1824,1781,-17,135,-152
1910,410000,0797526c057dcf5b,7,0,1151,1553,1783,1739,1951,3130,1278,848,1290,1492,1391,1525,1458,1469,134,-101,235
1767,330000,0797526c057dcf5b,7,0,1140,1443,1709,2001,2019,2088,700,801,1246,1369,1509,1644,1576,1507,135,140,-5
1101,420000,0797526c057dcf5b,7,0,689,870,1071,1120,1425,1562,736,376,772,827,842,1061,952,910,219,15,204
1786,430000,0797526c057dcf5b,7,0,1384,1668,1721,1444,1769,3168,1244,677,1105,1093,1503,1476,1490,1357,-27,410,-437
1316,350000,0797526c057dcf5b,7,0,991,1227,1477,1846,1591,1981,769,598,1058,945,1316,1163,1240,1141,-153,371,-524
1931,210000,0797526c057dcf5b,7,0,2715,3298,3035,2443,2622,3705,1059,1132,1642,1541,1606,1822,1714,1656,216,65,151
364,500000,0797526c057dcf5b,7,0,510,660,624,494,548,828,333,235,331,330,400,708,554,479,308,70,238
382,610000,0797526c057dcf5b,7,0,480,451,462,457,402,722,289,175,287,284,326,299,312,303,-27,42,-69
701,230000,0797526c057dcf5b,7,0,421,630,651,605,913,1064,350,347,604,509,589,621,605,573,32,80,-48
62,310000,936168bd4850913d,7,0,275,253,330,234,241,272,250,161,224,213,175,131,153,173,-44,-38,-6
81,530000,936168bd4850913d,7,0,317,281,288,285,282,383,494,162,297,298,329,209,269,279,-120,31,-151
84,150000,936168bd4850913d,7,0,346,325,397,353,331,374,412,213,364,399,353,232,292,328,-121,-46,-75
126,110000,936168bd4850913d,7,0,541,459,651,432,527,798,336,255,324,347,230,135,182,237,-95,-117,22
64,510000,936168bd4850913d,7,0,374,356,560,353,364,502,560,198,280,354,296,108,202,253,-188,-58,-130
125,340000,936168bd4850913d,7,0,347,370,464,369,339,449,378,228,339,365,359,86,222,270,-273,-6,-267
273,370000,936168bd4850913d,7,0,1063,896,1347,1014,1020,1083,1132,648,948,1214,1085,369,727,889,-716,-129,-587
148,140000,936168bd4850913d,7,0,311,334,462,394,347,454,373,276,370,403,345,137,241,295,-208,-58,-150
594,440000,936168bd4850913d,7,0,2478,2391,3040,2810,2842,3119,2859,1337,2735,2621,2524,1566,2045,2237,-958,-97,-861
103,450000,936168bd4850913d,7,0,273,237,346,287,279,316,376,154,306,255,297,140,218,231,-157,42,-199
226,320000,936168bd4850913d,7,0,914,919,1153,908,905,1057,1012,579,905,787,820,405,612,671,-415,33,-448
95,360000,936168bd4850913d,7,0,370,350,407,325,334,414,397,195,355,439,342,151,246,311,-191,-97,-94
253,130000,936168bd4850913d,7,0,623,691,837,696,646,778,797,602,842,1066,971,374,672,804,-597,-95,-502
428,410000,936168bd4850913d,7,0,976,801,1165,786,979,1154,954,596,986,1159,919,330,624,803,-589,-240,-349
191,330000,936168bd4850913d,7,0,746,631,767,611,709,819,752,388,650,682,669,277,473,543,-392,-13,-379
316,420000,936168bd4850913d,7,0,1289,1127,1463,1111,1292,1497,1405,549,1164,1131,1057,674,866,954,-383,-74,-309
194,430000,936168bd4850913d,7,0,656,726,776,563,649,953,623,341,556,689,570,218,394,492,-352,-119,-233
137,350000,936168bd4850913d,7,0,655,558,641,586,610,611,627,347,556,479,612,226,419,439,-386,133,-519
271,210000,936168bd4850913d,7,0,727,667,816,696,727,851,758,485,709,730,631,387,509,583,-244,-99,-145
39,500000,936168bd4850913d,7,0,222,181,222,152,145,208,248,87,111,125,128,35,82,96,-93,3,-96
125,610000,936168bd4850913d,7,0,362,360,429,415,400,482,463,229,331,386,360,198,279,315,-162,-26,-136
130,230000,936168bd4850913d,7,0,503,567,621,450,630,549,617,346,607,485,461,268,364,405,-193,-24,-169
235,310000,cc21c7e91a3b5a0c,7,0,256,281,287,238,345,456,114,153,205,172,211,259,235,214,48,39,9
548,530000,cc21c7e91a3b5a0c,7,0,381,345,327,285,338,442,406,203,364,347,383,359,371,363,-24,36,-60
426,150000,cc21c7e91a3b5a0c,7,0,235,267,246,282,331,382,195,193,311,298,379,324,352,334,-55,81,-136
143,110000,cc21c7e91a3b5a0c,7,0,253,208,303,262,356,580,121,115,186,128,156,127,142,137,-29,28,-57
512,510000,cc21c7e91a3b5a0c,7,0,453,451,636,487,569,804,459,234,390,378,467,472,470,439,5,89,-84
589,340000,cc21c7e91a3b5a0c,7,0,377,400,439,428,489,503,403,244,376,434,485,530,508,483,45,51,-6
978,370000,cc21c7e91a3b5a0c,7,0,778,692,815,855,912,1164,554,505,703,953,906,900,903,920,-6,-47,41
437,140000,cc21c7e91a3b5a0c,7,0,226,277,310,284,316,428,223,193,301,299,310,314,312,308,4,11,-7
3073,440000,cc21c7e91a3b5a0c,7,0,2288,2219,2478,2450,3345,3730,1930,1262,2615,2284,2880,3003,2942,2722,123,596,-473
440,450000,cc21c7e91a3b5a0c,7,0,277,270,290,313,377,417,266,187,309,304,370,332,351,335,-38,66,-104
1359,320000,cc21c7e91a3b5a0c,7,0,1035,1139,1193,1114,1454,1527,877,754,1069,1130,1243,1239,1241,1204,-4,113,-117
505,360000,cc21c7e91a3b5a0c,7,0,354,314,340,317,350,507,305,161,323,377,500,498,499,458,-2,123,-125
1076,130000,cc21c7e91a3b5a0c,7,0,517,521,590,551,574,797,453,434,572,723,877,842,860,814,-35,154,-189
1251,410000,cc21c7e91a3b5a0c,7,0,657,647,687,548,872,1036,630,391,702,797,764,826,795,796,62,-33,95
1336,330000,cc21c7e91a3b5a0c,7,0,928,863,800,942,1151,1258,739,529,861,969,1092,1188,1140,1083,96,123,-27
1247,420000,cc21c7e91a3b5a0c,7,0,954,876,1065,918,1189,1511,963,454,719,775,822,1002,912,866,180,47,133
597,430000,cc21c7e91a3b5a0c,7,0,436,456,456,452,506,737,420,189,443,430,470,484,477,461,14,40,-26
791,350000,cc21c7e91a3b5a0c,7,0,574,525,556,643,734,779,473,353,640,561,659,677,668,632,18,98,-80
627,210000,cc21c7e91a3b5a0c,7,0,423,434,437,390,480,602,285,241,431,475,512,466,489,484,-46,37,-83
211,500000,cc21c7e91a3b5a0c,7,0,232,218,203,186,200,305,185,95,179,155,153,233,193,180,80,-2,82
352,610000,cc21c7e91a3b5a0c,7,0,303,301,293,309,345,496,293,157,234,292,346,246,296,295,-100,54,-154
444,230000,cc21c7e91a3b5a0c,7,0,360,329,347,306,404,422,214,206,322,309,385,388,386,361,3,76,-73
126,310000,7aab7fca2470987e,7,0,228,228,248,166,277,348,224,140,212,313,130,176,153,206,46,-183,229
9,530000,7aab7fca2470987e,7,0,29,23,22,12,22,33,19,19,18,22,20,12,16,18,-8,-2,-6
26,150000,7aab7fca2470987e,7,0,34,26,20,16,19,22,21,19,29,36,17,19,18,24,2,-19,21
250,110000,7aab7fca2470987e,7,0,397,450,433,353,372,511,424,244,378,320,244,260,252,275,16,-76,92
13,510000,7aab7fca2470987e,7,0,45,33,53,34,42,64,69,42,47,33,29,34,32,32,5,-4,9
31,340000,7aab7fca2470987e,7,0,58,60,65,52,74,75,83,59,59,57,45,62,54,55,17,-12,29
256,370000,7aab7fca2470987e,7,0,323,300,349,309,286,341,430,189,295,303,192,237,214,244,45,-111,156
85,140000,7aab7fca2470987e,7,0,83,86,76,58,62,78,105,64,83,78,62,75,68,72,13,-16,29
757,440000,7aab7fca2470987e,7,0,845,827,959,887,972,1235,1009,443,848,749,579,865,722,731,286,-170,456
16,450000,7aab7fca2470987e,7,0,15,35,23,23,13,26,34,17,20,12,20,22,21,18,2,8,-6
301,320000,7aab7fca2470987e,7,0,390,384,352,323,380,481,397,258,351,301,241,305,273,282,64,-60,124
32,360000,7aab7fca2470987e,7,0,34,41,44,29,35,37,61,16,26,40,25,30,28,32,5,-15,20
233,130000,7aab7fca2470987e,7,0,231,259,229,234,231,316,308,172,236,271,218,215,216,235,-3,-53,50
155,410000,7aab7fca2470987e,7,0,204,209,192,150,188,209,242,134,155,146,105,140,122,130,35,-41,76
354,330000,7aab7fca2470987e,7,0,302,300,252,293,323,375,353,222,270,371,311,449,380,377,138,-60,198
44,420000,7aab7fca2470987e,7,0,41,58,58,26,64,62,54,47,52,51,39,64,52,51,25,-12,37
22,430000,7aab7fca2470987e,7,0,54,26,47,25,31,44,54,26,27,28,26,30,28,28,4,-2,6
57,350000,7aab7fca2470987e,7,0,56,64,42,57,83,105,92,41,56,43,37,75,56,52,38,-6,44
126,210000,7aab7fca2470987e,7,0,170,176,181,127,153,187,158,103,124,129,115,148,132,131,33,-14,47
18,500000,7aab7fca2470987e,7,0,25,22,19,17,12,27,22,12,27,12,19,15,17,15,-4,7,-11
27,610000,7aab7fca2470987e,7,0,32,34,19,25,29,46,61,16,38,37,27,23,25,29,-4,-10,6
42,230000,7aab7fca2470987e,7,0,90,78,77,62,61,65,66,41,61,62,37,56,46,52,19,-25,44
189,310000,fde95ea242abd896,7,0,222,233,237,260,331,369,161,142,190,140,165,214,190,173,49,25,24
382,530000,fde95ea242abd896,7,0,397,351,388,519,521,651,386,202,309,233,292,232,262,252,-60,59,-119
141,150000,fde95ea242abd896,7,0,115,149,181,185,190,234,146,90,139,127,131,111,121,123,-20,4,-24
100,110000,fde95ea242abd896,7,0,223,271,313,223,301,382,210,141,181,149,153,130,142,144,-23,4,-27
430,510000,fde95ea242abd896,7,0,408,384,645,492,617,839,509,240,360,342,344,334,339,340,-10,2,-12
348,340000,fde95ea242abd896,7,0,371,429,508,453,504,690,387,163,254,266,293,273,283,277,-20,27,-47
649,370000,fde95ea242abd896,7,0,603,642,825,774,709,964,444,303,464,570,555,507,531,544,-48,-15,-33
257,140000,fde95ea242abd896,7,0,194,300,278,277,302,443,175,132,238,204,221,191,206,205,-30,17,-47
2940,440000,fde95ea242abd896,7,0,2769,3466,3967,4449,4901,5547,3229,1517,2906,3040,2996,3064,3030,3033,68,-44,112
271,450000,fde95ea242abd896,7,0,295,375,362,434,458,665,381,181,321,247,278,230,254,252,-48,31,-79
855,320000,fde95ea242abd896,7,0,767,910,875,888,974,1139,690,508,722,614,698,656,677,656,-42,84,-126
286,360000,fde95ea242abd896,7,0,326,283,440,408,499,625,381,184,276,300,321,252,286,291,-69,21,-90
601,130000,fde95ea242abd896,7,0,434,560,591,602,602,830,407,320,433,514,507,400,454,474,-107,-7,-100
626,410000,fde95ea242abd896,7,0,414,574,666,620,614,920,507,247,499,530,473,405,439,469,-68,-57,-11
969,330000,fde95ea242abd896,7,0,917,968,1148,998,1169,1424,732,558,806,842,817,859,838,839,42,-25,67
672,420000,fde95ea242abd896,7,0,629,764,987,818,1066,1347,698,270,511,498,504,540,522,514,36,6,30
577,430000,fde95ea242abd896,7,0,526,503,752,630,700,988,570,203,418,421,498,401,450,440,-97,77,-174
615,350000,fde95ea242abd896,7,0,603,671,676,754,796,1043,605,368,580,595,656,635,646,629,-21,61,-82
369,210000,fde95ea242abd896,7,0,473,472,553,433,460,600,253,193,341,357,363,293,328,338,-70,6,-76
132,500000,fde95ea242abd896,7,0,168,172,243,227,222,229,139,105,116,140,127,159,143,142,32,-13,45
199,610000,fde95ea242abd896,7,0,148,164,191,253,229,293,140,96,140,126,155,135,145,139,-20,29,-49
233,230000,fde95ea242abd896,7,0,234,372,256,198,199,322,111,123,264,218,232,182,207,211,-50,14,-64
311,310000,97f15de12cfabbd5,7,0,279,368,455,354,457,516,264,193,369,368,312,223,268,301,-89,-56,-33
120,530000,97f15de12cfabbd5,7,0,134,137,168,236,233,253,206,111,144,116,120,119,120,118,-1,4,-5
176,150000,97f15de12cfabbd5,7,0,170,148,180,212,200,238,219,114,172,145,184,185,184,171,1,39,-38
359,110000,97f15de12cfabbd5,7,0,614,704,733,603,754,1094,601,390,482,397,375,385,380,386,10,-22,32
231,510000,97f15de12cfabbd5,7,0,286,280,498,363,489,543,391,237,325,296,251,270,260,272,19,-45,64
190,340000,97f15de12cfabbd5,7,0,319,361,472,444,568,578,495,153,185,233,254,279,266,255,25,21,4
709,370000,97f15de12cfabbd5,7,0,653,771,1001,1018,1094,1221,1031,476,846,727,791,753,772,757,-38,64,-102
379,140000,97f15de12cfabbd5,7,0,310,398,381,370,395,605,316,221,369,335,297,249,273,294,-48,-38,-10
2148,440000,97f15de12cfabbd5,7,0,1926,2292,2762,3019,3563,3747,2666,1125,2377,2460,2143,2250,2196,2284,107,-317,424
103,450000,97f15de12cfabbd5,7,0,105,132,134,146,194,174,193,92,119,101,114,104,109,106,-10,13,-23
803,320000,97f15de12cfabbd5,7,0,884,1139,1155,1292,1491,1524,1070,552,1008,901,895,803,849,866,-92,-6,-86
187,360000,97f15de12cfabbd5,7,0,163,206,280,258,340,409,346,81,166,179,201,165,183,182,-36,22,-58
806,130000,97f15de12cfabbd5,7,0,573,819,812,975,971,1119,789,422,734,762,790,652,721,735,-138,28,-166
469,410000,97f15de12cfabbd5,7,0,472,519,592,609,805,866,692,326,488,531,450,448,449,476,-2,-81,79
1507,330000,97f15de12cfabbd5,7,0,1116,1100,1259,1371,1516,1515,1138,549,969,1010,1108,1385,1246,1168,277,98,179
412,420000,97f15de12cfabbd5,7,0,346,475,707,729,779,906,749,253,446,434,381,436,408,417,55,-53,108
398,430000,97f15de12cfabbd5,7,0,381,419,626,645,767,839,710,238,437,402,430,431,430,421,1,28,-27
327,350000,97f15de12cfabbd5,7,0,400,389,434,571,612,638,509,288,542,508,519,527,523,518,8,11,-3
914,210000,97f15de12cfabbd5,7,0,1057,1068,1256,1020,1269,1395,898,506,962,872,971,851,911,898,-120,99,-219
133,500000,97f15de12cfabbd5,7,0,183,190,183,170,200,213,159,106,164,130,104,160,132,131,56,-26,82
173,610000,97f15de12cfabbd5,7,0,278,246,251,273,309,371,227,159,225,195,179,129,154,168,-50,-16,-34
533,230000,97f15de12cfabbd5,7,0,381,659,536,422,639,783,366,217,537,358,448,306,377,371,-142,90,-232
195,310000,f5d69960089c3614,7,0,213,231,263,186,304,291,260,125,252,169,218,208,213,198,-10,49,-59
79,530000,f5d69960089c3614,7,0,86,70,45,62,97,95,78,48,59,48,61,43,52,51,-18,13,-31
61,150000,f5d69960089c3614,7,0,34,48,53,57,54,64,35,18,51,53,69,55,62,59,-14,16,-30
426,110000,f5d69960089c3614,7,0,387,431,542,458,551,739,435,233,445,341,391,396,394,376,5,50,-45
208,510000,f5d69960089c3614,7,0,208,192,406,218,246,296,270,133,178,212,190,231,210,211,41,-22,63
72,340000,f5d69960089c3614,7,0,83,102,108,119,125,125,156,59,89,69,81,70,76,73,-11,12,-23
193,370000,f5d69960089c3614,7,0,211,236,259,209,228,356,218,112,223,197,226,179,202,201,-47,29,-76
45,140000,f5d69960089c3614,7,0,39,38,29,27,53,51,47,21,35,29,43,35,39,36,-8,14,-22
305,440000,f5d69960089c3614,7,0,201,283,319,341,442,572,437,152,310,246,338,497,418,360,159,92,67
50,450000,f5d69960089c3614,7,0,25,47,48,35,38,46,44,34,25,32,38,35,36,35,-3,6,-9
187,320000,f5d69960089c3614,7,0,179,202,235,218,248,301,251,138,200,177,214,189,202,193,-25,37,-62
70,360000,f5d69960089c3614,7,0,43,63,74,57,75,92,84,32,51,53,76,51,64,60,-25,23,-48
129,130000,f5d69960089c3614,7,0,75,106,81,95,123,131,106,79,112,113,144,111,128,123,-33,31,-64
135,410000,f5d69960089c3614,7,0,120,133,136,137,144,187,131,57,111,155,108,118,113,127,10,-47,57
110,330000,f5d69960089c3614,7,0,117,123,127,129,149,230,149,78,139,107,108,142,125,119,34,1,33
110,420000,f5d69960089c3614,7,0,100,88,128,132,148,184,148,61,111,94,101,110,106,102,9,7,2
96,430000,f5d69960089c3614,7,0,113,129,125,121,157,211,135,74,132,109,108,118,113,112,10,-1,11
75,350000,f5d69960089c3614,7,0,91,79,63,93,111,124,108,57,77,71,97,95,96,88,-2,26,-28
96,210000,f5d69960089c3614,7,0,86,129,93,93,126,129,69,51,75,76,107,67,87,83,-40,31,-71
112,500000,f5d69960089c3614,7,0,124,91,113,105,132,160,125,77,112,97,87,149,118,111,62,-10,72
112,610000,f5d69960089c3614,7,0,101,114,118,176,150,182,148,77,137,111,172,117,144,133,-55,61,-116
50,230000,f5d69960089c3614,7,0,51,83,64,44,71,77,53,34,68,53,50,51,50,51,1,-3,4
90,310000,5b1c11c3efed5312,7,0,120,182,195,186,244,388,154,85,126,92,105,104,104,100,-1,13,-14
54,530000,5b1c11c3efed5312,7,0,132,175,199,190,214,267,194,91,60,53,77,69,73,66,-8,24,-32
53,150000,5b1c11c3efed5312,7,0,86,129,117,180,167,259,127,62,61,62,68,40,54,57,-28,6,-34
21,110000,5b1c11c3efed5312,7,0,124,189,195,143,181,370,71,41,51,25,21,23,22,23,2,-4,6
113,510000,5b1c11c3efed5312,7,0,259,271,451,335,432,691,448,194,129,110,118,105,112,111,-13,8,-21
209,340000,5b1c11c3efed5312,7,0,457,615,665,719,699,1253,712,250,227,217,259,222,240,233,-37,42,-79
290,370000,5b1c11c3efed5312,7,0,525,598,799,850,792,1449,549,320,297,347,332,246,289,308,-86,-15,-71
86,140000,5b1c11c3efed5312,7,0,112,180,176,226,231,426,153,81,103,83,114,108,111,102,-6,31,-37
247,440000,5b1c11c3efed5312,7,0,570,682,810,953,1204,1628,496,168,342,246,344,349,346,313,5,98,-93
31,450000,5b1c11c3efed5312,7,0,74,93,96,119,135,240,121,56,54,26,39,23,31,29,-16,13,-29
340,320000,5b1c11c3efed5312,7,0,664,879,928,1050,1083,1908,768,543,404,402,487,371,429,420,-116,85,-201
131,360000,5b1c11c3efed5312,7,0,256,256,368,358,434,733,453,153,150,168,191,126,158,162,-65,23,-88
304,130000,5b1c11c3efed5312,7,0,433,513,576,665,667,1158,476,272,257,300,350,276,313,309,-74,50,-124
321,410000,5b1c11c3efed5312,7,0,604,728,823,894,1006,1883,910,372,312,380,366,295,330,347,-71,-14,-57
360,330000,5b1c11c3efed5312,7,0,618,806,968,1022,1202,2202,744,430,386,337,361,407,384,368,46,24,22
117,420000,5b1c11c3efed5312,7,0,224,236,278,353,409,749,443,143,138,130,145,146,146,140,1,15,-14
113,430000,5b1c11c3efed5312,7,0,221,263,352,322,439,744,378,131,137,149,138,134,136,140,-4,-11,7
100,350000,5b1c11c3efed5312,7,0,185,197,242,345,391,594,265,149,173,130,137,127,132,131,-10,7,-17
39,210000,5b1c11c3efed5312,7,0,118,166,151,176,186,256,75,62,80,75,84,47,66,69,-37,9,-46
17,500000,5b1c11c3efed5312,7,0,92,81,101,86,92,172,124,38,29,23,20,27,24,23,7,-3,10
67,610000,5b1c11c3efed5312,7,0,108,126,155,205,212,325,144,79,70,64,97,57,77,73,-40,33,-73
34,230000,5b1c11c3efed5312,7,0,66,138,116,107,126,152,43,36,52,38,43,41,42,41,-2,5,-7
7,310000,17363f08d683d52b,7,0,70,93,94,69,88,96,65,19,37,175,5,12,8,64,7,-170,177
67,530000,17363f08d683d52b,7,0,260,181,192,214,209,182,216,75,82,86,83,57,70,75,-26,-3,-23
38,150000,17363f08d683d52b,7,0,152,130,174,176,130,141,132,46,66,45,69,41,55,52,-28,24,-52
33,110000,17363f08d683d52b,7,0,267,229,259,158,186,277,124,81,65,48,29,26,28,34,-3,-19,16
97,510000,17363f08d683d52b,7,0,338,249,374,267,205,292,350,117,93,78,81,64,72,74,-17,3,-20
107,340000,17363f08d683d52b,7,0,369,409,407,332,341,384,513,121,108,92,90,118,104,100,28,-2,30
145,370000,17363f08d683d52b,7,0,578,578,669,572,480,596,555,214,153,209,203,175,189,196,-28,-6,-22
23,140000,17363f08d683d52b,7,0,80,105,82,89,70,67,66,26,12,22,19,12,16,18,-7,-3,-4
26,440000,17363f08d683d52b,7,0,153,130,99,91,101,84,62,19,63,37,30,29,30,32,-1,-7,6
8,450000,17363f08d683d52b,7,0,59,47,57,42,39,50,45,14,26,20,6,2,4,9,-4,-14,10
129,320000,17363f08d683d52b,7,0,540,652,534,502,474,569,538,214,216,188,191,134,162,171,-57,3,-60
82,360000,17363f08d683d52b,7,0,334,361,423,281,274,309,360,94,101,91,90,79,84,87,-11,-1,-10
144,130000,17363f08d683d52b,7,0,415,474,378,372,326,383,353,154,150,162,149,131,140,147,-18,-13,-5
70,410000,17363f08d683d52b,7,0,537,516,505,471,372,457,538,139,100,129,104,87,96,107,-17,-25,8
91,330000,17363f08d683d52b,7,0,527,619,525,437,429,453,388,129,152,151,108,106,107,122,-2,-43,41
109,420000,17363f08d683d52b,7,0,357,348,470,379,317,421,474,120,139,119,158,186,172,154,28,39,-11
100,430000,17363f08d683d52b,7,0,369,394,455,353,348,428,459,95,148,114,114,115,114,114,1,0,1
15,350000,17363f08d683d52b,7,0,156,140,150,148,127,159,136,38,44,37,55,51,53,48,-4,18,-22
60,210000,17363f08d683d52b,7,0,211,236,239,216,174,238,151,59,93,137,105,53,79,98,-52,-32,-20
22,500000,17363f08d683d52b,7,0,154,160,119,108,151,126,110,41,27,16,19,16,18,17,-3,3,-6
81,610000,17363f08d683d52b,7,0,243,241,219,279,210,288,180,80,67,82,94,70,82,82,-24,12,-36
28,230000,17363f08d683d52b,7,0,135,185,126,121,118,156,75,46,57,45,34,22,28,34,-12,-11,-1
195,310000,06880909932890ca,7,0,200,260,330,188,341,384,208,78,136,169,219,267,243,218,48,50,-2
106,530000,06880909932890ca,7,0,160,152,177,216,186,206,142,56,68,79,116,111,114,102,-5,37,-42
48,150000,06880909932890ca,7,0,95,118,103,121,125,115,74,44,45,52,72,39,56,54,-33,20,-53
159,110000,06880909932890ca,7,0,587,598,646,461,553,771,253,139,206,162,160,198,179,173,38,-2,40
464,510000,06880909932890ca,7,0,529,541,770,548,657,933,673,263,243,304,396,459,428,386,63,92,-29
640,340000,06880909932890ca,7,0,815,909,849,800,764,993,964,338,340,389,526,609,568,508,83,137,-54
597,370000,06880909932890ca,7,0,955,1028,1068,979,957,1332,1011,383,430,537,623,546,584,569,-77,86,-163
121,140000,06880909932890ca,7,0,166,260,200,213,203,275,128,67,102,111,136,137,136,128,1,25,-24
669,440000,06880909932890ca,7,0,970,1165,1341,1182,1660,1546,767,278,638,579,734,773,754,695,39,155,-116
129,450000,06880909932890ca,7,0,138,192,192,181,188,276,186,86,105,86,125,135,130,115,10,39,-29
1465,320000,06880909932890ca,7,0,1784,2086,2054,2015,2022,2642,2094,991,984,1074,1356,1448,1402,1293,92,282,-190
295,360000,06880909932890ca,7,0,446,466,481,368,453,691,614,157,211,274,326,317,322,306,-9,52,-61
393,130000,06880909932890ca,7,0,679,797,728,665,667,773,530,290,330,342,436,385,410,388,-51,94,-145
1138,410000,06880909932890ca,7,0,1588,1680,1676,1390,1577,2409,1865,640,650,891,1055,1267,1161,1071,212,164,48
1232,330000,06880909932890ca,7,0,1405,1649,1572,1696,1832,2222,1022,501,663,715,913,1088,1000,905,175,198,-23
394,420000,06880909932890ca,7,0,475,562,525,475,492,661,605,178,211,256,312,333,322,300,21,56,-35
388,430000,06880909932890ca,7,0,414,541,561,481,547,698,488,170,228,287,352,372,362,337,20,65,-45
263,350000,06880909932890ca,7,0,350,418,427,469,556,601,361,197,246,246,307,332,320,295,25,61,-36
149,210000,06880909932890ca,7,0,287,309,335,246,211,328,161,100,120,120,168,137,152,142,-31,48,-79
272,500000,06880909932890ca,7,0,415,439,445,330,373,430,326,140,158,145,189,295,242,210,106,44,62
185,610000,06880909932890ca,7,0,349,407,350,449,347,562,349,119,145,167,210,170,190,182,-40,43,-83
72,230000,06880909932890ca,7,0,128,149,133,82,97,100,69,37,53,48,62,47,54,52,-15,14,-29
11,310000,9c1c7ee8ebdda299,7,0,13,27,10,4,41,46,32,19,54,17,10,12,11,13,2,-7,9
54,530000,9c1c7ee8ebdda299,7,0,181,200,159,126,119,169,142,104,91,53,62,66,64,60,4,9,-5
153,150000,9c1c7ee8ebdda299,7,0,350,323,327,297,353,430,278,168,258,163,176,174,175,171,-2,13,-15
11,110000,9c1c7ee8ebdda299,7,0,170,121,96,46,78,112,52,38,30,13,7,12,10,11,5,-6,11
161,510000,9c1c7ee8ebdda299,7,0,869,836,723,408,517,641,617,336,250,134,145,143,144,141,-2,11,-13
63,340000,9c1c7ee8ebdda299,7,0,293,261,211,71,198,190,278,146,119,59,72,88,80,73,16,13,3
656,370000,9c1c7ee8ebdda299,7,0,1763,1885,1782,1445,1562,2281,1763,885,746,509,752,650,701,637,-102,243,-345
283,140000,9c1c7ee8ebdda299,7,0,854,973,842,579,768,886,691,295,401,285,317,252,284,285,-65,32,-97
130,440000,9c1c7ee8ebdda299,7,0,793,791,821,619,710,1008,472,229,471,212,177,139,158,176,-38,-35,-3
134,450000,9c1c7ee8ebdda299,7,0,169,185,191,132,192,308,251,110,119,55,137,102,120,98,-35,82,-117
119,320000,9c1c7ee8ebdda299,7,0,299,267,195,95,307,309,370,299,211,106,111,126,118,114,15,5,10
41,360000,9c1c7ee8ebdda299,7,0,215,138,145,60,177,182,224,84,107,42,42,52,47,45,10,0,10
713,130000,9c1c7ee8ebdda299,7,0,1898,2125,1949,1092,1644,1840,1468,940,941,733,782,635,708,717,-147,49,-196
280,410000,9c1c7ee8ebdda299,7,0,797,693,546,306,774,911,1101,433,362,211,283,281,282,258,-2,72,-74
240,330000,9c1c7ee8ebdda299,7,0,216,202,149,42,380,352,327,197,195,168,241,204,222,204,-37,73,-110
41,420000,9c1c7ee8ebdda299,7,0,121,123,100,46,116,125,211,58,65,32,39,46,42,39,7,7,0
55,430000,9c1c7ee8ebdda299,7,0,195,142,140,74,141,165,230,105,87,42,50,62,56,51,12,8,4
48,350000,9c1c7ee8ebdda299,7,0,254,219,159,110,281,215,204,105,130,66,70,71,70,69,1,4,-3
173,210000,9c1c7ee8ebdda299,7,0,791,715,654,384,528,619,375,317,409,425,215,168,192,269,-47,-210,163
27,500000,9c1c7ee8ebdda299,7,0,210,170,119,62,80,104,116,61,54,25,34,33,34,31,-1,9,-10
148,610000,9c1c7ee8ebdda299,7,0,504,331,168,145,214,250,261,108,136,75,123,125,124,108,2,48,-46
97,230000,9c1c7ee8ebdda299,7,0,307,328,302,291,350,342,207,144,192,137,117,137,127,130,20,-20,40
204,310000,c6833cb891626c17,7,0,187,321,371,283,435,596,174,80,151,177,200,272,236,216,72,23,49
239,530000,c6833cb891626c17,7,0,391,368,477,514,538,699,444,236,185,176,241,235,238,217,-6,65,-71
202,150000,c6833cb891626c17,7,0,278,328,337,354,323,485,221,94,125,138,233,182,208,184,-51,95,-146
287,110000,c6833cb891626c17,7,0,616,785,877,636,879,1517,309,174,289,242,251,279,265,257,28,9,19
364,510000,c6833cb891626c17,7,0,553,602,1020,712,770,1305,743,339,285,287,359,363,361,336,4,72,-68
677,340000,c6833cb891626c17,7,0,658,834,1066,894,964,1597,855,344,344,422,524,660,592,535,136,102,34
841,370000,c6833cb891626c17,7,0,793,998,1278,1160,1107,1740,687,383,327,543,829,670,750,681,-159,286,-445
186,140000,c6833cb891626c17,7,0,206,301,280,282,301,514,192,100,117,126,207,172,190,168,-35,81,-116
483,440000,c6833cb891626c17,7,0,710,890,1382,1240,1586,1899,542,186,403,360,460,604,532,475,144,100,44
123,450000,c6833cb891626c17,7,0,201,232,277,266,309,514,260,96,110,81,120,111,116,104,-9,39,-48
918,320000,c6833cb891626c17,7,0,955,1345,1406,1396,1446,2279,939,574,593,645,899,941,920,828,42,254,-212
342,360000,c6833cb891626c17,7,0,356,409,638,519,571,900,502,180,199,229,302,289,296,273,-13,73,-86
843,130000,c6833cb891626c17,7,0,725,929,1066,990,1108,1749,708,414,412,600,843,768,806,737,-75,243,-318
1208,410000,c6833cb891626c17,7,0,1208,1438,1525,1493,1622,2735,1331,509,557,792,1003,1139,1071,978,136,211,-75
1212,330000,c6833cb891626c17,7,0,1284,1635,1804,1911,2130,3255,1119,581,616,676,899,1179,1039,918,280,223,57
354,420000,c6833cb891626c17,7,0,419,485,678,560,634,1014,597,202,210,256,309,467,388,344,158,53,105
311,430000,c6833cb891626c17,7,0,374,473,712,546,606,978,498,212,209,272,280,287,284,280,7,8,-1
160,350000,c6833cb891626c17,7,0,238,291,406,499,552,782,311,141,184,131,214,223,218,189,9,83,-74
176,210000,c6833cb891626c17,7,0,229,283,315,299,258,424,127,80,97,131,161,165,163,152,4,30,-26
148,500000,c6833cb891626c17,7,0,193,277,336,267,309,532,260,104,78,93,126,161,144,127,35,33,2
263,610000,c6833cb891626c17,7,0,253,326,373,472,366,620,315,130,154,179,263,204,234,215,-59,84,-143
91,230000,c6833cb891626c17,7,0,137,237,206,170,232,274,80,52,66,71,97,87,92,85,-10,26,-36
130,310000,3e21824be728cbec,7,0,187,249,257,239,345,396,369,177,174,163,140,140,140,148,0,-23,23
202,530000,3e21824be728cbec,7,0,300,344,358,406,373,334,203,134,207,159,159,199,179,172,40,0,40
39,150000,3e21824be728cbec,7,0,65,160,123,116,59,90,51,29,42,27,40,31,36,33,-9,13,-22
40,110000,3e21824be728cbec,7,0,164,139,203,168,222,242,93,60,87,42,47,47,47,45,0,5,-5
352,510000,3e21824be728cbec,7,0,488,625,731,758,778,781,288,239,321,272,333,406,370,337,73,61,12
297,340000,3e21824be728cbec,7,0,347,570,630,644,607,661,309,266,301,237,309,289,299,278,-20,72,-92
383,370000,3e21824be728cbec,7,0,576,690,772,807,782,994,540,419,572,464,433,395,414,431,-38,-31,-7
87,140000,3e21824be728cbec,7,0,162,287,240,200,132,201,88,44,87,60,67,72,70,66,5,7,-2
380,440000,3e21824be728cbec,7,0,486,516,619,721,938,1135,331,231,477,411,394,418,406,408,24,-17,41
121,450000,3e21824be728cbec,7,0,205,301,268,247,370,403,140,92,140,131,131,161,146,141,30,0,30
656,320000,3e21824be728cbec,7,0,837,1017,1020,1227,1286,1781,805,710,885,641,740,693,716,691,-47,99,-146
175,360000,3e21824be728cbec,7,0,221,285,391,438,444,431,157,97,173,170,210,195,202,192,-15,40,-55
404,130000,3e21824be728cbec,7,0,574,734,729,766,589,806,391,375,484,404,455,438,446,432,-17,51,-68
381,410000,3e21824be728cbec,7,0,840,854,777,834,729,896,363,334,528,418,445,554,500,472,109,27,82
443,330000,3e21824be728cbec,7,0,507,510,573,616,797,1044,341,386,475,363,466,458,462,429,-8,103,-111
181,420000,3e21824be728cbec,7,0,280,357,375,452,413,461,270,123,194,119,150,177,164,149,27,31,-4
200,430000,3e21824be728cbec,7,0,255,292,394,414,458,478,157,99,182,167,188,184,186,180,-4,21,-25
214,350000,3e21824be728cbec,7,0,310,328,339,397,455,593,250,154,266,219,283,228,256,243,-55,64,-119
71,210000,3e21824be728cbec,7,0,139,151,144,114,136,149,45,36,75,66,76,84,80,75,8,10,-2
137,500000,3e21824be728cbec,7,0,311,410,422,402,422,475,136,124,148,136,160,225,192,174,65,24,41
164,610000,3e21824be728cbec,7,0,375,494,446,595,355,464,194,145,188,141,176,186,181,168,10,35,-25
39,230000,3e21824be728cbec,7,0,146,202,237,176,82,87,40,47,82,54,34,48,41,45,14,-20,34
286,310000,f8a6975573af1b33,7,0,258,427,420,355,228,579,371,131,288,266,225,283,254,258,58,-41,99
217,530000,f8a6975573af1b33,7,0,180,214,200,244,165,338,215,134,179,192,167,169,168,176,2,-25,27
54,150000,f8a6975573af1b33,7,0,43,34,40,41,43,48,41,28,59,37,53,61,57,50,8,16,-8
89,110000,f8a6975573af1b33,7,0,202,267,304,268,372,383,131,61,110,108,70,103,86,94,33,-38,71
476,510000,f8a6975573af1b33,7,0,352,370,632,431,484,820,550,286,428,433,456,497,476,462,41,23,18
499,340000,f8a6975573af1b33,7,0,305,443,521,495,362,758,508,322,432,425,545,563,554,511,18,120,-102
345,370000,f8a6975573af1b33,7,0,303,357,410,423,383,729,410,227,320,381,388,394,391,388,6,7,-1
62,140000,f8a6975573af1b33,7,0,59,51,78,61,91,136,74,57,53,62,47,59,53,56,12,-15,27
954,440000,f8a6975573af1b33,7,0,879,1153,1298,1305,1034,2232,1023,444,1072,1007,969,1190,1080,1055,221,-38,259
223,450000,f8a6975573af1b33,7,0,192,217,237,215,191,328,208,107,160,131,178,209,194,173,31,47,-16
1045,320000,f8a6975573af1b33,7,0,845,1153,1190,1239,807,1846,1142,747,1023,870,969,1040,1004,960,71,99,-28
243,360000,f8a6975573af1b33,7,0,177,232,306,226,131,436,290,111,237,235,226,237,232,233,11,-9,20
355,130000,f8a6975573af1b33,7,0,243,316,360,308,272,475,287,194,265,298,335,339,337,324,4,37,-33
508,410000,f8a6975573af1b33,7,0,405,509,554,543,420,747,459,249,457,513,513,571,542,532,58,0,58
836,330000,f8a6975573af1b33,7,0,614,743,824,856,695,1454,752,503,780,679,725,759,742,721,34,46,-12
347,420000,f8a6975573af1b33,7,0,205,250,304,278,190,481,312,158,246,258,251,428,340,312,177,-7,184
308,430000,f8a6975573af1b33,7,0,226,283,329,289,235,425,324,139,263,238,293,308,300,280,15,55,-40
406,350000,f8a6975573af1b33,7,0,354,411,469,472,415,699,508,260,395,323,426,506,466,418,80,103,-23
110,210000,f8a6975573af1b33,7,0,94,128,154,125,64,125,66,52,82,116,125,102,114,114,-23,9,-32
280,500000,f8a6975573af1b33,7,0,279,300,389,322,256,548,310,185,288,287,285,378,332,317,93,-2,95
167,610000,f8a6975573af1b33,7,0,162,175,188,226,181,259,170,96,124,121,134,165,150,140,31,13,18
53,230000,f8a6975573af1b33,7,0,95,86,84,67,65,115,61,52,76,85,53,52,52,63,-1,-32,31
230,310000,54fc07138d70374c,7,0,315,327,336,292,421,473,415,199,338,303,272,297,284,291,25,-31,56
320,530000,54fc07138d70374c,7,0,381,320,316,363,485,535,500,259,353,295,304,293,298,297,-11,9,-20
194,150000,54fc07138d70374c,7,0,210,230,224,233,229,234,273,129,208,180,191,167,179,179,-24,11,-35
341,110000,54fc07138d70374c,7,0,454,424,442,429,500,681,534,295,402,398,365,374,370,379,9,-33,42
476,510000,54fc07138d70374c,7,0,557,495,659,704,743,849,933,442,540,493,508,553,530,518,45,15,30
197,340000,54fc07138d70374c,7,0,219,249,314,271,334,368,404,198,210,162,176,206,191,181,30,14,16
483,370000,54fc07138d70374c,7,0,579,617,771,679,776,936,911,376,595,546,558,596,577,567,38,12,26
107,140000,54fc07138d70374c,7,0,113,131,135,142,208,244,213,113,141,101,103,104,104,103,1,2,-1
825,440000,54fc07138d70374c,7,0,1120,1145,1408,1392,1836,2078,1526,521,1068,875,905,1067,986,949,162,30,132
140,450000,54fc07138d70374c,7,0,203,212,207,208,246,317,323,145,236,156,189,166,178,170,-23,33,-56
436,320000,54fc07138d70374c,7,0,553,616,611,660,847,820,821,461,589,458,423,545,484,475,122,-35,157
150,360000,54fc07138d70374c,7,0,206,215,215,187,249,262,297,113,164,151,133,139,136,141,6,-18,24
495,130000,54fc07138d70374c,7,0,475,528,576,625,746,750,758,431,483,470,474,415,444,453,-59,4,-63
423,410000,54fc07138d70374c,7,0,548,623,596,604,752,820,826,447,615,567,493,543,518,534,50,-74,124
307,330000,54fc07138d70374c,7,0,357,379,387,524,623,684,550,252,401,254,311,325,318,297,14,57,-43
238,420000,54fc07138d70374c,7,0,268,311,346,310,385,425,481,197,299,246,238,274,256,253,36,-8,44
325,430000,54fc07138d70374c,7,0,350,384,424,364,460,493,505,239,383,321,315,341,328,326,26,-6,32
141,350000,54fc07138d70374c,7,0,259,222,223,268,329,338,400,163,217,128,161,123,142,137,-38,33,-71
236,210000,54fc07138d70374c,7,0,281,324,364,303,369,450,249,117,274,320,298,258,278,292,-40,-22,-18
296,500000,54fc07138d70374c,7,0,402,372,406,400,540,575,576,284,403,314,306,439,372,353,133,-8,141
203,610000,54fc07138d70374c,7,0,299,275,293,365,346,404,376,178,272,285,266,201,234,251,-65,-19,-46
292,230000,54fc07138d70374c,7,0,359,356,331,302,341,410,324,206,341,242,239,273,256,251,34,-3,37
247,310000,212083a9246d2fd3,7,0,581,617,628,446,636,846,241,179,180,191,192,253,222,212,61,1,60
183,530000,212083a9246d2fd3,7,0,197,189,278,304,365,493,290,145,117,124,158,128,143,137,-30,34,-64
97,150000,212083a9246d2fd3,7,0,168,136,222,206,310,562,284,123,119,71,119,101,110,97,-18,48,-66
51,110000,212083a9246d2fd3,7,0,521,473,498,257,444,824,105,71,55,60,50,59,54,56,9,-10,19
516,510000,212083a9246d2fd3,7,0,717,777,1042,762,1080,1730,983,504,400,394,380,436,408,403,56,-14,70
594,340000,212083a9246d2fd3,7,0,945,973,1078,1023,1260,2243,1186,528,593,566,477,521,499,521,44,-89,133
724,370000,212083a9246d2fd3,7,0,1176,1294,1622,1536,1637,2998,1261,553,503,551,645,651,648,616,6,94,-88
195,140000,212083a9246d2fd3,7,0,257,272,308,299,372,645,313,178,140,164,178,173,176,172,-5,14,-19
794,440000,212083a9246d2fd3,7,0,1121,1670,1369,1274,1967,3191,905,337,855,959,831,614,722,801,-217,-128,-89
204,450000,212083a9246d2fd3,7,0,192,188,232,252,337,697,471,179,227,188,213,224,218,208,11,25,-14
889,320000,212083a9246d2fd3,7,0,1702,2067,2163,1918,2283,3836,1631,972,777,763,993,802,898,853,-191,230,-421
273,360000,212083a9246d2fd3,7,0,411,440,542,547,676,1270,658,229,229,221,283,227,255,244,-56,62,-118
544,130000,212083a9246d2fd3,7,0,854,909,987,969,1064,2232,950,551,442,578,697,555,626,610,-142,119,-261
1189,410000,212083a9246d2fd3,7,0,1257,1337,1548,1431,1720,3243,1894,828,807,1011,1085,1013,1049,1036,-72,74,-146
467,330000,212083a9246d2fd3,7,0,886,1003,1067,1140,1205,1850,574,328,328,361,426,423,424,403,-3,65,-68
223,420000,212083a9246d2fd3,7,0,356,435,576,710,866,1354,755,244,256,243,222,247,234,237,25,-21,46
466,430000,212083a9246d2fd3,7,0,590,709,844,687,982,1756,938,322,403,371,448,412,430,410,-36,77,-113
233,350000,212083a9246d2fd3,7,0,422,486,645,645,746,1041,462,182,250,215,304,238,271,252,-66,89,-155
123,210000,212083a9246d2fd3,7,0,300,418,415,275,422,561,181,92,144,178,144,111,128,144,-33,-34,1
190,500000,212083a9246d2fd3,7,0,758,749,722,571,643,1136,557,231,195,203,189,260,224,217,71,-14,85
381,610000,212083a9246d2fd3,7,0,811,726,652,682,805,1567,639,298,275,310,369,282,326,320,-87,59,-146
101,230000,212083a9246d2fd3,7,0,259,159,164,109,207,305,102,62,72,62,93,71,82,75,-22,31,-53
21,310000,4f79773e600518a6,7,0,88,90,112,64,139,159,95,31,32,33,18,19,18,23,1,-15,16
56,530000,4f79773e600518a6,7,0,102,103,88,129,116,195,181,91,58,50,67,48,58,55,-19,17,-36
83,150000,4f79773e600518a6,7,0,192,148,178,215,227,336,327,113,110,91,126,86,106,101,-40,35,-75
19,110000,4f79773e600518a6,7,0,110,107,124,113,153,246,99,35,29,28,28,17,22,24,-11,0,-11
76,510000,4f79773e600518a6,7,0,169,165,260,194,267,387,398,155,108,95,80,69,74,81,-11,-15,4
101,340000,4f79773e600518a6,7,0,192,228,277,262,301,471,484,121,103,101,118,103,110,107,-15,17,-32
273,370000,4f79773e600518a6,7,0,433,565,670,629,591,961,723,263,300,312,311,242,276,288,-69,-1,-68
45,140000,4f79773e600518a6,7,0,88,106,92,114,133,167,149,66,59,57,51,58,54,55,7,-6,13
30,440000,4f79773e600518a6,7,0,99,112,111,142,134,176,97,19,44,38,31,35,33,35,4,-7,11
23,450000,4f79773e600518a6,7,0,36,46,27,44,52,62,66,20,31,15,25,9,17,16,-16,10,-26
97,320000,4f79773e600518a6,7,0,216,275,222,289,312,450,333,168,137,94,101,95,98,97,-6,7,-13
58,360000,4f79773e600518a6,7,0,96,123,158,141,164,252,264,69,58,63,82,66,74,70,-16,19,-35
157,130000,4f79773e600518a6,7,0,209,251,268,281,338,473,362,182,165,226,205,142,174,191,-63,-21,-42
239,410000,4f79773e600518a6,7,0,458,438,436,457,535,679,669,213,223,212,206,190,198,203,-16,-6,-10
47,330000,4f79773e600518a6,7,0,117,144,152,167,161,255,131,59,54,69,64,57,60,63,-7,-5,-2
81,420000,4f79773e600518a6,7,0,166,169,231,258,278,385,450,105,110,104,89,90,90,94,1,-15,16
243,430000,4f79773e600518a6,7,0,322,320,453,378,533,776,857,222,262,247,257,219,238,241,-38,10,-48
21,350000,4f79773e600518a6,7,0,47,38,50,51,83,65,41,21,20,20,33,19,26,24,-14,13,-27
43,210000,4f79773e600518a6,7,0,101,115,152,128,129,166,109,50,66,72,45,46,46,54,1,-27,28
67,500000,4f79773e600518a6,7,0,125,149,157,175,189,306,256,58,77,65,70,84,77,73,14,5,9
204,610000,4f79773e600518a6,7,0,270,298,329,421,381,634,493,193,190,176,193,161,177,177,-32,17,-49
66,230000,4f79773e600518a6,7,0,132,165,141,126,204,277,131,70,96,70,62,54,58,62,-8,-8,0
81,310000,fc32b1a017b34efe,7,0,164,176,188,167,211,361,138,71,95,74,75,111,93,87,36,1,35
373,530000,fc32b1a017b34efe,7,0,407,402,486,521,434,743,406,299,256,259,276,323,300,286,47,17,30
314,150000,fc32b1a017b34efe,7,0,256,255,374,366,390,683,304,135,211,181,248,260,254,230,12,67,-55
102,110000,fc32b1a017b34efe,7,0,365,388,458,302,357,675,173,56,121,79,138,89,114,102,-49,59,-108
1044,510000,fc32b1a017b34efe,7,0,1135,1222,1530,1137,1318,2057,1186,681,782,644,814,979,896,812,165,170,-5
317,340000,fc32b1a017b34efe,7,0,363,463,479,476,493,865,574,194,213,248,307,345,326,300,38,59,-21
680,370000,fc32b1a017b34efe,7,0,720,875,922,870,894,1538,723,282,412,473,536,614,575,541,78,63,15
656,140000,fc32b1a017b34efe,7,0,358,454,470,495,510,974,417,214,254,346,509,560,534,472,51,163,-112
484,440000,fc32b1a017b34efe,7,0,557,610,730,702,768,1105,569,259,493,354,430,585,508,456,155,76,79
194,450000,fc32b1a017b34efe,7,0,182,175,217,208,212,406,260,101,165,105,174,218,196,166,44,69,-25
550,320000,fc32b1a017b34efe,7,0,652,768,765,828,786,1332,698,402,409,494,495,557,526,515,62,1,61
283,360000,fc32b1a017b34efe,7,0,276,281,350,363,356,774,420,110,193,205,216,298,257,240,82,11,71
1137,130000,fc32b1a017b34efe,7,0,693,937,936,974,964,2069,891,397,516,929,990,983,986,967,-7,61,-68
946,410000,fc32b1a017b34efe,7,0,796,900,924,913,934,1916,1026,330,387,521,645,908,776,691,263,124,139
371,330000,fc32b1a017b34efe,7,0,491,561,604,663,556,982,370,195,281,311,304,395,350,337,91,-7,98
290,420000,fc32b1a017b34efe,7,0,276,301,385,300,389,721,401,105,159,186,195,272,234,218,77,9,68
424,430000,fc32b1a017b34efe,7,0,551,548,722,567,687,1290,631,205,298,333,363,464,414,387,101,30,71
163,350000,fc32b1a017b34efe,7,0,152,178,217,240,253,385,180,95,138,114,150,154,152,139,4,36,-32
145,210000,fc32b1a017b34efe,7,0,212,251,209,211,226,330,135,104,181,144,138,167,152,150,29,-6,35
557,500000,fc32b1a017b34efe,7,0,790,970,909,844,751,1420,661,420,464,477,481,631,556,530,150,4,146
687,610000,fc32b1a017b34efe,7,0,496,540,574,623,639,1234,604,184,336,402,415,468,442,428,53,13,40
127,230000,fc32b1a017b34efe,7,0,131,146,126,126,150,236,76,111,111,78,108,134,121,107,26,30,-4
286,310000,feabbf46658382b9,7,0,275,484,500,412,620,805,357,95,198,187,218,252,235,219,34,31,3
766,530000,feabbf46658382b9,7,0,521,806,851,856,921,1249,829,418,522,444,470,542,506,485,72,26,46
595,150000,feabbf46658382b9,7,0,347,507,500,528,675,925,601,288,415,322,461,499,480,427,38,139,-101
302,110000,feabbf46658382b9,7,0,534,743,672,532,779,1421,437,212,313,278,276,253,264,269,-23,-2,-21
1538,510000,feabbf46658382b9,7,0,1077,1757,2178,1620,1861,2915,2183,903,1084,938,1042,1247,1144,1076,205,104,101
585,340000,feabbf46658382b9,7,0,395,690,798,757,934,1307,1141,304,330,322,356,545,450,408,189,34,155
1014,370000,feabbf46658382b9,7,0,668,1173,1160,1214,1192,1610,1006,389,569,611,624,776,700,670,152,13,139
552,140000,feabbf46658382b9,7,0,316,582,505,511,601,970,406,198,368,305,370,503,436,393,133,65,68
1134,440000,feabbf46658382b9,7,0,758,1347,1576,1507,1902,2685,1203,341,825,879,785,1142,964,935,357,-94,451
296,450000,feabbf46658382b9,7,0,193,394,347,352,440,665,433,149,235,168,197,226,212,197,29,29,0
1420,320000,feabbf46658382b9,7,0,1014,1794,1646,1598,1955,2752,1481,650,861,854,961,1280,1120,1032,319,107,212
440,360000,feabbf46658382b9,7,0,281,443,510,475,511,802,624,159,229,268,266,354,310,296,88,-2,90
1254,130000,feabbf46658382b9,7,0,624,985,1009,905,1021,1551,970,478,608,767,810,890,850,822,80,43,37
1787,410000,feabbf46658382b9,7,0,846,1361,1342,1399,1530,2696,1928,502,672,701,850,1415,1132,989,565,149,416
1254,330000,feabbf46658382b9,7,0,720,1247,1320,1351,1499,2124,704,292,530,641,696,932,814,756,236,55,181
609,420000,feabbf46658382b9,7,0,347,614,653,620,794,1252,837,201,313,330,347,462,404,380,115,17,98
934,430000,feabbf46658382b9,7,0,741,1241,1383,1339,1478,2360,1657,503,671,579,591,827,709,666,236,12,224
378,350000,feabbf46658382b9,7,0,231,425,414,399,601,698,428,129,211,219,281,359,320,286,78,62,16
334,210000,feabbf46658382b9,7,0,191,375,331,306,361,459,235,125,226,187,250,248,249,228,-2,63,-65
1313,500000,feabbf46658382b9,7,0,994,1592,1671,1487,1581,2727,1846,758,896,740,908,1151,1030,933,243,168,75
798,610000,feabbf46658382b9,7,0,538,758,764,827,896,1319,905,333,426,445,444,565,504,485,121,-1,122
253,230000,feabbf46658382b9,7,0,136,271,219,256,312,397,173,117,199,155,143,190,166,163,47,-12,59
32,310000,f270f6a489c6a9d7,7,0,25,37,28,27,30,34,19,29,28,25,38,29,34,31,-9,13,-22
875,530000,f270f6a489c6a9d7,7,0,1342,1395,1639,1736,1547,1939,1680,1190,1187,815,815,786,800,805,-29,0,-29
56,150000,f270f6a489c6a9d7,7,0,79,74,107,93,105,108,54,78,117,71,70,60,65,67,-10,-1,-9
70,110000,f270f6a489c6a9d7,7,0,229,238,282,198,305,504,106,118,157,120,110,104,107,111,-6,-10,4
468,510000,f270f6a489c6a9d7,7,0,620,742,717,655,773,955,603,645,678,519,472,474,473,488,2,-47,49
145,340000,f270f6a489c6a9d7,7,0,172,194,197,214,225,272,216,223,191,165,153,149,151,156,-4,-12,8
388,370000,f270f6a489c6a9d7,7,0,644,631,622,551,636,1105,629,541,513,451,400,375,388,409,-25,-51,26
93,140000,f270f6a489c6a9d7,7,0,131,103,137,118,161,233,166,115,127,118,117,113,115,116,-4,-1,-3
390,440000,f270f6a489c6a9d7,7,0,568,627,644,624,713,866,346,505,757,513,503,519,511,512,16,-10,26
20,450000,f270f6a489c6a9d7,7,0,69,50,93,63,75,97,92,50,85,53,57,36,46,49,-21,4,-25
522,320000,f270f6a489c6a9d7,7,0,653,752,766,763,871,1150,610,843,857,623,558,495,526,559,-63,-65,2
87,360000,f270f6a489c6a9d7,7,0,121,107,134,92,117,148,132,89,105,90,70,62,66,74,-8,-20,12
570,130000,f270f6a489c6a9d7,7,0,529,574,561,554,769,983,537,616,685,621,541,500,520,554,-41,-80,39
715,410000,f270f6a489c6a9d7,7,0,759,825,703,746,952,1314,922,778,753,612,592,519,556,574,-73,-20,-53
353,330000,f270f6a489c6a9d7,7,0,405,385,451,456,466,653,312,498,511,368,351,319,335,346,-32,-17,-15
306,420000,f270f6a489c6a9d7,7,0,513,518,582,592,590,903,514,438,482,408,403,314,358,375,-89,-5,-84
276,430000,f270f6a489c6a9d7,7,0,353,375,366,327,426,575,405,314,375,353,267,377,322,332,110,-86,196
94,350000,f270f6a489c6a9d7,7,0,152,164,156,179,175,195,85,140,157,133,146,133,140,137,-13,13,-26
200,210000,f270f6a489c6a9d7,7,0,212,192,216,260,281,370,158,187,236,191,184,170,177,182,-14,-7,-7
470,500000,f270f6a489c6a9d7,7,0,554,592,643,645,706,955,636,643,771,438,521,498,510,486,-23,83,-106
131,610000,f270f6a489c6a9d7,7,0,180,190,227,209,280,324,195,155,198,180,157,132,144,156,-25,-23,-2
28,230000,f270f6a489c6a9d7,7,0,47,88,70,59,76,90,35,48,67,46,41,40,40,42,-1,-5,4
59,310000,d0f245b8781e3631,7,0,139,176,218,159,193,281,60,52,74,61,69,81,75,70,12,8,4
106,530000,d0f245b8781e3631,7,0,201,192,241,224,227,356,181,119,130,103,154,125,140,127,-29,51,-80
51,150000,d0f245b8781e3631,7,0,103,63,86,129,183,244,117,67,81,65,79,55,67,66,-24,14,-38
172,110000,d0f245b8781e3631,7,0,463,464,472,326,417,805,105,52,132,97,103,144,124,115,41,6,35
453,510000,d0f245b8781e3631,7,0,739,855,1133,824,910,1456,816,454,505,463,516,491,504,490,-25,53,-78
110,340000,d0f245b8781e3631,7,0,323,314,310,267,287,463,251,96,133,88,118,91,104,99,-27,30,-57
332,370000,d0f245b8781e3631,7,0,646,773,797,679,738,1182,600,283,311,395,408,271,340,358,-137,13,-150
132,140000,d0f245b8781e3631,7,0,199,221,226,243,264,497,192,96,135,117,169,144,156,143,-25,52,-77
238,440000,d0f245b8781e3631,7,0,378,429,596,574,615,869,297,127,271,262,258,278,268,266,20,-4,24
104,450000,d0f245b8781e3631,7,0,161,139,167,205,233,425,254,71,136,107,135,145,140,129,10,28,-18
260,320000,d0f245b8781e3631,7,0,683,706,761,731,749,1017,461,270,342,363,373,289,331,342,-84,10,-94
78,360000,d0f245b8781e3631,7,0,145,145,229,198,198,315,211,60,84,84,68,64,66,72,-4,-16,12
459,130000,d0f245b8781e3631,7,0,551,690,771,682,755,1430,754,390,398,481,498,419,458,466,-79,17,-96
440,410000,d0f245b8781e3631,7,0,779,871,851,876,865,1601,892,268,371,333,363,396,380,364,33,30,3
243,330000,d0f245b8781e3631,7,0,410,370,1437,406,420,845,174,81,170,192,246,204,225,214,-42,54,-96
51,420000,d0f245b8781e3631,7,0,124,88,110,128,133,246,134,39,47,55,60,48,54,54,-12,5,-17
177,430000,d0f245b8781e3631,7,0,335,319,439,335,447,756,439,130,231,191,211,178,194,193,-33,20,-53
79,350000,d0f245b8781e3631,7,0,116,102,142,175,166,247,102,51,67,60,67,91,79,73,24,7,17
21,210000,d0f245b8781e3631,7,0,77,81,68,54,102,113,47,21,29,27,30,22,26,26,-8,3,-11
428,500000,d0f245b8781e3631,7,0,781,1602,764,548,596,1578,630,283,298,337,395,444,420,392,49,58,-9
286,610000,d0f245b8781e3631,7,0,435,453,455,455,558,938,498,189,261,260,236,226,231,241,-10,-24,14
12,230000,d0f245b8781e3631,7,0,25,28,17,16,45,45,7,10,21,11,20,18,19,16,-2,9,-11
1154,310000,c6cd4e0e073f5ac2,7,0,547,590,1049,393,448,746,228,125,223,190,233,237,235,220,4,43,-39
79,530000,c6cd4e0e073f5ac2,7,0,317,301,410,266,224,235,105,67,68,72,70,100,85,81,30,-2,32
75,150000,c6cd4e0e073f5ac2,7,0,178,248,263,289,273,340,208,63,95,64,75,89,82,76,14,11,3
417,110000,c6cd4e0e073f5ac2,7,0,216,265,2528,156,179,362,72,29,64,61,50,56,53,56,6,-11,17
834,510000,c6cd4e0e073f5ac2,7,0,942,1243,1666,730,631,1027,542,251,246,265,230,226,228,240,-4,-35,31
315,340000,c6cd4e0e073f5ac2,7,0,742,968,961,755,678,1434,792,244,232,308,344,363,354,338,19,36,-17
372,370000,c6cd4e0e073f5ac2,7,0,2176,2848,2646,1380,1053,1685,823,326,341,453,371,362,366,395,-9,-82,73
558,140000,c6cd4e0e073f5ac2,7,0,468,657,660,386,479,604,321,126,162,162,182,154,168,166,-28,20,-48
329,440000,c6cd4e0e073f5ac2,7,0,546,819,1623,936,1038,1493,451,130,374,366,407,481,444,418,74,41,33
103,450000,c6cd4e0e073f5ac2,7,0,234,316,360,349,312,543,250,76,136,99,136,130,133,122,-6,37,-43
1395,320000,c6cd4e0e073f5ac2,7,0,1827,2527,2388,1650,1467,2828,1205,656,751,787,807,758,782,784,-49,20,-69
268,360000,c6cd4e0e073f5ac2,7,0,450,511,752,626,577,1241,549,138,232,271,262,250,256,261,-12,-9,-3
285,130000,c6cd4e0e073f5ac2,7,0,987,1387,1606,840,561,1020,602,249,293,362,351,329,340,347,-22,-11,-11
719,410000,c6cd4e0e073f5ac2,7,0,1416,1736,1669,959,1021,1584,992,320,512,660,557,721,639,646,164,-103,267
337,330000,c6cd4e0e073f5ac2,7,0,717,1019,1203,828,859,1272,386,193,342,341,375,377,376,364,2,34,-32
775,420000,c6cd4e0e073f5ac2,7,0,430,713,769,691,751,1208,523,161,272,326,270,280,275,292,10,-56,66
261,430000,c6cd4e0e073f5ac2,7,0,641,816,847,522,619,891,508,132,232,212,222,268,245,234,46,10,36
77,350000,c6cd4e0e073f5ac2,7,0,221,243,304,268,291,431,173,74,106,104,121,115,118,113,-6,17,-23
52,210000,c6cd4e0e073f5ac2,7,0,228,366,291,139,186,225,91,51,75,101,66,42,54,70,-24,-35,11
57,500000,c6cd4e0e073f5ac2,7,0,215,324,310,182,148,242,128,33,53,51,65,76,70,64,11,14,-3
754,610000,c6cd4e0e073f5ac2,7,0,687,656,661,278,275,432,182,64,143,136,155,142,148,144,-13,19,-32
21,230000,c6cd4e0e073f5ac2,7,0,97,146,137,83,61,140,53,29,33,28,48,27,38,34,-21,20,-41
143,310000,a9a43d1a7ecbe75d,7,0,141,138,161,113,162,163,142,84,128,99,108,102,105,103,-6,9,-15
136,530000,a9a43d1a7ecbe75d,7,0,141,123,111,95,152,131,146,84,119,80,84,87,86,84,3,4,-1
58,150000,a9a43d1a7ecbe75d,7,0,84,71,81,97,81,90,83,41,62,87,86,67,76,80,-19,-1,-18
53,110000,a9a43d1a7ecbe75d,7,0,119,87,131,79,100,123,88,65,74,70,62,63,62,65,1,-8,9
192,510000,a9a43d1a7ecbe75d,7,0,232,227,447,284,279,330,341,184,223,201,224,188,206,204,-36,23,-59
136,340000,a9a43d1a7ecbe75d,7,0,138,167,182,170,183,198,254,107,149,150,152,146,149,149,-6,2,-8
116,370000,a9a43d1a7ecbe75d,7,0,138,136,198,152,160,191,159,74,162,163,162,117,140,147,-45,-1,-44
28,140000,a9a43d1a7ecbe75d,7,0,30,36,34,32,31,28,41,25,46,41,28,30,29,33,2,-13,15
440,440000,a9a43d1a7ecbe75d,7,0,487,435,593,541,658,638,568,264,527,387,410,437,424,411,27,23,4
143,450000,a9a43d1a7ecbe75d,7,0,151,154,208,163,172,213,297,121,197,152,163,152,158,156,-11,11,-22
373,320000,a9a43d1a7ecbe75d,7,0,317,361,402,385,402,439,430,213,408,324,345,284,314,318,-61,21,-82
82,360000,a9a43d1a7ecbe75d,7,0,82,64,94,87,76,120,103,50,101,76,71,82,76,76,11,-5,16
134,130000,a9a43d1a7ecbe75d,7,0,88,102,92,82,85,95,109,50,116,95,137,104,120,112,-33,42,-75
140,410000,a9a43d1a7ecbe75d,7,0,120,123,153,141,134,164,130,78,142,114,90,124,107,109,34,-24,58
351,330000,a9a43d1a7ecbe75d,7,0,322,299,308,339,364,397,466,185,307,317,322,277,300,305,-45,5,-50
186,420000,a9a43d1a7ecbe75d,7,0,155,179,232,184,244,236,270,129,200,183,140,190,165,171,50,-43,93
319,430000,a9a43d1a7ecbe75d,7,0,299,298,395,308,355,445,519,215,330,301,296,262,279,286,-34,-5,-29
78,350000,a9a43d1a7ecbe75d,7,0,92,91,93,87,125,99,145,57,96,88,101,91,96,93,-10,13,-23
79,210000,a9a43d1a7ecbe75d,7,0,136,158,194,115,126,155,89,59,109,102,100,85,92,96,-15,-2,-13
151,500000,a9a43d1a7ecbe75d,7,0,146,146,203,173,179,214,160,89,140,134,104,264,184,167,160,-30,190
256,610000,a9a43d1a7ecbe75d,7,0,273,229,256,263,252,263,274,154,228,212,258,163,210,211,-95,46,-141
39,230000,a9a43d1a7ecbe75d,7,0,75,75,68,54,66,57,65,35,91,67,47,50,48,55,3,-20,23
298,310000,3c974920a76ac9c1,8,0,162,265,228,369,374,305,193,309,264,241,251,240,246,244,-11,10,-21
323,530000,3c974920a76ac9c1,8,0,246,217,310,402,456,434,194,302,243,321,230,362,296,304,132,-91,223
170,150000,3c974920a76ac9c1,8,0,153,157,178,204,219,180,128,201,176,192,155,199,177,182,44,-37,81
310,110000,3c974920a76ac9c1,8,0,244,337,371,460,563,468,432,472,340,407,314,302,308,341,-12,-93,81
330,510000,3c974920a76ac9c1,8,0,345,623,350,453,570,500,253,378,337,331,336,304,320,324,-32,5,-37
166,340000,3c974920a76ac9c1,8,0,127,159,136,179,226,198,76,132,155,144,166,155,160,155,-11,22,-33
413,370000,3c974920a76ac9c1,8,0,259,422,394,483,601,468,290,412,484,450,432,449,440,444,17,-18,35
197,140000,3c974920a76ac9c1,8,0,189,194,233,215,260,248,146,249,182,251,173,213,193,212,40,-78,118
2782,440000,3c974920a76ac9c1,8,0,1804,2265,2711,3532,3800,2692,1680,2958,2368,2754,2696,2582,2639,2677,-114,-58,-56
331,450000,3c974920a76ac9c1,8,0,249,267,349,472,505,425,248,383,277,377,293,309,301,326,16,-84,100
682,320000,3c974920a76ac9c1,8,0,569,631,764,871,1010,800,486,817,617,720,689,718,704,709,29,-31,60
168,360000,3c974920a76ac9c1,8,0,95,156,166,204,262,236,78,191,154,186,149,156,152,164,7,-37,44
352,130000,3c974920a76ac9c1,8,0,235,225,228,291,305,260,190,297,311,328,293,325,309,315,32,-35,67
309,410000,3c974920a76ac9c1,8,0,256,301,351,521,505,405,250,355,393,307,297,380,338,328,83,-10,93
669,330000,3c974920a76ac9c1,8,0,422,545,702,660,865,633,409,621,561,562,591,624,608,592,33,29,4
361,420000,3c974920a76ac9c1,8,0,325,381,447,480,474,497,228,445,423,403,455,424,440,427,-31,52,-83
280,430000,3c974920a76ac9c1,8,0,286,299,327,364,474,347,174,297,304,284,259,316,288,286,57,-25,82
316,350000,3c974920a76ac9c1,8,0,226,258,368,331,404,292,181,307,209,324,299,311,305,311,12,-25,37
715,210000,3c974920a76ac9c1,8,0,556,721,769,941,997,650,566,775,692,738,626,805,716,723,179,-112,291
104,500000,3c974920a76ac9c1,8,0,111,101,120,155,199,115,72,126,107,119,138,135,136,131,-3,19,-22
307,610000,3c974920a76ac9c1,8,0,204,187,324,393,440,305,219,295,292,328,285,305,295,306,20,-43,63
335,230000,3c974920a76ac9c1,8,0,351,302,310,458,461,292,234,401,305,324,284,313,298,307,29,-40,69
506,310000,3d7554f1f56dd664,8,0,410,417,271,639,518,268,263,442,321,383,408,481,444,424,73,25,48
506,530000,3d7554f1f56dd664,8,0,266,368,334,609,519,292,264,403,325,415,354,487,420,419,133,-61,194
332,150000,3d7554f1f56dd664,8,0,216,208,216,370,337,175,149,316,260,258,252,263,258,258,11,-6,17
326,110000,3d7554f1f56dd664,8,0,464,449,231,675,811,368,359,470,369,376,352,396,374,375,44,-24,68
901,510000,3d7554f1f56dd664,8,0,758,1227,469,1053,1125,657,560,806,700,679,724,721,722,708,-3,45,-48
517,340000,3d7554f1f56dd664,8,0,358,325,253,574,507,301,225,317,315,350,352,460,406,387,108,2,106
1502,370000,3d7554f1f56dd664,8,0,917,1222,876,1567,1574,775,729,1060,1229,1119,1113,1342,1228,1191,229,-6,235
519,140000,3d7554f1f56dd664,8,0,382,372,320,590,571,290,239,407,358,384,335,452,394,390,117,-49,166
10367,440000,3d7554f1f56dd664,8,0,10596,10140,6925,13598,11515,5136,4688,10371,8733,8990,9100,9110,9105,9067,10,110,-100
1222,450000,3d7554f1f56dd664,8,0,866,969,642,1386,1258,750,559,1074,832,939,901,1075,988,972,174,-38,212
2406,320000,3d7554f1f56dd664,8,0,2216,2075,1763,3112,2877,1445,1635,2184,1828,1916,1948,2090,2019,1985,142,32,110
577,360000,3d7554f1f56dd664,8,0,420,535,356,595,741,435,311,545,463,483,513,576,544,524,63,30,33
1183,130000,3d7554f1f56dd664,8,0,569,722,520,1137,974,498,486,847,1025,993,829,1052,940,958,223,-164,387
1163,410000,3d7554f1f56dd664,8,0,785,808,565,1273,1234,645,486,968,944,932,1043,1153,1098,1043,110,111,-1
2419,330000,3d7554f1f56dd664,8,0,1785,1658,1293,2709,2467,1135,1205,1969,1744,1919,1847,2165,2006,1977,318,-72,390
989,420000,3d7554f1f56dd664,8,0,883,908,742,1001,1050,703,508,734,619,699,876,984,930,853,108,177,-69
1006,430000,3d7554f1f56dd664,8,0,721,958,582,1112,1192,689,445,769,687,748,707,821,764,759,114,-41,155
1699,350000,3d7554f1f56dd664,8,0,1388,1310,817,2205,1578,856,899,1607,1181,1494,1511,1522,1516,1509,11,17,-6
2361,210000,3d7554f1f56dd664,8,0,2301,1915,1064,2892,2161,1110,1306,1905,1837,1784,1845,2218,2032,1949,373,61,312
317,500000,3d7554f1f56dd664,8,0,319,331,173,470,398,244,215,285,259,240,371,328,350,313,-43,131,-174
525,610000,3d7554f1f56dd664,8,0,492,462,375,582,607,340,260,369,435,466,394,526,460,462,132,-72,204
1229,230000,3d7554f1f56dd664,8,0,1107,843,480,1076,1018,447,521,1186,639,827,849,957,903,878,108,22,86
195,310000,2d0d2c3403909fdb,8,0,159,169,112,163,167,157,101,187,162,155,200,158,179,171,-42,45,-87
329,530000,2d0d2c3403909fdb,8,0,309,270,218,354,350,290,213,293,226,236,265,410,338,304,145,29,116
251,150000,2d0d2c3403909fdb,8,0,246,234,155,184,233,279,174,228,241,255,251,306,278,271,55,-4,59
475,110000,2d0d2c3403909fdb,8,0,554,583,457,611,677,549,387,627,524,389,503,552,528,481,49,114,-65
373,510000,2d0d2c3403909fdb,8,0,319,387,300,411,434,516,235,377,355,370,404,481,442,418,77,34,43
124,340000,2d0d2c3403909fdb,8,0,108,157,129,128,138,176,83,127,116,129,142,151,146,141,9,13,-4
410,370000,2d0d2c3403909fdb,8,0,328,376,327,415,400,420,235,353,334,323,407,400,404,377,-7,84,-91
167,140000,2d0d2c3403909fdb,8,0,152,135,111,141,197,179,103,189,173,157,177,211,194,182,34,20,14
1593,440000,2d0d2c3403909fdb,8,0,1490,1683,1421,1989,1829,1713,1159,1738,1536,1581,1833,1828,1830,1747,-5,252,-257
133,450000,2d0d2c3403909fdb,8,0,141,192,165,181,173,211,121,197,149,174,163,216,190,184,53,-11,64
461,320000,2d0d2c3403909fdb,8,0,340,401,333,437,427,470,296,446,386,375,444,454,449,424,10,69,-59
154,360000,2d0d2c3403909fdb,8,0,84,108,90,107,109,126,55,113,112,112,126,130,128,123,4,14,-10
444,130000,2d0d2c3403909fdb,8,0,321,309,274,302,328,389,251,371,364,437,425,531,478,464,106,-12,118
320,410000,2d0d2c3403909fdb,8,0,300,327,262,352,337,377,202,331,306,338,396,390,393,375,-6,58,-64
444,330000,2d0d2c3403909fdb,8,0,352,336,342,428,424,401,264,349,335,366,380,435,408,394,55,14,41
267,420000,2d0d2c3403909fdb,8,0,201,303,211,267,280,321,189,271,255,230,322,292,307,281,-30,92,-122
286,430000,2d0d2c3403909fdb,8,0,193,250,211,244,275,284,146,275,262,250,285,292,288,276,7,35,-28
94,350000,2d0d2c3403909fdb,8,0,95,124,106,151,157,167,81,107,85,111,132,133,132,125,1,21,-20
708,210000,2d0d2c3403909fdb,8,0,466,488,346,464,567,506,316,529,433,489,457,606,532,517,149,-32,181
176,500000,2d0d2c3403909fdb,8,0,134,169,138,184,155,213,116,188,148,168,179,203,191,183,24,11,13
254,610000,2d0d2c3403909fdb,8,0,253,271,195,252,267,297,206,288,291,280,277,346,312,301,69,-3,72
316,230000,2d0d2c3403909fdb,8,0,304,239,208,258,336,315,155,306,267,240,317,304,310,287,-13,77,-90
201,310000,a28bb927b6fcb33c,8,0,249,216,166,212,210,117,96,135,131,161,142,167,154,157,25,-19,44
332,530000,a28bb927b6fcb33c,8,0,232,256,209,270,308,173,110,159,185,191,176,253,214,207,77,-15,92
167,150000,a28bb927b6fcb33c,8,0,134,193,128,165,176,89,72,136,148,139,117,145,131,134,28,-22,50
159,110000,a28bb927b6fcb33c,8,0,309,286,179,246,342,136,109,179,166,96,85,131,108,104,46,-11,57
553,510000,a28bb927b6fcb33c,8,0,492,712,401,438,436,351,212,361,425,290,324,427,376,347,103,34,69
313,340000,a28bb927b6fcb33c,8,0,368,358,250,325,348,264,151,204,182,203,195,266,230,221,71,-8,79
522,370000,a28bb927b6fcb33c,8,0,489,606,454,468,556,225,175,357,467,449,285,377,331,370,92,-164,256
198,140000,a28bb927b6fcb33c,8,0,233,187,181,144,181,92,70,148,181,165,127,190,158,161,63,-38,101
4949,440000,a28bb927b6fcb33c,8,0,4618,5211,4012,4216,4195,2391,1639,3992,3988,3668,3906,4522,4214,4032,616,238,378
540,450000,a28bb927b6fcb33c,8,0,409,444,331,432,386,248,166,443,418,434,344,461,402,413,117,-90,207
1268,320000,a28bb927b6fcb33c,8,0,1148,1130,943,1033,1154,680,651,982,1039,1051,947,1072,1010,1023,125,-104,229
451,360000,a28bb927b6fcb33c,8,0,288,380,260,302,351,208,96,254,328,298,271,331,301,300,60,-27,87
623,130000,a28bb927b6fcb33c,8,0,550,584,385,397,419,248,284,584,570,485,345,559,452,463,214,-140,354
816,410000,a28bb927b6fcb33c,8,0,658,673,556,567,651,338,242,578,638,439,516,644,580,533,128,77,51
1730,330000,a28bb927b6fcb33c,8,0,1244,1296,1228,1343,1310,747,739,1438,1404,1200,1131,1522,1326,1284,391,-69,460
665,420000,a28bb927b6fcb33c,8,0,655,744,726,677,787,450,226,461,459,468,446,524,485,479,78,-22,100
787,430000,a28bb927b6fcb33c,8,0,610,619,436,474,674,394,223,436,554,554,548,663,606,588,115,-6,121
966,350000,a28bb927b6fcb33c,8,0,535,615,563,615,519,231,173,535,612,676,709,737,723,707,28,33,-5
792,210000,a28bb927b6fcb33c,8,0,1031,840,522,652,848,213,233,610,646,562,459,596,528,539,137,-103,240
173,500000,a28bb927b6fcb33c,8,0,316,208,150,157,208,123,85,166,157,116,162,140,151,139,-22,46,-68
358,610000,a28bb927b6fcb33c,8,0,274,262,219,225,317,148,105,202,242,221,226,279,252,242,53,5,48
349,230000,a28bb927b6fcb33c,8,0,335,334,222,288,303,90,85,233,244,241,205,236,220,227,31,-36,67
208,310000,17bc272c93f19d56,8,0,256,234,168,249,477,199,177,267,169,193,170,168,169,177,-2,-23,21
1981,530000,17bc272c93f19d56,8,0,2565,3307,3096,3216,4503,4785,3067,2754,2281,2227,1995,2206,2100,2143,211,-232,443
433,150000,17bc272c93f19d56,8,0,368,502,360,520,675,504,451,680,487,440,356,384,370,393,28,-84,112
80,110000,17bc272c93f19d56,8,0,202,242,199,305,514,151,92,197,124,132,112,101,106,115,-11,-20,9
1119,510000,17bc272c93f19d56,8,0,1230,1449,1007,1411,1954,1724,1537,1481,1090,1021,990,1018,1004,1010,28,-31,59
1126,340000,17bc272c93f19d56,8,0,1418,1458,1238,1535,2328,2152,1881,1518,1284,1266,1165,1072,1118,1168,-93,-101,8
2917,370000,17bc272c93f19d56,8,0,3600,3519,3268,3907,6576,4483,3060,2839,2545,2879,2279,2583,2431,2580,304,-600,904
1235,140000,17bc272c93f19d56,8,0,1452,1749,1354,1585,2844,2093,1361,1353,1118,1259,955,1154,1054,1123,199,-304,503
1573,440000,17bc272c93f19d56,8,0,1550,1999,1555,2007,3029,1611,1579,2180,1684,1684,1682,1409,1546,1592,-273,-2,-271
1943,450000,17bc272c93f19d56,8,0,2291,2515,2293,2687,4443,3084,1836,2310,1540,1616,1343,1308,1326,1422,-35,-273,238
1501,320000,17bc272c93f19d56,8,0,1799,1764,1493,1942,3067,2165,2419,2029,1601,1578,1375,1523,1449,1492,148,-203,351
656,360000,17bc272c93f19d56,8,0,890,1111,824,980,1510,1290,922,875,668,648,536,537,536,574,1,-112,113
2808,130000,17bc272c93f19d56,8,0,3368,3303,2808,3641,6231,3870,3403,2945,3015,3119,2522,2789,2656,2810,267,-597,864
2563,410000,17bc272c93f19d56,8,0,3591,3584,3821,4668,7650,5825,3564,3197,2704,2715,2598,2658,2628,2657,60,-117,177
1188,330000,17bc272c93f19d56,8,0,1016,1295,1112,1294,2062,1260,1629,1592,1156,1224,1121,1218,1170,1188,97,-103,200
949,420000,17bc272c93f19d56,8,0,992,1202,958,1353,2198,1919,1140,1262,895,1069,835,836,836,913,1,-234,235
1035,430000,17bc272c93f19d56,8,0,1678,1773,1354,1770,2693,2364,1506,1541,1174,1020,997,939,968,985,-58,-23,-35
402,350000,17bc272c93f19d56,8,0,565,573,523,688,892,592,650,741,463,546,473,389,431,469,-84,-73,-11
964,210000,17bc272c93f19d56,8,0,1010,1135,824,1154,1710,924,939,1322,959,988,854,912,883,918,58,-134,192
218,500000,17bc272c93f19d56,8,0,204,284,201,250,357,250,248,235,212,191,173,197,185,187,24,-18,42
1117,610000,17bc272c93f19d56,8,0,1245,1658,1590,1877,3217,2072,1105,1314,1222,1105,910,1051,980,1022,141,-195,336
544,230000,17bc272c93f19d56,8,0,835,795,518,816,982,506,518,806,657,585,602,530,566,572,-72,17,-89
347,310000,2a2ab41f8f6ff1cb,8,0,445,555,272,582,623,382,114,351,229,285,289,234,262,269,-55,4,-59
639,530000,2a2ab41f8f6ff1cb,8,0,409,543,553,546,680,484,300,452,403,419,390,633,512,481,243,-29,272
623,150000,2a2ab41f8f6ff1cb,8,0,645,831,715,836,832,551,317,489,505,604,525,595,560,575,70,-79,149
133,110000,2a2ab41f8f6ff1cb,8,0,369,502,362,440,598,212,102,180,142,124,93,130,112,116,37,-31,68
1346,510000,2a2ab41f8f6ff1cb,8,0,1165,1460,1050,1385,1850,1223,671,850,790,838,870,1020,945,909,150,32,118
1280,340000,2a2ab41f8f6ff1cb,8,0,1409,1565,1256,1491,1666,1515,717,1018,980,1077,1165,1206,1186,1149,41,88,-47
2226,370000,2a2ab41f8f6ff1cb,8,0,2139,2580,2061,2146,2737,1706,842,1734,1902,2031,1983,2192,2088,2069,209,-48,257
717,140000,2a2ab41f8f6ff1cb,8,0,655,690,724,762,993,533,312,595,582,569,606,683,644,619,77,37,40
5914,440000,2a2ab41f8f6ff1cb,8,0,6544,8215,6582,6734,6492,5607,2647,5713,4896,5717,5445,4899,5172,5354,-546,-272,-274
719,450000,2a2ab41f8f6ff1cb,8,0,680,913,743,853,894,799,409,719,453,603,532,611,572,582,79,-71,150
1857,320000,2a2ab41f8f6ff1cb,8,0,2252,2410,2283,2584,2672,1728,1016,1729,1498,1701,1735,1850,1792,1762,115,34,81
1041,360000,2a2ab41f8f6ff1cb,8,0,964,1340,1065,1086,1291,1027,356,690,687,838,753,813,783,801,60,-85,145
2989,130000,2a2ab41f8f6ff1cb,8,0,2864,3253,2277,2327,2703,2119,1271,2126,2486,2863,2426,2914,2670,2734,488,-437,925
3319,410000,2a2ab41f8f6ff1cb,8,0,3318,3446,2827,2797,3447,2952,1308,2514,2566,2841,2880,3363,3122,3028,483,39,444
1379,330000,2a2ab41f8f6ff1cb,8,0,1151,1369,1262,1632,1972,795,459,876,905,1141,1077,1165,1121,1128,88,-64,152
1344,420000,2a2ab41f8f6ff1cb,8,0,1412,1938,1686,1663,2151,1566,597,1095,1029,1047,1133,1293,1213,1158,160,86,74
1802,430000,2a2ab41f8f6ff1cb,8,0,1918,2573,2247,1966,2770,1651,844,1487,1573,1636,1382,1564,1473,1527,182,-254,436
436,350000,2a2ab41f8f6ff1cb,8,0,348,390,371,447,476,264,148,314,267,427,418,348,383,398,-70,-9,-61
462,210000,2a2ab41f8f6ff1cb,8,0,369,397,317,403,513,241,211,360,293,362,342,372,357,359,30,-20,50
633,500000,2a2ab41f8f6ff1cb,8,0,810,888,646,803,1149,803,328,472,453,543,623,549,586,572,-74,80,-154
577,610000,2a2ab41f8f6ff1cb,8,0,566,687,665,655,845,620,247,468,497,551,436,566,501,518,130,-115,245
594,230000,2a2ab41f8f6ff1cb,8,0,652,669,544,740,1032,399,306,506,449,585,503,512,508,533,9,-82,91
1194,310000,c06a2a387c0ee510,8,0,1068,958,710,977,1212,1265,890,1247,1119,1184,1456,1316,1386,1319,-140,272,-412
187,530000,c06a2a387c0ee510,8,0,62,79,45,66,119,104,63,214,133,132,248,173,210,184,-75,116,-191
193,150000,c06a2a387c0ee510,8,0,51,54,43,56,75,86,64,154,131,164,163,146,154,158,-17,-1,-16
1416,110000,c06a2a387c0ee510,8,0,976,1027,677,793,1627,1352,1114,1508,1132,1430,1670,1367,1518,1489,-303,240,-543
420,510000,c06a2a387c0ee510,8,0,234,199,102,145,321,208,187,254,335,308,285,276,280,290,-9,-23,14
384,340000,c06a2a387c0ee510,8,0,167,182,145,176,251,253,175,322,340,315,352,311,332,326,-41,37,-78
1284,370000,c06a2a387c0ee510,8,0,698,710,494,739,1047,878,649,1303,1248,1216,1405,1283,1344,1301,-122,189,-311
292,140000,c06a2a387c0ee510,8,0,101,121,83,105,184,165,123,244,320,272,242,233,238,249,-9,-30,21
984,440000,c06a2a387c0ee510,8,0,453,514,463,571,819,762,448,944,1100,1025,1038,994,1016,1019,-44,13,-57
99,450000,c06a2a387c0ee510,8,0,65,36,87,45,96,92,54,103,134,119,86,123,104,109,37,-33,70
1253,320000,c06a2a387c0ee510,8,0,653,923,563,731,1002,974,650,1188,1289,1048,1276,1137,1206,1154,-139,228,-367
154,360000,c06a2a387c0ee510,8,0,56,89,43,74,97,118,85,164,140,153,162,165,164,160,3,9,-6
773,130000,c06a2a387c0ee510,8,0,302,284,232,288,493,470,361,599,660,769,569,656,612,665,87,-200,287
849,410000,c06a2a387c0ee510,8,0,356,387,282,366,596,517,345,763,731,685,764,754,759,734,-10,79,-89
999,330000,c06a2a387c0ee510,8,0,578,350,278,533,736,534,424,754,915,865,808,908,858,860,100,-57,157
286,420000,c06a2a387c0ee510,8,0,119,115,66,94,173,151,103,240,253,187,234,272,253,231,38,47,-9
239,430000,c06a2a387c0ee510,8,0,91,68,60,83,119,101,59,203,163,182,206,192,199,193,-14,24,-38
249,350000,c06a2a387c0ee510,8,0,123,99,106,97,170,123,106,206,303,187,204,204,204,198,0,17,-17
435,210000,c06a2a387c0ee510,8,0,178,184,111,151,300,181,154,357,324,363,378,413,396,385,35,15,20
150,500000,c06a2a387c0ee510,8,0,66,120,43,58,100,60,71,130,181,128,151,124,138,134,-27,23,-50
390,610000,c06a2a387c0ee510,8,0,228,164,136,164,313,234,179,320,305,340,358,313,336,337,-45,18,-63
227,230000,c06a2a387c0ee510,8,0,113,130,76,95,177,129,74,323,185,255,260,224,242,246,-36,5,-41
272,310000,7023efdab9cedc03,8,0,504,605,431,543,697,325,168,288,309,527,516,379,448,474,-137,-11,-126
116,530000,7023efdab9cedc03,8,0,60,80,64,106,112,40,25,38,54,68,55,75,65,66,20,-13,33
78,150000,7023efdab9cedc03,8,0,65,50,48,60,75,31,18,29,46,51,51,61,56,54,10,0,10
111,110000,7023efdab9cedc03,8,0,105,107,59,86,132,40,51,59,50,54,60,151,106,88,91,6,85
437,510000,7023efdab9cedc03,8,0,194,379,187,278,408,216,117,192,175,229,259,209,234,232,-50,30,-80
401,340000,7023efdab9cedc03,8,0,383,452,363,447,587,357,148,207,278,368,463,445,454,425,-18,95,-113
517,370000,7023efdab9cedc03,8,0,434,524,437,477,555,320,180,373,400,374,355,402,378,377,47,-19,66
103,140000,7023efdab9cedc03,8,0,40,61,59,55,64,30,23,28,38,44,60,71,66,58,11,16,-5
453,440000,7023efdab9cedc03,8,0,191,284,225,342,408,121,39,166,158,211,185,222,204,206,37,-26,63
125,450000,7023efdab9cedc03,8,0,72,86,66,86,129,68,34,47,50,71,60,56,58,62,-4,-11,7
690,320000,7023efdab9cedc03,8,0,1240,1311,1156,1271,1767,893,628,788,879,1067,1002,995,998,1021,-7,-65,58
263,360000,7023efdab9cedc03,8,0,201,205,175,224,302,169,92,161,188,202,170,233,202,202,63,-32,95
289,130000,7023efdab9cedc03,8,0,129,149,129,127,215,80,56,93,108,163,149,199,174,170,50,-14,64
298,410000,7023efdab9cedc03,8,0,264,300,257,320,368,183,97,185,329,340,259,262,260,287,3,-81,84
532,330000,7023efdab9cedc03,8,0,791,867,742,941,1163,445,309,478,511,775,845,706,776,775,-139,70,-209
256,420000,7023efdab9cedc03,8,0,189,253,233,287,401,211,94,172,184,195,243,185,214,208,-58,48,-106
231,430000,7023efdab9cedc03,8,0,202,213,182,259,315,201,83,173,167,198,189,202,196,196,13,-9,22
168,350000,7023efdab9cedc03,8,0,77,86,70,117,145,54,20,51,78,114,140,134,137,129,-6,26,-32
119,210000,7023efdab9cedc03,8,0,56,78,81,68,104,28,21,52,82,45,37,92,64,58,55,-8,63
101,500000,7023efdab9cedc03,8,0,63,77,40,57,62,28,20,37,37,33,64,92,78,63,28,31,-3
142,610000,7023efdab9cedc03,8,0,126,137,141,113,177,107,51,78,83,124,102,102,102,109,0,-22,22
60,230000,7023efdab9cedc03,8,0,29,39,29,28,30,11,11,8,18,20,17,27,22,21,10,-3,13
914,310000,af6f4f548684e14d,8,0,878,839,851,1537,1734,940,540,957,807,919,933,755,844,869,-178,14,-192
329,530000,af6f4f548684e14d,8,0,406,375,464,639,732,400,288,346,301,327,290,401,346,339,111,-37,148
293,150000,af6f4f548684e14d,8,0,346,426,433,493,573,322,195,323,333,363,302,240,271,302,-62,-61,-1
449,110000,af6f4f548684e14d,8,0,572,648,532,915,1057,659,394,601,489,595,532,503,518,543,-29,-63,34
898,510000,af6f4f548684e14d,8,0,821,1394,1020,1293,1876,1072,611,873,761,808,800,793,796,800,-7,-8,1
875,340000,af6f4f548684e14d,8,0,782,938,1018,1287,1597,1015,457,773,664,769,751,688,720,736,-63,-18,-45
1078,370000,af6f4f548684e14d,8,0,1232,1497,1547,1722,2394,1077,522,1253,1236,1215,1019,955,987,1063,-64,-196,132
378,140000,af6f4f548684e14d,8,0,365,407,489,581,742,375,248,450,310,404,335,340,338,360,5,-69,74
972,440000,af6f4f548684e14d,8,0,986,1197,1508,2163,2594,949,463,1024,892,976,1062,838,950,959,-224,86,-310
262,450000,af6f4f548684e14d,8,0,261,338,373,502,713,341,210,322,222,345,302,257,280,301,-45,-43,-2
1305,320000,af6f4f548684e14d,8,0,1497,1413,1635,2059,2647,1466,939,1519,1181,1355,1281,1072,1176,1236,-209,-74,-135
886,360000,af6f4f548684e14d,8,0,687,798,900,1083,1527,753,397,757,746,837,677,745,711,753,68,-160,228
691,130000,af6f4f548684e14d,8,0,745,771,828,1012,1235,691,404,655,694,773,655,680,668,703,25,-118,143
1080,410000,af6f4f548684e14d,8,0,998,1228,1191,1470,2122,1000,589,1119,1013,903,937,951,944,930,14,34,-20
986,330000,af6f4f548684e14d,8,0,942,1042,1090,1626,2068,1003,537,978,796,1015,879,797,838,897,-82,-136,54
965,420000,af6f4f548684e14d,8,0,977,1135,1284,1519,1632,1025,485,1058,873,1015,949,835,892,933,-114,-66,-48
959,430000,af6f4f548684e14d,8,0,1034,1175,1168,1619,2178,1217,467,1068,962,1084,875,893,884,951,18,-209,227
398,350000,af6f4f548684e14d,8,0,426,426,568,767,913,522,257,433,373,497,408,356,382,420,-52,-89,37
428,210000,af6f4f548684e14d,8,0,365,365,407,443,594,254,172,277,329,290,263,262,262,272,-1,-27,26
286,500000,af6f4f548684e14d,8,0,329,386,354,500,762,420,252,342,321,324,387,329,358,347,-58,63,-121
312,610000,af6f4f548684e14d,8,0,283,360,444,478,651,365,184,306,238,357,732,447,590,512,-285,375,-660
232,230000,af6f4f548684e14d,8,0,233,201,203,289,372,142,121,207,187,231,186,143,164,187,-43,-45,2
1207,310000,7cf283430b3b5e38,8,0,1715,1560,1261,1546,1428,635,513,975,1070,1137,2596,1172,1884,1635,-1424,1459,-2883
649,530000,7cf283430b3b5e38,8,0,462,412,350,412,626,249,167,333,316,408,510,602,556,507,92,102,-10
575,150000,7cf283430b3b5e38,8,0,335,434,451,516,701,285,178,320,330,439,413,440,426,431,27,-26,53
124,110000,7cf283430b3b5e38,8,0,248,278,174,264,913,106,74,113,101,453,335,314,324,367,-21,-118,97
2318,510000,7cf283430b3b5e38,8,0,1833,2351,1555,1783,2691,1134,763,1522,1501,1649,1954,1996,1975,1866,42,305,-263
2828,340000,7cf283430b3b5e38,8,0,2572,2578,2110,2138,2356,1607,968,1908,2068,2171,2517,2384,2450,2357,-133,346,-479
5234,370000,7cf283430b3b5e38,8,0,3623,4079,3911,3787,4830,2048,1323,3138,3779,4223,3954,4263,4108,4147,309,-269,578
1391,140000,7cf283430b3b5e38,8,0,770,774,678,852,1073,317,283,629,610,883,1085,1017,1051,995,-68,202,-270
2643,440000,7cf283430b3b5e38,8,0,2230,2219,1912,2435,2500,695,488,1495,1512,1848,2203,1964,2084,2005,-239,355,-594
1065,450000,7cf283430b3b5e38,8,0,597,723,646,783,869,475,293,738,554,830,966,1021,994,939,55,136,-81
5866,320000,7cf283430b3b5e38,8,0,5439,5089,5170,5016,5865,2657,2401,4119,4083,4704,4995,4877,4936,4859,-118,291,-409
1988,360000,7cf283430b3b5e38,8,0,1228,1446,1175,1376,1737,923,549,1502,1828,1895,1662,1811,1736,1789,149,-233,382
3219,130000,7cf283430b3b5e38,8,0,2030,2166,1672,1926,2621,900,720,1379,2198,2809,2761,2856,2808,2809,95,-48,143
4333,410000,7cf283430b3b5e38,8,0,3033,2794,2644,2874,3243,1683,1042,2558,3199,3067,3400,3871,3636,3446,471,333,138
3712,330000,7cf283430b3b5e38,8,0,3079,3258,3003,3295,3490,1289,1038,1965,1876,2506,2778,3135,2956,2806,357,272,85
1835,420000,7cf283430b3b5e38,8,0,1694,1779,1500,1547,1624,929,480,1234,1278,1437,1882,1699,1790,1673,-183,445,-628
2057,430000,7cf283430b3b5e38,8,0,1556,1793,1457,1585,1952,989,516,1513,1616,1696,1720,1686,1703,1701,-34,24,-58
1327,350000,7cf283430b3b5e38,8,0,913,859,836,1130,958,546,402,859,878,1319,1184,1258,1221,1254,74,-135,209
964,210000,7cf283430b3b5e38,8,0,710,667,540,619,821,205,149,446,498,474,571,727,649,591,156,97,59
590,500000,7cf283430b3b5e38,8,0,463,501,422,419,597,296,163,296,401,429,660,507,584,532,-153,231,-384
1205,610000,7cf283430b3b5e38,8,0,830,880,891,912,1151,413,242,475,689,883,1688,1091,1390,1221,-597,805,-1402
412,230000,7cf283430b3b5e38,8,0,332,298,250,347,415,118,130,301,193,254,310,279,294,281,-31,56,-87
103,310000,d4efbebb087fd03f,8,0,170,225,144,225,270,79,27,45,95,103,101,83,92,96,-18,-2,-16
282,530000,d4efbebb087fd03f,8,0,193,215,192,267,384,296,172,285,192,231,213,247,230,230,34,-18,52
202,150000,d4efbebb087fd03f,8,0,211,257,237,359,450,248,124,211,203,178,177,181,179,179,4,-1,5
836,110000,d4efbebb087fd03f,8,0,596,755,684,938,1287,118,74,556,952,1106,818,968,893,964,150,-288,438
905,510000,d4efbebb087fd03f,8,0,1135,1134,707,1002,2805,1326,797,891,676,702,734,761,748,732,27,32,-5
660,340000,d4efbebb087fd03f,8,0,807,752,716,977,1443,903,436,535,520,582,612,532,572,575,-80,30,-110
1747,370000,d4efbebb087fd03f,8,0,2013,2253,1752,2198,3785,1878,1009,1343,1575,1488,1335,1337,1336,1387,2,-153,155
540,140000,d4efbebb087fd03f,8,0,591,635,370,1993,2925,603,248,417,464,574,426,448,437,483,22,-148,170
1245,440000,d4efbebb087fd03f,8,0,1851,1526,1065,2044,2419,914,399,1078,1095,1082,1215,1038,1126,1112,-177,133,-310
495,450000,d4efbebb087fd03f,8,0,565,452,368,493,935,666,303,492,403,512,470,474,472,485,4,-42,46
908,320000,d4efbebb087fd03f,8,0,1263,1231,1184,1531,2308,910,648,752,1041,985,944,821,882,917,-123,-41,-82
643,360000,d4efbebb087fd03f,8,0,657,831,701,917,1377,999,364,509,561,555,561,469,515,528,-92,6,-98
1050,130000,d4efbebb087fd03f,8,0,991,941,754,1144,2067,1110,641,741,953,1002,876,936,906,938,60,-126,186
1740,410000,d4efbebb087fd03f,8,0,1922,1491,1090,1965,3560,2272,888,1199,1423,1368,1487,1652,1570,1502,165,119,46
2222,330000,d4efbebb087fd03f,8,0,2534,1978,2287,3147,4324,1028,639,1114,1097,2340,1882,1700,1791,1974,-182,-458,276
525,420000,d4efbebb087fd03f,8,0,636,528,521,941,1534,1004,347,476,456,410,475,460,468,448,-15,65,-80
750,430000,d4efbebb087fd03f,8,0,1148,1102,762,1142,1719,1133,438,685,688,650,716,659,688,675,-57,66,-123
609,350000,d4efbebb087fd03f,8,0,861,605,468,762,1967,434,268,656,565,712,722,602,662,679,-120,10,-130
157,210000,d4efbebb087fd03f,8,0,373,319,239,291,520,199,149,205,202,188,167,160,164,172,-7,-21,14
366,500000,d4efbebb087fd03f,8,0,500,317,253,326,532,432,291,409,310,302,286,280,283,289,-6,-16,10
818,610000,d4efbebb087fd03f,8,0,1191,1013,830,1010,1651,919,422,609,612,587,580,1155,868,774,575,-7,582
136,230000,d4efbebb087fd03f,8,0,179,154,114,204,257,135,104,114,128,104,132,112,122,116,-20,28,-48
48,310000,7245e0ee27b195cd,8,0,82,78,75,125,158,63,40,60,51,45,46,45,46,45,-1,1,-2
341,530000,7245e0ee27b195cd,8,0,297,409,425,375,535,421,246,288,240,252,266,378,322,299,112,14,98
180,150000,7245e0ee27b195cd,8,0,186,321,287,448,676,363,164,250,212,180,206,169,188,185,-37,26,-63
68,110000,7245e0ee27b195cd,8,0,229,328,289,360,496,86,74,109,80,71,61,54,58,62,-7,-10,3
720,510000,7245e0ee27b195cd,8,0,740,894,870,831,1260,724,451,621,526,535,628,654,641,606,26,93,-67
391,340000,7245e0ee27b195cd,8,0,423,570,478,510,806,576,272,358,315,316,346,322,334,328,-24,30,-54
1153,370000,7245e0ee27b195cd,8,0,1385,1544,1660,1778,2915,1529,762,977,1071,1025,958,930,944,971,-28,-67,39
702,140000,7245e0ee27b195cd,8,0,526,657,689,668,1092,615,366,578,543,590,543,530,536,554,-13,-47,34
867,440000,7245e0ee27b195cd,8,0,1003,987,1170,1384,1437,718,363,821,836,734,867,743,805,781,-124,133,-257
373,450000,7245e0ee27b195cd,8,0,275,336,321,463,659,452,233,370,288,292,316,346,331,318,30,24,6
481,320000,7245e0ee27b195cd,8,0,503,619,691,743,1008,543,405,518,460,406,448,428,438,427,-20,42,-62
348,360000,7245e0ee27b195cd,8,0,384,576,518,577,816,634,247,323,301,331,301,285,293,306,-16,-30,14
1221,130000,7245e0ee27b195cd,8,0,1190,1442,1308,1432,2365,1304,951,1023,1070,1210,930,1140,1035,1093,210,-280,490
1131,410000,7245e0ee27b195cd,8,0,1180,1362,1148,1406,2228,1526,717,888,888,823,850,1053,952,909,203,27,176
573,330000,7245e0ee27b195cd,8,0,656,656,660,874,1121,438,306,511,460,520,507,491,499,506,-16,-13,-3
342,420000,7245e0ee27b195cd,8,0,445,594,534,655,903,635,255,364,342,325,362,407,384,365,45,37,8
513,430000,7245e0ee27b195cd,8,0,665,852,609,763,1216,773,321,479,531,540,517,429,473,495,-88,-23,-65
300,350000,7245e0ee27b195cd,8,0,279,280,218,239,420,249,153,274,195,252,248,212,230,237,-36,-4,-32
291,210000,7245e0ee27b195cd,8,0,361,450,328,514,641,287,222,321,326,279,247,251,249,259,4,-32,36
260,500000,7245e0ee27b195cd,8,0,289,325,272,292,402,296,142,238,207,233,232,240,236,235,8,-1,9
664,610000,7245e0ee27b195cd,8,0,667,705,729,755,1158,815,410,484,484,492,471,470,470,478,-1,-21,20
211,230000,7245e0ee27b195cd,8,0,179,249,176,328,336,166,145,205,161,183,216,199,208,199,-17,33,-50
83,310000,8c915fe4632fb9fa,8,0,149,181,158,314,461,180,102,190,125,145,92,77,84,105,-15,-53,38
573,530000,8c915fe4632fb9fa,8,0,336,447,627,757,1396,1059,575,778,650,682,486,654,570,607,168,-196,364
415,150000,8c915fe4632fb9fa,8,0,216,287,324,527,720,520,270,473,409,472,356,344,350,391,-12,-116,104
43,110000,8c915fe4632fb9fa,8,0,177,237,199,242,487,101,86,162,127,117,78,41,60,79,-37,-39,2
1055,510000,8c915fe4632fb9fa,8,0,845,1263,1243,1605,2433,1860,1194,1302,1156,1192,925,872,898,996,-53,-267,214
739,340000,8c915fe4632fb9fa,8,0,840,1069,1269,1370,2298,1440,720,878,861,934,738,651,694,774,-87,-196,109
1563,370000,8c915fe4632fb9fa,8,0,999,1485,1686,2126,3804,2217,1109,1504,1812,1956,1321,1432,1376,1570,111,-635,746
597,140000,8c915fe4632fb9fa,8,0,379,496,642,748,1215,772,404,591,661,732,531,562,546,608,31,-201,232
649,440000,8c915fe4632fb9fa,8,0,650,835,848,1467,2021,1040,446,977,1064,948,854,663,758,822,-191,-94,-97
303,450000,8c915fe4632fb9fa,8,0,284,342,388,511,880,738,330,660,454,586,385,399,392,457,14,-201,215
863,320000,8c915fe4632fb9fa,8,0,1001,1116,1451,1816,2525,1540,1130,1441,1246,1265,930,913,922,1036,-17,-335,318
477,360000,8c915fe4632fb9fa,8,0,440,725,733,889,1320,1015,377,598,631,632,491,445,468,523,-46,-141,95
1628,130000,8c915fe4632fb9fa,8,0,1014,1437,1548,2026,3281,1882,1126,1456,2041,2368,1518,1714,1616,1867,196,-850,1046
1395,410000,8c915fe4632fb9fa,8,0,953,1313,1473,1843,2975,2324,1002,1413,1518,1509,1135,1362,1248,1335,227,-374,601
804,330000,8c915fe4632fb9fa,8,0,805,1089,1175,1502,2235,958,565,880,893,948,697,814,756,820,117,-251,368
627,420000,8c915fe4632fb9fa,8,0,669,868,924,1339,1557,1148,463,782,723,758,663,696,680,706,33,-95,128
508,430000,8c915fe4632fb9fa,8,0,438,633,772,835,1281,1235,439,733,664,655,498,506,502,553,8,-157,165
306,350000,8c915fe4632fb9fa,8,0,282,307,414,622,877,518,365,529,461,541,380,328,354,416,-52,-161,109
286,210000,8c915fe4632fb9fa,8,0,231,291,296,396,542,311,224,349,397,405,266,303,284,325,37,-139,176
258,500000,8c915fe4632fb9fa,8,0,259,311,316,419,666,489,274,346,334,368,358,284,321,337,-74,-10,-64
551,610000,8c915fe4632fb9fa,8,0,362,519,627,715,1549,1036,394,463,535,597,405,487,446,496,82,-192,274
672,230000,8c915fe4632fb9fa,8,0,422,442,411,616,998,401,372,684,679,736,526,592,559,618,66,-210,276
376,310000,6155b214590c66e6,8,0,522,661,472,781,1047,423,192,279,354,355,429,362,396,382,-67,74,-141
1036,530000,6155b214590c66e6,8,0,877,1084,1148,1159,1879,1354,680,631,992,1295,955,1148,1052,1133,193,-340,533
839,150000,6155b214590c66e6,8,0,578,725,701,941,1442,814,347,566,786,1042,724,802,763,856,78,-318,396
291,110000,6155b214590c66e6,8,0,496,664,474,569,1295,274,176,281,280,376,386,433,410,398,47,10,37
1860,510000,6155b214590c66e6,8,0,1488,2289,1556,2162,4188,2540,1081,1111,1488,1668,1412,1619,1516,1566,207,-256,463
1555,340000,6155b214590c66e6,8,0,1803,1996,1889,2073,3650,2495,863,893,1218,1582,1360,1404,1382,1449,44,-222,266
2942,370000,6155b214590c66e6,8,0,2886,3461,3252,3594,6275,3467,1356,2002,3249,3444,2666,3057,2862,3056,391,-778,1169
855,140000,6155b214590c66e6,8,0,652,805,800,914,1576,743,357,500,790,998,720,798,759,839,78,-278,356
2128,440000,6155b214590c66e6,8,0,2246,2808,2902,3269,4342,1784,653,1364,1722,2162,2247,2038,2142,2149,-209,85,-294
609,450000,6155b214590c66e6,8,0,574,670,621,739,1316,892,381,556,538,802,574,699,636,692,125,-228,353
2570,320000,6155b214590c66e6,8,0,3230,3453,3560,3776,5864,3032,1760,2316,2607,3244,2604,2564,2584,2804,-40,-640,600
887,360000,6155b214590c66e6,8,0,860,1325,1195,1285,2160,1579,453,603,962,960,811,902,856,891,91,-149,240
2481,130000,6155b214590c66e6,8,0,2258,2481,2298,2594,4551,2375,1231,1427,2467,3049,2213,2567,2390,2610,354,-836,1190
3143,410000,6155b214590c66e6,8,0,3396,3571,3427,4047,8018,5309,1586,1915,2716,3025,2701,2930,2816,2885,229,-324,553
2234,330000,6155b214590c66e6,8,0,2229,2579,2724,3014,4336,1679,826,1161,1890,2275,1899,2230,2064,2135,331,-376,707
1217,420000,6155b214590c66e6,8,0,1341,1747,1512,1848,3179,2049,551,906,1028,1278,1264,1359,1312,1300,95,-14,109
1482,430000,6155b214590c66e6,8,0,1679,2187,1872,2355,3747,2461,732,1157,1395,1621,1288,1479,1384,1463,191,-333,524
708,350000,6155b214590c66e6,8,0,618,738,859,1140,1306,596,364,463,616,759,757,740,748,752,-17,-2,-15
1102,210000,6155b214590c66e6,8,0,1132,1218,970,1188,1784,769,415,765,1227,1203,969,1200,1084,1124,231,-234,465
620,500000,6155b214590c66e6,8,0,655,770,622,761,1417,877,373,399,529,594,627,619,623,613,-8,33,-41
773,610000,6155b214590c66e6,8,0,654,727,899,841,1546,1008,303,361,648,917,661,790,726,789,129,-256,385
865,230000,6155b214590c66e6,8,0,777,675,517,944,1290,579,365,604,725,778,831,876,854,828,45,53,-8
968,310000,28e29f2c03dcd84c,8,0,720,820,623,807,1293,851,433,764,667,727,689,522,606,646,-167,-38,-129
436,530000,28e29f2c03dcd84c,8,0,405,456,394,535,639,509,300,415,361,462,414,443,428,440,29,-48,77
576,150000,28e29f2c03dcd84c,8,0,480,482,477,451,580,494,276,556,527,562,528,446,487,512,-82,-34,-48
1075,110000,28e29f2c03dcd84c,8,0,1143,1276,969,1288,2146,1327,923,1308,982,1002,1096,834,965,977,-262,94,-356
861,510000,28e29f2c03dcd84c,8,0,715,1123,634,781,1105,856,454,680,597,621,651,776,714,683,125,30,95
895,340000,28e29f2c03dcd84c,8,0,667,840,774,803,1070,953,364,644,584,685,706,708,707,700,2,21,-19
1334,370000,28e29f2c03dcd84c,8,0,1162,1315,1224,1513,1837,1329,778,1244,1284,1298,1141,1319,1230,1253,178,-157,335
991,140000,28e29f2c03dcd84c,8,0,750,729,770,798,1203,945,474,746,713,727,660,639,650,675,-21,-67,46
618,440000,28e29f2c03dcd84c,8,0,351,438,425,536,825,423,180,427,549,477,696,389,542,521,-307,219,-526
141,450000,28e29f2c03dcd84c,8,0,121,141,135,160,243,179,71,140,141,183,151,137,144,157,-14,-32,18
1676,320000,28e29f2c03dcd84c,8,0,1793,1838,1848,1951,2643,1820,1058,1565,1288,1340,1313,1263,1288,1305,-50,-27,-23
351,360000,28e29f2c03dcd84c,8,0,334,419,377,424,571,408,151,325,301,312,293,255,274,287,-38,-19,-19
1590,130000,28e29f2c03dcd84c,8,0,1321,1377,1264,1433,1923,1604,884,1377,1523,1631,1539,1425,1482,1532,-114,-92,-22
1238,410000,28e29f2c03dcd84c,8,0,1010,1081,952,1113,1482,1178,548,1003,1062,1044,1052,1125,1088,1074,73,8,65
814,330000,28e29f2c03dcd84c,8,0,601,733,722,894,1112,767,352,679,681,651,616,628,622,632,12,-35,47
388,420000,28e29f2c03dcd84c,8,0,295,373,329,377,483,446,164,271,261,296,275,330,302,300,55,-21,76
447,430000,28e29f2c03dcd84c,8,0,383,464,438,477,783,487,262,452,359,428,383,395,389,402,12,-45,57
259,350000,28e29f2c03dcd84c,8,0,189,235,212,345,456,397,140,227,217,291,297,182,240,257,-115,6,-121
255,210000,28e29f2c03dcd84c,8,0,296,261,247,251,310,270,165,356,218,179,255,221,238,218,-34,76,-110
447,500000,28e29f2c03dcd84c,8,0,414,486,426,491,644,555,263,408,381,378,462,374,418,405,-88,84,-172
624,610000,28e29f2c03dcd84c,8,0,413,568,617,622,758,719,361,603,579,645,499,553,526,566,54,-146,200
121,230000,28e29f2c03dcd84c,8,0,187,159,142,152,169,104,79,149,106,141,121,123,122,128,2,-20,22
42,310000,37aa9169b575ef79,8,0,46,41,395,67,117,63,37,86,109,100,151,123,137,125,-28,51,-79
1207,530000,37aa9169b575ef79,8,0,1426,1254,988,1142,1590,946,692,1035,755,884,765,1277,1021,975,512,-119,631
1139,150000,37aa9169b575ef79,8,0,864,895,802,945,982,602,413,714,724,743,629,652,640,675,23,-114,137
289,110000,37aa9169b575ef79,8,0,794,737,477,625,985,300,271,404,282,274,292,278,285,281,-14,18,-32
2754,510000,37aa9169b575ef79,8,0,2791,2955,1733,2221,3340,1470,1639,3175,2405,2457,2398,2530,2464,2462,132,-59,191
371,340000,37aa9169b575ef79,8,0,552,488,424,410,575,248,260,384,279,286,452,366,409,368,-86,166,-252
3096,370000,37aa9169b575ef79,8,0,3130,3837,3617,3662,4024,1903,1708,2748,2376,2932,2420,2797,2608,2716,377,-512,889
1189,140000,37aa9169b575ef79,8,0,1217,1561,1243,1188,1616,679,442,672,792,892,815,1028,922,912,213,-77,290
1885,440000,37aa9169b575ef79,8,0,1963,2010,1906,2111,2398,1196,1075,2249,1558,2005,1936,1682,1809,1874,-254,-69,-185
573,450000,37aa9169b575ef79,8,0,319,409,384,459,435,440,301,449,664,501,523,446,484,490,-77,22,-99
694,320000,37aa9169b575ef79,8,0,745,840,781,777,930,527,626,655,605,586,670,623,646,626,-47,84,-131
355,360000,37aa9169b575ef79,8,0,358,538,488,482,540,354,189,356,270,359,296,244,270,300,-52,-63,11
3648,130000,37aa9169b575ef79,8,0,3388,3910,3483,3233,4206,2068,1780,2633,2656,3148,2856,3242,3049,3082,386,-292,678
1836,410000,37aa9169b575ef79,8,0,2100,2323,1931,2018,2962,1570,1050,1823,1515,1509,1506,1785,1646,1600,279,-3,282
542,330000,37aa9169b575ef79,8,0,777,723,606,634,886,424,422,628,555,606,538,517,528,554,-21,-68,47
440,420000,37aa9169b575ef79,8,0,715,725,585,544,920,483,270,442,304,376,403,430,416,403,27,27,0
1284,430000,37aa9169b575ef79,8,0,1533,1680,1444,1489,2336,1714,653,1232,835,1023,1076,1149,1112,1083,73,53,20
413,350000,37aa9169b575ef79,8,0,773,710,690,597,622,308,292,460,424,486,428,470,449,461,42,-58,100
1601,210000,37aa9169b575ef79,8,0,1815,1871,1308,1478,1878,681,691,1319,1119,1215,1237,1419,1328,1290,182,22,160
199,500000,37aa9169b575ef79,8,0,502,347,184,172,247,131,105,125,160,126,176,161,168,154,-15,50,-65
780,610000,37aa9169b575ef79,8,0,1106,695,580,634,1051,558,384,605,487,577,560,603,582,580,43,-17,60
2283,230000,37aa9169b575ef79,8,0,1427,1562,1308,1636,1781,730,952,1556,1254,1336,1463,1649,1556,1483,186,127,59
1782,310000,63065128401bb3ff,8,0,1500,2397,1674,2362,3060,1909,501,2672,4039,883,4181,1421,2801,2162,-2760,3298,-6058
1307,530000,63065128401bb3ff,8,0,974,1076,1038,1033,1402,656,504,651,603,785,827,1300,1064,971,473,42,431
777,150000,63065128401bb3ff,8,0,446,541,468,630,827,268,214,376,413,543,491,575,533,536,84,-52,136
297,110000,63065128401bb3ff,8,0,1118,835,516,1494,2145,217,200,2331,1550,280,361,498,430,380,137,81,56
2351,510000,63065128401bb3ff,8,0,1864,2707,1708,2119,2450,1355,937,1478,2078,1399,1459,1801,1630,1553,342,60,282
2510,340000,63065128401bb3ff,8,0,2809,2863,2529,2927,3132,1460,775,1436,1362,1591,1598,1947,1772,1712,349,7,342
3929,370000,63065128401bb3ff,8,0,4018,4409,4129,4087,5401,1885,1225,2010,2269,2615,2569,3263,2916,2816,694,-46,740
2019,140000,63065128401bb3ff,8,0,1490,1510,1452,1547,2066,692,491,877,974,1192,1135,1670,1402,1332,535,-57,592
1754,440000,63065128401bb3ff,8,0,2112,2192,2036,2188,2519,625,462,1475,1506,1216,1544,1515,1530,1425,-29,328,-357
551,450000,63065128401bb3ff,8,0,503,589,568,596,616,308,176,366,289,407,451,518,484,459,67,44,23
4173,320000,63065128401bb3ff,8,0,4854,5016,4475,5007,5643,2143,1862,2644,2631,3008,3307,4299,3803,3538,992,299,693
1810,360000,63065128401bb3ff,8,0,1681,2044,1627,1981,2357,973,442,916,895,1031,1009,1333,1171,1124,324,-22,346
4869,130000,63065128401bb3ff,8,0,3829,3951,3277,3711,5424,1723,1261,2043,2652,2981,2611,4091,3351,3228,1480,-370,1850
4961,410000,63065128401bb3ff,8,0,4398,4500,3793,4237,5119,2463,1238,2429,2562,2723,3091,4009,3550,3274,918,368,550
2205,330000,63065128401bb3ff,8,0,2513,2777,2324,2401,2755,895,768,1359,1321,1533,1474,1767,1620,1591,293,-59,352
1415,420000,63065128401bb3ff,8,0,1591,1818,1296,1466,1985,1002,357,841,848,822,1085,1431,1258,1113,346,263,83
1969,430000,63065128401bb3ff,8,0,1906,2187,1670,2078,2533,1085,531,1104,1014,1204,1328,1663,1496,1398,335,124,211
1223,350000,63065128401bb3ff,8,0,1347,1279,1170,1218,1549,440,400,775,721,1235,973,1141,1057,1116,168,-262,430
861,210000,63065128401bb3ff,8,0,806,897,700,869,1098,268,212,386,587,555,690,977,834,741,287,135,152
1072,500000,63065128401bb3ff,8,0,1230,1171,824,938,1120,617,359,603,607,619,800,1027,914,815,227,181,46
1436,610000,63065128401bb3ff,8,0,1278,1300,1165,1199,1748,631,397,661,1831,842,1735,1691,1713,1423,-44,893,-937
467,230000,63065128401bb3ff,8,0,404,404,286,466,480,162,156,276,218,323,452,354,403,376,-98,129,-227
334,310000,ea489c253676aafc,8,0,535,502,314,574,754,315,362,767,319,351,300,314,307,322,14,-51,65
578,530000,ea489c253676aafc,8,0,450,435,635,692,866,452,295,448,404,525,442,543,492,503,101,-83,184
704,150000,ea489c253676aafc,8,0,452,427,495,612,941,427,254,591,556,550,476,504,490,510,28,-74,102
110,110000,ea489c253676aafc,8,0,397,346,199,341,546,125,89,159,100,115,114,150,132,126,36,-1,37
1050,510000,ea489c253676aafc,8,0,1197,903,838,1187,1812,1017,704,1344,1235,1081,1056,878,967,1005,-178,-25,-153
857,340000,ea489c253676aafc,8,0,958,734,813,952,1669,741,475,869,701,638,694,733,714,688,39,56,-17
3266,370000,ea489c253676aafc,8,0,3299,2451,2995,3812,5496,2330,1515,2865,2841,2834,2558,2825,2692,2739,267,-276,543
1538,140000,ea489c253676aafc,8,0,1588,1052,1126,1234,2626,1165,641,1247,1425,1531,1329,1557,1443,1472,228,-202,430
681,440000,ea489c253676aafc,8,0,448,529,384,525,1055,368,255,433,540,513,805,467,636,595,-338,292,-630
128,450000,ea489c253676aafc,8,0,291,255,362,355,448,365,155,240,485,249,405,222,314,292,-183,156,-339
955,320000,ea489c253676aafc,8,0,1085,864,1310,1728,2261,1167,1028,1507,1281,827,792,892,842,837,100,-35,135
217,360000,ea489c253676aafc,8,0,335,301,356,946,847,641,223,316,236,253,238,242,240,244,4,-15,19
3386,130000,ea489c253676aafc,8,0,3609,2265,2586,3058,5478,1932,1551,2981,3513,3250,2524,3284,2904,3019,760,-726,1486
1721,410000,ea489c253676aafc,8,0,1452,1141,1472,1941,3092,1731,893,1695,1504,1408,1487,1714,1600,1536,227,79,148
432,330000,ea489c253676aafc,8,0,913,659,638,706,1205,504,467,741,598,514,446,578,512,513,132,-68,200
172,420000,ea489c253676aafc,8,0,263,202,272,348,657,298,154,273,222,166,164,170,167,167,6,-2,8
393,430000,ea489c253676aafc,8,0,701,698,568,587,1351,576,253,448,437,409,373,484,428,422,111,-36,147
301,350000,ea489c253676aafc,8,0,355,342,307,452,617,215,148,255,232,240,199,231,215,223,32,-41,73
892,210000,ea489c253676aafc,8,0,716,684,572,853,1026,394,408,768,721,776,679,667,673,707,-12,-97,85
199,500000,ea489c253676aafc,8,0,474,304,408,379,694,353,248,346,329,249,207,249,228,235,42,-42,84
614,610000,ea489c253676aafc,8,0,832,623,693,804,1400,754,418,791,600,553,553,625,589,577,72,0,72
859,230000,ea489c253676aafc,8,0,508,307,324,496,710,280,266,503,464,518,466,471,468,485,5,-52,57
307,310000,cd5841d44fd7625e,8,0,232,150,148,312,359,339,177,321,249,248,328,254,291,277,-74,80,-154
418,530000,cd5841d44fd7625e,8,0,290,304,344,442,485,409,248,357,375,412,347,430,388,396,83,-65,148
411,150000,cd5841d44fd7625e,8,0,348,325,432,401,434,519,319,522,443,583,484,431,458,499,-53,-99,46
860,110000,cd5841d44fd7625e,8,0,1183,1150,795,1121,1802,1263,877,1267,1047,1549,1033,967,1000,1183,-66,-516,450
1009,510000,cd5841d44fd7625e,8,0,519,741,610,732,1083,1390,565,951,827,852,794,845,820,830,51,-58,109
499,340000,cd5841d44fd7625e,8,0,360,323,440,519,629,667,315,471,534,553,570,581,576,568,11,17,-6
1927,370000,cd5841d44fd7625e,8,0,1311,1391,1370,1666,1642,1861,878,1578,1694,1792,1554,1627,1590,1658,73,-238,311
409,140000,cd5841d44fd7625e,8,0,332,330,480,421,414,426,317,451,395,445,395,431,413,424,36,-50,86
839,440000,cd5841d44fd7625e,8,0,516,523,704,995,1243,727,322,827,693,791,804,769,786,788,-35,13,-48
192,450000,cd5841d44fd7625e,8,0,101,156,159,192,214,225,119,204,139,193,190,168,179,184,-22,-3,-19
1296,320000,cd5841d44fd7625e,8,0,871,1280,881,1099,1374,1336,868,1301,1124,1278,1241,1197,1219,1239,-44,-37,-7
309,360000,cd5841d44fd7625e,8,0,169,178,237,276,329,364,141,291,237,315,278,285,282,293,7,-37,44
1864,130000,cd5841d44fd7625e,8,0,1360,1115,1052,1461,1615,1768,1165,1697,1805,2074,1714,1806,1760,1865,92,-360,452
1579,410000,cd5841d44fd7625e,8,0,1047,1104,1357,1223,1443,1429,856,1325,1403,1419,1413,1478,1446,1437,65,-6,71
732,330000,cd5841d44fd7625e,8,0,404,404,512,747,863,742,356,707,633,707,646,663,654,672,17,-61,78
546,420000,cd5841d44fd7625e,8,0,379,393,374,473,566,558,262,443,396,470,482,493,488,482,11,12,-1
399,430000,cd5841d44fd7625e,8,0,291,253,248,418,494,519,230,424,383,397,379,387,383,388,8,-18,26
315,350000,cd5841d44fd7625e,8,0,183,186,285,325,402,404,188,330,251,340,301,284,292,308,-17,-39,22
765,210000,cd5841d44fd7625e,8,0,721,569,738,644,1082,704,546,870,783,781,790,785,788,785,-5,9,-14
381,500000,cd5841d44fd7625e,8,0,213,262,251,282,391,433,202,335,319,317,436,335,386,363,-101,119,-220
500,610000,cd5841d44fd7625e,8,0,360,419,276,346,497,487,257,378,390,460,393,519,456,457,126,-67,193
1044,230000,cd5841d44fd7625e,8,0,929,731,657,664,964,785,666,1198,1070,1179,970,890,930,1013,-80,-209,129
602,310000,b25c4e2e3856af22,8,0,946,1150,1010,1563,1504,815,447,731,532,612,632,552,592,599,-80,20,-100
439,530000,b25c4e2e3856af22,8,0,595,570,759,692,785,585,277,403,310,422,368,501,434,430,133,-54,187
170,150000,b25c4e2e3856af22,8,0,333,327,407,342,430,303,110,229,177,183,153,136,144,157,-17,-30,13
270,110000,b25c4e2e3856af22,8,0,772,925,740,925,1127,376,284,427,371,462,336,275,306,358,-61,-126,65
717,510000,b25c4e2e3856af22,8,0,1085,1885,1100,1320,1775,1096,562,764,657,680,772,616,694,689,-156,92,-248
685,340000,b25c4e2e3856af22,8,0,980,1023,1001,1064,1490,952,364,600,581,589,605,632,618,609,27,16,11
940,370000,b25c4e2e3856af22,8,0,1323,1432,1303,1408,1739,940,501,805,813,957,836,892,864,895,56,-121,177
135,140000,b25c4e2e3856af22,8,0,295,289,333,332,371,229,113,151,138,130,107,102,104,113,-5,-23,18
780,440000,b25c4e2e3856af22,8,0,1195,1320,1463,1644,2216,854,451,986,862,846,947,768,858,854,-179,101,-280
169,450000,b25c4e2e3856af22,8,0,218,240,280,255,372,218,114,237,155,197,163,181,172,180,18,-34,52
1181,320000,b25c4e2e3856af22,8,0,1947,1897,1872,2263,3132,1586,987,1345,1015,1158,1068,1086,1077,1104,18,-90,108
461,360000,b25c4e2e3856af22,8,0,684,855,798,870,1144,754,284,498,430,503,444,457,450,468,13,-59,72
679,130000,b25c4e2e3856af22,8,0,985,861,883,944,1218,652,442,599,687,716,543,668,606,642,125,-173,298
653,410000,b25c4e2e3856af22,8,0,1056,1067,1021,1121,1578,856,471,700,719,644,669,703,686,672,34,25,9
1334,330000,b25c4e2e3856af22,8,0,2037,2367,2323,2703,3371,1749,893,1369,1150,1156,1037,1172,1104,1122,135,-119,254
519,420000,b25c4e2e3856af22,8,0,829,920,1033,988,1333,941,363,579,523,593,600,621,610,605,21,7,14
642,430000,b25c4e2e3856af22,8,0,908,1056,973,1081,1561,1003,386,716,610,659,562,594,578,605,32,-97,129
372,350000,b25c4e2e3856af22,8,0,684,714,853,905,1102,667,370,551,387,534,372,366,369,424,-6,-162,156
272,210000,b25c4e2e3856af22,8,0,478,491,437,403,555,253,188,258,212,206,203,265,234,225,62,-3,65
250,500000,b25c4e2e3856af22,8,0,422,477,428,496,740,452,184,293,290,264,303,274,288,280,-29,39,-68
238,610000,b25c4e2e3856af22,8,0,351,433,450,479,533,395,223,292,216,328,233,285,259,282,52,-95,147
238,230000,b25c4e2e3856af22,8,0,461,359,320,352,428,213,219,281,217,259,239,210,224,236,-29,-20,-9
607,310000,4a103c30d593fbbe,8,0,563,552,450,685,688,275,231,396,369,368,427,353,390,383,-74,59,-133
556,530000,4a103c30d593fbbe,8,0,743,640,687,714,1001,409,321,443,427,437,368,556,462,454,188,-69,257
607,150000,4a103c30d593fbbe,8,0,544,557,650,671,789,370,239,440,455,525,460,522,491,502,62,-65,127
542,110000,4a103c30d593fbbe,8,0,1288,1431,1045,1332,1807,402,360,619,496,497,491,482,486,490,-9,-6,-3
2475,510000,4a103c30d593fbbe,8,0,2009,2921,2017,2913,3590,1589,1106,1523,1538,1537,1666,1861,1764,1688,195,129,66
1713,340000,4a103c30d593fbbe,8,0,1431,1596,1491,1717,1968,921,593,995,1124,1199,1070,1346,1208,1205,276,-129,405
2655,370000,4a103c30d593fbbe,8,0,2387,2615,2547,2776,3299,1329,945,1856,2083,2108,1738,2082,1910,1976,344,-370,714
866,140000,4a103c30d593fbbe,8,0,800,787,813,782,1130,401,261,510,549,610,526,688,607,608,162,-84,246
1368,440000,4a103c30d593fbbe,8,0,1303,1438,1702,2171,2397,475,354,1081,908,1044,1235,994,1114,1091,-241,191,-432
397,450000,4a103c30d593fbbe,8,0,282,358,395,493,595,225,179,348,224,290,274,316,295,293,42,-16,58
3088,320000,4a103c30d593fbbe,8,0,3107,2962,3228,3579,4302,1623,1477,2234,2129,2434,2155,2485,2320,2358,330,-279,609
808,360000,4a103c30d593fbbe,8,0,641,755,781,885,1016,398,230,537,551,590,548,652,600,597,104,-42,146
4173,130000,4a103c30d593fbbe,8,0,2979,2860,2877,2989,3954,1565,1311,2239,2725,3260,2705,3344,3024,3103,639,-555,1194
2996,410000,4a103c30d593fbbe,8,0,2398,2493,2358,2638,3291,1489,872,1684,1948,1801,1780,2489,2134,2023,709,-21,730
2472,330000,4a103c30d593fbbe,8,0,1914,1992,2163,2458,2897,961,793,1491,1417,1453,1417,1645,1531,1505,228,-36,264
966,420000,4a103c30d593fbbe,8,0,996,1142,948,1247,1304,805,357,634,667,656,762,898,830,772,136,106,30
991,430000,4a103c30d593fbbe,8,0,817,950,757,948,1222,427,264,565,544,561,563,728,646,617,165,2,163
690,350000,4a103c30d593fbbe,8,0,640,694,837,946,924,385,327,518,415,620,444,541,492,535,97,-176,273
1272,210000,4a103c30d593fbbe,8,0,1088,1057,1007,1160,1513,414,423,828,916,847,707,895,801,816,188,-140,328
435,500000,4a103c30d593fbbe,8,0,374,365,407,493,612,296,209,288,300,336,388,329,358,351,-59,52,-111
835,610000,4a103c30d593fbbe,8,0,761,801,945,946,1143,404,239,410,468,587,452,654,553,564,202,-135,337
1100,230000,4a103c30d593fbbe,8,0,1154,914,753,1190,1198,462,436,1058,713,772,690,729,710,730,39,-82,121
758,310000,7a7885e2d7c00bcf,8,0,670,690,633,790,925,325,455,653,555,624,740,612,676,659,-128,116,-244
290,530000,7a7885e2d7c00bcf,8,0,447,408,431,527,546,194,218,317,270,316,211,290,250,272,79,-105,184
328,150000,7a7885e2d7c00bcf,8,0,341,355,371,359,418,168,163,287,292,335,266,288,277,296,22,-69,91
559,110000,7a7885e2d7c00bcf,8,0,911,1074,915,1162,1615,471,523,831,698,714,664,617,640,665,-47,-50,3
820,510000,7a7885e2d7c00bcf,8,0,722,1155,772,961,1167,445,516,738,665,640,630,656,643,642,26,-10,36
791,340000,7a7885e2d7c00bcf,8,0,767,841,878,933,1003,374,418,658,653,606,565,618,592,596,53,-41,94
2002,370000,7a7885e2d7c00bcf,8,0,1852,2308,2307,2370,2766,875,984,1739,1860,1899,1420,1615,1518,1645,195,-479,674
307,140000,7a7885e2d7c00bcf,8,0,300,313,320,355,484,139,184,247,243,229,225,247,236,234,22,-4,26
829,440000,7a7885e2d7c00bcf,8,0,951,992,1092,1209,1464,402,402,896,629,772,826,680,753,759,-146,54,-200
183,450000,7a7885e2d7c00bcf,8,0,262,246,259,290,384,118,109,224,157,222,215,154,184,197,-61,-7,-54
2422,320000,7a7885e2d7c00bcf,8,0,2209,2679,2595,2801,3241,1057,1612,2234,1953,2227,1909,2048,1978,2061,139,-318,457
404,360000,7a7885e2d7c00bcf,8,0,393,442,498,481,511,213,176,385,307,351,273,345,309,323,72,-78,150
1916,130000,7a7885e2d7c00bcf,8,0,1461,1525,1603,1929,2115,754,885,1533,1690,1813,1571,1661,1616,1682,90,-242,332
1211,410000,7a7885e2d7c00bcf,8,0,1283,1383,1309,1461,1740,591,724,1200,1228,1058,967,1158,1062,1061,191,-91,282
2258,330000,7a7885e2d7c00bcf,8,0,1697,1991,2033,2127,2662,818,1237,1764,1676,1729,1525,1884,1704,1713,359,-204,563
504,420000,7a7885e2d7c00bcf,8,0,596,611,603,616,685,305,279,470,356,444,412,438,425,431,26,-32,58
480,430000,7a7885e2d7c00bcf,8,0,514,645,501,559,768,256,278,497,347,424,341,409,375,391,68,-83,151
356,350000,7a7885e2d7c00bcf,8,0,451,397,473,480,608,216,257,389,262,395,326,356,341,359,30,-69,99
352,210000,7a7885e2d7c00bcf,8,0,505,553,489,516,595,169,217,412,408,386,321,346,334,351,25,-65,90
116,500000,7a7885e2d7c00bcf,8,0,145,189,159,216,258,69,99,133,100,129,180,126,153,145,-54,51,-105
437,610000,7a7885e2d7c00bcf,8,0,487,425,510,487,657,185,238,361,306,395,301,417,359,371,116,-94,210
475,230000,7a7885e2d7c00bcf,8,0,611,511,443,413,533,157,228,535,404,398,359,345,352,367,-14,-39,25
39,310000,346393c2c6305fb1,8,0,134,126,104,114,215,76,41,45,61,38,52,37,44,42,-15,14,-29
55,530000,346393c2c6305fb1,8,0,121,133,139,121,182,95,41,34,36,31,58,44,51,44,-14,27,-41
85,150000,346393c2c6305fb1,8,0,92,121,108,174,205,99,66,95,76,72,76,74,75,74,-2,4,-6
51,110000,346393c2c6305fb1,8,0,202,250,161,243,439,74,40,54,53,41,27,32,30,33,5,-14,19
136,510000,346393c2c6305fb1,8,0,317,459,291,297,513,309,153,136,133,149,150,134,142,144,-16,1,-17
347,340000,346393c2c6305fb1,8,0,733,655,600,692,1047,578,273,312,307,331,314,279,296,308,-35,-17,-18
649,370000,346393c2c6305fb1,8,0,1063,1138,1097,1099,1844,902,381,538,572,675,544,536,540,585,-8,-131,123
237,140000,346393c2c6305fb1,8,0,261,250,277,308,545,238,158,237,226,236,217,178,198,210,-39,-19,-20
121,440000,346393c2c6305fb1,8,0,295,282,277,289,373,126,71,118,103,101,96,92,94,96,-4,-5,1
50,450000,346393c2c6305fb1,8,0,107,108,100,115,162,93,53,69,35,53,40,48,44,47,8,-13,21
213,320000,346393c2c6305fb1,8,0,461,370,406,397,621,300,168,197,206,183,203,185,194,190,-18,20,-38
57,360000,346393c2c6305fb1,8,0,112,150,164,143,266,151,36,61,68,60,40,53,46,51,13,-20,33
524,130000,346393c2c6305fb1,8,0,645,742,699,808,1460,748,389,430,459,518,401,452,426,457,51,-117,168
316,410000,346393c2c6305fb1,8,0,544,566,471,617,1100,524,174,251,240,290,254,290,272,278,36,-36,72
72,330000,346393c2c6305fb1,8,0,181,198,211,191,260,101,55,63,66,67,90,77,84,78,-13,23,-36
127,420000,346393c2c6305fb1,8,0,266,326,324,313,534,275,79,103,125,96,138,125,132,120,-13,42,-55
161,430000,346393c2c6305fb1,8,0,273,347,286,335,535,308,119,163,126,142,139,138,138,140,-1,-3,2
28,350000,346393c2c6305fb1,8,0,114,102,89,87,129,60,25,51,31,35,42,33,38,37,-9,7,-16
200,210000,346393c2c6305fb1,8,0,331,280,278,265,371,149,91,133,121,130,132,148,140,137,16,2,14
79,500000,346393c2c6305fb1,8,0,251,250,189,199,335,168,84,69,66,80,88,67,78,78,-21,8,-29
85,610000,346393c2c6305fb1,8,0,161,167,197,186,360,209,62,83,76,106,84,83,84,91,-1,-22,21
123,230000,346393c2c6305fb1,8,0,264,248,169,223,312,126,95,154,101,143,86,105,96,111,19,-57,76
727,310000,02aab221aabc03b9,8,0,687,651,489,558,362,679,494,731,600,672,772,704,738,716,-68,100,-168
267,530000,02aab221aabc03b9,8,0,209,201,174,160,155,229,130,223,186,188,194,250,222,211,56,6,50
112,150000,02aab221aabc03b9,8,0,130,97,99,82,59,106,63,136,99,113,83,99,91,98,16,-30,46
630,110000,02aab221aabc03b9,8,0,847,831,642,654,521,798,532,838,575,694,618,670,644,661,52,-76,128
576,510000,02aab221aabc03b9,8,0,559,615,471,430,474,703,394,653,524,606,614,549,582,590,-65,8,-73
353,340000,02aab221aabc03b9,8,0,344,348,248,228,187,338,203,372,311,341,346,340,343,342,-6,5,-11
526,370000,02aab221aabc03b9,8,0,549,525,474,421,353,610,362,607,527,608,548,531,540,562,-17,-60,43
124,140000,02aab221aabc03b9,8,0,154,121,105,117,105,129,94,160,139,138,152,130,141,140,-22,14,-36
1304,440000,02aab221aabc03b9,8,0,1238,1180,1049,976,1007,1207,847,1361,1093,1267,1219,1095,1157,1194,-124,-48,-76
153,450000,02aab221aabc03b9,8,0,161,151,126,138,119,159,102,172,121,154,153,137,145,148,-16,-1,-15
1583,320000,02aab221aabc03b9,8,0,1821,1585,1270,1186,1077,1735,1066,1713,1523,1554,1639,1493,1566,1562,-146,85,-231
215,360000,02aab221aabc03b9,8,0,224,232,164,154,152,242,146,291,216,232,253,206,230,230,-47,21,-68
362,130000,02aab221aabc03b9,8,0,330,362,307,254,182,340,242,360,379,362,327,372,350,354,45,-35,80
407,410000,02aab221aabc03b9,8,0,389,339,239,284,223,320,199,311,289,319,320,350,335,330,30,1,29
1537,330000,02aab221aabc03b9,8,0,1568,1439,1239,1136,1024,1529,973,1602,1326,1507,1501,1473,1487,1494,-28,-6,-22
321,420000,02aab221aabc03b9,8,0,383,407,272,273,274,370,238,369,296,339,369,331,350,346,-38,30,-68
275,430000,02aab221aabc03b9,8,0,270,285,213,205,215,305,186,346,275,278,289,275,282,281,-14,11,-25
477,350000,02aab221aabc03b9,8,0,437,448,353,321,324,518,242,572,350,498,528,403,466,476,-125,30,-155
316,210000,02aab221aabc03b9,8,0,346,299,229,207,174,292,205,321,225,242,252,295,274,263,43,10,33
263,500000,02aab221aabc03b9,8,0,222,255,197,217,217,267,199,277,240,244,232,258,245,245,26,-12,38
252,610000,02aab221aabc03b9,8,0,319,283,263,205,197,285,151,281,203,248,250,270,260,256,20,2,18
134,230000,02aab221aabc03b9,8,0,119,71,81,63,53,93,68,133,85,82,113,113,113,103,0,31,-31
299,310000,5d7fb682edd0f937,8,0,303,281,281,247,225,315,160,297,263,287,314,230,272,277,-84,27,-111
169,530000,5d7fb682edd0f937,8,0,187,165,167,133,176,164,108,164,133,153,126,180,153,153,54,-27,81
89,150000,5d7fb682edd0f937,8,0,117,120,96,85,86,86,62,103,111,102,97,88,92,96,-9,-5,-4
246,110000,5d7fb682edd0f937,8,0,427,429,308,324,417,323,190,356,270,290,257,234,246,260,-23,-33,10
271,510000,5d7fb682edd0f937,8,0,376,389,305,301,337,483,166,411,313,351,316,288,302,318,-28,-35,7
222,340000,5d7fb682edd0f937,8,0,227,205,162,169,174,188,119,173,183,210,172,186,179,189,14,-38,52
292,370000,5d7fb682edd0f937,8,0,302,292,265,227,253,339,160,306,297,331,234,253,244,273,19,-97,116
94,140000,5d7fb682edd0f937,8,0,103,99,83,81,91,111,56,97,101,97,84,91,88,91,7,-13,20
478,440000,5d7fb682edd0f937,8,0,565,575,462,510,512,581,314,531,409,540,562,422,492,508,-140,22,-162
94,450000,5d7fb682edd0f937,8,0,117,108,102,103,109,128,57,103,59,104,114,85,100,101,-29,10,-39
701,320000,5d7fb682edd0f937,8,0,823,757,642,661,734,807,456,741,678,793,643,655,649,697,12,-150,162
127,360000,5d7fb682edd0f937,8,0,153,155,115,129,138,165,79,158,126,152,118,104,111,125,-14,-34,20
222,130000,5d7fb682edd0f937,8,0,219,226,184,180,178,203,126,201,195,251,175,165,170,197,-10,-76,66
216,410000,5d7fb682edd0f937,8,0,186,187,161,189,173,186,103,191,191,194,156,186,171,179,30,-38,68
732,330000,5d7fb682edd0f937,8,0,709,620,587,599,595,656,382,738,625,720,647,584,616,650,-63,-73,10
241,420000,5d7fb682edd0f937,8,0,319,331,219,258,266,270,142,257,214,255,256,231,244,247,-25,1,-26
198,430000,5d7fb682edd0f937,8,0,219,179,160,168,191,210,114,205,161,191,162,167,164,173,5,-29,34
201,350000,5d7fb682edd0f937,8,0,260,259,202,201,205,241,127,267,183,283,239,197,218,240,-42,-44,2
145,210000,5d7fb682edd0f937,8,0,161,165,130,138,128,140,90,113,125,138,146,129,138,138,-17,8,-25
110,500000,5d7fb682edd0f937,8,0,158,109,123,106,134,131,54,117,102,136,130,124,127,130,-6,-6,0
140,610000,5d7fb682edd0f937,8,0,205,192,172,135,145,159,85,142,119,156,144,123,134,141,-21,-12,-9
83,230000,5d7fb682edd0f937,8,0,99,74,50,53,61,68,34,78,65,79,70,61,66,70,-9,-9,0
694,310000,a207df29ec9583f0,8,0,559,478,428,493,474,835,424,592,562,626,644,634,639,635,-10,18,-28
250,530000,a207df29ec9583f0,8,0,240,237,204,210,215,310,178,234,223,203,223,258,240,228,35,20,15
128,150000,a207df29ec9583f0,8,0,115,91,72,82,74,139,87,116,104,125,105,116,110,115,11,-20,31
824,110000,a207df29ec9583f0,8,0,824,853,604,747,817,1033,648,841,763,792,726,727,726,748,1,-66,67
440,510000,a207df29ec9583f0,8,0,458,388,382,361,382,695,383,524,456,456,507,479,493,481,-28,51,-79
259,340000,a207df29ec9583f0,8,0,226,228,183,176,177,354,152,225,259,222,223,254,238,233,31,1,30
468,370000,a207df29ec9583f0,8,0,453,344,338,348,336,608,328,530,488,475,451,429,440,452,-22,-24,2
152,140000,a207df29ec9583f0,8,0,108,108,84,93,100,165,96,130,118,97,142,140,141,126,-2,45,-47
1109,440000,a207df29ec9583f0,8,0,886,875,627,766,825,1178,690,1101,964,1020,962,1084,1023,1022,122,-58,180
129,450000,a207df29ec9583f0,8,0,105,124,72,100,114,160,106,163,133,138,136,134,135,136,-2,-2,0
1080,320000,a207df29ec9583f0,8,0,1124,918,791,915,1007,1591,766,1115,1026,1072,1033,982,1008,1029,-51,-39,-12
197,360000,a207df29ec9583f0,8,0,140,155,101,129,108,227,115,167,214,182,168,165,166,172,-3,-14,11
298,130000,a207df29ec9583f0,8,0,266,200,202,203,219,376,209,316,289,290,301,301,301,297,0,11,-11
287,410000,a207df29ec9583f0,8,0,276,252,194,283,262,357,201,287,304,275,256,289,272,273,33,-19,52
1063,330000,a207df29ec9583f0,8,0,880,834,733,849,908,1436,623,970,967,965,954,954,954,958,0,-11,11
384,420000,a207df29ec9583f0,8,0,327,326,230,315,356,436,202,366,316,282,393,360,376,345,-33,111,-144
249,430000,a207df29ec9583f0,8,0,190,184,143,174,192,302,179,246,255,226,219,246,232,230,27,-7,34
330,350000,a207df29ec9583f0,8,0,296,266,197,227,256,500,212,338,297,357,330,288,309,325,-42,-27,-15
299,210000,a207df29ec9583f0,8,0,281,225,176,194,227,304,176,286,261,241,263,276,270,260,13,22,-9
198,500000,a207df29ec9583f0,8,0,184,176,151,174,194,265,152,205,197,174,223,187,205,195,-36,49,-85
224,610000,a207df29ec9583f0,8,0,213,228,210,194,216,307,140,222,205,251,252,248,250,250,-4,1,-5
123,230000,a207df29ec9583f0,8,0,106,77,74,83,85,102,84,125,116,121,127,86,106,111,-41,6,-47
182,310000,b4be3a4917289c82,8,0,203,190,188,201,262,80,97,160,113,154,142,142,142,146,0,-12,12
46,530000,b4be3a4917289c82,8,0,60,52,76,100,59,26,35,34,50,78,51,74,62,68,23,-27,50
27,150000,b4be3a4917289c82,8,0,33,31,42,40,37,22,17,26,37,25,21,17,19,21,-4,-4,0
112,110000,b4be3a4917289c82,8,0,203,232,200,230,226,93,117,153,137,139,94,88,91,107,-6,-45,39
184,510000,b4be3a4917289c82,8,0,152,216,166,240,223,57,76,90,137,164,128,144,136,145,16,-36,52
108,340000,b4be3a4917289c82,8,0,104,106,110,130,121,57,59,72,81,74,76,100,88,83,24,2,22
180,370000,b4be3a4917289c82,8,0,232,258,215,231,199,113,137,218,152,167,149,160,154,159,11,-18,29
27,140000,b4be3a4917289c82,8,0,37,31,31,28,33,16,10,28,22,76,22,26,24,41,4,-54,58
225,440000,b4be3a4917289c82,8,0,223,290,309,396,384,120,115,231,223,244,188,202,195,211,14,-56,70
38,450000,b4be3a4917289c82,8,0,29,35,34,41,40,20,18,18,25,33,31,30,30,31,-1,-2,1
426,320000,b4be3a4917289c82,8,0,471,447,420,635,591,225,325,414,342,390,329,340,334,353,11,-61,72
50,360000,b4be3a4917289c82,8,0,43,50,52,66,85,10,18,37,40,39,37,38,38,38,1,-2,3
118,130000,b4be3a4917289c82,8,0,130,145,141,166,161,78,99,131,131,102,71,97,84,90,26,-31,57
121,410000,b4be3a4917289c82,8,0,86,118,117,128,163,57,77,90,88,75,84,92,88,84,8,9,-1
511,330000,b4be3a4917289c82,8,0,382,415,422,523,567,168,290,344,386,300,355,415,385,357,60,55,5
103,420000,b4be3a4917289c82,8,0,106,110,92,120,142,48,54,76,88,66,69,75,72,70,6,3,3
85,430000,b4be3a4917289c82,8,0,64,96,79,112,124,41,43,61,74,75,46,72,59,64,26,-29,55
64,350000,b4be3a4917289c82,8,0,84,61,85,108,127,23,28,50,51,59,58,62,60,60,4,-1,5
75,210000,b4be3a4917289c82,8,0,88,87,77,106,83,28,38,67,45,65,40,54,47,53,14,-25,39
40,500000,b4be3a4917289c82,8,0,35,47,43,77,67,17,20,19,34,34,37,30,34,34,-7,3,-10
90,610000,b4be3a4917289c82,8,0,82,79,83,68,82,41,52,48,66,99,56,51,54,69,-5,-43,38
30,230000,b4be3a4917289c82,8,0,61,42,40,48,45,18,18,48,30,46,28,19,24,31,-9,-18,9
609,310000,ef76a85c4b39f693,8,0,360,145,129,306,492,378,283,374,311,427,498,475,486,467,-23,71,-94
277,530000,ef76a85c4b39f693,8,0,153,83,75,142,154,140,101,145,149,178,192,272,232,214,80,14,66
176,150000,ef76a85c4b39f693,8,0,105,47,48,67,109,121,79,109,124,169,140,135,138,148,-5,-29,24
697,110000,ef76a85c4b39f693,8,0,502,321,175,311,576,511,299,438,522,580,543,591,567,571,48,-37,85
643,510000,ef76a85c4b39f693,8,0,488,356,206,340,526,495,291,361,444,497,529,571,550,532,42,32,10
453,340000,ef76a85c4b39f693,8,0,208,104,111,219,307,304,148,259,319,271,331,363,347,322,32,60,-28
741,370000,ef76a85c4b39f693,8,0,446,246,241,312,378,406,284,400,479,557,520,550,535,542,30,-37,67
177,140000,ef76a85c4b39f693,8,0,80,47,46,58,83,94,61,99,97,93,99,121,110,104,22,6,16
899,440000,ef76a85c4b39f693,8,0,740,398,282,593,912,598,355,607,642,701,764,756,760,740,-8,63,-71
145,450000,ef76a85c4b39f693,8,0,95,39,30,50,68,74,33,77,72,113,104,139,122,119,35,-9,44
1451,320000,ef76a85c4b39f693,8,0,610,270,351,609,1028,993,652,891,910,1046,1085,1159,1122,1097,74,39,35
258,360000,ef76a85c4b39f693,8,0,130,47,59,107,208,200,69,151,150,175,152,209,180,179,57,-23,80
563,130000,ef76a85c4b39f693,8,0,351,172,141,298,340,342,250,323,382,440,423,438,430,434,15,-17,32
492,410000,ef76a85c4b39f693,8,0,206,143,136,170,239,290,184,293,341,325,356,405,380,362,49,31,18
1958,330000,ef76a85c4b39f693,8,0,815,643,498,965,1300,996,708,969,1088,1209,1284,1524,1404,1339,240,75,165
437,420000,ef76a85c4b39f693,8,0,253,116,101,212,331,334,134,250,279,305,303,339,321,316,36,-2,38
429,430000,ef76a85c4b39f693,8,0,229,78,92,180,310,284,146,251,271,354,267,331,299,317,64,-87,151
308,350000,ef76a85c4b39f693,8,0,200,69,95,138,176,229,97,153,164,270,221,253,237,248,32,-49,81
648,210000,ef76a85c4b39f693,8,0,291,193,157,189,261,256,190,274,317,341,370,440,405,384,70,29,41
190,500000,ef76a85c4b39f693,8,0,135,51,35,76,157,115,82,120,97,175,209,162,186,182,-47,34,-81
366,610000,ef76a85c4b39f693,8,0,241,115,96,127,205,223,136,166,239,247,199,284,242,243,85,-48,133
240,230000,ef76a85c4b39f693,8,0,123,58,56,108,145,104,92,153,138,145,157,161,159,154,4,12,-8
471,310000,bb9fbec9a2833839,8,0,528,494,298,341,507,266,214,347,256,335,387,323,355,348,-64,52,-116
206,530000,bb9fbec9a2833839,8,0,213,197,180,169,225,142,99,142,158,164,176,231,204,190,55,12,43
168,150000,bb9fbec9a2833839,8,0,178,174,157,121,169,76,74,105,133,145,136,151,144,144,15,-9,24
274,110000,bb9fbec9a2833839,8,0,450,529,355,417,450,177,170,259,234,290,279,265,272,278,-14,-11,-3
452,510000,bb9fbec9a2833839,8,0,533,641,403,433,394,242,224,324,333,361,319,358,338,346,39,-42,81
298,340000,bb9fbec9a2833839,8,0,297,328,172,256,310,160,139,211,231,217,227,254,240,233,27,10,17
574,370000,bb9fbec9a2833839,8,0,487,582,453,469,507,305,251,332,402,428,398,413,406,413,15,-30,45
169,140000,bb9fbec9a2833839,8,0,168,143,117,124,97,55,43,101,86,111,100,106,103,106,6,-11,17
772,440000,bb9fbec9a2833839,8,0,813,867,710,821,895,435,271,630,599,641,694,710,702,682,16,53,-37
137,450000,bb9fbec9a2833839,8,0,129,137,85,114,124,79,66,108,95,119,99,124,112,114,25,-20,45
1098,320000,bb9fbec9a2833839,8,0,1272,1166,688,937,1154,552,589,835,807,903,879,877,878,886,-2,-24,22
202,360000,bb9fbec9a2833839,8,0,202,193,186,189,178,106,91,145,142,176,146,152,149,158,6,-30,36
411,130000,bb9fbec9a2833839,8,0,427,423,324,327,378,179,188,251,302,319,290,307,298,305,17,-29,46
290,410000,bb9fbec9a2833839,8,0,336,420,237,276,308,156,143,260,258,238,212,252,232,234,40,-26,66
1285,330000,bb9fbec9a2833839,8,0,1196,1045,917,1072,1169,550,543,759,841,892,995,1035,1015,974,40,103,-63
372,420000,bb9fbec9a2833839,8,0,395,429,270,308,378,261,177,285,262,281,264,324,294,290,60,-17,77
332,430000,bb9fbec9a2833839,8,0,360,359,193,226,309,145,129,251,238,285,222,261,242,256,39,-63,102
280,350000,bb9fbec9a2833839,8,0,281,263,253,214,293,168,110,183,202,270,233,236,234,246,3,-37,40
209,210000,bb9fbec9a2833839,8,0,241,242,174,177,213,86,85,121,151,164,140,139,140,148,-1,-24,23
96,500000,bb9fbec9a2833839,8,0,146,128,96,89,130,65,59,92,68,101,131,82,106,105,-49,30,-79
189,610000,bb9fbec9a2833839,8,0,229,215,165,164,174,112,81,131,150,180,137,151,144,156,14,-43,57
128,230000,bb9fbec9a2833839,8,0,130,140,82,95,85,44,40,74,82,95,78,104,91,92,26,-17,43
558,310000,da457d15788fe8ee,8,0,521,504,402,593,748,538,251,456,315,445,485,411,448,447,-74,40,-114
252,530000,da457d15788fe8ee,8,0,266,231,316,323,344,263,166,191,198,263,290,341,316,298,51,27,24
172,150000,da457d15788fe8ee,8,0,217,201,207,206,200,197,109,152,165,213,178,177,178,189,-1,-35,34
949,110000,da457d15788fe8ee,8,0,898,731,715,939,1050,755,424,693,651,781,754,805,780,780,51,-27,78
673,510000,da457d15788fe8ee,8,0,658,1072,583,560,641,624,348,443,468,502,547,611,579,553,64,45,19
317,340000,da457d15788fe8ee,8,0,346,329,282,331,409,330,200,229,256,264,317,284,300,288,-33,53,-86
632,370000,da457d15788fe8ee,8,0,543,678,438,630,646,659,309,458,540,534,523,541,532,533,18,-11,29
187,140000,da457d15788fe8ee,8,0,155,143,139,142,103,120,44,90,120,136,128,136,132,133,8,-8,16
1323,440000,da457d15788fe8ee,8,0,1237,1342,1295,1408,1829,1269,499,1006,894,1099,1203,1068,1136,1123,-135,104,-239
198,450000,da457d15788fe8ee,8,0,125,189,162,142,255,213,82,152,117,156,149,174,162,160,25,-7,32
1268,320000,da457d15788fe8ee,8,0,1106,1255,1040,1108,1430,1304,649,954,933,1003,955,1112,1034,1023,157,-48,205
256,360000,da457d15788fe8ee,8,0,230,275,218,275,247,282,85,186,198,229,203,249,226,227,46,-26,72
546,130000,da457d15788fe8ee,8,0,476,471,407,417,527,425,254,337,412,434,405,458,432,432,53,-29,82
398,410000,da457d15788fe8ee,8,0,422,469,405,382,502,442,251,354,426,325,372,375,374,357,3,47,-44
1460,330000,da457d15788fe8ee,8,0,1181,1241,932,1214,1500,938,567,836,888,1017,1178,1317,1248,1171,139,161,-22
468,420000,da457d15788fe8ee,8,0,427,529,447,473,526,572,259,428,363,377,445,438,442,420,-7,68,-75
421,430000,da457d15788fe8ee,8,0,451,476,369,391,505,374,207,342,370,431,366,451,408,416,85,-65,150
319,350000,da457d15788fe8ee,8,0,266,282,298,320,358,335,144,206,194,282,238,262,250,261,24,-44,68
482,210000,da457d15788fe8ee,8,0,459,418,357,335,454,281,156,268,293,330,277,371,324,326,94,-53,147
224,500000,da457d15788fe8ee,8,0,230,259,188,209,244,199,108,153,121,186,284,146,215,205,-138,98,-236
298,610000,da457d15788fe8ee,8,0,312,352,366,242,346,325,174,210,225,299,236,330,283,288,94,-63,157
210,230000,da457d15788fe8ee,8,0,240,219,123,190,198,139,94,144,137,133,149,128,138,137,-21,16,-37
664,310000,6858d6dfe680bdf7,8,0,607,438,357,513,576,543,384,696,487,649,633,685,659,656,52,-16,68
267,530000,6858d6dfe680bdf7,8,0,213,139,117,236,257,243,199,312,234,314,249,292,270,285,43,-65,108
68,150000,6858d6dfe680bdf7,8,0,43,47,37,60,80,54,43,84,76,64,93,74,84,77,-19,29,-48
640,110000,6858d6dfe680bdf7,8,0,449,410,328,585,816,536,311,688,527,617,587,668,628,624,81,-30,111
645,510000,6858d6dfe680bdf7,8,0,445,455,290,447,593,591,337,640,478,571,603,551,577,575,-52,32,-84
364,340000,6858d6dfe680bdf7,8,0,265,236,233,275,385,322,230,435,350,391,362,386,374,380,24,-29,53
586,370000,6858d6dfe680bdf7,8,0,358,297,285,401,440,468,289,622,538,593,498,535,516,542,37,-95,132
114,140000,6858d6dfe680bdf7,8,0,60,31,30,61,103,57,64,78,79,91,70,76,73,79,6,-21,27
1360,440000,6858d6dfe680bdf7,8,0,1033,800,773,983,1319,1274,618,1449,1061,1394,1469,1265,1367,1376,-204,75,-279
172,450000,6858d6dfe680bdf7,8,0,99,93,94,126,167,115,84,164,123,176,156,157,156,163,1,-20,21
1458,320000,6858d6dfe680bdf7,8,0,893,729,862,988,1160,1203,919,1681,1193,1428,1269,1375,1322,1357,106,-159,265
230,360000,6858d6dfe680bdf7,8,0,134,144,96,129,200,185,89,224,198,224,201,206,204,210,5,-23,28
437,130000,6858d6dfe680bdf7,8,0,266,194,192,281,283,417,232,460,496,484,423,463,443,457,40,-61,101
418,410000,6858d6dfe680bdf7,8,0,272,209,174,237,350,258,224,388,425,429,397,410,404,412,13,-32,45
1906,330000,6858d6dfe680bdf7,8,0,1547,1208,929,1465,1724,1540,1004,2273,1596,1876,1650,1852,1751,1793,202,-226,428
383,420000,6858d6dfe680bdf7,8,0,235,199,144,218,283,271,143,325,266,300,353,314,334,322,-39,53,-92
409,430000,6858d6dfe680bdf7,8,0,251,209,203,255,374,375,195,380,321,402,363,372,368,379,9,-39,48
366,350000,6858d6dfe680bdf7,8,0,276,236,214,251,346,352,161,369,304,419,307,353,330,360,46,-112,158
305,210000,6858d6dfe680bdf7,8,0,187,133,91,159,186,215,146,225,256,285,240,260,250,262,20,-45,65
268,500000,6858d6dfe680bdf7,8,0,189,132,105,200,253,198,131,290,195,274,315,277,296,289,-38,41,-79
219,610000,6858d6dfe680bdf7,8,0,163,159,132,134,174,188,135,235,193,286,212,215,214,238,3,-74,77
104,230000,6858d6dfe680bdf7,8,0,57,23,28,58,76,70,44,104,104,97,90,78,84,88,-12,-7,-5
209,310000,79de4e4b24c35b04,8,0,379,426,299,501,825,333,136,253,217,192,208,169,188,190,-39,16,-55
496,530000,79de4e4b24c35b04,8,0,707,913,926,928,1393,1050,634,598,559,552,559,568,564,560,9,7,2
189,150000,79de4e4b24c35b04,8,0,132,200,230,272,405,185,132,207,141,156,128,146,137,143,18,-28,46
105,110000,79de4e4b24c35b04,8,0,313,370,330,446,852,178,127,199,127,128,132,116,124,125,-16,4,-20
447,510000,79de4e4b24c35b04,8,0,755,971,792,934,1509,1063,565,512,413,385,387,456,422,409,69,2,67
904,340000,79de4e4b24c35b04,8,0,1349,1421,1263,1461,2601,1965,1072,936,771,749,842,897,870,829,55,93,-38
1912,370000,79de4e4b24c35b04,8,0,2677,2814,2975,3077,5360,2858,1598,1729,1694,1756,1539,1936,1738,1744,397,-217,614
484,140000,79de4e4b24c35b04,8,0,640,778,791,803,1442,701,396,447,437,462,390,470,430,441,80,-72,152
2831,440000,79de4e4b24c35b04,8,0,4086,5098,5032,5800,8421,3465,1872,3263,2465,2754,2779,2551,2665,2695,-228,25,-253
2120,450000,79de4e4b24c35b04,8,0,2497,3110,3025,3479,6171,2981,1510,1845,1206,1444,1326,1376,1351,1382,50,-118,168
1382,320000,79de4e4b24c35b04,8,0,1829,2045,1978,2153,3757,2028,1542,1465,1325,1301,1251,1387,1319,1313,136,-50,186
426,360000,79de4e4b24c35b04,8,0,635,806,703,736,1319,827,443,434,359,341,393,389,391,374,-4,52,-56
1269,130000,79de4e4b24c35b04,8,0,1505,1631,1500,1789,2863,1366,1047,1021,1146,1168,1072,1294,1183,1178,222,-96,318
2973,410000,79de4e4b24c35b04,8,0,4302,4617,4700,5194,9539,6024,2842,2528,2423,2523,2603,3162,2882,2763,559,80,479
822,330000,79de4e4b24c35b04,8,0,1291,1435,1528,1653,2646,934,580,745,680,733,621,813,717,722,192,-112,304
447,420000,79de4e4b24c35b04,8,0,753,891,696,982,1629,1137,521,524,406,468,397,454,426,440,57,-71,128
779,430000,79de4e4b24c35b04,8,0,1113,1544,1234,1513,2352,1658,771,808,663,615,657,743,700,672,86,42,44
322,350000,79de4e4b24c35b04,8,0,548,706,724,738,1086,453,316,456,314,359,319,319,319,332,0,-40,40
483,210000,79de4e4b24c35b04,8,0,616,644,644,694,1039,408,313,505,468,482,534,500,517,505,-34,52,-86
160,500000,79de4e4b24c35b04,8,0,277,359,279,304,514,324,210,169,172,136,158,183,170,159,25,22,3
576,610000,79de4e4b24c35b04,8,0,648,785,855,1045,1704,937,403,499,452,488,436,535,486,486,99,-52,151
543,230000,79de4e4b24c35b04,8,0,791,839,638,832,1045,394,365,562,482,469,565,521,543,518,-44,96,-140
726,310000,12f8b7e14947c34d,8,0,1065,2065,1032,1283,1483,389,338,505,521,647,608,619,614,625,11,-39,50
263,530000,12f8b7e14947c34d,8,0,346,402,396,360,567,208,160,208,214,226,198,297,248,240,99,-28,127
370,150000,12f8b7e14947c34d,8,0,575,712,648,698,789,413,215,340,311,387,355,326,340,356,-29,-32,3
101,110000,12f8b7e14947c34d,8,0,397,451,276,389,488,143,102,126,84,102,87,71,79,87,-16,-15,-1
664,510000,12f8b7e14947c34d,8,0,820,1286,786,820,1117,531,374,577,521,559,581,527,554,556,-54,22,-76
420,340000,12f8b7e14947c34d,8,0,644,726,594,615,705,385,198,241,246,257,285,305,295,282,20,28,-8
1138,370000,12f8b7e14947c34d,8,0,1454,1777,1435,1352,1707,803,424,738,843,928,824,912,868,888,88,-104,192
345,140000,12f8b7e14947c34d,8,0,346,391,347,352,464,131,87,174,169,231,178,188,183,199,10,-53,63
249,440000,12f8b7e14947c34d,8,0,286,326,342,407,475,130,117,221,195,239,246,184,215,223,-62,7,-69
76,450000,12f8b7e14947c34d,8,0,135,181,167,158,231,93,43,77,54,89,79,95,87,88,16,-10,26
1318,320000,12f8b7e14947c34d,8,0,2024,2099,1880,1868,2181,991,782,1094,1007,1280,1090,1058,1074,1143,-32,-190,158
281,360000,12f8b7e14947c34d,8,0,349,532,430,438,495,251,128,183,180,217,188,232,210,212,44,-29,73
860,130000,12f8b7e14947c34d,8,0,1026,1153,782,978,1229,546,360,592,598,847,611,670,640,709,59,-236,295
755,410000,12f8b7e14947c34d,8,0,951,954,750,835,1053,508,259,492,410,471,586,659,622,572,73,115,-42
714,330000,12f8b7e14947c34d,8,0,773,920,884,1063,1213,348,291,556,450,632,576,610,593,606,34,-56,90
228,420000,12f8b7e14947c34d,8,0,340,406,336,358,440,200,80,136,138,174,236,210,223,207,-26,62,-88
398,430000,12f8b7e14947c34d,8,0,550,688,528,670,749,385,150,254,224,307,284,328,306,306,44,-23,67
252,350000,12f8b7e14947c34d,8,0,275,314,302,385,408,188,136,178,176,297,240,200,220,246,-40,-57,17
144,210000,12f8b7e14947c34d,8,0,254,246,156,195,210,53,54,81,84,109,71,94,82,91,23,-38,61
136,500000,12f8b7e14947c34d,8,0,205,240,178,181,295,131,85,113,117,117,161,107,134,128,-54,44,-98
763,610000,12f8b7e14947c34d,8,0,1276,1109,958,1012,1286,412,280,531,610,649,548,736,642,644,188,-101,289
153,230000,12f8b7e14947c34d,8,0,236,256,202,210,228,66,80,160,104,150,105,113,109,123,8,-45,53
364,310000,04e66e578f653ab9,8,0,342,422,337,524,679,950,175,263,226,214,231,1376,804,607,1145,17,1128
133,530000,04e66e578f653ab9,8,0,129,142,173,215,293,131,118,135,108,106,85,183,134,125,98,-21,119
52,150000,04e66e578f653ab9,8,0,80,87,94,102,118,60,38,63,48,62,45,54,50,54,9,-17,26
120,110000,04e66e578f653ab9,8,0,158,241,166,231,280,180,87,167,105,117,108,135,122,120,27,-9,36
240,510000,04e66e578f653ab9,8,0,208,419,226,291,404,151,140,210,163,126,156,158,157,147,2,30,-28
141,340000,04e66e578f653ab9,8,0,146,172,127,176,201,116,64,85,74,80,96,91,94,89,-5,16,-21
313,370000,04e66e578f653ab9,8,0,253,405,274,383,451,230,146,276,296,237,243,266,254,249,23,6,17
67,140000,04e66e578f653ab9,8,0,68,104,75,85,95,42,23,68,34,43,37,45,41,42,8,-6,14
115,440000,04e66e578f653ab9,8,0,149,140,175,225,268,104,54,144,101,111,106,100,103,106,-6,-5,-1
34,450000,04e66e578f653ab9,8,0,43,42,39,42,71,30,28,32,17,42,31,35,33,36,4,-11,15
427,320000,04e66e578f653ab9,8,0,477,566,501,644,669,334,279,388,278,361,289,335,312,328,46,-72,118
62,360000,04e66e578f653ab9,8,0,72,97,83,104,86,64,32,40,53,58,44,58,51,53,14,-14,28
222,130000,04e66e578f653ab9,8,0,185,186,192,206,272,140,97,162,151,190,159,151,155,167,-8,-31,23
253,410000,04e66e578f653ab9,8,0,191,156,169,219,319,144,90,156,142,133,159,150,154,147,-9,26,-35
265,330000,04e66e578f653ab9,8,0,262,293,289,400,452,190,120,235,179,236,184,200,192,207,16,-52,68
75,420000,04e66e578f653ab9,8,0,58,71,47,81,82,146,33,61,41,44,47,128,88,73,81,3,78
142,430000,04e66e578f653ab9,8,0,118,158,115,135,228,105,59,115,89,71,92,97,94,87,5,21,-16
71,350000,04e66e578f653ab9,8,0,82,93,107,132,139,77,43,64,62,76,55,207,131,113,152,-21,173
41,210000,04e66e578f653ab9,8,0,64,69,52,62,81,42,40,28,19,48,46,42,44,45,-4,-2,-2
75,500000,04e66e578f653ab9,8,0,42,66,46,77,87,44,31,56,52,34,81,74,78,63,-7,47,-54
151,610000,04e66e578f653ab9,8,0,169,208,170,201,238,124,83,169,151,120,99,145,122,121,46,-21,67
39,230000,04e66e578f653ab9,8,0,60,45,45,56,48,22,17,60,50,40,34,50,42,41,16,-6,22
229,310000,dff803b4024d261d,8,0,96,130,129,206,317,238,124,175,178,198,247,172,210,206,-75,49,-124
64,530000,dff803b4024d261d,8,0,48,150,68,61,94,64,55,50,58,59,74,82,78,72,8,15,-7
126,150000,dff803b4024d261d,8,0,80,59,69,77,114,119,58,88,84,113,93,124,108,110,31,-20,51
536,110000,dff803b4024d261d,8,0,549,341,411,466,954,488,303,463,422,404,405,524,464,444,119,1,118
476,510000,dff803b4024d261d,8,0,213,226,219,270,560,493,212,308,310,321,356,354,355,344,-2,35,-37
244,340000,dff803b4024d261d,8,0,105,226,131,164,192,238,108,126,152,161,181,221,201,188,40,20,20
968,370000,dff803b4024d261d,8,0,376,451,391,462,714,609,352,736,802,743,732,752,742,742,20,-11,31
214,140000,dff803b4024d261d,8,0,87,81,104,152,230,168,75,152,133,162,155,176,166,164,21,-7,28
1632,440000,dff803b4024d261d,8,0,688,783,887,1988,1893,1283,554,1157,1342,1371,1506,1365,1436,1414,-141,135,-276
240,450000,dff803b4024d261d,8,0,333,211,167,204,333,316,132,218,179,232,209,214,212,218,5,-23,28
808,320000,dff803b4024d261d,8,0,701,409,489,602,865,785,520,701,575,790,696,727,712,738,31,-94,125
228,360000,dff803b4024d261d,8,0,104,272,168,194,280,264,100,195,178,199,185,190,188,191,5,-14,19
546,130000,dff803b4024d261d,8,0,358,279,275,250,454,387,248,489,372,444,470,561,516,492,91,26,65
287,410000,dff803b4024d261d,8,0,201,184,168,191,300,319,141,195,250,224,252,313,282,263,61,28,33
739,330000,dff803b4024d261d,8,0,406,355,572,795,787,577,391,567,562,623,668,663,666,651,-5,45,-50
667,420000,dff803b4024d261d,8,0,222,287,394,374,566,545,193,390,310,389,475,504,490,456,29,86,-57
402,430000,dff803b4024d261d,8,0,181,332,203,423,412,412,410,531,262,352,341,399,370,364,58,-11,69
652,350000,dff803b4024d261d,8,0,353,331,397,363,562,555,242,485,658,692,517,589,553,599,72,-175,247
346,210000,dff803b4024d261d,8,0,234,219,239,228,340,230,163,328,229,232,286,261,274,260,-25,54,-79
265,500000,dff803b4024d261d,8,0,184,281,158,348,846,378,203,261,239,256,499,348,424,368,-151,243,-394
222,610000,dff803b4024d261d,8,0,64,63,62,99,126,138,68,103,103,121,139,167,153,142,28,18,10
126,230000,dff803b4024d261d,8,0,56,91,46,89,107,57,72,88,195,88,95,117,106,100,22,7,15
305,310000,61e73e32ad101892,8,0,265,263,222,276,374,264,140,173,111,133,219,252,236,201,33,86,-53
328,530000,61e73e32ad101892,8,0,328,322,420,444,423,403,246,278,240,349,251,370,310,323,119,-98,217
554,150000,61e73e32ad101892,8,0,467,541,608,505,619,534,251,398,363,397,446,439,442,427,-7,49,-56
710,110000,61e73e32ad101892,8,0,803,1019,845,1016,1441,741,459,672,521,645,648,738,693,677,90,3,87
853,510000,61e73e32ad101892,8,0,668,1080,712,743,1078,940,507,616,610,516,696,747,722,653,51,180,-129
240,340000,61e73e32ad101892,8,0,177,210,217,212,273,247,107,152,149,170,178,202,190,183,24,8,16
792,370000,61e73e32ad101892,8,0,643,866,764,681,1011,688,350,548,657,631,628,667,648,642,39,-3,42
326,140000,61e73e32ad101892,8,0,276,283,280,288,348,274,115,219,218,272,224,246,235,247,22,-48,70
2104,440000,61e73e32ad101892,8,0,1456,1686,2097,2144,2562,1849,777,1549,1067,1547,1898,1873,1886,1773,-25,351,-376
340,450000,61e73e32ad101892,8,0,221,333,376,342,443,364,194,278,172,226,248,272,260,249,24,22,2
698,320000,61e73e32ad101892,8,0,656,670,713,682,857,658,425,546,407,545,534,592,563,557,58,-11,69
241,360000,61e73e32ad101892,8,0,207,304,324,277,382,334,121,180,176,242,230,289,260,254,59,-12,71
1094,130000,61e73e32ad101892,8,0,756,829,875,790,1042,804,407,572,721,849,721,962,842,844,241,-128,369
714,410000,61e73e32ad101892,8,0,520,525,514,567,656,654,303,427,422,450,484,638,561,524,154,34,120
739,330000,61e73e32ad101892,8,0,628,658,707,687,970,632,338,464,407,503,544,617,580,555,73,41,32
1196,420000,61e73e32ad101892,8,0,879,1194,1234,1296,1458,1429,526,890,740,929,1121,1218,1170,1089,97,192,-95
587,430000,61e73e32ad101892,8,0,504,586,532,579,879,712,262,444,376,475,496,530,513,500,34,21,13
322,350000,61e73e32ad101892,8,0,324,331,423,388,523,387,223,336,237,399,355,340,348,365,-15,-44,29
909,210000,61e73e32ad101892,8,0,859,919,871,786,1105,571,424,658,595,611,583,678,630,624,95,-28,123
383,500000,61e73e32ad101892,8,0,378,452,406,568,732,616,327,364,351,290,544,368,456,401,-176,254,-430
615,610000,61e73e32ad101892,8,0,429,480,618,464,618,561,288,381,522,505,419,505,462,476,86,-86,172
428,230000,61e73e32ad101892,8,0,463,364,346,348,497,267,165,333,307,314,331,413,372,353,82,17,65
56,310000,a432c483b5beb856,8,0,125,135,111,242,237,68,37,61,48,42,46,60,53,49,14,4,10
116,530000,a432c483b5beb856,8,0,143,170,165,182,271,140,100,100,97,72,92,101,96,88,9,20,-11
105,150000,a432c483b5beb856,8,0,135,135,144,149,195,78,54,74,78,87,84,89,86,87,5,-3,8
40,110000,a432c483b5beb856,8,0,151,163,97,128,205,34,44,59,36,32,45,41,43,39,-4,13,-17
287,510000,a432c483b5beb856,8,0,290,355,284,276,560,275,186,178,154,123,197,155,176,158,-42,74,-116
120,340000,a432c483b5beb856,8,0,210,258,234,289,496,209,109,109,97,103,125,123,124,117,-2,22,-24
260,370000,a432c483b5beb856,8,0,370,455,430,397,599,241,156,188,181,193,211,187,199,197,-24,18,-42
108,140000,a432c483b5beb856,8,0,154,165,187,192,226,67,52,65,70,76,81,82,82,80,1,5,-4
615,440000,a432c483b5beb856,8,0,969,966,1096,1273,1753,510,290,467,429,504,568,492,530,521,-76,64,-140
120,450000,a432c483b5beb856,8,0,133,163,183,209,314,161,76,113,66,89,103,111,107,101,8,14,-6
423,320000,a432c483b5beb856,8,0,659,663,720,808,1176,484,399,360,358,395,364,346,355,368,-18,-31,13
192,360000,a432c483b5beb856,8,0,182,243,282,281,556,258,99,139,120,123,138,130,134,130,-8,15,-23
217,130000,a432c483b5beb856,8,0,275,311,284,290,435,164,126,133,165,184,178,191,184,184,13,-6,19
365,410000,a432c483b5beb856,8,0,313,316,283,364,562,252,130,136,161,188,248,234,241,223,-14,60,-74
549,330000,a432c483b5beb856,8,0,581,660,738,799,1102,332,255,331,293,293,451,433,442,392,-18,158,-176
148,420000,a432c483b5beb856,8,0,230,271,257,362,526,267,110,92,100,79,129,117,123,108,-12,50,-62
229,430000,a432c483b5beb856,8,0,271,292,260,313,627,286,115,133,96,119,133,162,148,138,29,14,15
134,350000,a432c483b5beb856,8,0,274,282,315,340,500,185,128,160,130,141,134,138,136,138,4,-7,11
164,210000,a432c483b5beb856,8,0,310,311,260,209,299,101,86,133,111,127,127,138,132,131,11,0,11
95,500000,a432c483b5beb856,8,0,199,165,151,159,317,179,87,70,59,80,101,84,92,88,-17,21,-38
86,610000,a432c483b5beb856,8,0,126,114,163,141,242,89,58,62,55,62,48,76,62,62,28,-14,42
93,230000,a432c483b5beb856,8,0,155,139,103,121,126,60,44,65,66,61,78,87,82,75,9,17,-8
341,310000,0797526c057dcf5b,8,0,346,427,336,1289,571,175,135,300,320,311,280,332,306,308,52,-31,83
210,530000,0797526c057dcf5b,8,0,218,226,257,285,393,160,154,201,154,174,208,237,222,206,29,34,-5
396,150000,0797526c057dcf5b,8,0,218,291,326,339,631,236,164,278,287,352,354,352,353,353,-2,2,-4
421,110000,0797526c057dcf5b,8,0,743,797,664,656,980,232,253,315,319,299,344,411,378,351,67,45,22
1179,510000,0797526c057dcf5b,8,0,904,1230,923,1016,1536,609,478,708,677,703,870,874,872,816,4,167,-163
638,340000,0797526c057dcf5b,8,0,476,565,666,550,750,358,257,522,447,450,474,531,502,485,57,24,33
2770,370000,0797526c057dcf5b,8,0,2200,2915,3148,3502,5481,1788,1203,1635,2012,1985,2046,2150,2098,2060,104,61,43
1077,140000,0797526c057dcf5b,8,0,585,792,899,919,1474,502,371,567,626,775,870,822,846,822,-48,95,-143
10514,440000,0797526c057dcf5b,8,0,9999,11167,12710,12394,15317,5306,3718,8079,6812,7957,8612,8119,8366,8229,-493,655,-1148
2291,450000,0797526c057dcf5b,8,0,1186,1639,1709,1789,2693,1195,777,1366,1087,1463,1613,1736,1674,1604,123,150,-27
2603,320000,0797526c057dcf5b,8,0,1726,2274,2226,2622,3296,1247,1529,2148,2087,2259,2343,2472,2408,2358,129,84,45
1342,360000,0797526c057dcf5b,8,0,715,1083,1277,1265,1764,857,484,797,835,979,1050,1189,1120,1073,139,71,68
2449,130000,0797526c057dcf5b,8,0,1516,1988,2221,2449,3796,1214,995,1259,1697,1832,1815,2279,2047,1975,464,-17,481
2272,410000,0797526c057dcf5b,8,0,1553,1783,1739,1951,3130,1278,848,1290,1492,1391,1525,1910,1718,1609,385,134,251
1896,330000,0797526c057dcf5b,8,0,1443,1709,2001,2019,2088,700,801,1246,1369,1509,1644,1767,1706,1640,123,135,-12
1051,420000,0797526c057dcf5b,8,0,870,1071,1120,1425,1562,736,376,772,827,842,1061,1101,1081,1001,40,219,-179
1858,430000,0797526c057dcf5b,8,0,1668,1721,1444,1769,3168,1244,677,1105,1093,1503,1476,1786,1631,1588,310,-27,337
1476,350000,0797526c057dcf5b,8,0,1227,1477,1846,1591,1981,769,598,1058,945,1316,1163,1316,1240,1265,153,-153,306
2151,210000,0797526c057dcf5b,8,0,3298,3035,2443,2622,3705,1059,1132,1642,1541,1606,1822,1931,1876,1786,109,216,-107
385,500000,0797526c057dcf5b,8,0,660,624,494,548,828,333,235,331,330,400,708,364,536,491,-344,308,-652
387,610000,0797526c057dcf5b,8,0,451,462,457,402,722,289,175,287,284,326,299,382,340,336,83,-27,110
1075,230000,0797526c057dcf5b,8,0,630,651,605,913,1064,350,347,604,509,589,621,701,661,637,80,32,48
223,310000,936168bd4850913d,8,0,253,330,234,241,272,250,161,224,213,175,131,62,96,123,-69,-44,-25
389,530000,936168bd4850913d,8,0,281,288,285,282,383,494,162,297,298,329,209,81,145,206,-128,-120,-8
339,150000,936168bd4850913d,8,0,325,397,353,331,374,412,213,364,399,353,232,84,158,223,-148,-121,-27
317,110000,936168bd4850913d,8,0,459,651,432,527,798,336,255,324,347,230,135,126,130,164,-9,-95,86
382,510000,936168bd4850913d,8,0,356,560,353,364,502,560,198,280,354,296,108,64,86,156,-44,-188,144
393,340000,936168bd4850913d,8,0,370,464,369,339,449,378,228,339,365,359,86,125,106,190,39,-273,312
1000,370000,936168bd4850913d,8,0,896,1347,1014,1020,1083,1132,648,948,1214,1085,369,273,321,576,-96,-716,620
396,140000,936168bd4850913d,8,0,334,462,394,347,454,373,276,370,403,345,137,148,142,210,11,-208,219
2431,440000,936168bd4850913d,8,0,2391,3040,2810,2842,3119,2859,1337,2735,2621,2524,1566,594,1080,1561,-972,-958,-14
277,450000,936168bd4850913d,8,0,237,346,287,279,316,376,154,306,255,297,140,103,122,180,-37,-157,120
838,320000,936168bd4850913d,8,0,919,1153,908,905,1057,1012,579,905,787,820,405,226,316,484,-179,-415,236
317,360000,936168bd4850913d,8,0,350,407,325,334,414,397,195,355,439,342,151,95,123,196,-56,-191,135
922,130000,936168bd4850913d,8,0,691,837,696,646,778,797,602,842,1066,971,374,253,314,533,-121,-597,476
1111,410000,936168bd4850913d,8,0,801,1165,786,979,1154,954,596,986,1159,919,330,428,379,559,98,-589,687
789,330000,936168bd4850913d,8,0,631,767,611,709,819,752,388,650,682,669,277,191,234,379,-86,-392,306
1053,420000,936168bd4850913d,8,0,1127,1463,1111,1292,1497,1405,549,1164,1131,1057,674,316,495,682,-358,-383,25
551,430000,936168bd4850913d,8,0,726,776,563,649,953,623,341,556,689,570,218,194,206,327,-24,-352,328
543,350000,936168bd4850913d,8,0,558,641,586,610,611,627,347,556,479,612,226,137,182,325,-89,-386,297
733,210000,936168bd4850913d,8,0,667,816,696,727,851,758,485,709,730,631,387,271,329,430,-116,-244,128
154,500000,936168bd4850913d,8,0,181,222,152,145,208,248,87,111,125,128,35,39,37,67,4,-93,97
357,610000,936168bd4850913d,8,0,360,429,415,400,482,463,229,331,386,360,198,125,162,228,-73,-162,89
519,230000,936168bd4850913d,8,0,567,621,450,630,549,617,346,607,485,461,268,130,199,286,-138,-193,55
234,310000,cc21c7e91a3b5a0c,8,0,281,287,238,345,456,114,153,205,172,211,259,235,247,235,-24,48,-72
448,530000,cc21c7e91a3b5a0c,8,0,345,327,285,338,442,406,203,364,347,383,359,548,454,430,189,-24,213
353,150000,cc21c7e91a3b5a0c,8,0,267,246,282,331,382,195,193,311,298,379,324,426,375,376,102,-55,157
113,110000,cc21c7e91a3b5a0c,8,0,208,303,262,356,580,121,115,186,128,156,127,143,135,142,16,-29,45
561,510000,cc21c7e91a3b5a0c,8,0,451,636,487,569,804,459,234,390,378,467,472,512,492,484,40,5,35
548,340000,cc21c7e91a3b5a0c,8,0,400,439,428,489,503,403,244,376,434,485,530,589,560,535,59,45,14
952,370000,cc21c7e91a3b5a0c,8,0,692,815,855,912,1164,554,505,703,953,906,900,978,939,928,78,-6,84
371,140000,cc21c7e91a3b5a0c,8,0,277,310,284,316,428,223,193,301,299,310,314,437,376,354,123,4,119
3157,440000,cc21c7e91a3b5a0c,8,0,2219,2478,2450,3345,3730,1930,1262,2615,2284,2880,3003,3073,3038,2985,70,123,-53
396,450000,cc21c7e91a3b5a0c,8,0,270,290,313,377,417,266,187,309,304,370,332,440,386,381,108,-38,146
1276,320000,cc21c7e91a3b5a0c,8,0,1139,1193,1114,1454,1527,877,754,1069,1130,1243,1239,1359,1299,1280,120,-4,124
477,360000,cc21c7e91a3b5a0c,8,0,314,340,317,350,507,305,161,323,377,500,498,505,502,501,7,-2,9
876,130000,cc21c7e91a3b5a0c,8,0,521,590,551,574,797,453,434,572,723,877,842,1076,959,932,234,-35,269
974,410000,cc21c7e91a3b5a0c,8,0,647,687,548,872,1036,630,391,702,797,764,826,1251,1038,947,425,62,363
1191,330000,cc21c7e91a3b5a0c,8,0,863,800,942,1151,1258,739,529,861,969,1092,1188,1336,1262,1205,148,96,52
1129,420000,cc21c7e91a3b5a0c,8,0,876,1065,918,1189,1511,963,454,719,775,822,1002,1247,1124,1024,245,180,65
615,430000,cc21c7e91a3b5a0c,8,0,456,456,452,506,737,420,189,443,430,470,484,597,540,517,113,14,99
724,350000,cc21c7e91a3b5a0c,8,0,525,556,643,734,779,473,353,640,561,659,677,791,734,709,114,18,96
589,210000,cc21c7e91a3b5a0c,8,0,434,437,390,480,602,285,241,431,475,512,466,627,546,535,161,-46,207
194,500000,cc21c7e91a3b5a0c,8,0,218,203,186,200,305,185,95,179,155,153,233,211,222,199,-22,80,-102
406,610000,cc21c7e91a3b5a0c,8,0,301,293,309,345,496,293,157,234,292,346,246,352,299,315,106,-100,206
380,230000,cc21c7e91a3b5a0c,8,0,329,347,306,404,422,214,206,322,309,385,388,444,416,406,56,3,53
150,310000,7aab7fca2470987e,8,0,228,248,166,277,348,224,140,212,313,130,176,126,151,144,-50,46,-96
9,530000,7aab7fca2470987e,8,0,23,22,12,22,33,19,19,18,22,20,12,9,10,14,-3,-8,5
22,150000,7aab7fca2470987e,8,0,26,20,16,19,22,21,19,29,36,17,19,26,22,21,7,2,5
268,110000,7aab7fca2470987e,8,0,450,433,353,372,511,424,244,378,320,244,260,250,255,251,-10,16,-26
37,510000,7aab7fca2470987e,8,0,33,53,34,42,64,69,42,47,33,29,34,13,24,25,-21,5,-26
45,340000,7aab7fca2470987e,8,0,60,65,52,74,75,83,59,59,57,45,62,31,46,46,-31,17,-48
222,370000,7aab7fca2470987e,8,0,300,349,309,286,341,430,189,295,303,192,237,256,246,228,19,45,-26
83,140000,7aab7fca2470987e,8,0,86,76,58,62,78,105,64,83,78,62,75,85,80,74,10,13,-3
844,440000,7aab7fca2470987e,8,0,827,959,887,972,1235,1009,443,848,749,579,865,757,811,734,-108,286,-394
21,450000,7aab7fca2470987e,8,0,35,23,23,13,26,34,17,20,12,20,22,16,19,19,-6,2,-8
319,320000,7aab7fca2470987e,8,0,384,352,323,380,481,397,258,351,301,241,305,301,303,282,-4,64,-68
20,360000,7aab7fca2470987e,8,0,41,44,29,35,37,61,16,26,40,25,30,32,31,29,2,5,-3
230,130000,7aab7fca2470987e,8,0,259,229,234,231,316,308,172,236,271,218,215,233,224,222,18,-3,21
161,410000,7aab7fca2470987e,8,0,209,192,150,188,209,242,134,155,146,105,140,155,148,133,15,35,-20
283,330000,7aab7fca2470987e,8,0,300,252,293,323,375,353,222,270,371,311,449,354,402,371,-95,138,-233
59,420000,7aab7fca2470987e,8,0,58,58,26,64,62,54,47,52,51,39,64,44,54,49,-20,25,-45
38,430000,7aab7fca2470987e,8,0,26,47,25,31,44,54,26,27,28,26,30,22,26,26,-8,4,-12
57,350000,7aab7fca2470987e,8,0,64,42,57,83,105,92,41,56,43,37,75,57,66,56,-18,38,-56
163,210000,7aab7fca2470987e,8,0,176,181,127,153,187,158,103,124,129,115,148,126,137,130,-22,33,-55
21,500000,7aab7fca2470987e,8,0,22,19,17,12,27,22,12,27,12,19,15,18,16,17,3,-4,7
20,610000,7aab7fca2470987e,8,0,34,19,25,29,46,61,16,38,37,27,23,27,25,26,4,-4,8
70,230000,7aab7fca2470987e,8,0,78,77,62,61,65,66,41,61,62,37,56,42,49,45,-14,19,-33
313,310000,fde95ea242abd896,8,0,233,237,260,331,369,161,142,190,140,165,214,189,202,189,-25,49,-74
379,530000,fde95ea242abd896,8,0,351,388,519,521,651,386,202,309,233,292,232,382,307,302,150,-60,210
187,150000,fde95ea242abd896,8,0,149,181,185,190,234,146,90,139,127,131,111,141,126,128,30,-20,50
130,110000,fde95ea242abd896,8,0,271,313,223,301,382,210,141,181,149,153,130,100,115,128,-30,-23,-7
617,510000,fde95ea242abd896,8,0,384,645,492,617,839,509,240,360,342,344,334,430,382,369,96,-10,106
415,340000,fde95ea242abd896,8,0,429,508,453,504,690,387,163,254,266,293,273,348,310,305,75,-20,95
847,370000,fde95ea242abd896,8,0,642,825,774,709,964,444,303,464,570,555,507,649,578,570,142,-48,190
331,140000,fde95ea242abd896,8,0,300,278,277,302,443,175,132,238,204,221,191,257,224,223,66,-30,96
3296,440000,fde95ea242abd896,8,0,3466,3967,4449,4901,5547,3229,1517,2906,3040,2996,3064,2940,3002,3000,-124,68,-192
353,450000,fde95ea242abd896,8,0,375,362,434,458,665,381,181,321,247,278,230,271,250,260,41,-48,89
923,320000,fde95ea242abd896,8,0,910,875,888,974,1139,690,508,722,614,698,656,855,756,736,199,-42,241
354,360000,fde95ea242abd896,8,0,283,440,408,499,625,381,184,276,300,321,252,286,269,286,34,-69,103
794,130000,fde95ea242abd896,8,0,560,591,602,602,830,407,320,433,514,507,400,601,500,503,201,-107,308
853,410000,fde95ea242abd896,8,0,574,666,620,614,920,507,247,499,530,473,405,626,516,501,221,-68,289
1255,330000,fde95ea242abd896,8,0,968,1148,998,1169,1424,732,558,806,842,817,859,969,914,882,110,42,68
774,420000,fde95ea242abd896,8,0,764,987,818,1066,1347,698,270,511,498,504,540,672,606,572,132,36,96
729,430000,fde95ea242abd896,8,0,503,752,630,700,988,570,203,418,421,498,401,577,489,492,176,-97,273
765,350000,fde95ea242abd896,8,0,671,676,754,796,1043,605,368,580,595,656,635,615,625,635,-20,-21,1
581,210000,fde95ea242abd896,8,0,472,553,433,460,600,253,193,341,357,363,293,369,331,342,76,-70,146
163,500000,fde95ea242abd896,8,0,172,243,227,222,229,139,105,116,140,127,159,132,146,139,-27,32,-59
252,610000,fde95ea242abd896,8,0,164,191,253,229,293,140,96,140,126,155,135,199,167,163,64,-20,84
390,230000,fde95ea242abd896,8,0,372,256,198,199,322,111,123,264,218,232,182,233,208,216,51,-50,101
325,310000,97f15de12cfabbd5,8,0,368,455,354,457,516,264,193,369,368,312,223,311,267,282,88,-89,177
92,530000,97f15de12cfabbd5,8,0,137,168,236,233,253,206,111,144,116,120,119,120,120,120,1,-1,2
175,150000,97f15de12cfabbd5,8,0,148,180,212,200,238,219,114,172,145,184,185,176,180,182,-9,1,-10
390,110000,97f15de12cfabbd5,8,0,704,733,603,754,1094,601,390,482,397,375,385,359,372,373,-26,10,-36
353,510000,97f15de12cfabbd5,8,0,280,498,363,489,543,391,237,325,296,251,270,231,250,251,-39,19,-58
233,340000,97f15de12cfabbd5,8,0,361,472,444,568,578,495,153,185,233,254,279,190,234,241,-89,25,-114
746,370000,97f15de12cfabbd5,8,0,771,1001,1018,1094,1221,1031,476,846,727,791,753,709,731,751,-44,-38,-6
331,140000,97f15de12cfabbd5,8,0,398,381,370,395,605,316,221,369,335,297,249,379,314,308,130,-48,178
2251,440000,97f15de12cfabbd5,8,0,2292,2762,3019,3563,3747,2666,1125,2377,2460,2143,2250,2148,2199,2180,-102,107,-209
130,450000,97f15de12cfabbd5,8,0,132,134,146,194,174,193,92,119,101,114,104,103,104,107,-1,-10,9
813,320000,97f15de12cfabbd5,8,0,1139,1155,1292,1491,1524,1070,552,1008,901,895,803,803,803,834,0,-92,92
208,360000,97f15de12cfabbd5,8,0,206,280,258,340,409,346,81,166,179,201,165,187,176,184,22,-36,58
800,130000,97f15de12cfabbd5,8,0,819,812,975,971,1119,789,422,734,762,790,652,806,729,749,154,-138,292
417,410000,97f15de12cfabbd5,8,0,519,592,609,805,866,692,326,488,531,450,448,469,458,456,21,-2,23
1239,330000,97f15de12cfabbd5,8,0,1100,1259,1371,1516,1515,1138,549,969,1010,1108,1385,1507,1446,1333,122,277,-155
489,420000,97f15de12cfabbd5,8,0,475,707,729,779,906,749,253,446,434,381,436,412,424,410,-24,55,-79
373,430000,97f15de12cfabbd5,8,0,419,626,645,767,839,710,238,437,402,430,431,398,414,420,-33,1,-34
322,350000,97f15de12cfabbd5,8,0,389,434,571,612,638,509,288,542,508,519,527,327,427,458,-200,8,-208
875,210000,97f15de12cfabbd5,8,0,1068,1256,1020,1269,1395,898,506,962,872,971,851,914,882,912,63,-120,183
125,500000,97f15de12cfabbd5,8,0,190,183,170,200,213,159,106,164,130,104,160,133,146,132,-27,56,-83
160,610000,97f15de12cfabbd5,8,0,246,251,273,309,371,227,159,225,195,179,129,173,151,160,44,-50,94
522,230000,97f15de12cfabbd5,8,0,659,536,422,639,783,366,217,537,358,448,306,533,420,429,227,-142,369
239,310000,f5d69960089c3614,8,0,231,263,186,304,291,260,125,252,169,218,208,195,202,207,-13,-10,-3
64,530000,f5d69960089c3614,8,0,70,45,62,97,95,78,48,59,48,61,43,79,61,61,36,-18,54
64,150000,f5d69960089c3614,8,0,48,53,57,54,64,35,18,51,53,69,55,61,58,62,6,-14,20
482,110000,f5d69960089c3614,8,0,431,542,458,551,739,435,233,445,341,391,396,426,411,404,30,5,25
233,510000,f5d69960089c3614,8,0,192,406,218,246,296,270,133,178,212,190,231,208,220,210,-23,41,-64
75,340000,f5d69960089c3614,8,0,102,108,119,125,125,156,59,89,69,81,70,72,71,74,2,-11,13
249,370000,f5d69960089c3614,8,0,236,259,209,228,356,218,112,223,197,226,179,193,186,199,14,-47,61
44,140000,f5d69960089c3614,8,0,38,29,27,53,51,47,21,35,29,43,35,45,40,41,10,-8,18
362,440000,f5d69960089c3614,8,0,283,319,341,442,572,437,152,310,246,338,497,305,401,380,-192,159,-351
44,450000,f5d69960089c3614,8,0,47,48,35,38,46,44,34,25,32,38,35,50,42,41,15,-3,18
223,320000,f5d69960089c3614,8,0,202,235,218,248,301,251,138,200,177,214,189,187,188,197,-2,-25,23
67,360000,f5d69960089c3614,8,0,63,74,57,75,92,84,32,51,53,76,51,70,60,66,19,-25,44
162,130000,f5d69960089c3614,8,0,106,81,95,123,131,106,79,112,113,144,111,129,120,128,18,-33,51
163,410000,f5d69960089c3614,8,0,133,136,137,144,187,131,57,111,155,108,118,135,126,120,17,10,7
130,330000,f5d69960089c3614,8,0,123,127,129,149,230,149,78,139,107,108,142,110,126,120,-32,34,-66
157,420000,f5d69960089c3614,8,0,88,128,132,148,184,148,61,111,94,101,110,110,110,107,0,9,-9
135,430000,f5d69960089c3614,8,0,129,125,121,157,211,135,74,132,109,108,118,96,107,107,-22,10,-32
85,350000,f5d69960089c3614,8,0,79,63,93,111,124,108,57,77,71,97,95,75,85,89,-20,-2,-18
152,210000,f5d69960089c3614,8,0,129,93,93,126,129,69,51,75,76,107,67,96,82,90,29,-40,69
142,500000,f5d69960089c3614,8,0,91,113,105,132,160,125,77,112,97,87,149,112,130,116,-37,62,-99
144,610000,f5d69960089c3614,8,0,114,118,176,150,182,148,77,137,111,172,117,112,114,134,-5,-55,50
100,230000,f5d69960089c3614,8,0,83,64,44,71,77,53,34,68,53,50,51,50,50,50,-1,1,-2
95,310000,5b1c11c3efed5312,8,0,182,195,186,244,388,154,85,126,92,105,104,90,97,100,-14,-1,-13
60,530000,5b1c11c3efed5312,8,0,175,199,190,214,267,194,91,60,53,77,69,54,62,67,-15,-8,-7
87,150000,5b1c11c3efed5312,8,0,129,117,180,167,259,127,62,61,62,68,40,53,46,54,13,-28,41
16,110000,5b1c11c3efed5312,8,0,189,195,143,181,370,71,41,51,25,21,23,21,22,22,-2,2,-4
152,510000,5b1c11c3efed5312,8,0,271,451,335,432,691,448,194,129,110,118,105,113,109,112,8,-13,21
229,340000,5b1c11c3efed5312,8,0,615,665,719,699,1253,712,250,227,217,259,222,209,216,230,-13,-37,24
297,370000,5b1c11c3efed5312,8,0,598,799,850,792,1449,549,320,297,347,332,246,290,268,289,44,-86,130
92,140000,5b1c11c3efed5312,8,0,180,176,226,231,426,153,81,103,83,114,108,86,97,103,-22,-6,-16
271,440000,5b1c11c3efed5312,8,0,682,810,953,1204,1628,496,168,342,246,344,349,247,298,313,-102,5,-107
45,450000,5b1c11c3efed5312,8,0,93,96,119,135,240,121,56,54,26,39,23,31,27,31,8,-16,24
347,320000,5b1c11c3efed5312,8,0,879,928,1050,1083,1908,768,543,404,402,487,371,340,356,399,-31,-116,85
163,360000,5b1c11c3efed5312,8,0,256,368,358,434,733,453,153,150,168,191,126,131,128,149,5,-65,70
321,130000,5b1c11c3efed5312,8,0,513,576,665,667,1158,476,272,257,300,350,276,304,290,310,28,-74,102
290,410000,5b1c11c3efed5312,8,0,728,823,894,1006,1883,910,372,312,380,366,295,321,308,327,26,-71,97
410,330000,5b1c11c3efed5312,8,0,806,968,1022,1202,2202,744,430,386,337,361,407,360,384,376,-47,46,-93
118,420000,5b1c11c3efed5312,8,0,236,278,353,409,749,443,143,138,130,145,146,117,132,136,-29,1,-30
150,430000,5b1c11c3efed5312,8,0,263,352,322,439,744,378,131,137,149,138,134,113,124,128,-21,-4,-17
127,350000,5b1c11c3efed5312,8,0,197,242,345,391,594,265,149,173,130,137,127,100,114,121,-27,-10,-17
66,210000,5b1c11c3efed5312,8,0,166,151,176,186,256,75,62,80,75,84,47,39,43,57,-8,-37,29
21,500000,5b1c11c3efed5312,8,0,81,101,86,92,172,124,38,29,23,20,27,17,22,21,-10,7,-17
82,610000,5b1c11c3efed5312,8,0,126,155,205,212,325,144,79,70,64,97,57,67,62,74,10,-40,50
44,230000,5b1c11c3efed5312,8,0,138,116,107,126,152,43,36,52,38,43,41,34,38,39,-7,-2,-5
8,310000,17363f08d683d52b,8,0,93,94,69,88,96,65,19,37,175,5,12,7,10,8,-5,7,-12
66,530000,17363f08d683d52b,8,0,181,192,214,209,182,216,75,82,86,83,57,67,62,69,10,-26,36
46,150000,17363f08d683d52b,8,0,130,174,176,130,141,132,46,66,45,69,41,38,40,49,-3,-28,25
15,110000,17363f08d683d52b,8,0,229,259,158,186,277,124,81,65,48,29,26,33,30,29,7,-3,10
44,510000,17363f08d683d52b,8,0,249,374,267,205,292,350,117,93,78,81,64,97,80,81,33,-17,50
99,340000,17363f08d683d52b,8,0,409,407,332,341,384,513,121,108,92,90,118,107,112,105,-11,28,-39
127,370000,17363f08d683d52b,8,0,578,669,572,480,596,555,214,153,209,203,175,145,160,174,-30,-28,-2
3,140000,17363f08d683d52b,8,0,105,82,89,70,67,66,26,12,22,19,12,23,18,18,11,-7,18
25,440000,17363f08d683d52b,8,0,130,99,91,101,84,62,19,63,37,30,29,26,28,28,-3,-1,-2
5,450000,17363f08d683d52b,8,0,47,57,42,39,50,45,14,26,20,6,2,8,5,5,6,-4,10
86,320000,17363f08d683d52b,8,0,652,534,502,474,569,538,214,216,188,191,134,129,132,151,-5,-57,52
62,360000,17363f08d683d52b,8,0,361,423,281,274,309,360,94,101,91,90,79,82,80,84,3,-11,14
91,130000,17363f08d683d52b,8,0,474,378,372,326,383,353,154,150,162,149,131,144,138,141,13,-18,31
63,410000,17363f08d683d52b,8,0,516,505,471,372,457,538,139,100,129,104,87,70,78,87,-17,-17,0
89,330000,17363f08d683d52b,8,0,619,525,437,429,453,388,129,152,151,108,106,91,98,102,-15,-2,-13
65,420000,17363f08d683d52b,8,0,348,470,379,317,421,474,120,139,119,158,186,109,148,151,-77,28,-105
92,430000,17363f08d683d52b,8,0,394,455,353,348,428,459,95,148,114,114,115,100,108,110,-15,1,-16
28,350000,17363f08d683d52b,8,0,140,150,148,127,159,136,38,44,37,55,51,15,33,40,-36,-4,-32
48,210000,17363f08d683d52b,8,0,236,239,216,174,238,151,59,93,137,105,53,60,56,73,7,-52,59
15,500000,17363f08d683d52b,8,0,160,119,108,151,126,110,41,27,16,19,16,22,19,19,6,-3,9
86,610000,17363f08d683d52b,8,0,241,219,279,210,288,180,80,67,82,94,70,81,76,82,11,-24,35
31,230000,17363f08d683d52b,8,0,185,126,121,118,156,75,46,57,45,34,22,28,25,28,6,-12,18
272,310000,06880909932890ca,8,0,260,330,188,341,384,208,78,136,169,219,267,195,231,227,-72,48,-120
126,530000,06880909932890ca,8,0,152,177,216,186,206,142,56,68,79,116,111,106,108,111,-5,-5,0
70,150000,06880909932890ca,8,0,118,103,121,125,115,74,44,45,52,72,39,48,44,53,9,-33,42
181,110000,06880909932890ca,8,0,598,646,461,553,771,253,139,206,162,160,198,159,178,172,-39,38,-77
505,510000,06880909932890ca,8,0,541,770,548,657,933,673,263,243,304,396,459,464,462,440,5,63,-58
679,340000,06880909932890ca,8,0,909,849,800,764,993,964,338,340,389,526,609,640,624,592,31,83,-52
690,370000,06880909932890ca,8,0,1028,1068,979,957,1332,1011,383,430,537,623,546,597,572,589,51,-77,128
130,140000,06880909932890ca,8,0,260,200,213,203,275,128,67,102,111,136,137,121,129,131,-16,1,-17
732,440000,06880909932890ca,8,0,1165,1341,1182,1660,1546,767,278,638,579,734,773,669,721,725,-104,39,-143
121,450000,06880909932890ca,8,0,192,192,181,188,276,186,86,105,86,125,135,129,132,130,-6,10,-16
1619,320000,06880909932890ca,8,0,2086,2054,2015,2022,2642,2094,991,984,1074,1356,1448,1465,1456,1423,17,92,-75
445,360000,06880909932890ca,8,0,466,481,368,453,691,614,157,211,274,326,317,295,306,313,-22,-9,-13
514,130000,06880909932890ca,8,0,797,728,665,667,773,530,290,330,342,436,385,393,389,405,8,-51,59
1176,410000,06880909932890ca,8,0,1680,1676,1390,1577,2409,1865,640,650,891,1055,1267,1138,1202,1153,-129,212,-341
1489,330000,06880909932890ca,8,0,1649,1572,1696,1832,2222,1022,501,663,715,913,1088,1232,1160,1078,144,175,-31
414,420000,06880909932890ca,8,0,562,525,475,492,661,605,178,211,256,312,333,394,364,346,61,21,40
447,430000,06880909932890ca,8,0,541,561,481,547,698,488,170,228,287,352,372,388,380,371,16,20,-4
303,350000,06880909932890ca,8,0,418,427,469,556,601,361,197,246,246,307,332,263,298,301,-69,25,-94
154,210000,06880909932890ca,8,0,309,335,246,211,328,161,100,120,120,168,137,149,143,151,12,-31,43
251,500000,06880909932890ca,8,0,439,445,330,373,430,326,140,158,145,189,295,272,284,252,-23,106,-129
229,610000,06880909932890ca,8,0,407,350,449,347,562,349,119,145,167,210,170,185,178,188,15,-40,55
53,230000,06880909932890ca,8,0,149,133,82,97,100,69,37,53,48,62,47,72,60,60,25,-15,40
6,310000,9c1c7ee8ebdda299,8,0,27,10,4,41,46,32,19,54,17,10,12,11,12,11,-1,2,-3
100,530000,9c1c7ee8ebdda299,8,0,200,159,126,119,169,142,104,91,53,62,66,54,60,61,-12,4,-16
161,150000,9c1c7ee8ebdda299,8,0,323,327,297,353,430,278,168,258,163,176,174,153,164,168,-21,-2,-19
3,110000,9c1c7ee8ebdda299,8,0,121,96,46,78,112,52,38,30,13,7,12,11,12,10,-1,5,-6
174,510000,9c1c7ee8ebdda299,8,0,836,723,408,517,641,617,336,250,134,145,143,161,152,150,18,-2,20
82,340000,9c1c7ee8ebdda299,8,0,261,211,71,198,190,278,146,119,59,72,88,63,76,74,-25,16,-41
635,370000,9c1c7ee8ebdda299,8,0,1885,1782,1445,1562,2281,1763,885,746,509,752,650,656,653,686,6,-102,108
337,140000,9c1c7ee8ebdda299,8,0,973,842,579,768,886,691,295,401,285,317,252,283,268,284,31,-65,96
131,440000,9c1c7ee8ebdda299,8,0,791,821,619,710,1008,472,229,471,212,177,139,130,134,149,-9,-38,29
127,450000,9c1c7ee8ebdda299,8,0,185,191,132,192,308,251,110,119,55,137,102,134,118,124,32,-35,67
95,320000,9c1c7ee8ebdda299,8,0,267,195,95,307,309,370,299,211,106,111,126,119,122,119,-7,15,-22
45,360000,9c1c7ee8ebdda299,8,0,138,145,60,177,182,224,84,107,42,42,52,41,46,45,-11,10,-21
852,130000,9c1c7ee8ebdda299,8,0,2125,1949,1092,1644,1840,1468,940,941,733,782,635,713,674,710,78,-147,225
284,410000,9c1c7ee8ebdda299,8,0,693,546,306,774,911,1101,433,362,211,283,281,280,280,281,-1,-2,1
223,330000,9c1c7ee8ebdda299,8,0,202,149,42,380,352,327,197,195,168,241,204,240,222,228,36,-37,73
44,420000,9c1c7ee8ebdda299,8,0,123,100,46,116,125,211,58,65,32,39,46,41,44,42,-5,7,-12
47,430000,9c1c7ee8ebdda299,8,0,142,140,74,141,165,230,105,87,42,50,62,55,58,56,-7,12,-19
58,350000,9c1c7ee8ebdda299,8,0,219,159,110,281,215,204,105,130,66,70,71,48,60,63,-23,1,-24
244,210000,9c1c7ee8ebdda299,8,0,715,654,384,528,619,375,317,409,425,215,168,173,170,185,5,-47,52
26,500000,9c1c7ee8ebdda299,8,0,170,119,62,80,104,116,61,54,25,34,33,27,30,31,-6,-1,-5
123,610000,9c1c7ee8ebdda299,8,0,331,168,145,214,250,261,108,136,75,123,125,148,136,132,23,2,21
118,230000,9c1c7ee8ebdda299,8,0,328,302,291,350,342,207,144,192,137,117,137,97,117,117,-40,20,-60
286,310000,c6833cb891626c17,8,0,321,371,283,435,596,174,80,151,177,200,272,204,238,225,-68,72,-140
233,530000,c6833cb891626c17,8,0,368,477,514,538,699,444,236,185,176,241,235,239,237,238,4,-6,10
244,150000,c6833cb891626c17,8,0,328,337,354,323,485,221,94,125,138,233,182,202,192,206,20,-51,71
271,110000,c6833cb891626c17,8,0,785,877,636,879,1517,309,174,289,242,251,279,287,283,272,8,28,-20
444,510000,c6833cb891626c17,8,0,602,1020,712,770,1305,743,339,285,287,359,363,364,364,362,1,4,-3
843,340000,c6833cb891626c17,8,0,834,1066,894,964,1597,855,344,344,422,524,660,677,668,620,17,136,-119
808,370000,c6833cb891626c17,8,0,998,1278,1160,1107,1740,687,383,327,543,829,670,841,756,780,171,-159,330
212,140000,c6833cb891626c17,8,0,301,280,282,301,514,192,100,117,126,207,172,186,179,188,14,-35,49
479,440000,c6833cb891626c17,8,0,890,1382,1240,1586,1899,542,186,403,360,460,604,483,544,516,-121,144,-265
118,450000,c6833cb891626c17,8,0,232,277,266,309,514,260,96,110,81,120,111,123,117,118,12,-9,21
876,320000,c6833cb891626c17,8,0,1345,1406,1396,1446,2279,939,574,593,645,899,941,918,930,919,-23,42,-65
439,360000,c6833cb891626c17,8,0,409,638,519,571,900,502,180,199,229,302,289,342,316,311,53,-13,66
1013,130000,c6833cb891626c17,8,0,929,1066,990,1108,1749,708,414,412,600,843,768,843,806,818,75,-75,150
1046,410000,c6833cb891626c17,8,0,1438,1525,1493,1622,2735,1331,509,557,792,1003,1139,1208,1174,1117,69,136,-67
1449,330000,c6833cb891626c17,8,0,1635,1804,1911,2130,3255,1119,581,616,676,899,1179,1212,1196,1097,33,280,-247
417,420000,c6833cb891626c17,8,0,485,678,560,634,1014,597,202,210,256,309,467,354,410,377,-113,158,-271
368,430000,c6833cb891626c17,8,0,473,712,546,606,978,498,212,209,272,280,287,311,299,293,24,7,17
193,350000,c6833cb891626c17,8,0,291,406,499,552,782,311,141,184,131,214,223,160,192,199,-63,9,-72
170,210000,c6833cb891626c17,8,0,283,315,299,258,424,127,80,97,131,161,165,176,170,167,11,4,7
159,500000,c6833cb891626c17,8,0,277,336,267,309,532,260,104,78,93,126,161,148,154,145,-13,35,-48
363,610000,c6833cb891626c17,8,0,326,373,472,366,620,315,130,154,179,263,204,263,234,243,59,-59,118
116,230000,c6833cb891626c17,8,0,237,206,170,232,274,80,52,66,71,97,87,91,89,92,4,-10,14
154,310000,3e21824be728cbec,8,0,249,257,239,345,396,369,177,174,163,140,140,130,135,137,-10,0,-10
227,530000,3e21824be728cbec,8,0,344,358,406,373,334,203,134,207,159,159,199,202,200,187,3,40,-37
40,150000,3e21824be728cbec,8,0,160,123,116,59,90,51,29,42,27,40,31,39,35,37,8,-9,17
41,110000,3e21824be728cbec,8,0,139,203,168,222,242,93,60,87,42,47,47,40,44,45,-7,0,-7
417,510000,3e21824be728cbec,8,0,625,731,758,778,781,288,239,321,272,333,406,352,379,364,-54,73,-127
345,340000,3e21824be728cbec,8,0,570,630,644,607,661,309,266,301,237,309,289,297,293,298,8,-20,28
432,370000,3e21824be728cbec,8,0,690,772,807,782,994,540,419,572,464,433,395,383,389,404,-12,-38,26
105,140000,3e21824be728cbec,8,0,287,240,200,132,201,88,44,87,60,67,72,87,80,75,15,5,10
461,440000,3e21824be728cbec,8,0,516,619,721,938,1135,331,231,477,411,394,418,380,399,397,-38,24,-62
124,450000,3e21824be728cbec,8,0,301,268,247,370,403,140,92,140,131,131,161,121,141,138,-40,30,-70
701,320000,3e21824be728cbec,8,0,1017,1020,1227,1286,1781,805,710,885,641,740,693,656,674,696,-37,-47,10
219,360000,3e21824be728cbec,8,0,285,391,438,444,431,157,97,173,170,210,195,175,185,193,-20,-15,-5
455,130000,3e21824be728cbec,8,0,734,729,766,589,806,391,375,484,404,455,438,404,421,432,-34,-17,-17
446,410000,3e21824be728cbec,8,0,854,777,834,729,896,363,334,528,418,445,554,381,468,460,-173,109,-282
473,330000,3e21824be728cbec,8,0,510,573,616,797,1044,341,386,475,363,466,458,443,450,456,-15,-8,-7
200,420000,3e21824be728cbec,8,0,357,375,452,413,461,270,123,194,119,150,177,181,179,169,4,27,-23
195,430000,3e21824be728cbec,8,0,292,394,414,458,478,157,99,182,167,188,184,200,192,191,16,-4,20
225,350000,3e21824be728cbec,8,0,328,339,397,455,593,250,154,266,219,283,228,214,221,242,-14,-55,41
67,210000,3e21824be728cbec,8,0,151,144,114,136,149,45,36,75,66,76,84,71,78,77,-13,8,-21
123,500000,3e21824be728cbec,8,0,410,422,402,422,475,136,124,148,136,160,225,137,181,174,-88,65,-153
204,610000,3e21824be728cbec,8,0,494,446,595,355,464,194,145,188,141,176,186,164,175,175,-22,10,-32
38,230000,3e21824be728cbec,8,0,202,237,176,82,87,40,47,82,54,34,48,39,44,40,-9,14,-23
352,310000,f8a6975573af1b33,8,0,427,420,355,228,579,371,131,288,266,225,283,286,284,265,3,58,-55
170,530000,f8a6975573af1b33,8,0,214,200,244,165,338,215,134,179,192,167,169,217,193,184,48,2,46
60,150000,f8a6975573af1b33,8,0,34,40,41,43,48,41,28,59,37,53,61,54,58,56,-7,8,-15
94,110000,f8a6975573af1b33,8,0,267,304,268,372,383,131,61,110,108,70,103,89,96,87,-14,33,-47
571,510000,f8a6975573af1b33,8,0,370,632,431,484,820,550,286,428,433,456,497,476,486,476,-21,41,-62
558,340000,f8a6975573af1b33,8,0,443,521,495,362,758,508,322,432,425,545,563,499,531,536,-64,18,-82
413,370000,f8a6975573af1b33,8,0,357,410,423,383,729,410,227,320,381,388,394,345,370,376,-49,6,-55
56,140000,f8a6975573af1b33,8,0,51,78,61,91,136,74,57,53,62,47,59,62,60,56,3,12,-9
1225,440000,f8a6975573af1b33,8,0,1153,1298,1305,1034,2232,1023,444,1072,1007,969,1190,954,1072,1038,-236,221,-457
211,450000,f8a6975573af1b33,8,0,217,237,215,191,328,208,107,160,131,178,209,223,216,203,14,31,-17
1132,320000,f8a6975573af1b33,8,0,1153,1190,1239,807,1846,1142,747,1023,870,969,1040,1045,1042,1018,5,71,-66
304,360000,f8a6975573af1b33,8,0,232,306,226,131,436,290,111,237,235,226,237,243,240,235,6,11,-5
444,130000,f8a6975573af1b33,8,0,316,360,308,272,475,287,194,265,298,335,339,355,347,343,16,4,12
547,410000,f8a6975573af1b33,8,0,509,554,543,420,747,459,249,457,513,513,571,508,540,531,-63,58,-121
1202,330000,f8a6975573af1b33,8,0,743,824,856,695,1454,752,503,780,679,725,759,836,798,773,77,34,43
390,420000,f8a6975573af1b33,8,0,250,304,278,190,481,312,158,246,258,251,428,347,388,342,-81,177,-258
344,430000,f8a6975573af1b33,8,0,283,329,289,235,425,324,139,263,238,293,308,308,308,303,0,15,-15
485,350000,f8a6975573af1b33,8,0,411,469,472,415,699,508,260,395,323,426,506,406,456,446,-100,80,-180
143,210000,f8a6975573af1b33,8,0,128,154,125,64,125,66,52,82,116,125,102,110,106,112,8,-23,31
285,500000,f8a6975573af1b33,8,0,300,389,322,256,548,310,185,288,287,285,378,280,329,314,-98,93,-191
184,610000,f8a6975573af1b33,8,0,175,188,226,181,259,170,96,124,121,134,165,167,166,155,2,31,-29
68,230000,f8a6975573af1b33,8,0,86,84,67,65,115,61,52,76,85,53,52,53,52,53,1,-1,2
306,310000,54fc07138d70374c,8,0,327,336,292,421,473,415,199,338,303,272,297,230,264,266,-67,25,-92
299,530000,54fc07138d70374c,8,0,320,316,363,485,535,500,259,353,295,304,293,320,306,306,27,-11,38
197,150000,54fc07138d70374c,8,0,230,224,233,229,234,273,129,208,180,191,167,194,180,184,27,-24,51
360,110000,54fc07138d70374c,8,0,424,442,429,500,681,534,295,402,398,365,374,341,358,360,-33,9,-42
460,510000,54fc07138d70374c,8,0,495,659,704,743,849,933,442,540,493,508,553,476,514,512,-77,45,-122
185,340000,54fc07138d70374c,8,0,249,314,271,334,368,404,198,210,162,176,206,197,202,193,-9,30,-39
522,370000,54fc07138d70374c,8,0,617,771,679,776,936,911,376,595,546,558,596,483,540,546,-113,38,-151
143,140000,54fc07138d70374c,8,0,131,135,142,208,244,213,113,141,101,103,104,107,106,105,3,1,2
969,440000,54fc07138d70374c,8,0,1145,1408,1392,1836,2078,1526,521,1068,875,905,1067,825,946,932,-242,162,-404
172,450000,54fc07138d70374c,8,0,212,207,208,246,317,323,145,236,156,189,166,140,153,165,-26,-23,-3
500,320000,54fc07138d70374c,8,0,616,611,660,847,820,821,461,589,458,423,545,436,490,468,-109,122,-231
149,360000,54fc07138d70374c,8,0,215,215,187,249,262,297,113,164,151,133,139,150,144,141,11,6,5
501,130000,54fc07138d70374c,8,0,528,576,625,746,750,758,431,483,470,474,415,495,455,461,80,-59,139
493,410000,54fc07138d70374c,8,0,623,596,604,752,820,826,447,615,567,493,543,423,483,486,-120,50,-170
322,330000,54fc07138d70374c,8,0,379,387,524,623,684,550,252,401,254,311,325,307,316,314,-18,14,-32
273,420000,54fc07138d70374c,8,0,311,346,310,385,425,481,197,299,246,238,274,238,256,250,-36,36,-72
336,430000,54fc07138d70374c,8,0,384,424,364,460,493,505,239,383,321,315,341,325,333,327,-16,26,-42
139,350000,54fc07138d70374c,8,0,222,223,268,329,338,400,163,217,128,161,123,141,132,142,18,-38,56
274,210000,54fc07138d70374c,8,0,324,364,303,369,450,249,117,274,320,298,258,236,247,264,-22,-40,18
285,500000,54fc07138d70374c,8,0,372,406,400,540,575,576,284,403,314,306,439,296,368,347,-143,133,-276
229,610000,54fc07138d70374c,8,0,275,293,365,346,404,376,178,272,285,266,201,203,202,223,2,-65,67
251,230000,54fc07138d70374c,8,0,356,331,302,341,410,324,206,341,242,239,273,292,282,268,19,34,-15
261,310000,212083a9246d2fd3,8,0,617,628,446,636,846,241,179,180,191,192,253,247,250,231,-6,61,-67
166,530000,212083a9246d2fd3,8,0,189,278,304,365,493,290,145,117,124,158,128,183,156,156,55,-30,85
110,150000,212083a9246d2fd3,8,0,136,222,206,310,562,284,123,119,71,119,101,97,99,106,-4,-18,14
57,110000,212083a9246d2fd3,8,0,473,498,257,444,824,105,71,55,60,50,59,51,55,53,-8,9,-17
607,510000,212083a9246d2fd3,8,0,777,1042,762,1080,1730,983,504,400,394,380,436,516,476,444,80,56,24
770,340000,212083a9246d2fd3,8,0,973,1078,1023,1260,2243,1186,528,593,566,477,521,594,558,531,73,44,29
836,370000,212083a9246d2fd3,8,0,1294,1622,1536,1637,2998,1261,553,503,551,645,651,724,688,673,73,6,67
230,140000,212083a9246d2fd3,8,0,272,308,299,372,645,313,178,140,164,178,173,195,184,182,22,-5,27
1007,440000,212083a9246d2fd3,8,0,1670,1369,1274,1967,3191,905,337,855,959,831,614,794,704,746,180,-217,397
252,450000,212083a9246d2fd3,8,0,188,232,252,337,697,471,179,227,188,213,224,204,214,214,-20,11,-31
897,320000,212083a9246d2fd3,8,0,2067,2163,1918,2283,3836,1631,972,777,763,993,802,889,846,895,87,-191,278
344,360000,212083a9246d2fd3,8,0,440,542,547,676,1270,658,229,229,221,283,227,273,250,261,46,-56,102
666,130000,212083a9246d2fd3,8,0,909,987,969,1064,2232,950,551,442,578,697,555,544,550,599,-11,-142,131
1300,410000,212083a9246d2fd3,8,0,1337,1548,1431,1720,3243,1894,828,807,1011,1085,1013,1189,1101,1096,176,-72,248
565,330000,212083a9246d2fd3,8,0,1003,1067,1140,1205,1850,574,328,328,361,426,423,467,445,439,44,-3,47
230,420000,212083a9246d2fd3,8,0,435,576,710,866,1354,755,244,256,243,222,247,223,235,231,-24,25,-49
511,430000,212083a9246d2fd3,8,0,709,844,687,982,1756,938,322,403,371,448,412,466,439,442,54,-36,90
338,350000,212083a9246d2fd3,8,0,486,645,645,746,1041,462,182,250,215,304,238,233,236,258,-5,-66,61
123,210000,212083a9246d2fd3,8,0,418,415,275,422,561,181,92,144,178,144,111,123,117,126,12,-33,45
212,500000,212083a9246d2fd3,8,0,749,722,571,643,1136,557,231,195,203,189,260,190,225,213,-70,71,-141
491,610000,212083a9246d2fd3,8,0,726,652,682,805,1567,639,298,275,310,369,282,381,332,344,99,-87,186
93,230000,212083a9246d2fd3,8,0,159,164,109,207,305,102,62,72,62,93,71,101,86,88,30,-22,52
31,310000,4f79773e600518a6,8,0,90,112,64,139,159,95,31,32,33,18,19,21,20,19,2,1,1
60,530000,4f79773e600518a6,8,0,103,88,129,116,195,181,91,58,50,67,48,56,52,57,8,-19,27
105,150000,4f79773e600518a6,8,0,148,178,215,227,336,327,113,110,91,126,86,83,84,98,-3,-40,37
21,110000,4f79773e600518a6,8,0,107,124,113,153,246,99,35,29,28,28,17,19,18,21,2,-11,13
114,510000,4f79773e600518a6,8,0,165,260,194,267,387,398,155,108,95,80,69,76,72,75,7,-11,18
112,340000,4f79773e600518a6,8,0,228,277,262,301,471,484,121,103,101,118,103,101,102,107,-2,-15,13
332,370000,4f79773e600518a6,8,0,565,670,629,591,961,723,263,300,312,311,242,273,258,275,31,-69,100
92,140000,4f79773e600518a6,8,0,106,92,114,133,167,149,66,59,57,51,58,45,52,51,-13,7,-20
38,440000,4f79773e600518a6,8,0,112,111,142,134,176,97,19,44,38,31,35,30,32,32,-5,4,-9
18,450000,4f79773e600518a6,8,0,46,27,44,52,62,66,20,31,15,25,9,23,16,19,14,-16,30
80,320000,4f79773e600518a6,8,0,275,222,289,312,450,333,168,137,94,101,95,97,96,98,2,-6,8
86,360000,4f79773e600518a6,8,0,123,158,141,164,252,264,69,58,63,82,66,58,62,69,-8,-16,8
221,130000,4f79773e600518a6,8,0,251,268,281,338,473,362,182,165,226,205,142,157,150,168,15,-63,78
237,410000,4f79773e600518a6,8,0,438,436,457,535,679,669,213,223,212,206,190,239,214,212,49,-16,65
53,330000,4f79773e600518a6,8,0,144,152,167,161,255,131,59,54,69,64,57,47,52,56,-10,-7,-3
127,420000,4f79773e600518a6,8,0,169,231,258,278,385,450,105,110,104,89,90,81,86,87,-9,1,-10
308,430000,4f79773e600518a6,8,0,320,453,378,533,776,857,222,262,247,257,219,243,231,240,24,-38,62
25,350000,4f79773e600518a6,8,0,38,50,51,83,65,41,21,20,20,33,19,21,20,24,2,-14,16
59,210000,4f79773e600518a6,8,0,115,152,128,129,166,109,50,66,72,45,46,43,44,45,-3,1,-4
84,500000,4f79773e600518a6,8,0,149,157,175,189,306,256,58,77,65,70,84,67,76,74,-17,14,-31
222,610000,4f79773e600518a6,8,0,298,329,421,381,634,493,193,190,176,193,161,204,182,186,43,-32,75
59,230000,4f79773e600518a6,8,0,165,141,126,204,277,131,70,96,70,62,54,66,60,61,12,-8,20
104,310000,fc32b1a017b34efe,8,0,176,188,167,211,361,138,71,95,74,75,111,81,96,89,-30,36,-66
379,530000,fc32b1a017b34efe,8,0,402,486,521,434,743,406,299,256,259,276,323,373,348,324,50,47,3
339,150000,fc32b1a017b34efe,8,0,255,374,366,390,683,304,135,211,181,248,260,314,287,274,54,12,42
103,110000,fc32b1a017b34efe,8,0,388,458,302,357,675,173,56,121,79,138,89,102,96,110,13,-49,62
1182,510000,fc32b1a017b34efe,8,0,1222,1530,1137,1318,2057,1186,681,782,644,814,979,1044,1012,946,65,165,-100
346,340000,fc32b1a017b34efe,8,0,463,479,476,493,865,574,194,213,248,307,345,317,331,323,-28,38,-66
774,370000,fc32b1a017b34efe,8,0,875,922,870,894,1538,723,282,412,473,536,614,680,647,610,66,78,-12
816,140000,fc32b1a017b34efe,8,0,454,470,495,510,974,417,214,254,346,509,560,656,608,575,96,51,45
578,440000,fc32b1a017b34efe,8,0,610,730,702,768,1105,569,259,493,354,430,585,484,534,500,-101,155,-256
217,450000,fc32b1a017b34efe,8,0,175,217,208,212,406,260,101,165,105,174,218,194,206,195,-24,44,-68
609,320000,fc32b1a017b34efe,8,0,768,765,828,786,1332,698,402,409,494,495,557,550,554,534,-7,62,-69
295,360000,fc32b1a017b34efe,8,0,281,350,363,356,774,420,110,193,205,216,298,283,290,266,-15,82,-97
1295,130000,fc32b1a017b34efe,8,0,937,936,974,964,2069,891,397,516,929,990,983,1137,1060,1037,154,-7,161
966,410000,fc32b1a017b34efe,8,0,900,924,913,934,1916,1026,330,387,521,645,908,946,927,833,38,263,-225
467,330000,fc32b1a017b34efe,8,0,561,604,663,556,982,370,195,281,311,304,395,371,383,357,-24,91,-115
243,420000,fc32b1a017b34efe,8,0,301,385,300,389,721,401,105,159,186,195,272,290,281,252,18,77,-59
425,430000,fc32b1a017b34efe,8,0,548,722,567,687,1290,631,205,298,333,363,464,424,444,417,-40,101,-141
198,350000,fc32b1a017b34efe,8,0,178,217,240,253,385,180,95,138,114,150,154,163,158,156,9,4,5
200,210000,fc32b1a017b34efe,8,0,251,209,211,226,330,135,104,181,144,138,167,145,156,150,-22,29,-51
639,500000,fc32b1a017b34efe,8,0,970,909,844,751,1420,661,420,464,477,481,631,557,594,556,-74,150,-224
690,610000,fc32b1a017b34efe,8,0,540,574,623,639,1234,604,184,336,402,415,468,687,578,523,219,53,166
165,230000,fc32b1a017b34efe,8,0,146,126,126,150,236,76,111,111,78,108,134,127,130,123,-7,26,-33
379,310000,feabbf46658382b9,8,0,484,500,412,620,805,357,95,198,187,218,252,286,269,252,34,34,0
801,530000,feabbf46658382b9,8,0,806,851,856,921,1249,829,418,522,444,470,542,766,654,593,224,72,152
688,150000,feabbf46658382b9,8,0,507,500,528,675,925,601,288,415,322,461,499,595,547,518,96,38,58
320,110000,feabbf46658382b9,8,0,743,672,532,779,1421,437,212,313,278,276,253,302,278,277,49,-23,72
1846,510000,feabbf46658382b9,8,0,1757,2178,1620,1861,2915,2183,903,1084,938,1042,1247,1538,1392,1276,291,205,86
712,340000,feabbf46658382b9,8,0,690,798,757,934,1307,1141,304,330,322,356,545,585,565,495,40,189,-149
1189,370000,feabbf46658382b9,8,0,1173,1160,1214,1192,1610,1006,389,569,611,624,776,1014,895,805,238,152,86
733,140000,feabbf46658382b9,8,0,582,505,511,601,970,406,198,368,305,370,503,552,528,475,49,133,-84
1550,440000,feabbf46658382b9,8,0,1347,1576,1507,1902,2685,1203,341,825,879,785,1142,1134,1138,1020,-8,357,-365
330,450000,feabbf46658382b9,8,0,394,347,352,440,665,433,149,235,168,197,226,296,261,240,70,29,41
1671,320000,feabbf46658382b9,8,0,1794,1646,1598,1955,2752,1481,650,861,854,961,1280,1420,1350,1220,140,319,-179
475,360000,feabbf46658382b9,8,0,443,510,475,511,802,624,159,229,268,266,354,440,397,353,86,88,-2
1423,130000,feabbf46658382b9,8,0,985,1009,905,1021,1551,970,478,608,767,810,890,1254,1072,985,364,80,284
1789,410000,feabbf46658382b9,8,0,1361,1342,1399,1530,2696,1928,502,672,701,850,1415,1787,1601,1351,372,565,-193
1486,330000,feabbf46658382b9,8,0,1247,1320,1351,1499,2124,704,292,530,641,696,932,1254,1093,961,322,236,86
643,420000,feabbf46658382b9,8,0,614,653,620,794,1252,837,201,313,330,347,462,609,536,473,147,115,32
1043,430000,feabbf46658382b9,8,0,1241,1383,1339,1478,2360,1657,503,671,579,591,827,934,880,784,107,236,-129
470,350000,feabbf46658382b9,8,0,425,414,399,601,698,428,129,211,219,281,359,378,368,339,19,78,-59
351,210000,feabbf46658382b9,8,0,375,331,306,361,459,235,125,226,187,250,248,334,291,277,86,-2,88
1405,500000,feabbf46658382b9,8,0,1592,1671,1487,1581,2727,1846,758,896,740,908,1151,1313,1232,1124,162,243,-81
975,610000,feabbf46658382b9,8,0,758,764,827,896,1319,905,333,426,445,444,565,798,682,602,233,121,112
271,230000,feabbf46658382b9,8,0,271,219,256,312,397,173,117,199,155,143,190,253,222,195,63,47,16
29,310000,f270f6a489c6a9d7,8,0,37,28,27,30,34,19,29,28,25,38,29,32,30,33,3,-9,12
755,530000,f270f6a489c6a9d7,8,0,1395,1639,1736,1547,1939,1680,1190,1187,815,815,786,875,830,825,89,-29,118
65,150000,f270f6a489c6a9d7,8,0,74,107,93,105,108,54,78,117,71,70,60,56,58,62,-4,-10,6
81,110000,f270f6a489c6a9d7,8,0,238,282,198,305,504,106,118,157,120,110,104,70,87,95,-34,-6,-28
514,510000,f270f6a489c6a9d7,8,0,742,717,655,773,955,603,645,678,519,472,474,468,471,471,-6,2,-8
130,340000,f270f6a489c6a9d7,8,0,194,197,214,225,272,216,223,191,165,153,149,145,147,149,-4,-4,0
431,370000,f270f6a489c6a9d7,8,0,631,622,551,636,1105,629,541,513,451,400,375,388,382,388,13,-25,38
103,140000,f270f6a489c6a9d7,8,0,103,137,118,161,233,166,115,127,118,117,113,93,103,108,-20,-4,-16
440,440000,f270f6a489c6a9d7,8,0,627,644,624,713,866,346,505,757,513,503,519,390,454,471,-129,16,-145
17,450000,f270f6a489c6a9d7,8,0,50,93,63,75,97,92,50,85,53,57,36,20,28,38,-16,-21,5
542,320000,f270f6a489c6a9d7,8,0,752,766,763,871,1150,610,843,857,623,558,495,522,508,525,27,-63,90
69,360000,f270f6a489c6a9d7,8,0,107,134,92,117,148,132,89,105,90,70,62,87,74,73,25,-8,33
609,130000,f270f6a489c6a9d7,8,0,574,561,554,769,983,537,616,685,621,541,500,570,535,537,70,-41,111
609,410000,f270f6a489c6a9d7,8,0,825,703,746,952,1314,922,778,753,612,592,519,715,617,609,196,-73,269
307,330000,f270f6a489c6a9d7,8,0,385,451,456,466,653,312,498,511,368,351,319,353,336,341,34,-32,66
325,420000,f270f6a489c6a9d7,8,0,518,582,592,590,903,514,438,482,408,403,314,306,310,341,-8,-89,81
257,430000,f270f6a489c6a9d7,8,0,375,366,327,426,575,405,314,375,353,267,377,276,326,307,-101,110,-211
101,350000,f270f6a489c6a9d7,8,0,164,156,179,175,195,85,140,157,133,146,133,94,114,124,-39,-13,-26
162,210000,f270f6a489c6a9d7,8,0,192,216,260,281,370,158,187,236,191,184,170,200,185,185,30,-14,44
463,500000,f270f6a489c6a9d7,8,0,592,643,645,706,955,636,643,771,438,521,498,470,484,496,-28,-23,-5
161,610000,f270f6a489c6a9d7,8,0,190,227,209,280,324,195,155,198,180,157,132,131,132,140,-1,-25,24
43,230000,f270f6a489c6a9d7,8,0,88,70,59,76,90,35,48,67,46,41,40,28,34,36,-12,-1,-11
68,310000,d0f245b8781e3631,8,0,176,218,159,193,281,60,52,74,61,69,81,59,70,70,-22,12,-34
113,530000,d0f245b8781e3631,8,0,192,241,224,227,356,181,119,130,103,154,125,106,116,128,-19,-29,10
79,150000,d0f245b8781e3631,8,0,63,86,129,183,244,117,67,81,65,79,55,51,53,62,-4,-24,20
170,110000,d0f245b8781e3631,8,0,464,472,326,417,805,105,52,132,97,103,144,172,158,140,28,41,-13
624,510000,d0f245b8781e3631,8,0,855,1133,824,910,1456,816,454,505,463,516,491,453,472,487,-38,-25,-13
111,340000,d0f245b8781e3631,8,0,314,310,267,287,463,251,96,133,88,118,91,110,100,106,19,-27,46
415,370000,d0f245b8781e3631,8,0,773,797,679,738,1182,600,283,311,395,408,271,332,302,337,61,-137,198
175,140000,d0f245b8781e3631,8,0,221,226,243,264,497,192,96,135,117,169,144,132,138,148,-12,-25,13
265,440000,d0f245b8781e3631,8,0,429,596,574,615,869,297,127,271,262,258,278,238,258,258,-40,20,-60
103,450000,d0f245b8781e3631,8,0,139,167,205,233,425,254,71,136,107,135,145,104,124,128,-41,10,-51
265,320000,d0f245b8781e3631,8,0,706,761,731,749,1017,461,270,342,363,373,289,260,274,307,-29,-84,55
105,360000,d0f245b8781e3631,8,0,145,229,198,198,315,211,60,84,84,68,64,78,71,70,14,-4,18
630,130000,d0f245b8781e3631,8,0,690,771,682,755,1430,754,390,398,481,498,419,459,439,459,40,-79,119
436,410000,d0f245b8781e3631,8,0,871,851,876,865,1601,892,268,371,333,363,396,440,418,400,44,33,11
235,330000,d0f245b8781e3631,8,0,370,1437,406,420,845,174,81,170,192,246,204,243,224,231,39,-42,81
63,420000,d0f245b8781e3631,8,0,88,110,128,133,246,134,39,47,55,60,48,51,50,53,3,-12,15
209,430000,d0f245b8781e3631,8,0,319,439,335,447,756,439,130,231,191,211,178,177,178,189,-1,-33,32
101,350000,d0f245b8781e3631,8,0,102,142,175,166,247,102,51,67,60,67,91,79,85,79,-12,24,-36
21,210000,d0f245b8781e3631,8,0,81,68,54,102,113,47,21,29,27,30,22,21,22,24,-1,-8,7
519,500000,d0f245b8781e3631,8,0,1602,764,548,596,1578,630,283,298,337,395,444,428,436,422,-16,49,-65
349,610000,d0f245b8781e3631,8,0,453,455,455,558,938,498,189,261,260,236,226,286,256,249,60,-10,70
17,230000,d0f245b8781e3631,8,0,28,17,16,45,45,7,10,21,11,20,18,12,15,17,-6,-2,-4
290,310000,c6cd4e0e073f5ac2,8,0,590,1049,393,448,746,228,125,223,190,233,237,1154,696,541,917,4,913
62,530000,c6cd4e0e073f5ac2,8,0,301,410,266,224,235,105,67,68,72,70,100,79,90,83,-21,30,-51
89,150000,c6cd4e0e073f5ac2,8,0,248,263,289,273,340,208,63,95,64,75,89,75,82,80,-14,14,-28
666,110000,c6cd4e0e073f5ac2,8,0,265,2528,156,179,362,72,29,64,61,50,56,417,236,174,361,6,355
315,510000,c6cd4e0e073f5ac2,8,0,1243,1666,730,631,1027,542,251,246,265,230,226,834,530,430,608,-4,612
452,340000,c6cd4e0e073f5ac2,8,0,968,961,755,678,1434,792,244,232,308,344,363,315,339,341,-48,19,-67
520,370000,c6cd4e0e073f5ac2,8,0,2848,2646,1380,1053,1685,823,326,341,453,371,362,372,367,368,10,-9,19
292,140000,c6cd4e0e073f5ac2,8,0,657,660,386,479,604,321,126,162,162,182,154,558,356,298,404,-28,432
409,440000,c6cd4e0e073f5ac2,8,0,819,1623,936,1038,1493,451,130,374,366,407,481,329,405,406,-152,74,-226
145,450000,c6cd4e0e073f5ac2,8,0,316,360,349,312,543,250,76,136,99,136,130,103,116,123,-27,-6,-21
929,320000,c6cd4e0e073f5ac2,8,0,2527,2388,1650,1467,2828,1205,656,751,787,807,758,1395,1076,987,637,-49,686
377,360000,c6cd4e0e073f5ac2,8,0,511,752,626,577,1241,549,138,232,271,262,250,268,259,260,18,-12,30
374,130000,c6cd4e0e073f5ac2,8,0,1387,1606,840,561,1020,602,249,293,362,351,329,285,307,322,-44,-22,-22
991,410000,c6cd4e0e073f5ac2,8,0,1736,1669,959,1021,1584,992,320,512,660,557,721,719,720,666,-2,164,-166
402,330000,c6cd4e0e073f5ac2,8,0,1019,1203,828,859,1272,386,193,342,341,375,377,337,357,363,-40,2,-42
316,420000,c6cd4e0e073f5ac2,8,0,713,769,691,751,1208,523,161,272,326,270,280,775,528,442,495,10,485
329,430000,c6cd4e0e073f5ac2,8,0,816,847,522,619,891,508,132,232,212,222,268,261,264,250,-7,46,-53
91,350000,c6cd4e0e073f5ac2,8,0,243,304,268,291,431,173,74,106,104,121,115,77,96,104,-38,-6,-32
68,210000,c6cd4e0e073f5ac2,8,0,366,291,139,186,225,91,51,75,101,66,42,52,47,53,10,-24,34
46,500000,c6cd4e0e073f5ac2,8,0,324,310,182,148,242,128,33,53,51,65,76,57,66,66,-19,11,-30
199,610000,c6cd4e0e073f5ac2,8,0,656,661,278,275,432,182,64,143,136,155,142,754,448,350,612,-13,625
28,230000,c6cd4e0e073f5ac2,8,0,146,137,83,61,140,53,29,33,28,48,27,21,24,32,-6,-21,15
141,310000,a9a43d1a7ecbe75d,8,0,138,161,113,162,163,142,84,128,99,108,102,143,122,118,41,-6,47
120,530000,a9a43d1a7ecbe75d,8,0,123,111,95,152,131,146,84,119,80,84,87,136,112,102,49,3,46
68,150000,a9a43d1a7ecbe75d,8,0,71,81,97,81,90,83,41,62,87,86,67,58,62,70,-9,-19,10
50,110000,a9a43d1a7ecbe75d,8,0,87,131,79,100,123,88,65,74,70,62,63,53,58,59,-10,1,-11
262,510000,a9a43d1a7ecbe75d,8,0,227,447,284,279,330,341,184,223,201,224,188,192,190,201,4,-36,40
174,340000,a9a43d1a7ecbe75d,8,0,167,182,170,183,198,254,107,149,150,152,146,136,141,145,-10,-6,-4
158,370000,a9a43d1a7ecbe75d,8,0,136,198,152,160,191,159,74,162,163,162,117,116,116,132,-1,-45,44
32,140000,a9a43d1a7ecbe75d,8,0,36,34,32,31,28,41,25,46,41,28,30,28,29,29,-2,2,-4
502,440000,a9a43d1a7ecbe75d,8,0,435,593,541,658,638,568,264,527,387,410,437,440,438,429,3,27,-24
162,450000,a9a43d1a7ecbe75d,8,0,154,208,163,172,213,297,121,197,152,163,152,143,148,153,-9,-11,2
290,320000,a9a43d1a7ecbe75d,8,0,361,402,385,402,439,430,213,408,324,345,284,373,328,334,89,-61,150
105,360000,a9a43d1a7ecbe75d,8,0,64,94,87,76,120,103,50,101,76,71,82,82,82,78,0,11,-11
131,130000,a9a43d1a7ecbe75d,8,0,102,92,82,85,95,109,50,116,95,137,104,134,119,125,30,-33,63
149,410000,a9a43d1a7ecbe75d,8,0,123,153,141,134,164,130,78,142,114,90,124,140,132,118,16,34,-18
327,330000,a9a43d1a7ecbe75d,8,0,299,308,339,364,397,466,185,307,317,322,277,351,314,317,74,-45,119
222,420000,a9a43d1a7ecbe75d,8,0,179,232,184,244,236,270,129,200,183,140,190,186,188,172,-4,50,-54
373,430000,a9a43d1a7ecbe75d,8,0,298,395,308,355,445,519,215,330,301,296,262,319,290,292,57,-34,91
106,350000,a9a43d1a7ecbe75d,8,0,91,93,87,125,99,145,57,96,88,101,91,78,84,90,-13,-10,-3
140,210000,a9a43d1a7ecbe75d,8,0,158,194,115,126,155,89,59,109,102,100,85,79,82,88,-6,-15,9
136,500000,a9a43d1a7ecbe75d,8,0,146,203,173,179,214,160,89,140,134,104,264,151,208,173,-113,160,-273
338,610000,a9a43d1a7ecbe75d,8,0,229,256,263,252,263,274,154,228,212,258,163,256,210,226,93,-95,188
70,230000,a9a43d1a7ecbe75d,8,0,75,68,54,66,57,65,35,91,67,47,50,39,44,45,-11,3,-14
308,310000,3c974920a76ac9c1,9,0,265,228,369,374,305,193,309,264,241,251,240,298,269,263,58,-11,69
306,530000,3c974920a76ac9c1,9,0,217,310,402,456,434,194,302,243,321,230,362,323,342,305,-39,132,-171
176,150000,3c974920a76ac9c1,9,0,157,178,204,219,180,128,201,176,192,155,199,170,184,175,-29,44,-73
293,110000,3c974920a76ac9c1,9,0,337,371,460,563,468,432,472,340,407,314,302,310,306,309,8,-12,20
449,510000,3c974920a76ac9c1,9,0,623,350,453,570,500,253,378,337,331,336,304,330,317,323,26,-32,58
192,340000,3c974920a76ac9c1,9,0,159,136,179,226,198,76,132,155,144,166,155,166,160,162,11,-11,22
563,370000,3c974920a76ac9c1,9,0,422,394,483,601,468,290,412,484,450,432,449,413,431,431,-36,17,-53
239,140000,3c974920a76ac9c1,9,0,194,233,215,260,248,146,249,182,251,173,213,197,205,194,-16,40,-56
2822,440000,3c974920a76ac9c1,9,0,2265,2711,3532,3800,2692,1680,2958,2368,2754,2696,2582,2782,2682,2687,200,-114,314
402,450000,3c974920a76ac9c1,9,0,267,349,472,505,425,248,383,277,377,293,309,331,320,311,22,16,6
759,320000,3c974920a76ac9c1,9,0,631,764,871,1010,800,486,817,617,720,689,718,682,700,696,-36,29,-65
164,360000,3c974920a76ac9c1,9,0,156,166,204,262,236,78,191,154,186,149,156,168,162,158,12,7,5
363,130000,3c974920a76ac9c1,9,0,225,228,291,305,260,190,297,311,328,293,325,352,338,323,27,32,-5
344,410000,3c974920a76ac9c1,9,0,301,351,521,505,405,250,355,393,307,297,380,309,344,329,-71,83,-154
649,330000,3c974920a76ac9c1,9,0,545,702,660,865,633,409,621,561,562,591,624,669,646,628,45,33,12
409,420000,3c974920a76ac9c1,9,0,381,447,480,474,497,228,445,423,403,455,424,361,392,413,-63,-31,-32
304,430000,3c974920a76ac9c1,9,0,299,327,364,474,347,174,297,304,284,259,316,280,298,285,-36,57,-93
288,350000,3c974920a76ac9c1,9,0,258,368,331,404,292,181,307,209,324,299,311,316,314,309,5,12,-7
744,210000,3c974920a76ac9c1,9,0,721,769,941,997,650,566,775,692,738,626,805,715,760,715,-90,179,-269
119,500000,3c974920a76ac9c1,9,0,101,120,155,199,115,72,126,107,119,138,135,104,120,126,-31,-3,-28
293,610000,3c974920a76ac9c1,9,0,187,324,393,440,305,219,295,292,328,285,305,307,306,299,2,20,-18
248,230000,3c974920a76ac9c1,9,0,302,310,458,461,292,234,401,305,324,284,313,335,324,311,22,29,-7
615,310000,3d7554f1f56dd664,9,0,417,271,639,518,268,263,442,321,383,408,481,506,494,465,25,73,-48
484,530000,3d7554f1f56dd664,9,0,368,334,609,519,292,264,403,325,415,354,487,506,496,449,19,133,-114
312,150000,3d7554f1f56dd664,9,0,208,216,370,337,175,149,316,260,258,252,263,332,298,282,69,11,58
421,110000,3d7554f1f56dd664,9,0,449,231,675,811,368,359,470,369,376,352,396,326,361,358,-70,44,-114
1021,510000,3d7554f1f56dd664,9,0,1227,469,1053,1125,657,560,806,700,679,724,721,901,811,782,180,-3,183
524,340000,3d7554f1f56dd664,9,0,325,253,574,507,301,225,317,315,350,352,460,517,488,443,57,108,-51
1693,370000,3d7554f1f56dd664,9,0,1222,876,1567,1574,775,729,1060,1229,1119,1113,1342,1502,1422,1319,160,229,-69
543,140000,3d7554f1f56dd664,9,0,372,320,590,571,290,239,407,358,384,335,452,519,486,435,67,117,-50
11177,440000,3d7554f1f56dd664,9,0,10140,6925,13598,11515,5136,4688,10371,8733,8990,9100,9110,10367,9738,9526,1257,10,1247
1237,450000,3d7554f1f56dd664,9,0,969,642,1386,1258,750,559,1074,832,939,901,1075,1222,1148,1066,147,174,-27
2465,320000,3d7554f1f56dd664,9,0,2075,1763,3112,2877,1445,1635,2184,1828,1916,1948,2090,2406,2248,2148,316,142,174
634,360000,3d7554f1f56dd664,9,0,535,356,595,741,435,311,545,463,483,513,576,577,576,555,1,63,-62
1231,130000,3d7554f1f56dd664,9,0,722,520,1137,974,498,486,847,1025,993,829,1052,1183,1118,1021,131,223,-92
1133,410000,3d7554f1f56dd664,9,0,808,565,1273,1234,645,486,968,944,932,1043,1153,1163,1158,1120,10,110,-100
2373,330000,3d7554f1f56dd664,9,0,1658,1293,2709,2467,1135,1205,1969,1744,1919,1847,2165,2419,2292,2144,254,318,-64
1033,420000,3d7554f1f56dd664,9,0,908,742,1001,1050,703,508,734,619,699,876,984,989,986,950,5,108,-103
917,430000,3d7554f1f56dd664,9,0,958,582,1112,1192,689,445,769,687,748,707,821,1006,914,845,185,114,71
1828,350000,3d7554f1f56dd664,9,0,1310,817,2205,1578,856,899,1607,1181,1494,1511,1522,1699,1610,1577,177,11,166
2147,210000,3d7554f1f56dd664,9,0,1915,1064,2892,2161,1110,1306,1905,1837,1784,1845,2218,2361,2290,2141,143,373,-230
303,500000,3d7554f1f56dd664,9,0,331,173,470,398,244,215,285,259,240,371,328,317,322,339,-11,-43,32
529,610000,3d7554f1f56dd664,9,0,462,375,582,607,340,260,369,435,466,394,526,525,526,482,-1,132,-133
987,230000,3d7554f1f56dd664,9,0,843,480,1076,1018,447,521,1186,639,827,849,957,1229,1093,1012,272,108,164
163,310000,2d0d2c3403909fdb,9,0,169,112,163,167,157,101,187,162,155,200,158,195,176,184,37,-42,79
332,530000,2d0d2c3403909fdb,9,0,270,218,354,350,290,213,293,226,236,265,410,329,370,335,-81,145,-226
232,150000,2d0d2c3403909fdb,9,0,234,155,184,233,279,174,228,241,255,251,306,251,278,269,-55,55,-110
412,110000,2d0d2c3403909fdb,9,0,583,457,611,677,549,387,627,524,389,503,552,475,514,510,-77,49,-126
432,510000,2d0d2c3403909fdb,9,0,387,300,411,434,516,235,377,355,370,404,481,373,427,419,-108,77,-185
165,340000,2d0d2c3403909fdb,9,0,157,129,128,138,176,83,127,116,129,142,151,124,138,139,-27,9,-36
471,370000,2d0d2c3403909fdb,9,0,376,327,415,400,420,235,353,334,323,407,400,410,405,406,10,-7,17
160,140000,2d0d2c3403909fdb,9,0,135,111,141,197,179,103,189,173,157,177,211,167,189,185,-44,34,-78
1985,440000,2d0d2c3403909fdb,9,0,1683,1421,1989,1829,1713,1159,1738,1536,1581,1833,1828,1593,1710,1751,-235,-5,-230
185,450000,2d0d2c3403909fdb,9,0,192,165,181,173,211,121,197,149,174,163,216,133,174,171,-83,53,-136
476,320000,2d0d2c3403909fdb,9,0,401,333,437,427,470,296,446,386,375,444,454,461,458,453,7,10,-3
177,360000,2d0d2c3403909fdb,9,0,108,90,107,109,126,55,113,112,112,126,130,154,142,137,24,4,20
375,130000,2d0d2c3403909fdb,9,0,309,274,302,328,389,251,371,364,437,425,531,444,488,467,-87,106,-193
382,410000,2d0d2c3403909fdb,9,0,327,262,352,337,377,202,331,306,338,396,390,320,355,369,-70,-6,-64
478,330000,2d0d2c3403909fdb,9,0,336,342,428,424,401,264,349,335,366,380,435,444,440,420,9,55,-46
293,420000,2d0d2c3403909fdb,9,0,303,211,267,280,321,189,271,255,230,322,292,267,280,294,-25,-30,5
299,430000,2d0d2c3403909fdb,9,0,250,211,244,275,284,146,275,262,250,285,292,286,289,288,-6,7,-13
129,350000,2d0d2c3403909fdb,9,0,124,106,151,157,167,81,107,85,111,132,133,94,114,120,-39,1,-40
531,210000,2d0d2c3403909fdb,9,0,488,346,464,567,506,316,529,433,489,457,606,708,657,590,102,149,-47
174,500000,2d0d2c3403909fdb,9,0,169,138,184,155,213,116,188,148,168,179,203,176,190,186,-27,24,-51
290,610000,2d0d2c3403909fdb,9,0,271,195,252,267,297,206,288,291,280,277,346,254,300,292,-92,69,-161
199,230000,2d0d2c3403909fdb,9,0,239,208,258,336,315,155,306,267,240,317,304,316,310,312,12,-13,25
221,310000,a28bb927b6fcb33c,9,0,216,166,212,210,117,96,135,131,161,142,167,201,184,170,34,25,9
399,530000,a28bb927b6fcb33c,9,0,256,209,270,308,173,110,159,185,191,176,253,332,292,254,79,77,2
204,150000,a28bb927b6fcb33c,9,0,193,128,165,176,89,72,136,148,139,117,145,167,156,143,22,28,-6
164,110000,a28bb927b6fcb33c,9,0,286,179,246,342,136,109,179,166,96,85,131,159,145,125,28,46,-18
667,510000,a28bb927b6fcb33c,9,0,712,401,438,436,351,212,361,425,290,324,427,553,490,435,126,103,23
338,340000,a28bb927b6fcb33c,9,0,358,250,325,348,264,151,204,182,203,195,266,313,290,258,47,71,-24
729,370000,a28bb927b6fcb33c,9,0,606,454,468,556,225,175,357,467,449,285,377,522,450,395,145,92,53
230,140000,a28bb927b6fcb33c,9,0,187,181,144,181,92,70,148,181,165,127,190,198,194,172,8,63,-55
5596,440000,a28bb927b6fcb33c,9,0,5211,4012,4216,4195,2391,1639,3992,3988,3668,3906,4522,4949,4736,4459,427,616,-189
630,450000,a28bb927b6fcb33c,9,0,444,331,432,386,248,166,443,418,434,344,461,540,500,448,79,117,-38
1400,320000,a28bb927b6fcb33c,9,0,1130,943,1033,1154,680,651,982,1039,1051,947,1072,1268,1170,1096,196,125,71
520,360000,a28bb927b6fcb33c,9,0,380,260,302,351,208,96,254,328,298,271,331,451,391,351,120,60,60
645,130000,a28bb927b6fcb33c,9,0,584,385,397,419,248,284,584,570,485,345,559,623,591,509,64,214,-150
854,410000,a28bb927b6fcb33c,9,0,673,556,567,651,338,242,578,638,439,516,644,816,730,659,172,128,44
1887,330000,a28bb927b6fcb33c,9,0,1296,1228,1343,1310,747,739,1438,1404,1200,1131,1522,1730,1626,1461,208,391,-183
780,420000,a28bb927b6fcb33c,9,0,744,726,677,787,450,226,461,459,468,446,524,665,594,545,141,78,63
891,430000,a28bb927b6fcb33c,9,0,619,436,474,674,394,223,436,554,554,548,663,787,725,666,124,115,9
1034,350000,a28bb927b6fcb33c,9,0,615,563,615,519,231,173,535,612,676,709,737,966,852,804,229,28,201
810,210000,a28bb927b6fcb33c,9,0,840,522,652,848,213,233,610,646,562,459,596,792,694,616,196,137,59
200,500000,a28bb927b6fcb33c,9,0,208,150,157,208,123,85,166,157,116,162,140,173,156,158,33,-22,55
344,610000,a28bb927b6fcb33c,9,0,262,219,225,317,148,105,202,242,221,226,279,358,318,288,79,53,26
303,230000,a28bb927b6fcb33c,9,0,334,222,288,303,90,85,233,244,241,205,236,349,292,263,113,31,82
216,310000,17bc272c93f19d56,9,0,234,168,249,477,199,177,267,169,193,170,168,208,188,182,40,-2,42
2469,530000,17bc272c93f19d56,9,0,3307,3096,3216,4503,4785,3067,2754,2281,2227,1995,2206,1981,2094,2061,-225,211,-436
467,150000,17bc272c93f19d56,9,0,502,360,520,675,504,451,680,487,440,356,384,433,408,391,49,28,21
136,110000,17bc272c93f19d56,9,0,242,199,305,514,151,92,197,124,132,112,101,80,90,98,-21,-11,-10
1242,510000,17bc272c93f19d56,9,0,1449,1007,1411,1954,1724,1537,1481,1090,1021,990,1018,1119,1068,1042,101,28,73
1266,340000,17bc272c93f19d56,9,0,1458,1238,1535,2328,2152,1881,1518,1284,1266,1165,1072,1126,1099,1121,54,-93,147
2744,370000,17bc272c93f19d56,9,0,3519,3268,3907,6576,4483,3060,2839,2545,2879,2279,2583,2917,2750,2593,334,304,30
1338,140000,17bc272c93f19d56,9,0,1749,1354,1585,2844,2093,1361,1353,1118,1259,955,1154,1235,1194,1115,81,199,-118
1720,440000,17bc272c93f19d56,9,0,1999,1555,2007,3029,1611,1579,2180,1684,1684,1682,1409,1573,1491,1555,164,-273,437
1360,450000,17bc272c93f19d56,9,0,2515,2293,2687,4443,3084,1836,2310,1540,1616,1343,1308,1943,1626,1531,635,-35,670
1651,320000,17bc272c93f19d56,9,0,1764,1493,1942,3067,2165,2419,2029,1601,1578,1375,1523,1501,1512,1466,-22,148,-170
666,360000,17bc272c93f19d56,9,0,1111,824,980,1510,1290,922,875,668,648,536,537,656,596,576,119,1,118
2753,130000,17bc272c93f19d56,9,0,3303,2808,3641,6231,3870,3403,2945,3015,3119,2522,2789,2808,2798,2706,19,267,-248
2664,410000,17bc272c93f19d56,9,0,3584,3821,4668,7650,5825,3564,3197,2704,2715,2598,2658,2563,2610,2606,-95,60,-155
1319,330000,17bc272c93f19d56,9,0,1295,1112,1294,2062,1260,1629,1592,1156,1224,1121,1218,1188,1203,1176,-30,97,-127
1018,420000,17bc272c93f19d56,9,0,1202,958,1353,2198,1919,1140,1262,895,1069,835,836,949,892,873,113,1,112
1185,430000,17bc272c93f19d56,9,0,1773,1354,1770,2693,2364,1506,1541,1174,1020,997,939,1035,987,990,96,-58,154
400,350000,17bc272c93f19d56,9,0,573,523,688,892,592,650,741,463,546,473,389,402,396,421,13,-84,97
1041,210000,17bc272c93f19d56,9,0,1135,824,1154,1710,924,939,1322,959,988,854,912,964,938,910,52,58,-6
241,500000,17bc272c93f19d56,9,0,284,201,250,357,250,248,235,212,191,173,197,218,208,196,21,24,-3
1406,610000,17bc272c93f19d56,9,0,1658,1590,1877,3217,2072,1105,1314,1222,1105,910,1051,1117,1084,1026,66,141,-75
540,230000,17bc272c93f19d56,9,0,795,518,816,982,506,518,806,657,585,602,530,544,537,559,14,-72,86
399,310000,2a2ab41f8f6ff1cb,9,0,555,272,582,623,382,114,351,229,285,289,234,347,290,290,113,-55,168
493,530000,2a2ab41f8f6ff1cb,9,0,543,553,546,680,484,300,452,403,419,390,633,639,636,554,6,243,-237
640,150000,2a2ab41f8f6ff1cb,9,0,831,715,836,832,551,317,489,505,604,525,595,623,609,581,28,70,-42
130,110000,2a2ab41f8f6ff1cb,9,0,502,362,440,598,212,102,180,142,124,93,130,133,132,119,3,37,-34
1101,510000,2a2ab41f8f6ff1cb,9,0,1460,1050,1385,1850,1223,671,850,790,838,870,1020,1346,1183,1079,326,150,176
1168,340000,2a2ab41f8f6ff1cb,9,0,1565,1256,1491,1666,1515,717,1018,980,1077,1165,1206,1280,1243,1217,74,41,33
2022,370000,2a2ab41f8f6ff1cb,9,0,2580,2061,2146,2737,1706,842,1734,1902,2031,1983,2192,2226,2209,2134,34,209,-175
614,140000,2a2ab41f8f6ff1cb,9,0,690,724,762,993,533,312,595,582,569,606,683,717,700,669,34,77,-43
5863,440000,2a2ab41f8f6ff1cb,9,0,8215,6582,6734,6492,5607,2647,5713,4896,5717,5445,4899,5914,5406,5419,1015,-546,1561
734,450000,2a2ab41f8f6ff1cb,9,0,913,743,853,894,799,409,719,453,603,532,611,719,665,621,108,79,29
1722,320000,2a2ab41f8f6ff1cb,9,0,2410,2283,2584,2672,1728,1016,1729,1498,1701,1735,1850,1857,1854,1814,7,115,-108
905,360000,2a2ab41f8f6ff1cb,9,0,1340,1065,1086,1291,1027,356,690,687,838,753,813,1041,927,869,228,60,168
2361,130000,2a2ab41f8f6ff1cb,9,0,3253,2277,2327,2703,2119,1271,2126,2486,2863,2426,2914,2989,2952,2776,75,488,-413
2677,410000,2a2ab41f8f6ff1cb,9,0,3446,2827,2797,3447,2952,1308,2514,2566,2841,2880,3363,3319,3341,3187,-44,483,-527
1241,330000,2a2ab41f8f6ff1cb,9,0,1369,1262,1632,1972,795,459,876,905,1141,1077,1165,1379,1272,1207,214,88,126
1288,420000,2a2ab41f8f6ff1cb,9,0,1938,1686,1663,2151,1566,597,1095,1029,1047,1133,1293,1344,1318,1257,51,160,-109
1482,430000,2a2ab41f8f6ff1cb,9,0,2573,2247,1966,2770,1651,844,1487,1573,1636,1382,1564,1802,1683,1583,238,182,56
384,350000,2a2ab41f8f6ff1cb,9,0,390,371,447,476,264,148,314,267,427,418,348,436,392,401,88,-70,158
408,210000,2a2ab41f8f6ff1cb,9,0,397,317,403,513,241,211,360,293,362,342,372,462,417,392,90,30,60
579,500000,2a2ab41f8f6ff1cb,9,0,888,646,803,1149,803,328,472,453,543,623,549,633,591,602,84,-74,158
553,610000,2a2ab41f8f6ff1cb,9,0,687,665,655,845,620,247,468,497,551,436,566,577,572,526,11,130,-119
572,230000,2a2ab41f8f6ff1cb,9,0,669,544,740,1032,399,306,506,449,585,503,512,594,553,536,82,9,73
1258,310000,c06a2a387c0ee510,9,0,958,710,977,1212,1265,890,1247,1119,1184,1456,1316,1194,1255,1322,-122,-140,18
150,530000,c06a2a387c0ee510,9,0,79,45,66,119,104,63,214,133,132,248,173,187,180,203,14,-75,89
187,150000,c06a2a387c0ee510,9,0,54,43,56,75,86,64,154,131,164,163,146,193,170,167,47,-17,64
1463,110000,c06a2a387c0ee510,9,0,1027,677,793,1627,1352,1114,1508,1132,1430,1670,1367,1416,1392,1484,49,-303,352
431,510000,c06a2a387c0ee510,9,0,199,102,145,321,208,187,254,335,308,285,276,420,348,327,144,-9,153
398,340000,c06a2a387c0ee510,9,0,182,145,176,251,253,175,322,340,315,352,311,384,348,349,73,-41,114
1321,370000,c06a2a387c0ee510,9,0,710,494,739,1047,878,649,1303,1248,1216,1405,1283,1284,1284,1324,1,-122,123
344,140000,c06a2a387c0ee510,9,0,121,83,105,184,165,123,244,320,272,242,233,292,262,256,59,-9,68
1134,440000,c06a2a387c0ee510,9,0,514,463,571,819,762,448,944,1100,1025,1038,994,984,989,1005,-10,-44,34
126,450000,c06a2a387c0ee510,9,0,36,87,45,96,92,54,103,134,119,86,123,99,111,103,-24,37,-61
1328,320000,c06a2a387c0ee510,9,0,923,563,731,1002,974,650,1188,1289,1048,1276,1137,1253,1195,1222,116,-139,255
204,360000,c06a2a387c0ee510,9,0,89,43,74,97,118,85,164,140,153,162,165,154,160,160,-11,3,-14
873,130000,c06a2a387c0ee510,9,0,284,232,288,493,470,361,599,660,769,569,656,773,714,666,117,87,30
909,410000,c06a2a387c0ee510,9,0,387,282,366,596,517,345,763,731,685,764,754,849,802,789,95,-10,105
1113,330000,c06a2a387c0ee510,9,0,350,278,533,736,534,424,754,915,865,808,908,999,954,905,91,100,-9
270,420000,c06a2a387c0ee510,9,0,115,66,94,173,151,103,240,253,187,234,272,286,279,264,14,38,-24
250,430000,c06a2a387c0ee510,9,0,68,60,83,119,101,59,203,163,182,206,192,239,216,212,47,-14,61
241,350000,c06a2a387c0ee510,9,0,99,106,97,170,123,106,206,303,187,204,204,249,226,219,45,0,45
413,210000,c06a2a387c0ee510,9,0,184,111,151,300,181,154,357,324,363,378,413,435,424,409,22,35,-13
168,500000,c06a2a387c0ee510,9,0,120,43,58,100,60,71,130,181,128,151,124,150,137,142,26,-27,53
434,610000,c06a2a387c0ee510,9,0,164,136,164,313,234,179,320,305,340,358,313,390,352,354,77,-45,122
281,230000,c06a2a387c0ee510,9,0,130,76,95,177,129,74,323,185,255,260,224,227,226,237,3,-36,39
357,310000,7023efdab9cedc03,9,0,605,431,543,697,325,168,288,309,527,516,379,272,326,389,-107,-137,30
109,530000,7023efdab9cedc03,9,0,80,64,106,112,40,25,38,54,68,55,75,116,96,82,41,20,21
46,150000,7023efdab9cedc03,9,0,50,48,60,75,31,18,29,46,51,51,61,78,70,63,17,10,7
68,110000,7023efdab9cedc03,9,0,107,59,86,132,40,51,59,50,54,60,151,111,131,107,-40,91,-131
371,510000,7023efdab9cedc03,9,0,379,187,278,408,216,117,192,175,229,259,209,437,323,302,228,-50,278
385,340000,7023efdab9cedc03,9,0,452,363,447,587,357,148,207,278,368,463,445,401,423,436,-44,-18,-26
287,370000,7023efdab9cedc03,9,0,524,437,477,555,320,180,373,400,374,355,402,517,460,425,115,47,68
47,140000,7023efdab9cedc03,9,0,61,59,55,64,30,23,28,38,44,60,71,103,87,78,32,11,21
438,440000,7023efdab9cedc03,9,0,284,225,342,408,121,39,166,158,211,185,222,453,338,287,231,37,194
119,450000,7023efdab9cedc03,9,0,86,66,86,129,68,34,47,50,71,60,56,125,90,80,69,-4,73
648,320000,7023efdab9cedc03,9,0,1311,1156,1271,1767,893,628,788,879,1067,1002,995,690,842,896,-305,-7,-298
198,360000,7023efdab9cedc03,9,0,205,175,224,302,169,92,161,188,202,170,233,263,248,222,30,63,-33
190,130000,7023efdab9cedc03,9,0,149,129,127,215,80,56,93,108,163,149,199,289,244,212,90,50,40
278,410000,7023efdab9cedc03,9,0,300,257,320,368,183,97,185,329,340,259,262,298,280,273,36,3,33
466,330000,7023efdab9cedc03,9,0,867,742,941,1163,445,309,478,511,775,845,706,532,619,694,-174,-139,-35
244,420000,7023efdab9cedc03,9,0,253,233,287,401,211,94,172,184,195,243,185,256,220,228,71,-58,129
221,430000,7023efdab9cedc03,9,0,213,182,259,315,201,83,173,167,198,189,202,231,216,207,29,13,16
156,350000,7023efdab9cedc03,9,0,86,70,117,145,54,20,51,78,114,140,134,168,151,147,34,-6,40
77,210000,7023efdab9cedc03,9,0,78,81,68,104,28,21,52,82,45,37,92,119,106,83,27,55,-28
91,500000,7023efdab9cedc03,9,0,77,40,57,62,28,20,37,37,33,64,92,101,96,86,9,28,-19
134,610000,7023efdab9cedc03,9,0,137,141,113,177,107,51,78,83,124,102,102,142,122,115,40,0,40
33,230000,7023efdab9cedc03,9,0,39,29,28,30,11,11,8,18,20,17,27,60,44,35,33,10,23
982,310000,af6f4f548684e14d,9,0,839,851,1537,1734,940,540,957,807,919,933,755,914,834,867,159,-178,337
345,530000,af6f4f548684e14d,9,0,375,464,639,732,400,288,346,301,327,290,401,329,365,340,-72,111,-183
382,150000,af6f4f548684e14d,9,0,426,433,493,573,322,195,323,333,363,302,240,293,266,278,53,-62,115
472,110000,af6f4f548684e14d,9,0,648,532,915,1057,659,394,601,489,595,532,503,449,476,495,-54,-29,-25
1218,510000,af6f4f548684e14d,9,0,1394,1020,1293,1876,1072,611,873,761,808,800,793,898,846,830,105,-7,112
1020,340000,af6f4f548684e14d,9,0,938,1018,1287,1597,1015,457,773,664,769,751,688,875,782,771,187,-63,250
1388,370000,af6f4f548684e14d,9,0,1497,1547,1722,2394,1077,522,1253,1236,1215,1019,955,1078,1016,1017,123,-64,187
448,140000,af6f4f548684e14d,9,0,407,489,581,742,375,248,450,310,404,335,340,378,359,351,38,5,33
1048,440000,af6f4f548684e14d,9,0,1197,1508,2163,2594,949,463,1024,892,976,1062,838,972,905,957,134,-224,358
298,450000,af6f4f548684e14d,9,0,338,373,502,713,341,210,322,222,345,302,257,262,260,274,5,-45,50
1574,320000,af6f4f548684e14d,9,0,1413,1635,2059,2647,1466,939,1519,1181,1355,1281,1072,1305,1188,1219,233,-209,442
1080,360000,af6f4f548684e14d,9,0,798,900,1083,1527,753,397,757,746,837,677,745,886,816,769,141,68,73
793,130000,af6f4f548684e14d,9,0,771,828,1012,1235,691,404,655,694,773,655,680,691,686,675,11,25,-14
1247,410000,af6f4f548684e14d,9,0,1228,1191,1470,2122,1000,589,1119,1013,903,937,951,1080,1016,989,129,14,115
1136,330000,af6f4f548684e14d,9,0,1042,1090,1626,2068,1003,537,978,796,1015,879,797,986,892,887,189,-82,271
1376,420000,af6f4f548684e14d,9,0,1135,1284,1519,1632,1025,485,1058,873,1015,949,835,965,900,916,130,-114,244
1329,430000,af6f4f548684e14d,9,0,1175,1168,1619,2178,1217,467,1068,962,1084,875,893,959,926,909,66,18,48
487,350000,af6f4f548684e14d,9,0,426,568,767,913,522,257,433,373,497,408,356,398,377,387,42,-52,94
438,210000,af6f4f548684e14d,9,0,365,407,443,594,254,172,277,329,290,263,262,428,345,318,166,-1,167
390,500000,af6f4f548684e14d,9,0,386,354,500,762,420,252,342,321,324,387,329,286,308,334,-43,-58,15
423,610000,af6f4f548684e14d,9,0,360,444,478,651,365,184,306,238,357,732,447,312,380,497,-135,-285,150
203,230000,af6f4f548684e14d,9,0,201,203,289,372,142,121,207,187,231,186,143,232,188,187,89,-43,132
1337,310000,7cf283430b3b5e38,9,0,1560,1261,1546,1428,635,513,975,1070,1137,2596,1172,1207,1190,1658,35,-1424,1459
565,530000,7cf283430b3b5e38,9,0,412,350,412,626,249,167,333,316,408,510,602,649,626,587,47,92,-45
685,150000,7cf283430b3b5e38,9,0,434,451,516,701,285,178,320,330,439,413,440,575,508,476,135,27,108
110,110000,7cf283430b3b5e38,9,0,278,174,264,913,106,74,113,101,453,335,314,124,219,258,-190,-21,-169
2175,510000,7cf283430b3b5e38,9,0,2351,1555,1783,2691,1134,763,1522,1501,1649,1954,1996,2318,2157,2089,322,42,280
2098,340000,7cf283430b3b5e38,9,0,2578,2110,2138,2356,1607,968,1908,2068,2171,2517,2384,2828,2606,2576,444,-133,577
4184,370000,7cf283430b3b5e38,9,0,4079,3911,3787,4830,2048,1323,3138,3779,4223,3954,4263,5234,4748,4484,971,309,662
967,140000,7cf283430b3b5e38,9,0,774,678,852,1073,317,283,629,610,883,1085,1017,1391,1204,1164,374,-68,442
2750,440000,7cf283430b3b5e38,9,0,2219,1912,2435,2500,695,488,1495,1512,1848,2203,1964,2643,2304,2270,679,-239,918
1006,450000,7cf283430b3b5e38,9,0,723,646,783,869,475,293,738,554,830,966,1021,1065,1043,1017,44,55,-11
4453,320000,7cf283430b3b5e38,9,0,5089,5170,5016,5865,2657,2401,4119,4083,4704,4995,4877,5866,5372,5246,989,-118,1107
1776,360000,7cf283430b3b5e38,9,0,1446,1175,1376,1737,923,549,1502,1828,1895,1662,1811,1988,1900,1820,177,149,28
1969,130000,7cf283430b3b5e38,9,0,2166,1672,1926,2621,900,720,1379,2198,2809,2761,2856,3219,3038,2945,363,95,268
3047,410000,7cf283430b3b5e38,9,0,2794,2644,2874,3243,1683,1042,2558,3199,3067,3400,3871,4333,4102,3868,462,471,-9
3209,330000,7cf283430b3b5e38,9,0,3258,3003,3295,3490,1289,1038,1965,1876,2506,2778,3135,3712,3424,3208,577,357,220
1719,420000,7cf283430b3b5e38,9,0,1779,1500,1547,1624,929,480,1234,1278,1437,1882,1699,1835,1767,1805,136,-183,319
2090,430000,7cf283430b3b5e38,9,0,1793,1457,1585,1952,989,516,1513,1616,1696,1720,1686,2057,1872,1821,371,-34,405
1317,350000,7cf283430b3b5e38,9,0,859,836,1130,958,546,402,859,878,1319,1184,1258,1327,1292,1256,69,74,-5
874,210000,7cf283430b3b5e38,9,0,667,540,619,821,205,149,446,498,474,571,727,964,846,754,237,156,81
674,500000,7cf283430b3b5e38,9,0,501,422,419,597,296,163,296,401,429,660,507,590,548,586,83,-153,236
1047,610000,7cf283430b3b5e38,9,0,880,891,912,1151,413,242,475,689,883,1688,1091,1205,1148,1328,114,-597,711
382,230000,7cf283430b3b5e38,9,0,298,250,347,415,118,130,301,193,254,310,279,412,346,334,133,-31,164
129,310000,d4efbebb087fd03f,9,0,225,144,225,270,79,27,45,95,103,101,83,103,93,96,20,-18,38
327,530000,d4efbebb087fd03f,9,0,215,192,267,384,296,172,285,192,231,213,247,282,264,247,35,34,1
244,150000,d4efbebb087fd03f,9,0,257,237,359,450,248,124,211,203,178,177,181,202,192,187,21,4,17
546,110000,d4efbebb087fd03f,9,0,755,684,938,1287,118,74,556,952,1106,818,968,836,902,874,-132,150,-282
1065,510000,d4efbebb087fd03f,9,0,1134,707,1002,2805,1326,797,891,676,702,734,761,905,833,800,144,27,117
692,340000,d4efbebb087fd03f,9,0,752,716,977,1443,903,436,535,520,582,612,532,660,596,601,128,-80,208
1744,370000,d4efbebb087fd03f,9,0,2253,1752,2198,3785,1878,1009,1343,1575,1488,1335,1337,1747,1542,1473,410,2,408
518,140000,d4efbebb087fd03f,9,0,635,370,1993,2925,603,248,417,464,574,426,448,540,494,471,92,22,70
1500,440000,d4efbebb087fd03f,9,0,1526,1065,2044,2419,914,399,1078,1095,1082,1215,1038,1245,1142,1166,207,-177,384
629,450000,d4efbebb087fd03f,9,0,452,368,493,935,666,303,492,403,512,470,474,495,484,480,21,4,17
982,320000,d4efbebb087fd03f,9,0,1231,1184,1531,2308,910,648,752,1041,985,944,821,908,864,891,87,-123,210
721,360000,d4efbebb087fd03f,9,0,831,701,917,1377,999,364,509,561,555,561,469,643,556,558,174,-92,266
1031,130000,d4efbebb087fd03f,9,0,941,754,1144,2067,1110,641,741,953,1002,876,936,1050,993,954,114,60,54
1822,410000,d4efbebb087fd03f,9,0,1491,1090,1965,3560,2272,888,1199,1423,1368,1487,1652,1740,1696,1626,88,165,-77
2001,330000,d4efbebb087fd03f,9,0,1978,2287,3147,4324,1028,639,1114,1097,2340,1882,1700,2222,1961,1935,522,-182,704
1167,420000,d4efbebb087fd03f,9,0,528,521,941,1534,1004,347,476,456,410,475,460,525,492,487,65,-15,80
1015,430000,d4efbebb087fd03f,9,0,1102,762,1142,1719,1133,438,685,688,650,716,659,750,704,708,91,-57,148
775,350000,d4efbebb087fd03f,9,0,605,468,762,1967,434,268,656,565,712,722,602,609,606,644,7,-120,127
192,210000,d4efbebb087fd03f,9,0,319,239,291,520,199,149,205,202,188,167,160,157,158,161,-3,-7,4
470,500000,d4efbebb087fd03f,9,0,317,253,326,532,432,291,409,310,302,286,280,366,323,311,86,-6,92
1081,610000,d4efbebb087fd03f,9,0,1013,830,1010,1651,919,422,609,612,587,580,1155,818,986,851,-337,575,-912
138,230000,d4efbebb087fd03f,9,0,154,114,204,257,135,104,114,128,104,132,112,136,124,127,24,-20,44
64,310000,7245e0ee27b195cd,9,0,78,75,125,158,63,40,60,51,45,46,45,48,46,46,3,-1,4
384,530000,7245e0ee27b195cd,9,0,409,425,375,535,421,246,288,240,252,266,378,341,360,328,-37,112,-149
292,150000,7245e0ee27b195cd,9,0,321,287,448,676,363,164,250,212,180,206,169,180,174,185,11,-37,48
80,110000,7245e0ee27b195cd,9,0,328,289,360,496,86,74,109,80,71,61,54,68,61,61,14,-7,21
912,510000,7245e0ee27b195cd,9,0,894,870,831,1260,724,451,621,526,535,628,654,720,687,667,66,26,40
446,340000,7245e0ee27b195cd,9,0,570,478,510,806,576,272,358,315,316,346,322,391,356,353,69,-24,93
1156,370000,7245e0ee27b195cd,9,0,1544,1660,1778,2915,1529,762,977,1071,1025,958,930,1153,1042,1014,223,-28,251
862,140000,7245e0ee27b195cd,9,0,657,689,668,1092,615,366,578,543,590,543,530,702,616,592,172,-13,185
1000,440000,7245e0ee27b195cd,9,0,987,1170,1384,1437,718,363,821,836,734,867,743,867,805,826,124,-124,248
423,450000,7245e0ee27b195cd,9,0,336,321,463,659,452,233,370,288,292,316,346,373,360,345,27,30,-3
488,320000,7245e0ee27b195cd,9,0,619,691,743,1008,543,405,518,460,406,448,428,481,454,452,53,-20,73
422,360000,7245e0ee27b195cd,9,0,576,518,577,816,634,247,323,301,331,301,285,348,316,311,63,-16,79
1304,130000,7245e0ee27b195cd,9,0,1442,1308,1432,2365,1304,951,1023,1070,1210,930,1140,1221,1180,1097,81,210,-129
1233,410000,7245e0ee27b195cd,9,0,1362,1148,1406,2228,1526,717,888,888,823,850,1053,1131,1092,1011,78,203,-125
625,330000,7245e0ee27b195cd,9,0,656,660,874,1121,438,306,511,460,520,507,491,573,532,524,82,-16,98
478,420000,7245e0ee27b195cd,9,0,594,534,655,903,635,255,364,342,325,362,407,342,374,370,-65,45,-110
640,430000,7245e0ee27b195cd,9,0,852,609,763,1216,773,321,479,531,540,517,429,513,471,486,84,-88,172
311,350000,7245e0ee27b195cd,9,0,280,218,239,420,249,153,274,195,252,248,212,300,256,253,88,-36,124
348,210000,7245e0ee27b195cd,9,0,450,328,514,641,287,222,321,326,279,247,251,291,271,263,40,4,36
352,500000,7245e0ee27b195cd,9,0,325,272,292,402,296,142,238,207,233,232,240,260,250,244,20,8,12
857,610000,7245e0ee27b195cd,9,0,705,729,755,1158,815,410,484,484,492,471,470,664,567,535,194,-1,195
200,230000,7245e0ee27b195cd,9,0,249,176,328,336,166,145,205,161,183,216,199,211,205,209,12,-17,29
77,310000,8c915fe4632fb9fa,9,0,181,158,314,461,180,102,190,125,145,92,77,83,80,84,6,-15,21
601,530000,8c915fe4632fb9fa,9,0,447,627,757,1396,1059,575,778,650,682,486,654,573,614,571,-81,168,-249
453,150000,8c915fe4632fb9fa,9,0,287,324,527,720,520,270,473,409,472,356,344,415,380,372,71,-12,83
61,110000,8c915fe4632fb9fa,9,0,237,199,242,487,101,86,162,127,117,78,41,43,42,54,2,-37,39
1302,510000,8c915fe4632fb9fa,9,0,1263,1243,1605,2433,1860,1194,1302,1156,1192,925,872,1055,964,951,183,-53,236
952,340000,8c915fe4632fb9fa,9,0,1069,1269,1370,2298,1440,720,878,861,934,738,651,739,695,709,88,-87,175
1725,370000,8c915fe4632fb9fa,9,0,1485,1686,2126,3804,2217,1109,1504,1812,1956,1321,1432,1563,1498,1439,131,111,20
623,140000,8c915fe4632fb9fa,9,0,496,642,748,1215,772,404,591,661,732,531,562,597,580,563,35,31,4
829,440000,8c915fe4632fb9fa,9,0,835,848,1467,2021,1040,446,977,1064,948,854,663,649,656,722,-14,-191,177
460,450000,8c915fe4632fb9fa,9,0,342,388,511,880,738,330,660,454,586,385,399,303,351,362,-96,14,-110
957,320000,8c915fe4632fb9fa,9,0,1116,1451,1816,2525,1540,1130,1441,1246,1265,930,913,863,888,902,-50,-17,-33
574,360000,8c915fe4632fb9fa,9,0,725,733,889,1320,1015,377,598,631,632,491,445,477,461,471,32,-46,78
1540,130000,8c915fe4632fb9fa,9,0,1437,1548,2026,3281,1882,1126,1456,2041,2368,1518,1714,1628,1671,1620,-86,196,-282
1473,410000,8c915fe4632fb9fa,9,0,1313,1473,1843,2975,2324,1002,1413,1518,1509,1135,1362,1395,1378,1297,33,227,-194
930,330000,8c915fe4632fb9fa,9,0,1089,1175,1502,2235,958,565,880,893,948,697,814,804,809,772,-10,117,-127
825,420000,8c915fe4632fb9fa,9,0,868,924,1339,1557,1148,463,782,723,758,663,696,627,662,662,-69,33,-102
651,430000,8c915fe4632fb9fa,9,0,633,772,835,1281,1235,439,733,664,655,498,506,508,507,504,2,8,-6
337,350000,8c915fe4632fb9fa,9,0,307,414,622,877,518,365,529,461,541,380,328,306,317,338,-22,-52,30
359,210000,8c915fe4632fb9fa,9,0,291,296,396,542,311,224,349,397,405,266,303,286,294,285,-17,37,-54
335,500000,8c915fe4632fb9fa,9,0,311,316,419,666,489,274,346,334,368,358,284,258,271,300,-26,-74,48
603,610000,8c915fe4632fb9fa,9,0,519,627,715,1549,1036,394,463,535,597,405,487,551,519,481,64,82,-18
585,230000,8c915fe4632fb9fa,9,0,442,411,616,998,401,372,684,679,736,526,592,672,632,597,80,66,14
371,310000,6155b214590c66e6,9,0,661,472,781,1047,423,192,279,354,355,429,362,376,369,389,14,-67,81
994,530000,6155b214590c66e6,9,0,1084,1148,1159,1879,1354,680,631,992,1295,955,1148,1036,1092,1046,-112,193,-305
925,150000,6155b214590c66e6,9,0,725,701,941,1442,814,347,566,786,1042,724,802,839,820,788,37,78,-41
293,110000,6155b214590c66e6,9,0,664,474,569,1295,274,176,281,280,376,386,433,291,362,370,-142,47,-189
2342,510000,6155b214590c66e6,9,0,2289,1556,2162,4188,2540,1081,1111,1488,1668,1412,1619,1860,1740,1630,241,207,34
1685,340000,6155b214590c66e6,9,0,1996,1889,2073,3650,2495,863,893,1218,1582,1360,1404,1555,1480,1440,151,44,107
3377,370000,6155b214590c66e6,9,0,3461,3252,3594,6275,3467,1356,2002,3249,3444,2666,3057,2942,3000,2888,-115,391,-506
911,140000,6155b214590c66e6,9,0,805,800,914,1576,743,357,500,790,998,720,798,855,826,791,57,78,-21
2302,440000,6155b214590c66e6,9,0,2808,2902,3269,4342,1784,653,1364,1722,2162,2247,2038,2128,2083,2138,90,-209,299
693,450000,6155b214590c66e6,9,0,670,621,739,1316,892,381,556,538,802,574,699,609,654,627,-90,125,-215
2743,320000,6155b214590c66e6,9,0,3453,3560,3776,5864,3032,1760,2316,2607,3244,2604,2564,2570,2567,2579,6,-40,46
1133,360000,6155b214590c66e6,9,0,1325,1195,1285,2160,1579,453,603,962,960,811,902,887,894,867,-15,91,-106
2466,130000,6155b214590c66e6,9,0,2481,2298,2594,4551,2375,1231,1427,2467,3049,2213,2567,2481,2524,2420,-86,354,-440
3339,410000,6155b214590c66e6,9,0,3571,3427,4047,8018,5309,1586,1915,2716,3025,2701,2930,3143,3036,2925,213,229,-16
2335,330000,6155b214590c66e6,9,0,2579,2724,3014,4336,1679,826,1161,1890,2275,1899,2230,2234,2232,2121,4,331,-327
1693,420000,6155b214590c66e6,9,0,1747,1512,1848,3179,2049,551,906,1028,1278,1264,1359,1217,1288,1280,-142,95,-237
1887,430000,6155b214590c66e6,9,0,2187,1872,2355,3747,2461,732,1157,1395,1621,1288,1479,1482,1480,1416,3,191,-188
723,350000,6155b214590c66e6,9,0,738,859,1140,1306,596,364,463,616,759,757,740,708,724,735,-32,-17,-15
1144,210000,6155b214590c66e6,9,0,1218,970,1188,1784,769,415,765,1227,1203,969,1200,1102,1151,1090,-98,231,-329
836,500000,6155b214590c66e6,9,0,770,622,761,1417,877,373,399,529,594,627,619,620,620,622,1,-8,9
918,610000,6155b214590c66e6,9,0,727,899,841,1546,1008,303,361,648,917,661,790,773,782,741,-17,129,-146
867,230000,6155b214590c66e6,9,0,675,517,944,1290,579,365,604,725,778,831,876,865,870,857,-11,45,-56
719,310000,28e29f2c03dcd84c,9,0,820,623,807,1293,851,433,764,667,727,689,522,968,745,726,446,-167,613
471,530000,28e29f2c03dcd84c,9,0,456,394,535,639,509,300,415,361,462,414,443,436,440,431,-7,29,-36
531,150000,28e29f2c03dcd84c,9,0,482,477,451,580,494,276,556,527,562,528,446,576,511,517,130,-82,212
842,110000,28e29f2c03dcd84c,9,0,1276,969,1288,2146,1327,923,1308,982,1002,1096,834,1075,954,1002,241,-262,503
835,510000,28e29f2c03dcd84c,9,0,1123,634,781,1105,856,454,680,597,621,651,776,861,818,763,85,125,-40
856,340000,28e29f2c03dcd84c,9,0,840,774,803,1070,953,364,644,584,685,706,708,895,802,770,187,2,185
1363,370000,28e29f2c03dcd84c,9,0,1315,1224,1513,1837,1329,778,1244,1284,1298,1141,1319,1334,1326,1265,15,178,-163
794,140000,28e29f2c03dcd84c,9,0,729,770,798,1203,945,474,746,713,727,660,639,991,815,763,352,-21,373
526,440000,28e29f2c03dcd84c,9,0,438,425,536,825,423,180,427,549,477,696,389,618,504,568,229,-307,536
191,450000,28e29f2c03dcd84c,9,0,141,135,160,243,179,71,140,141,183,151,137,141,139,143,4,-14,18
1620,320000,28e29f2c03dcd84c,9,0,1838,1848,1951,2643,1820,1058,1565,1288,1340,1313,1263,1676,1470,1417,413,-50,463
379,360000,28e29f2c03dcd84c,9,0,419,377,424,571,408,151,325,301,312,293,255,351,303,300,96,-38,134
1515,130000,28e29f2c03dcd84c,9,0,1377,1264,1433,1923,1604,884,1377,1523,1631,1539,1425,1590,1508,1518,165,-114,279
1016,410000,28e29f2c03dcd84c,9,0,1081,952,1113,1482,1178,548,1003,1062,1044,1052,1125,1238,1182,1138,113,73,40
733,330000,28e29f2c03dcd84c,9,0,733,722,894,1112,767,352,679,681,651,616,628,814,721,686,186,12,174
373,420000,28e29f2c03dcd84c,9,0,373,329,377,483,446,164,271,261,296,275,330,388,359,331,58,55,3
527,430000,28e29f2c03dcd84c,9,0,464,438,477,783,487,262,452,359,428,383,395,447,421,408,52,12,40
217,350000,28e29f2c03dcd84c,9,0,235,212,345,456,397,140,227,217,291,297,182,259,220,246,77,-115,192
217,210000,28e29f2c03dcd84c,9,0,261,247,251,310,270,165,356,218,179,255,221,255,238,244,34,-34,68
448,500000,28e29f2c03dcd84c,9,0,486,426,491,644,555,263,408,381,378,462,374,447,410,428,73,-88,161
536,610000,28e29f2c03dcd84c,9,0,568,617,622,758,719,361,603,579,645,499,553,624,588,559,71,54,17
96,230000,28e29f2c03dcd84c,9,0,159,142,152,169,104,79,149,106,141,121,123,121,122,122,-2,2,-4
55,310000,37aa9169b575ef79,9,0,41,395,67,117,63,37,86,109,100,151,123,42,82,105,-81,-28,-53
1465,530000,37aa9169b575ef79,9,0,1254,988,1142,1590,946,692,1035,755,884,765,1277,1207,1242,1083,-70,512,-582
1161,150000,37aa9169b575ef79,9,0,895,802,945,982,602,413,714,724,743,629,652,1139,896,807,487,23,464
341,110000,37aa9169b575ef79,9,0,737,477,625,985,300,271,404,282,274,292,278,289,284,286,11,-14,25
3201,510000,37aa9169b575ef79,9,0,2955,1733,2221,3340,1470,1639,3175,2405,2457,2398,2530,2754,2642,2561,224,132,92
478,340000,37aa9169b575ef79,9,0,488,424,410,575,248,260,384,279,286,452,366,371,368,396,5,-86,91
3668,370000,37aa9169b575ef79,9,0,3837,3617,3662,4024,1903,1708,2748,2376,2932,2420,2797,3096,2946,2771,299,377,-78
1434,140000,37aa9169b575ef79,9,0,1561,1243,1188,1616,679,442,672,792,892,815,1028,1189,1108,1011,161,213,-52
2157,440000,37aa9169b575ef79,9,0,2010,1906,2111,2398,1196,1075,2249,1558,2005,1936,1682,1885,1784,1834,203,-254,457
488,450000,37aa9169b575ef79,9,0,409,384,459,435,440,301,449,664,501,523,446,573,510,514,127,-77,204
810,320000,37aa9169b575ef79,9,0,840,781,777,930,527,626,655,605,586,670,623,694,658,662,71,-47,118
399,360000,37aa9169b575ef79,9,0,538,488,482,540,354,189,356,270,359,296,244,355,300,298,111,-52,163
3843,130000,37aa9169b575ef79,9,0,3910,3483,3233,4206,2068,1780,2633,2656,3148,2856,3242,3648,3445,3249,406,386,20
2094,410000,37aa9169b575ef79,9,0,2323,1931,2018,2962,1570,1050,1823,1515,1509,1506,1785,1836,1810,1709,51,279,-228
822,330000,37aa9169b575ef79,9,0,723,606,634,886,424,422,628,555,606,538,517,542,530,532,25,-21,46
533,420000,37aa9169b575ef79,9,0,725,585,544,920,483,270,442,304,376,403,430,440,435,424,10,27,-17
1450,430000,37aa9169b575ef79,9,0,1680,1444,1489,2336,1714,653,1232,835,1023,1076,1149,1284,1216,1170,135,73,62
661,350000,37aa9169b575ef79,9,0,710,690,597,622,308,292,460,424,486,428,470,413,442,437,-57,42,-99
1582,210000,37aa9169b575ef79,9,0,1871,1308,1478,1878,681,691,1319,1119,1215,1237,1419,1601,1510,1419,182,182,0
234,500000,37aa9169b575ef79,9,0,347,184,172,247,131,105,125,160,126,176,161,199,180,179,38,-15,53
777,610000,37aa9169b575ef79,9,0,695,580,634,1051,558,384,605,487,577,560,603,780,692,648,177,43,134
2187,230000,37aa9169b575ef79,9,0,1562,1308,1636,1781,730,952,1556,1254,1336,1463,1649,2283,1966,1798,634,186,448
1879,310000,63065128401bb3ff,9,0,2397,1674,2362,3060,1909,501,2672,4039,883,4181,1421,1782,1602,2461,361,-2760,3121
1367,530000,63065128401bb3ff,9,0,1076,1038,1033,1402,656,504,651,603,785,827,1300,1307,1304,1145,7,473,-466
749,150000,63065128401bb3ff,9,0,541,468,630,827,268,214,376,413,543,491,575,777,676,614,202,84,118
355,110000,63065128401bb3ff,9,0,835,516,1494,2145,217,200,2331,1550,280,361,498,297,398,385,-201,137,-338
2567,510000,63065128401bb3ff,9,0,2707,1708,2119,2450,1355,937,1478,2078,1399,1459,1801,2351,2076,1870,550,342,208
2710,340000,63065128401bb3ff,9,0,2863,2529,2927,3132,1460,775,1436,1362,1591,1598,1947,2510,2228,2018,563,349,214
4366,370000,63065128401bb3ff,9,0,4409,4129,4087,5401,1885,1225,2010,2269,2615,2569,3263,3929,3596,3254,666,694,-28
1865,140000,63065128401bb3ff,9,0,1510,1452,1547,2066,692,491,877,974,1192,1135,1670,2019,1844,1608,349,535,-186
1731,440000,63065128401bb3ff,9,0,2192,2036,2188,2519,625,462,1475,1506,1216,1544,1515,1754,1634,1604,239,-29,268
689,450000,63065128401bb3ff,9,0,589,568,596,616,308,176,366,289,407,451,518,551,534,507,33,67,-34
4430,320000,63065128401bb3ff,9,0,5016,4475,5007,5643,2143,1862,2644,2631,3008,3307,4299,4173,4236,3926,-126,992,-1118
1734,360000,63065128401bb3ff,9,0,2044,1627,1981,2357,973,442,916,895,1031,1009,1333,1810,1572,1384,477,324,153
4197,130000,63065128401bb3ff,9,0,3951,3277,3711,5424,1723,1261,2043,2652,2981,2611,4091,4869,4480,3857,778,1480,-702
4989,410000,63065128401bb3ff,9,0,4500,3793,4237,5119,2463,1238,2429,2562,2723,3091,4009,4961,4485,4020,952,918,34
2322,330000,63065128401bb3ff,9,0,2777,2324,2401,2755,895,768,1359,1321,1533,1474,1767,2205,1986,1815,438,293,145
1567,420000,63065128401bb3ff,9,0,1818,1296,1466,1985,1002,357,841,848,822,1085,1431,1415,1423,1310,-16,346,-362
2202,430000,63065128401bb3ff,9,0,2187,1670,2078,2533,1085,531,1104,1014,1204,1328,1663,1969,1816,1653,306,335,-29
1242,350000,63065128401bb3ff,9,0,1279,1170,1218,1549,440,400,775,721,1235,973,1141,1223,1182,1112,82,168,-86
746,210000,63065128401bb3ff,9,0,897,700,869,1098,268,212,386,587,555,690,977,861,919,843,-116,287,-403
1122,500000,63065128401bb3ff,9,0,1171,824,938,1120,617,359,603,607,619,800,1027,1072,1050,966,45,227,-182
1577,610000,63065128401bb3ff,9,0,1300,1165,1199,1748,631,397,661,1831,842,1735,1691,1436,1564,1621,-255,-44,-211
458,230000,63065128401bb3ff,9,0,404,286,466,480,162,156,276,218,323,452,354,467,410,424,113,-98,211
352,310000,ea489c253676aafc,9,0,502,314,574,754,315,362,767,319,351,300,314,334,324,316,20,14,6
599,530000,ea489c253676aafc,9,0,435,635,692,866,452,295,448,404,525,442,543,578,560,521,35,101,-66
679,150000,ea489c253676aafc,9,0,427,495,612,941,427,254,591,556,550,476,504,704,604,561,200,28,172
113,110000,ea489c253676aafc,9,0,346,199,341,546,125,89,159,100,115,114,150,110,130,125,-40,36,-76
1236,510000,ea489c253676aafc,9,0,903,838,1187,1812,1017,704,1344,1235,1081,1056,878,1050,964,995,172,-178,350
812,340000,ea489c253676aafc,9,0,734,813,952,1669,741,475,869,701,638,694,733,857,795,761,124,39,85
3132,370000,ea489c253676aafc,9,0,2451,2995,3812,5496,2330,1515,2865,2841,2834,2558,2825,3266,3046,2883,441,267,174
1282,140000,ea489c253676aafc,9,0,1052,1126,1234,2626,1165,641,1247,1425,1531,1329,1557,1538,1548,1475,-19,228,-247
614,440000,ea489c253676aafc,9,0,529,384,525,1055,368,255,433,540,513,805,467,681,574,651,214,-338,552
107,450000,ea489c253676aafc,9,0,255,362,355,448,365,155,240,485,249,405,222,128,175,252,-94,-183,89
1053,320000,ea489c253676aafc,9,0,864,1310,1728,2261,1167,1028,1507,1281,827,792,892,955,924,880,63,100,-37
309,360000,ea489c253676aafc,9,0,301,356,946,847,641,223,316,236,253,238,242,217,230,232,-25,4,-29
2904,130000,ea489c253676aafc,9,0,2265,2586,3058,5478,1932,1551,2981,3513,3250,2524,3284,3386,3335,3065,102,760,-658
1597,410000,ea489c253676aafc,9,0,1141,1472,1941,3092,1731,893,1695,1504,1408,1487,1714,1721,1718,1641,7,227,-220
623,330000,ea489c253676aafc,9,0,659,638,706,1205,504,467,741,598,514,446,578,432,505,485,-146,132,-278
198,420000,ea489c253676aafc,9,0,202,272,348,657,298,154,273,222,166,164,170,172,171,169,2,6,-4
425,430000,ea489c253676aafc,9,0,698,568,587,1351,576,253,448,437,409,373,484,393,438,417,-91,111,-202
352,350000,ea489c253676aafc,9,0,342,307,452,617,215,148,255,232,240,199,231,301,266,244,70,32,38
902,210000,ea489c253676aafc,9,0,684,572,853,1026,394,408,768,721,776,679,667,892,780,746,225,-12,237
233,500000,ea489c253676aafc,9,0,304,408,379,694,353,248,346,329,249,207,249,199,224,218,-50,42,-92
777,610000,ea489c253676aafc,9,0,623,693,804,1400,754,418,791,600,553,553,625,614,620,597,-11,72,-83
943,230000,ea489c253676aafc,9,0,307,324,496,710,280,266,503,464,518,466,471,859,665,599,388,5,383
237,310000,cd5841d44fd7625e,9,0,150,148,312,359,339,177,321,249,248,328,254,307,280,296,53,-74,127
363,530000,cd5841d44fd7625e,9,0,304,344,442,485,409,248,357,375,412,347,430,418,424,398,-12,83,-95
444,150000,cd5841d44fd7625e,9,0,325,432,401,434,519,319,522,443,583,484,431,411,421,442,-20,-53,33
855,110000,cd5841d44fd7625e,9,0,1150,795,1121,1802,1263,877,1267,1047,1549,1033,967,860,914,953,-107,-66,-41
1048,510000,cd5841d44fd7625e,9,0,741,610,732,1083,1390,565,951,827,852,794,845,1009,927,883,164,51,113
590,340000,cd5841d44fd7625e,9,0,323,440,519,629,667,315,471,534,553,570,581,499,540,550,-82,11,-93
1942,370000,cd5841d44fd7625e,9,0,1391,1370,1666,1642,1861,878,1578,1694,1792,1554,1627,1927,1777,1703,300,73,227
455,140000,cd5841d44fd7625e,9,0,330,480,421,414,426,317,451,395,445,395,431,409,420,412,-22,36,-58
878,440000,cd5841d44fd7625e,9,0,523,704,995,1243,727,322,827,693,791,804,769,839,804,804,70,-35,105
190,450000,cd5841d44fd7625e,9,0,156,159,192,214,225,119,204,139,193,190,168,192,180,183,24,-22,46
1046,320000,cd5841d44fd7625e,9,0,1280,881,1099,1374,1336,868,1301,1124,1278,1241,1197,1296,1246,1245,99,-44,143
268,360000,cd5841d44fd7625e,9,0,178,237,276,329,364,141,291,237,315,278,285,309,297,291,24,7,17
1750,130000,cd5841d44fd7625e,9,0,1115,1052,1461,1615,1768,1165,1697,1805,2074,1714,1806,1864,1835,1795,58,92,-34
1504,410000,cd5841d44fd7625e,9,0,1104,1357,1223,1443,1429,856,1325,1403,1419,1413,1478,1579,1528,1490,101,65,36
701,330000,cd5841d44fd7625e,9,0,404,512,747,863,742,356,707,633,707,646,663,732,698,680,69,17,52
551,420000,cd5841d44fd7625e,9,0,393,374,473,566,558,262,443,396,470,482,493,546,520,507,53,11,42
409,430000,cd5841d44fd7625e,9,0,253,248,418,494,519,230,424,383,397,379,387,399,393,388,12,8,4
604,350000,cd5841d44fd7625e,9,0,186,285,325,402,404,188,330,251,340,301,284,315,300,300,31,-17,48
828,210000,cd5841d44fd7625e,9,0,569,738,644,1082,704,546,870,783,781,790,785,765,775,780,-20,-5,-15
329,500000,cd5841d44fd7625e,9,0,262,251,282,391,433,202,335,319,317,436,335,381,358,384,46,-101,147
482,610000,cd5841d44fd7625e,9,0,419,276,346,497,487,257,378,390,460,393,519,500,510,471,-19,126,-145
870,230000,cd5841d44fd7625e,9,0,731,657,664,964,785,666,1198,1070,1179,970,890,1044,967,968,154,-80,234
639,310000,b25c4e2e3856af22,9,0,1150,1010,1563,1504,815,447,731,532,612,632,552,602,577,595,50,-80,130
383,530000,b25c4e2e3856af22,9,0,570,759,692,785,585,277,403,310,422,368,501,439,470,436,-62,133,-195
141,150000,b25c4e2e3856af22,9,0,327,407,342,430,303,110,229,177,183,153,136,170,153,153,34,-17,51
272,110000,b25c4e2e3856af22,9,0,925,740,925,1127,376,284,427,371,462,336,275,270,272,294,-5,-61,56
828,510000,b25c4e2e3856af22,9,0,1885,1100,1320,1775,1096,562,764,657,680,772,616,717,666,702,101,-156,257
690,340000,b25c4e2e3856af22,9,0,1023,1001,1064,1490,952,364,600,581,589,605,632,685,658,641,53,27,26
1047,370000,b25c4e2e3856af22,9,0,1432,1303,1408,1739,940,501,805,813,957,836,892,940,916,889,48,56,-8
123,140000,b25c4e2e3856af22,9,0,289,333,332,371,229,113,151,138,130,107,102,135,118,115,33,-5,38
800,440000,b25c4e2e3856af22,9,0,1320,1463,1644,2216,854,451,986,862,846,947,768,780,774,832,12,-179,191
173,450000,b25c4e2e3856af22,9,0,240,280,255,372,218,114,237,155,197,163,181,169,175,171,-12,18,-30
1123,320000,b25c4e2e3856af22,9,0,1897,1872,2263,3132,1586,987,1345,1015,1158,1068,1086,1181,1134,1112,95,18,77
471,360000,b25c4e2e3856af22,9,0,855,798,870,1144,754,284,498,430,503,444,457,461,459,454,4,13,-9
581,130000,b25c4e2e3856af22,9,0,861,883,944,1218,652,442,599,687,716,543,668,679,674,630,11,125,-114
571,410000,b25c4e2e3856af22,9,0,1067,1021,1121,1578,856,471,700,719,644,669,703,653,678,675,-50,34,-84
1278,330000,b25c4e2e3856af22,9,0,2367,2323,2703,3371,1749,893,1369,1150,1156,1037,1172,1334,1253,1181,162,135,27
533,420000,b25c4e2e3856af22,9,0,920,1033,988,1333,941,363,579,523,593,600,621,519,570,580,-102,21,-123
673,430000,b25c4e2e3856af22,9,0,1056,973,1081,1561,1003,386,716,610,659,562,594,642,618,599,48,32,16
338,350000,b25c4e2e3856af22,9,0,714,853,905,1102,667,370,551,387,534,372,366,372,369,370,6,-6,12
248,210000,b25c4e2e3856af22,9,0,491,437,403,555,253,188,258,212,206,203,265,272,268,247,7,62,-55
248,500000,b25c4e2e3856af22,9,0,477,428,496,740,452,184,293,290,264,303,274,250,262,276,-24,-29,5
205,610000,b25c4e2e3856af22,9,0,433,450,479,533,395,223,292,216,328,233,285,238,262,252,-47,52,-99
179,230000,b25c4e2e3856af22,9,0,359,320,352,428,213,219,281,217,259,239,210,238,224,229,28,-29,57
636,310000,4a103c30d593fbbe,9,0,552,450,685,688,275,231,396,369,368,427,353,607,480,462,254,-74,328
634,530000,4a103c30d593fbbe,9,0,640,687,714,1001,409,321,443,427,437,368,556,556,556,493,0,188,-188
660,150000,4a103c30d593fbbe,9,0,557,650,671,789,370,239,440,455,525,460,522,607,564,530,85,62,23
549,110000,4a103c30d593fbbe,9,0,1431,1045,1332,1807,402,360,619,496,497,491,482,542,512,505,60,-9,69
3069,510000,4a103c30d593fbbe,9,0,2921,2017,2913,3590,1589,1106,1523,1538,1537,1666,1861,2475,2168,2001,614,195,419
1638,340000,4a103c30d593fbbe,9,0,1596,1491,1717,1968,921,593,995,1124,1199,1070,1346,1713,1530,1376,367,276,91
2980,370000,4a103c30d593fbbe,9,0,2615,2547,2776,3299,1329,945,1856,2083,2108,1738,2082,2655,2368,2158,573,344,229
791,140000,4a103c30d593fbbe,9,0,787,813,782,1130,401,261,510,549,610,526,688,866,777,693,178,162,16
1488,440000,4a103c30d593fbbe,9,0,1438,1702,2171,2397,475,354,1081,908,1044,1235,994,1368,1181,1199,374,-241,615
424,450000,4a103c30d593fbbe,9,0,358,395,493,595,225,179,348,224,290,274,316,397,356,329,81,42,39
3158,320000,4a103c30d593fbbe,9,0,2962,3228,3579,4302,1623,1477,2234,2129,2434,2155,2485,3088,2786,2576,603,330,273
842,360000,4a103c30d593fbbe,9,0,755,781,885,1016,398,230,537,551,590,548,652,808,730,669,156,104,52
4034,130000,4a103c30d593fbbe,9,0,2860,2877,2989,3954,1565,1311,2239,2725,3260,2705,3344,4173,3758,3407,829,639,190
3374,410000,4a103c30d593fbbe,9,0,2493,2358,2638,3291,1489,872,1684,1948,1801,1780,2489,2996,2742,2422,507,709,-202
2753,330000,4a103c30d593fbbe,9,0,1992,2163,2458,2897,961,793,1491,1417,1453,1417,1645,2472,2058,1845,827,228,599
1182,420000,4a103c30d593fbbe,9,0,1142,948,1247,1304,805,357,634,667,656,762,898,966,932,875,68,136,-68
1080,430000,4a103c30d593fbbe,9,0,950,757,948,1222,427,264,565,544,561,563,728,991,860,761,263,165,98
728,350000,4a103c30d593fbbe,9,0,694,837,946,924,385,327,518,415,620,444,541,690,616,558,149,97,52
1162,210000,4a103c30d593fbbe,9,0,1057,1007,1160,1513,414,423,828,916,847,707,895,1272,1084,958,377,188,189
559,500000,4a103c30d593fbbe,9,0,365,407,493,612,296,209,288,300,336,388,329,435,382,384,106,-59,165
911,610000,4a103c30d593fbbe,9,0,801,945,946,1143,404,239,410,468,587,452,654,835,744,647,181,202,-21
842,230000,4a103c30d593fbbe,9,0,914,753,1190,1198,462,436,1058,713,772,690,729,1100,914,840,371,39,332
1004,310000,7a7885e2d7c00bcf,9,0,690,633,790,925,325,455,653,555,624,740,612,758,685,703,146,-128,274
300,530000,7a7885e2d7c00bcf,9,0,408,431,527,546,194,218,317,270,316,211,290,290,290,264,0,79,-79
334,150000,7a7885e2d7c00bcf,9,0,355,371,359,418,168,163,287,292,335,266,288,328,308,294,40,22,18
655,110000,7a7885e2d7c00bcf,9,0,1074,915,1162,1615,471,523,831,698,714,664,617,559,588,613,-58,-47,-11
1044,510000,7a7885e2d7c00bcf,9,0,1155,772,961,1167,445,516,738,665,640,630,656,820,738,702,164,26,138
819,340000,7a7885e2d7c00bcf,9,0,841,878,933,1003,374,418,658,653,606,565,618,791,704,658,173,53,120
2507,370000,7a7885e2d7c00bcf,9,0,2308,2307,2370,2766,875,984,1739,1860,1899,1420,1615,2002,1808,1679,387,195,192
331,140000,7a7885e2d7c00bcf,9,0,313,320,355,484,139,184,247,243,229,225,247,307,277,260,60,22,38
845,440000,7a7885e2d7c00bcf,9,0,992,1092,1209,1464,402,402,896,629,772,826,680,829,754,778,149,-146,295
203,450000,7a7885e2d7c00bcf,9,0,246,259,290,384,118,109,224,157,222,215,154,183,168,184,29,-61,90
2463,320000,7a7885e2d7c00bcf,9,0,2679,2595,2801,3241,1057,1612,2234,1953,2227,1909,2048,2422,2235,2126,374,139,235
431,360000,7a7885e2d7c00bcf,9,0,442,498,481,511,213,176,385,307,351,273,345,404,374,341,59,72,-13
1901,130000,7a7885e2d7c00bcf,9,0,1525,1603,1929,2115,754,885,1533,1690,1813,1571,1661,1916,1788,1716,255,90,165
1356,410000,7a7885e2d7c00bcf,9,0,1383,1309,1461,1740,591,724,1200,1228,1058,967,1158,1211,1184,1112,53,191,-138
2311,330000,7a7885e2d7c00bcf,9,0,1991,2033,2127,2662,818,1237,1764,1676,1729,1525,1884,2258,2071,1889,374,359,15
557,420000,7a7885e2d7c00bcf,9,0,611,603,616,685,305,279,470,356,444,412,438,504,471,451,66,26,40
525,430000,7a7885e2d7c00bcf,9,0,645,501,559,768,256,278,497,347,424,341,409,480,444,410,71,68,3
363,350000,7a7885e2d7c00bcf,9,0,397,473,480,608,216,257,389,262,395,326,356,356,356,346,0,30,-30
385,210000,7a7885e2d7c00bcf,9,0,553,489,516,595,169,217,412,408,386,321,346,352,349,340,6,25,-19
163,500000,7a7885e2d7c00bcf,9,0,189,159,216,258,69,99,133,100,129,180,126,116,121,141,-10,-54,44
460,610000,7a7885e2d7c00bcf,9,0,425,510,487,657,185,238,361,306,395,301,417,437,427,385,20,116,-96
357,230000,7a7885e2d7c00bcf,9,0,511,443,413,533,157,228,535,404,398,359,345,475,410,393,130,-14,144
38,310000,346393c2c6305fb1,9,0,126,104,114,215,76,41,45,61,38,52,37,39,38,43,2,-15,17
41,530000,346393c2c6305fb1,9,0,133,139,121,182,95,41,34,36,31,58,44,55,50,52,11,-14,25
79,150000,346393c2c6305fb1,9,0,121,108,174,205,99,66,95,76,72,76,74,85,80,78,11,-2,13
39,110000,346393c2c6305fb1,9,0,250,161,243,439,74,40,54,53,41,27,32,51,42,37,19,5,14
183,510000,346393c2c6305fb1,9,0,459,291,297,513,309,153,136,133,149,150,134,136,135,140,2,-16,18
395,340000,346393c2c6305fb1,9,0,655,600,692,1047,578,273,312,307,331,314,279,347,313,313,68,-35,103
690,370000,346393c2c6305fb1,9,0,1138,1097,1099,1844,902,381,538,572,675,544,536,649,592,576,113,-8,121
265,140000,346393c2c6305fb1,9,0,250,277,308,545,238,158,237,226,236,217,178,237,208,211,59,-39,98
141,440000,346393c2c6305fb1,9,0,282,277,289,373,126,71,118,103,101,96,92,121,106,103,29,-4,33
56,450000,346393c2c6305fb1,9,0,108,100,115,162,93,53,69,35,53,40,48,50,49,46,2,8,-6
207,320000,346393c2c6305fb1,9,0,370,406,397,621,300,168,197,206,183,203,185,213,199,200,28,-18,46
59,360000,346393c2c6305fb1,9,0,150,164,143,266,151,36,61,68,60,40,53,57,55,50,4,13,-9
544,130000,346393c2c6305fb1,9,0,742,699,808,1460,748,389,430,459,518,401,452,524,488,459,72,51,21
303,410000,346393c2c6305fb1,9,0,566,471,617,1100,524,174,251,240,290,254,290,316,303,287,26,36,-10
74,330000,346393c2c6305fb1,9,0,198,211,191,260,101,55,63,66,67,90,77,72,74,80,-5,-13,8
182,420000,346393c2c6305fb1,9,0,326,324,313,534,275,79,103,125,96,138,125,127,126,130,2,-13,15
166,430000,346393c2c6305fb1,9,0,347,286,335,535,308,119,163,126,142,139,138,161,150,146,23,-1,24
56,350000,346393c2c6305fb1,9,0,102,89,87,129,60,25,51,31,35,42,33,28,30,34,-5,-9,4
180,210000,346393c2c6305fb1,9,0,280,278,265,371,149,91,133,121,130,132,148,200,174,160,52,16,36
85,500000,346393c2c6305fb1,9,0,250,189,199,335,168,84,69,66,80,88,67,79,73,78,12,-21,33
110,610000,346393c2c6305fb1,9,0,167,197,186,360,209,62,83,76,106,84,83,85,84,84,2,-1,3
132,230000,346393c2c6305fb1,9,0,248,169,223,312,126,95,154,101,143,86,105,123,114,105,18,19,-1
654,310000,02aab221aabc03b9,9,0,651,489,558,362,679,494,731,600,672,772,704,727,716,734,23,-68,91
174,530000,02aab221aabc03b9,9,0,201,174,160,155,229,130,223,186,188,194,250,267,258,237,17,56,-39
92,150000,02aab221aabc03b9,9,0,97,99,82,59,106,63,136,99,113,83,99,112,106,98,13,16,-3
659,110000,02aab221aabc03b9,9,0,831,642,654,521,798,532,838,575,694,618,670,630,650,639,-40,52,-92
507,510000,02aab221aabc03b9,9,0,615,471,430,474,703,394,653,524,606,614,549,576,562,580,27,-65,92
335,340000,02aab221aabc03b9,9,0,348,248,228,187,338,203,372,311,341,346,340,353,346,346,13,-6,19
473,370000,02aab221aabc03b9,9,0,525,474,421,353,610,362,607,527,608,548,531,526,528,535,-5,-17,12
119,140000,02aab221aabc03b9,9,0,121,105,117,105,129,94,160,139,138,152,130,124,127,135,-6,-22,16
1161,440000,02aab221aabc03b9,9,0,1180,1049,976,1007,1207,847,1361,1093,1267,1219,1095,1304,1200,1206,209,-124,333
146,450000,02aab221aabc03b9,9,0,151,126,138,119,159,102,172,121,154,153,137,153,145,148,16,-16,32
1338,320000,02aab221aabc03b9,9,0,1585,1270,1186,1077,1735,1066,1713,1523,1554,1639,1493,1583,1538,1572,90,-146,236
224,360000,02aab221aabc03b9,9,0,232,164,154,152,242,146,291,216,232,253,206,215,210,225,9,-47,56
376,130000,02aab221aabc03b9,9,0,362,307,254,182,340,242,360,379,362,327,372,362,367,354,-10,45,-55
332,410000,02aab221aabc03b9,9,0,339,239,284,223,320,199,311,289,319,320,350,407,378,359,57,30,27
1190,330000,02aab221aabc03b9,9,0,1439,1239,1136,1024,1529,973,1602,1326,1507,1501,1473,1537,1505,1504,64,-28,92
338,420000,02aab221aabc03b9,9,0,407,272,273,274,370,238,369,296,339,369,331,321,326,340,-10,-38,28
299,430000,02aab221aabc03b9,9,0,285,213,205,215,305,186,346,275,278,289,275,275,275,280,0,-14,14
413,350000,02aab221aabc03b9,9,0,448,353,321,324,518,242,572,350,498,528,403,477,440,469,74,-125,199
266,210000,02aab221aabc03b9,9,0,299,229,207,174,292,205,321,225,242,252,295,316,306,288,21,43,-22
190,500000,02aab221aabc03b9,9,0,255,197,217,217,267,199,277,240,244,232,258,263,260,251,5,26,-21
210,610000,02aab221aabc03b9,9,0,283,263,205,197,285,151,281,203,248,250,270,252,261,257,-18,20,-38
92,230000,02aab221aabc03b9,9,0,71,81,63,53,93,68,133,85,82,113,113,134,124,120,21,0,21
290,310000,5d7fb682edd0f937,9,0,281,281,247,225,315,160,297,263,287,314,230,299,264,281,69,-84,153
187,530000,5d7fb682edd0f937,9,0,165,167,133,176,164,108,164,133,153,126,180,169,174,158,-11,54,-65
103,150000,5d7fb682edd0f937,9,0,120,96,85,86,86,62,103,111,102,97,88,89,88,91,1,-9,10
289,110000,5d7fb682edd0f937,9,0,429,308,324,417,323,190,356,270,290,257,234,246,240,246,12,-23,35
389,510000,5d7fb682edd0f937,9,0,389,305,301,337,483,166,411,313,351,316,288,271,280,292,-17,-28,11
219,340000,5d7fb682edd0f937,9,0,205,162,169,174,188,119,173,183,210,172,186,222,204,193,36,14,22
332,370000,5d7fb682edd0f937,9,0,292,265,227,253,339,160,306,297,331,234,253,292,272,260,39,19,20
102,140000,5d7fb682edd0f937,9,0,99,83,81,91,111,56,97,101,97,84,91,94,92,90,3,7,-4
505,440000,5d7fb682edd0f937,9,0,575,462,510,512,581,314,531,409,540,562,422,478,450,487,56,-140,196
92,450000,5d7fb682edd0f937,9,0,108,102,103,109,128,57,103,59,104,114,85,94,90,98,9,-29,38
797,320000,5d7fb682edd0f937,9,0,757,642,661,734,807,456,741,678,793,643,655,701,678,666,46,12,34
138,360000,5d7fb682edd0f937,9,0,155,115,129,138,165,79,158,126,152,118,104,127,116,116,23,-14,37
247,130000,5d7fb682edd0f937,9,0,226,184,180,178,203,126,201,195,251,175,165,222,194,187,57,-10,67
215,410000,5d7fb682edd0f937,9,0,187,161,189,173,186,103,191,191,194,156,186,216,201,186,30,30,0
718,330000,5d7fb682edd0f937,9,0,620,587,599,595,656,382,738,625,720,647,584,732,658,654,148,-63,211
262,420000,5d7fb682edd0f937,9,0,331,219,258,266,270,142,257,214,255,256,231,241,236,243,10,-25,35
213,430000,5d7fb682edd0f937,9,0,179,160,168,191,210,114,205,161,191,162,167,198,182,176,31,5,26
237,350000,5d7fb682edd0f937,9,0,259,202,201,205,241,127,267,183,283,239,197,201,199,212,4,-42,46
130,210000,5d7fb682edd0f937,9,0,165,130,138,128,140,90,113,125,138,146,129,145,137,140,16,-17,33
144,500000,5d7fb682edd0f937,9,0,109,123,106,134,131,54,117,102,136,130,124,110,117,121,-14,-6,-8
138,610000,5d7fb682edd0f937,9,0,192,172,135,145,159,85,142,119,156,144,123,140,132,136,17,-21,38
81,230000,5d7fb682edd0f937,9,0,74,50,53,61,68,34,78,65,79,70,61,83,72,71,22,-9,31
593,310000,a207df29ec9583f0,9,0,478,428,493,474,835,424,592,562,626,644,634,694,664,657,60,-10,70
238,530000,a207df29ec9583f0,9,0,237,204,210,215,310,178,234,223,203,223,258,250,254,244,-8,35,-43
105,150000,a207df29ec9583f0,9,0,91,72,82,74,139,87,116,104,125,105,116,128,122,116,12,11,1
751,110000,a207df29ec9583f0,9,0,853,604,747,817,1033,648,841,763,792,726,727,824,776,759,97,1,96
615,510000,a207df29ec9583f0,9,0,388,382,361,382,695,383,524,456,456,507,479,440,460,475,-39,-28,-11
255,340000,a207df29ec9583f0,9,0,228,183,176,177,354,152,225,259,222,223,254,259,256,245,5,31,-26
468,370000,a207df29ec9583f0,9,0,344,338,348,336,608,328,530,488,475,451,429,468,448,449,39,-22,61
138,140000,a207df29ec9583f0,9,0,108,84,93,100,165,96,130,118,97,142,140,152,146,145,12,-2,14
1111,440000,a207df29ec9583f0,9,0,875,627,766,825,1178,690,1101,964,1020,962,1084,1109,1096,1052,25,122,-97
148,450000,a207df29ec9583f0,9,0,124,72,100,114,160,106,163,133,138,136,134,129,132,133,-5,-2,-3
1012,320000,a207df29ec9583f0,9,0,918,791,915,1007,1591,766,1115,1026,1072,1033,982,1080,1031,1032,98,-51,149
175,360000,a207df29ec9583f0,9,0,155,101,129,108,227,115,167,214,182,168,165,197,181,177,32,-3,35
260,130000,a207df29ec9583f0,9,0,200,202,203,219,376,209,316,289,290,301,301,298,300,300,-3,0,-3
329,410000,a207df29ec9583f0,9,0,252,194,283,262,357,201,287,304,275,256,289,287,288,277,-2,33,-35
930,330000,a207df29ec9583f0,9,0,834,733,849,908,1436,623,970,967,965,954,954,1063,1008,990,109,0,109
379,420000,a207df29ec9583f0,9,0,326,230,315,356,436,202,366,316,282,393,360,384,372,379,24,-33,57
252,430000,a207df29ec9583f0,9,0,184,143,174,192,302,179,246,255,226,219,246,249,248,238,3,27,-24
361,350000,a207df29ec9583f0,9,0,266,197,227,256,500,212,338,297,357,330,288,330,309,316,42,-42,84
268,210000,a207df29ec9583f0,9,0,225,176,194,227,304,176,286,261,241,263,276,299,288,279,23,13,10
223,500000,a207df29ec9583f0,9,0,176,151,174,194,265,152,205,197,174,223,187,198,192,203,11,-36,47
226,610000,a207df29ec9583f0,9,0,228,210,194,216,307,140,222,205,251,252,248,224,236,241,-24,-4,-20
92,230000,a207df29ec9583f0,9,0,77,74,83,85,102,84,125,116,121,127,86,123,104,112,37,-41,78
210,310000,b4be3a4917289c82,9,0,190,188,201,262,80,97,160,113,154,142,142,182,162,155,40,0,40
58,530000,b4be3a4917289c82,9,0,52,76,100,59,26,35,34,50,78,51,74,46,60,57,-28,23,-51
25,150000,b4be3a4917289c82,9,0,31,42,40,37,22,17,26,37,25,21,17,27,22,22,10,-4,14
163,110000,b4be3a4917289c82,9,0,232,200,230,226,93,117,153,137,139,94,88,112,100,98,24,-6,30
277,510000,b4be3a4917289c82,9,0,216,166,240,223,57,76,90,137,164,128,144,184,164,152,40,16,24
95,340000,b4be3a4917289c82,9,0,106,110,130,121,57,59,72,81,74,76,100,108,104,95,8,24,-16
268,370000,b4be3a4917289c82,9,0,258,215,231,199,113,137,218,152,167,149,160,180,170,163,20,11,9
34,140000,b4be3a4917289c82,9,0,31,31,28,33,16,10,28,22,76,22,26,27,26,25,1,4,-3
232,440000,b4be3a4917289c82,9,0,290,309,396,384,120,115,231,223,244,188,202,225,214,205,23,14,9
53,450000,b4be3a4917289c82,9,0,35,34,41,40,20,18,18,25,33,31,30,38,34,33,8,-1,9
503,320000,b4be3a4917289c82,9,0,447,420,635,591,225,325,414,342,390,329,340,426,383,365,86,11,75
58,360000,b4be3a4917289c82,9,0,50,52,66,85,10,18,37,40,39,37,38,50,44,42,12,1,11
127,130000,b4be3a4917289c82,9,0,145,141,166,161,78,99,131,131,102,71,97,118,108,95,21,26,-5
128,410000,b4be3a4917289c82,9,0,118,117,128,163,57,77,90,88,75,84,92,121,106,99,29,8,21
575,330000,b4be3a4917289c82,9,0,415,422,523,567,168,290,344,386,300,355,415,511,463,427,96,60,36
111,420000,b4be3a4917289c82,9,0,110,92,120,142,48,54,76,88,66,69,75,103,89,82,28,6,22
92,430000,b4be3a4917289c82,9,0,96,79,112,124,41,43,61,74,75,46,72,85,78,68,13,26,-13
70,350000,b4be3a4917289c82,9,0,61,85,108,127,23,28,50,51,59,58,62,64,63,61,2,4,-2
89,210000,b4be3a4917289c82,9,0,87,77,106,83,28,38,67,45,65,40,54,75,64,56,21,14,7
56,500000,b4be3a4917289c82,9,0,47,43,77,67,17,20,19,34,34,37,30,40,35,36,10,-7,17
75,610000,b4be3a4917289c82,9,0,79,83,68,82,41,52,48,66,99,56,51,90,70,66,39,-5,44
30,230000,b4be3a4917289c82,9,0,42,40,48,45,18,18,48,30,46,28,19,30,24,26,11,-9,20
825,310000,ef76a85c4b39f693,9,0,145,129,306,492,378,283,374,311,427,498,475,609,542,527,134,-23,157
259,530000,ef76a85c4b39f693,9,0,83,75,142,154,140,101,145,149,178,192,272,277,274,247,5,80,-75
185,150000,ef76a85c4b39f693,9,0,47,48,67,109,121,79,109,124,169,140,135,176,156,150,41,-5,46
730,110000,ef76a85c4b39f693,9,0,321,175,311,576,511,299,438,522,580,543,591,697,644,610,106,48,58
1038,510000,ef76a85c4b39f693,9,0,356,206,340,526,495,291,361,444,497,529,571,643,607,581,72,42,30
565,340000,ef76a85c4b39f693,9,0,104,111,219,307,304,148,259,319,271,331,363,453,408,382,90,32,58
941,370000,ef76a85c4b39f693,9,0,246,241,312,378,406,284,400,479,557,520,550,741,646,604,191,30,161
185,140000,ef76a85c4b39f693,9,0,47,46,58,83,94,61,99,97,93,99,121,177,149,132,56,22,34
1094,440000,ef76a85c4b39f693,9,0,398,282,593,912,598,355,607,642,701,764,756,899,828,806,143,-8,151
158,450000,ef76a85c4b39f693,9,0,39,30,50,68,74,33,77,72,113,104,139,145,142,129,6,35,-29
1727,320000,ef76a85c4b39f693,9,0,270,351,609,1028,993,652,891,910,1046,1085,1159,1451,1305,1232,292,74,218
344,360000,ef76a85c4b39f693,9,0,47,59,107,208,200,69,151,150,175,152,209,258,234,206,49,57,-8
630,130000,ef76a85c4b39f693,9,0,172,141,298,340,342,250,323,382,440,423,438,563,500,475,125,15,110
560,410000,ef76a85c4b39f693,9,0,143,136,170,239,290,184,293,341,325,356,405,492,448,418,87,49,38
2180,330000,ef76a85c4b39f693,9,0,643,498,965,1300,996,708,969,1088,1209,1284,1524,1958,1741,1589,434,240,194
473,420000,ef76a85c4b39f693,9,0,116,101,212,331,334,134,250,279,305,303,339,437,388,360,98,36,62
484,430000,ef76a85c4b39f693,9,0,78,92,180,310,284,146,251,271,354,267,331,429,380,342,98,64,34
353,350000,ef76a85c4b39f693,9,0,69,95,138,176,229,97,153,164,270,221,253,308,280,261,55,32,23
531,210000,ef76a85c4b39f693,9,0,193,157,189,261,256,190,274,317,341,370,440,648,544,486,208,70,138
256,500000,ef76a85c4b39f693,9,0,51,35,76,157,115,82,120,97,175,209,162,190,176,187,28,-47,75
387,610000,ef76a85c4b39f693,9,0,115,96,127,205,223,136,166,239,247,199,284,366,325,283,82,85,-3
210,230000,ef76a85c4b39f693,9,0,58,56,108,145,104,92,153,138,145,157,161,240,200,186,79,4,75
449,310000,bb9fbec9a2833839,9,0,494,298,341,507,266,214,347,256,335,387,323,471,397,394,148,-64,212
157,530000,bb9fbec9a2833839,9,0,197,180,169,225,142,99,142,158,164,176,231,206,218,204,-25,55,-80
178,150000,bb9fbec9a2833839,9,0,174,157,121,169,76,74,105,133,145,136,151,168,160,152,17,15,2
353,110000,bb9fbec9a2833839,9,0,529,355,417,450,177,170,259,234,290,279,265,274,270,273,9,-14,23
596,510000,bb9fbec9a2833839,9,0,641,403,433,394,242,224,324,333,361,319,358,452,405,376,94,39,55
323,340000,bb9fbec9a2833839,9,0,328,172,256,310,160,139,211,231,217,227,254,298,276,260,44,27,17
597,370000,bb9fbec9a2833839,9,0,582,453,469,507,305,251,332,402,428,398,413,574,494,462,161,15,146
173,140000,bb9fbec9a2833839,9,0,143,117,124,97,55,43,101,86,111,100,106,169,138,125,63,6,57
788,440000,bb9fbec9a2833839,9,0,867,710,821,895,435,271,630,599,641,694,710,772,741,725,62,16,46
118,450000,bb9fbec9a2833839,9,0,137,85,114,124,79,66,108,95,119,99,124,137,130,120,13,25,-12
1019,320000,bb9fbec9a2833839,9,0,1166,688,937,1154,552,589,835,807,903,879,877,1098,988,951,221,-2,223
227,360000,bb9fbec9a2833839,9,0,193,186,189,178,106,91,145,142,176,146,152,202,177,167,50,6,44
362,130000,bb9fbec9a2833839,9,0,423,324,327,378,179,188,251,302,319,290,307,411,359,336,104,17,87
348,410000,bb9fbec9a2833839,9,0,420,237,276,308,156,143,260,258,238,212,252,290,271,251,38,40,-2
1388,330000,bb9fbec9a2833839,9,0,1045,917,1072,1169,550,543,759,841,892,995,1035,1285,1160,1105,250,40,210
438,420000,bb9fbec9a2833839,9,0,429,270,308,378,261,177,285,262,281,264,324,372,348,320,48,60,-12
310,430000,bb9fbec9a2833839,9,0,359,193,226,309,145,129,251,238,285,222,261,332,296,272,71,39,32
255,350000,bb9fbec9a2833839,9,0,263,253,214,293,168,110,183,202,270,233,236,280,258,250,44,3,41
233,210000,bb9fbec9a2833839,9,0,242,174,177,213,86,85,121,151,164,140,139,209,174,163,70,-1,71
144,500000,bb9fbec9a2833839,9,0,128,96,89,130,65,59,92,68,101,131,82,96,89,103,14,-49,63
198,610000,bb9fbec9a2833839,9,0,215,165,164,174,112,81,131,150,180,137,151,189,170,159,38,14,24
90,230000,bb9fbec9a2833839,9,0,140,82,95,85,44,40,74,82,95,78,104,128,116,103,24,26,-2
671,310000,da457d15788fe8ee,9,0,504,402,593,748,538,251,456,315,445,485,411,558,484,485,147,-74,221
328,530000,da457d15788fe8ee,9,0,231,316,323,344,263,166,191,198,263,290,341,252,296,294,-89,51,-140
194,150000,da457d15788fe8ee,9,0,201,207,206,200,197,109,152,165,213,178,177,172,174,176,-5,-1,-4
920,110000,da457d15788fe8ee,9,0,731,715,939,1050,755,424,693,651,781,754,805,949,877,836,144,51,93
959,510000,da457d15788fe8ee,9,0,1072,583,560,641,624,348,443,468,502,547,611,673,642,610,62,64,-2
394,340000,da457d15788fe8ee,9,0,329,282,331,409,330,200,229,256,264,317,284,317,300,306,33,-33,66
768,370000,da457d15788fe8ee,9,0,678,438,630,646,659,309,458,540,534,523,541,632,586,565,91,18,73
160,140000,da457d15788fe8ee,9,0,143,139,142,103,120,44,90,120,136,128,136,187,162,150,51,8,43
1501,440000,da457d15788fe8ee,9,0,1342,1295,1408,1829,1269,499,1006,894,1099,1203,1068,1323,1196,1198,255,-135,390
193,450000,da457d15788fe8ee,9,0,189,162,142,255,213,82,152,117,156,149,174,198,186,174,24,25,-1
1354,320000,da457d15788fe8ee,9,0,1255,1040,1108,1430,1304,649,954,933,1003,955,1112,1268,1190,1112,156,157,-1
341,360000,da457d15788fe8ee,9,0,275,218,275,247,282,85,186,198,229,203,249,256,252,236,7,46,-39
548,130000,da457d15788fe8ee,9,0,471,407,417,527,425,254,337,412,434,405,458,546,502,470,88,53,35
412,410000,da457d15788fe8ee,9,0,469,405,382,502,442,251,354,426,325,372,375,398,386,382,23,3,20
1660,330000,da457d15788fe8ee,9,0,1241,932,1214,1500,938,567,836,888,1017,1178,1317,1460,1388,1318,143,139,4
503,420000,da457d15788fe8ee,9,0,529,447,473,526,572,259,428,363,377,445,438,468,453,450,30,-7,37
470,430000,da457d15788fe8ee,9,0,476,369,391,505,374,207,342,370,431,366,451,421,436,413,-30,85,-115
348,350000,da457d15788fe8ee,9,0,282,298,320,358,335,144,206,194,282,238,262,319,290,273,57,24,33
484,210000,da457d15788fe8ee,9,0,418,357,335,454,281,156,268,293,330,277,371,482,426,377,111,94,17
267,500000,da457d15788fe8ee,9,0,259,188,209,244,199,108,153,121,186,284,146,224,185,218,78,-138,216
331,610000,da457d15788fe8ee,9,0,352,366,242,346,325,174,210,225,299,236,330,298,314,288,-32,94,-126
136,230000,da457d15788fe8ee,9,0,219,123,190,198,139,94,144,137,133,149,128,210,169,162,82,-21,103
518,310000,6858d6dfe680bdf7,9,0,438,357,513,576,543,384,696,487,649,633,685,664,674,661,-21,52,-73
233,530000,6858d6dfe680bdf7,9,0,139,117,236,257,243,199,312,234,314,249,292,267,280,269,-25,43,-68
76,150000,6858d6dfe680bdf7,9,0,47,37,60,80,54,43,84,76,64,93,74,68,71,78,-6,-19,13
578,110000,6858d6dfe680bdf7,9,0,410,328,585,816,536,311,688,527,617,587,668,640,654,632,-28,81,-109
659,510000,6858d6dfe680bdf7,9,0,455,290,447,593,591,337,640,478,571,603,551,645,598,600,94,-52,146
400,340000,6858d6dfe680bdf7,9,0,236,233,275,385,322,230,435,350,391,362,386,364,375,371,-22,24,-46
540,370000,6858d6dfe680bdf7,9,0,297,285,401,440,468,289,622,538,593,498,535,586,560,540,51,37,14
91,140000,6858d6dfe680bdf7,9,0,31,30,61,103,57,64,78,79,91,70,76,114,95,87,38,6,32
1372,440000,6858d6dfe680bdf7,9,0,800,773,983,1319,1274,618,1449,1061,1394,1469,1265,1360,1312,1365,95,-204,299
190,450000,6858d6dfe680bdf7,9,0,93,94,126,167,115,84,164,123,176,156,157,172,164,162,15,1,14
1073,320000,6858d6dfe680bdf7,9,0,729,862,988,1160,1203,919,1681,1193,1428,1269,1375,1458,1416,1367,83,106,-23
203,360000,6858d6dfe680bdf7,9,0,144,96,129,200,185,89,224,198,224,201,206,230,218,212,24,5,19
409,130000,6858d6dfe680bdf7,9,0,194,192,281,283,417,232,460,496,484,423,463,437,450,441,-26,40,-66
393,410000,6858d6dfe680bdf7,9,0,209,174,237,350,258,224,388,425,429,397,410,418,414,408,8,13,-5
1579,330000,6858d6dfe680bdf7,9,0,1208,929,1465,1724,1540,1004,2273,1596,1876,1650,1852,1906,1879,1803,54,202,-148
331,420000,6858d6dfe680bdf7,9,0,199,144,218,283,271,143,325,266,300,353,314,383,348,350,69,-39,108
397,430000,6858d6dfe680bdf7,9,0,209,203,255,374,375,195,380,321,402,363,372,409,390,381,37,9,28
384,350000,6858d6dfe680bdf7,9,0,236,214,251,346,352,161,369,304,419,307,353,366,360,342,13,46,-33
212,210000,6858d6dfe680bdf7,9,0,133,91,159,186,215,146,225,256,285,240,260,305,282,268,45,20,25
213,500000,6858d6dfe680bdf7,9,0,132,105,200,253,198,131,290,195,274,315,277,268,272,287,-9,-38,29
199,610000,6858d6dfe680bdf7,9,0,159,132,134,174,188,135,235,193,286,212,215,219,217,215,4,3,1
69,230000,6858d6dfe680bdf7,9,0,23,28,58,76,70,44,104,104,97,90,78,104,91,91,26,-12,38
261,310000,79de4e4b24c35b04,9,0,426,299,501,825,333,136,253,217,192,208,169,209,189,195,40,-39,79
633,530000,79de4e4b24c35b04,9,0,913,926,928,1393,1050,634,598,559,552,559,568,496,532,541,-72,9,-81
194,150000,79de4e4b24c35b04,9,0,200,230,272,405,185,132,207,141,156,128,146,189,168,154,43,18,25
91,110000,79de4e4b24c35b04,9,0,370,330,446,852,178,127,199,127,128,132,116,105,110,118,-11,-16,5
479,510000,79de4e4b24c35b04,9,0,971,792,934,1509,1063,565,512,413,385,387,456,447,452,430,-9,69,-78
1032,340000,79de4e4b24c35b04,9,0,1421,1263,1461,2601,1965,1072,936,771,749,842,897,904,900,881,7,55,-48
2146,370000,79de4e4b24c35b04,9,0,2814,2975,3077,5360,2858,1598,1729,1694,1756,1539,1936,1912,1924,1796,-24,397,-421
542,140000,79de4e4b24c35b04,9,0,778,791,803,1442,701,396,447,437,462,390,470,484,477,448,14,80,-66
3372,440000,79de4e4b24c35b04,9,0,5098,5032,5800,8421,3465,1872,3263,2465,2754,2779,2551,2831,2691,2720,280,-228,508
1771,450000,79de4e4b24c35b04,9,0,3110,3025,3479,6171,2981,1510,1845,1206,1444,1326,1376,2120,1748,1607,744,50,694
1410,320000,79de4e4b24c35b04,9,0,2045,1978,2153,3757,2028,1542,1465,1325,1301,1251,1387,1382,1384,1340,-5,136,-141
463,360000,79de4e4b24c35b04,9,0,806,703,736,1319,827,443,434,359,341,393,389,426,408,403,37,-4,41
1276,130000,79de4e4b24c35b04,9,0,1631,1500,1789,2863,1366,1047,1021,1146,1168,1072,1294,1269,1282,1212,-25,222,-247
3080,410000,79de4e4b24c35b04,9,0,4617,4700,5194,9539,6024,2842,2528,2423,2523,2603,3162,2973,3068,2913,-189,559,-748
894,330000,79de4e4b24c35b04,9,0,1435,1528,1653,2646,934,580,745,680,733,621,813,822,818,752,9,192,-183
595,420000,79de4e4b24c35b04,9,0,891,696,982,1629,1137,521,524,406,468,397,454,447,450,433,-7,57,-64
889,430000,79de4e4b24c35b04,9,0,1544,1234,1513,2352,1658,771,808,663,615,657,743,779,761,726,36,86,-50
371,350000,79de4e4b24c35b04,9,0,706,724,738,1086,453,316,456,314,359,319,319,322,320,320,3,0,3
512,210000,79de4e4b24c35b04,9,0,644,644,694,1039,408,313,505,468,482,534,500,483,492,506,-17,-34,17
169,500000,79de4e4b24c35b04,9,0,359,279,304,514,324,210,169,172,136,158,183,160,172,167,-23,25,-48
634,610000,79de4e4b24c35b04,9,0,785,855,1045,1704,937,403,499,452,488,436,535,576,556,516,41,99,-58
559,230000,79de4e4b24c35b04,9,0,839,638,832,1045,394,365,562,482,469,565,521,543,532,543,22,-44,66
770,310000,12f8b7e14947c34d,9,0,2065,1032,1283,1483,389,338,505,521,647,608,619,726,672,651,107,11,96
248,530000,12f8b7e14947c34d,9,0,402,396,360,567,208,160,208,214,226,198,297,263,280,253,-34,99,-133
370,150000,12f8b7e14947c34d,9,0,712,648,698,789,413,215,340,311,387,355,326,370,348,350,44,-29,73
86,110000,12f8b7e14947c34d,9,0,451,276,389,488,143,102,126,84,102,87,71,101,86,86,30,-16,46
831,510000,12f8b7e14947c34d,9,0,1286,786,820,1117,531,374,577,521,559,581,527,664,596,591,137,-54,191
360,340000,12f8b7e14947c34d,9,0,726,594,615,705,385,198,241,246,257,285,305,420,362,337,115,20,95
1251,370000,12f8b7e14947c34d,9,0,1777,1435,1352,1707,803,424,738,843,928,824,912,1138,1025,958,226,88,138
260,140000,12f8b7e14947c34d,9,0,391,347,352,464,131,87,174,169,231,178,188,345,266,237,157,10,147
327,440000,12f8b7e14947c34d,9,0,326,342,407,475,130,117,221,195,239,246,184,249,216,226,65,-62,127
109,450000,12f8b7e14947c34d,9,0,181,167,158,231,93,43,77,54,89,79,95,76,86,83,-19,16,-35
1361,320000,12f8b7e14947c34d,9,0,2099,1880,1868,2181,991,782,1094,1007,1280,1090,1058,1318,1188,1155,260,-32,292
331,360000,12f8b7e14947c34d,9,0,532,430,438,495,251,128,183,180,217,188,232,281,256,234,49,44,5
765,130000,12f8b7e14947c34d,9,0,1153,782,978,1229,546,360,592,598,847,611,670,860,765,714,190,59,131
577,410000,12f8b7e14947c34d,9,0,954,750,835,1053,508,259,492,410,471,586,659,755,707,667,96,73,23
681,330000,12f8b7e14947c34d,9,0,920,884,1063,1213,348,291,556,450,632,576,610,714,662,633,104,34,70
238,420000,12f8b7e14947c34d,9,0,406,336,358,440,200,80,136,138,174,236,210,228,219,225,18,-26,44
464,430000,12f8b7e14947c34d,9,0,688,528,670,749,385,150,254,224,307,284,328,398,363,337,70,44,26
252,350000,12f8b7e14947c34d,9,0,314,302,385,408,188,136,178,176,297,240,200,252,226,231,52,-40,92
110,210000,12f8b7e14947c34d,9,0,246,156,195,210,53,54,81,84,109,71,94,144,119,103,50,23,27
118,500000,12f8b7e14947c34d,9,0,240,178,181,295,131,85,113,117,117,161,107,136,122,135,29,-54,83
674,610000,12f8b7e14947c34d,9,0,1109,958,1012,1286,412,280,531,610,649,548,736,763,750,682,27,188,-161
106,230000,12f8b7e14947c34d,9,0,256,202,210,228,66,80,160,104,150,105,113,153,133,124,40,8,32
429,310000,04e66e578f653ab9,9,0,422,337,524,679,950,175,263,226,214,231,1376,364,870,657,-1012,1145,-2157
193,530000,04e66e578f653ab9,9,0,142,173,215,293,131,118,135,108,106,85,183,133,158,134,-50,98,-148
67,150000,04e66e578f653ab9,9,0,87,94,102,118,60,38,63,48,62,45,54,52,53,50,-2,9,-11
201,110000,04e66e578f653ab9,9,0,241,166,231,280,180,87,167,105,117,108,135,120,128,121,-15,27,-42
401,510000,04e66e578f653ab9,9,0,419,226,291,404,151,140,210,163,126,156,158,240,199,185,82,2,80
190,340000,04e66e578f653ab9,9,0,172,127,176,201,116,64,85,74,80,96,91,141,116,109,50,-5,55
411,370000,04e66e578f653ab9,9,0,405,274,383,451,230,146,276,296,237,243,266,313,290,274,47,23,24
94,140000,04e66e578f653ab9,9,0,104,75,85,95,42,23,68,34,43,37,45,67,56,50,22,8,14
132,440000,04e66e578f653ab9,9,0,140,175,225,268,104,54,144,101,111,106,100,115,108,107,15,-6,21
44,450000,04e66e578f653ab9,9,0,42,39,42,71,30,28,32,17,42,31,35,34,34,33,-1,4,-5
537,320000,04e66e578f653ab9,9,0,566,501,644,669,334,279,388,278,361,289,335,427,381,350,92,46,46
97,360000,04e66e578f653ab9,9,0,97,83,104,86,64,32,40,53,58,44,58,62,60,55,4,14,-10
288,130000,04e66e578f653ab9,9,0,186,192,206,272,140,97,162,151,190,159,151,222,186,177,71,-8,79
275,410000,04e66e578f653ab9,9,0,156,169,219,319,144,90,156,142,133,159,150,253,202,187,103,-9,112
399,330000,04e66e578f653ab9,9,0,293,289,400,452,190,120,235,179,236,184,200,265,232,216,65,16,49
99,420000,04e66e578f653ab9,9,0,71,47,81,82,146,33,61,41,44,47,128,75,102,83,-53,81,-134
167,430000,04e66e578f653ab9,9,0,158,115,135,228,105,59,115,89,71,92,97,142,120,110,45,5,40
81,350000,04e66e578f653ab9,9,0,93,107,132,139,77,43,64,62,76,55,207,71,139,111,-136,152,-288
57,210000,04e66e578f653ab9,9,0,69,52,62,81,42,40,28,19,48,46,42,41,42,43,-1,-4,3
97,500000,04e66e578f653ab9,9,0,66,46,77,87,44,31,56,52,34,81,74,75,74,77,1,-7,8
182,610000,04e66e578f653ab9,9,0,208,170,201,238,124,83,169,151,120,99,145,151,148,132,6,46,-40
45,230000,04e66e578f653ab9,9,0,45,45,56,48,22,17,60,50,40,34,50,39,44,41,-11,16,-27
295,310000,dff803b4024d261d,9,0,130,129,206,317,238,124,175,178,198,247,172,229,200,216,57,-75,132
64,530000,dff803b4024d261d,9,0,150,68,61,94,64,55,50,58,59,74,82,64,73,73,-18,8,-26
127,150000,dff803b4024d261d,9,0,59,69,77,114,119,58,88,84,113,93,124,126,125,114,2,31,-29
639,110000,dff803b4024d261d,9,0,341,411,466,954,488,303,463,422,404,405,524,536,530,488,12,119,-107
541,510000,dff803b4024d261d,9,0,226,219,270,560,493,212,308,310,321,356,354,476,415,395,122,-2,124
275,340000,dff803b4024d261d,9,0,226,131,164,192,238,108,126,152,161,181,221,244,232,215,23,40,-17
895,370000,dff803b4024d261d,9,0,451,391,462,714,609,352,736,802,743,732,752,968,860,817,216,20,196
192,140000,dff803b4024d261d,9,0,81,104,152,230,168,75,152,133,162,155,176,214,195,182,38,21,17
2543,440000,dff803b4024d261d,9,0,783,887,1988,1893,1283,554,1157,1342,1371,1506,1365,1632,1498,1501,267,-141,408
299,450000,dff803b4024d261d,9,0,211,167,204,333,316,132,218,179,232,209,214,240,227,221,26,5,21
884,320000,dff803b4024d261d,9,0,409,489,602,865,785,520,701,575,790,696,727,808,768,744,81,31,50
334,360000,dff803b4024d261d,9,0,272,168,194,280,264,100,195,178,199,185,190,228,209,201,38,5,33
540,130000,dff803b4024d261d,9,0,279,275,250,454,387,248,489,372,444,470,561,546,554,526,-15,91,-106
373,410000,dff803b4024d261d,9,0,184,168,191,300,319,141,195,250,224,252,313,287,300,284,-26,61,-87
794,330000,dff803b4024d261d,9,0,355,572,795,787,577,391,567,562,623,668,663,739,701,690,76,-5,81
583,420000,dff803b4024d261d,9,0,287,394,374,566,545,193,390,310,389,475,504,667,586,549,163,29,134
522,430000,dff803b4024d261d,9,0,332,203,423,412,412,410,531,262,352,341,399,402,400,381,3,58,-55
643,350000,dff803b4024d261d,9,0,331,397,363,562,555,242,485,658,692,517,589,652,620,586,63,72,-9
342,210000,dff803b4024d261d,9,0,219,239,228,340,230,163,328,229,232,286,261,346,304,298,85,-25,110
359,500000,dff803b4024d261d,9,0,281,158,348,846,378,203,261,239,256,499,348,265,306,371,-83,-151,68
209,610000,dff803b4024d261d,9,0,63,62,99,126,138,68,103,103,121,139,167,222,194,176,55,28,27
705,230000,dff803b4024d261d,9,0,91,46,89,107,57,72,88,195,88,95,117,126,122,113,9,22,-13
253,310000,61e73e32ad101892,9,0,263,222,276,374,264,140,173,111,133,219,252,305,278,259,53,33,20
322,530000,61e73e32ad101892,9,0,322,420,444,423,403,246,278,240,349,251,370,328,349,316,-42,119,-161
594,150000,61e73e32ad101892,9,0,541,608,505,619,534,251,398,363,397,446,439,554,496,480,115,-7,122
716,110000,61e73e32ad101892,9,0,1019,845,1016,1441,741,459,672,521,645,648,738,710,724,699,-28,90,-118
964,510000,61e73e32ad101892,9,0,1080,712,743,1078,940,507,616,610,516,696,747,853,800,765,106,51,55
274,340000,61e73e32ad101892,9,0,210,217,212,273,247,107,152,149,170,178,202,240,221,207,38,24,14
970,370000,61e73e32ad101892,9,0,866,764,681,1011,688,350,548,657,631,628,667,792,730,696,125,39,86
337,140000,61e73e32ad101892,9,0,283,280,288,348,274,115,219,218,272,224,246,326,286,265,80,22,58
2281,440000,61e73e32ad101892,9,0,1686,2097,2144,2562,1849,777,1549,1067,1547,1898,1873,2104,1988,1958,231,-25,256
365,450000,61e73e32ad101892,9,0,333,376,342,443,364,194,278,172,226,248,272,340,306,287,68,24,44
728,320000,61e73e32ad101892,9,0,670,713,682,857,658,425,546,407,545,534,592,698,645,608,106,58,48
378,360000,61e73e32ad101892,9,0,304,324,277,382,334,121,180,176,242,230,289,241,265,253,-48,59,-107
1052,130000,61e73e32ad101892,9,0,829,875,790,1042,804,407,572,721,849,721,962,1094,1028,926,132,241,-109
768,410000,61e73e32ad101892,9,0,525,514,567,656,654,303,427,422,450,484,638,714,676,612,76,154,-78
738,330000,61e73e32ad101892,9,0,658,707,687,970,632,338,464,407,503,544,617,739,678,633,122,73,49
1452,420000,61e73e32ad101892,9,0,1194,1234,1296,1458,1429,526,890,740,929,1121,1218,1196,1207,1178,-22,97,-119
687,430000,61e73e32ad101892,9,0,586,532,579,879,712,262,444,376,475,496,530,587,558,538,57,34,23
385,350000,61e73e32ad101892,9,0,331,423,388,523,387,223,336,237,399,355,340,322,331,339,-18,-15,-3
852,210000,61e73e32ad101892,9,0,919,871,786,1105,571,424,658,595,611,583,678,909,794,723,231,95,136
473,500000,61e73e32ad101892,9,0,452,406,568,732,616,327,364,351,290,544,368,383,376,432,15,-176,191
617,610000,61e73e32ad101892,9,0,480,618,464,618,561,288,381,522,505,419,505,615,560,513,110,86,24
410,230000,61e73e32ad101892,9,0,364,346,348,497,267,165,333,307,314,331,413,428,420,391,15,82,-67
89,310000,a432c483b5beb856,9,0,135,111,242,237,68,37,61,48,42,46,60,56,58,54,-4,14,-18
117,530000,a432c483b5beb856,9,0,170,165,182,271,140,100,100,97,72,92,101,116,108,103,15,9,6
134,150000,a432c483b5beb856,9,0,135,144,149,195,78,54,74,78,87,84,89,105,97,93,16,5,11
42,110000,a432c483b5beb856,9,0,163,97,128,205,34,44,59,36,32,45,41,40,40,42,-1,-4,3
297,510000,a432c483b5beb856,9,0,355,284,276,560,275,186,178,154,123,197,155,287,221,213,132,-42,174
141,340000,a432c483b5beb856,9,0,258,234,289,496,209,109,109,97,103,125,123,120,122,123,-3,-2,-1
255,370000,a432c483b5beb856,9,0,455,430,397,599,241,156,188,181,193,211,187,260,224,219,73,-24,97
105,140000,a432c483b5beb856,9,0,165,187,192,226,67,52,65,70,76,81,82,108,95,90,26,1,25
692,440000,a432c483b5beb856,9,0,966,1096,1273,1753,510,290,467,429,504,568,492,615,554,558,123,-76,199
142,450000,a432c483b5beb856,9,0,163,183,209,314,161,76,113,66,89,103,111,120,116,111,9,8,1
460,320000,a432c483b5beb856,9,0,663,720,808,1176,484,399,360,358,395,364,346,423,384,378,77,-18,95
210,360000,a432c483b5beb856,9,0,243,282,281,556,258,99,139,120,123,138,130,192,161,153,62,-8,70
243,130000,a432c483b5beb856,9,0,311,284,290,435,164,126,133,165,184,178,191,217,204,195,26,13,13
372,410000,a432c483b5beb856,9,0,316,283,364,562,252,130,136,161,188,248,234,365,300,282,131,-14,145
507,330000,a432c483b5beb856,9,0,660,738,799,1102,332,255,331,293,293,451,433,549,491,478,116,-18,134
188,420000,a432c483b5beb856,9,0,271,257,362,526,267,110,92,100,79,129,117,148,132,131,31,-12,43
236,430000,a432c483b5beb856,9,0,292,260,313,627,286,115,133,96,119,133,162,229,196,175,67,29,38
168,350000,a432c483b5beb856,9,0,282,315,340,500,185,128,160,130,141,134,138,134,136,135,-4,4,-8
160,210000,a432c483b5beb856,9,0,311,260,209,299,101,86,133,111,127,127,138,164,151,143,26,11,15
112,500000,a432c483b5beb856,9,0,165,151,159,317,179,87,70,59,80,101,84,95,90,93,11,-17,28
87,610000,a432c483b5beb856,9,0,114,163,141,242,89,58,62,55,62,48,76,86,81,70,10,28,-18
69,230000,a432c483b5beb856,9,0,139,103,121,126,60,44,65,66,61,78,87,93,90,86,6,9,-3
475,310000,0797526c057dcf5b,9,0,427,336,1289,571,175,135,300,320,311,280,332,341,336,318,9,52,-43
296,530000,0797526c057dcf5b,9,0,226,257,285,393,160,154,201,154,174,208,237,210,224,218,-27,29,-56
368,150000,0797526c057dcf5b,9,0,291,326,339,631,236,164,278,287,352,354,352,396,374,367,44,-2,46
374,110000,0797526c057dcf5b,9,0,797,664,656,980,232,253,315,319,299,344,411,421,416,392,10,67,-57
1263,510000,0797526c057dcf5b,9,0,1230,923,1016,1536,609,478,708,677,703,870,874,1179,1026,974,305,4,301
743,340000,0797526c057dcf5b,9,0,565,666,550,750,358,257,522,447,450,474,531,638,584,548,107,57,50
3225,370000,0797526c057dcf5b,9,0,2915,3148,3502,5481,1788,1203,1635,2012,1985,2046,2150,2770,2460,2322,620,104,516
1141,140000,0797526c057dcf5b,9,0,792,899,919,1474,502,371,567,626,775,870,822,1077,950,923,255,-48,303
11327,440000,0797526c057dcf5b,9,0,11167,12710,12394,15317,5306,3718,8079,6812,7957,8612,8119,10514,9316,9082,2395,-493,2888
2448,450000,0797526c057dcf5b,9,0,1639,1709,1789,2693,1195,777,1366,1087,1463,1613,1736,2291,2014,1880,555,123,432
2698,320000,0797526c057dcf5b,9,0,2274,2226,2622,3296,1247,1529,2148,2087,2259,2343,2472,2603,2538,2473,131,129,2
1563,360000,0797526c057dcf5b,9,0,1083,1277,1265,1764,857,484,797,835,979,1050,1189,1342,1266,1194,153,139,14
2337,130000,0797526c057dcf5b,9,0,1988,2221,2449,3796,1214,995,1259,1697,1832,1815,2279,2449,2364,2181,170,464,-294
2311,410000,0797526c057dcf5b,9,0,1783,1739,1951,3130,1278,848,1290,1492,1391,1525,1910,2272,2091,1902,362,385,-23
1932,330000,0797526c057dcf5b,9,0,1709,2001,2019,2088,700,801,1246,1369,1509,1644,1767,1896,1832,1769,129,123,6
1206,420000,0797526c057dcf5b,9,0,1071,1120,1425,1562,736,376,772,827,842,1061,1101,1051,1076,1071,-50,40,-90
2160,430000,0797526c057dcf5b,9,0,1721,1444,1769,3168,1244,677,1105,1093,1503,1476,1786,1858,1822,1707,72,310,-238
1544,350000,0797526c057dcf5b,9,0,1477,1846,1591,1981,769,598,1058,945,1316,1163,1316,1476,1396,1318,160,153,7
2147,210000,0797526c057dcf5b,9,0,3035,2443,2622,3705,1059,1132,1642,1541,1606,1822,1931,2151,2041,1968,220,109,111
467,500000,0797526c057dcf5b,9,0,624,494,548,828,333,235,331,330,400,708,364,385,374,486,21,-344,365
425,610000,0797526c057dcf5b,9,0,462,457,402,722,289,175,287,284,326,299,382,387,384,356,5,83,-78
927,230000,0797526c057dcf5b,9,0,651,605,913,1064,350,347,604,509,589,621,701,1075,888,799,374,80,294
288,310000,936168bd4850913d,9,0,330,234,241,272,250,161,224,213,175,131,62,223,142,139,161,-69,230
480,530000,936168bd4850913d,9,0,288,285,282,383,494,162,297,298,329,209,81,389,235,226,308,-128,436
393,150000,936168bd4850913d,9,0,397,353,331,374,412,213,364,399,353,232,84,339,212,218,255,-148,403
411,110000,936168bd4850913d,9,0,651,432,527,798,336,255,324,347,230,135,126,317,222,193,191,-9,200
522,510000,936168bd4850913d,9,0,560,353,364,502,560,198,280,354,296,108,64,382,223,185,318,-44,362
488,340000,936168bd4850913d,9,0,464,369,339,449,378,228,339,365,359,86,125,393,259,201,268,39,229
1192,370000,936168bd4850913d,9,0,1347,1014,1020,1083,1132,648,948,1214,1085,369,273,1000,636,547,727,-96,823
551,140000,936168bd4850913d,9,0,462,394,347,454,373,276,370,403,345,137,148,396,272,227,248,11,237
2956,440000,936168bd4850913d,9,0,3040,2810,2842,3119,2859,1337,2735,2621,2524,1566,594,2431,1512,1530,1837,-972,2809
336,450000,936168bd4850913d,9,0,346,287,279,316,376,154,306,255,297,140,103,277,190,173,174,-37,211
926,320000,936168bd4850913d,9,0,1153,908,905,1057,1012,579,905,787,820,405,226,838,532,490,612,-179,791
402,360000,936168bd4850913d,9,0,407,325,334,414,397,195,355,439,342,151,95,317,206,188,222,-56,278
911,130000,936168bd4850913d,9,0,837,696,646,778,797,602,842,1066,971,374,253,922,588,516,669,-121,790
1295,410000,936168bd4850913d,9,0,1165,786,979,1154,954,596,986,1159,919,330,428,1111,770,623,683,98,585
847,330000,936168bd4850913d,9,0,767,611,709,819,752,388,650,682,669,277,191,789,490,419,598,-86,684
1385,420000,936168bd4850913d,9,0,1463,1111,1292,1497,1405,549,1164,1131,1057,674,316,1053,684,681,737,-358,1095
712,430000,936168bd4850913d,9,0,776,563,649,953,623,341,556,689,570,218,194,551,372,321,357,-24,381
591,350000,936168bd4850913d,9,0,641,586,610,611,627,347,556,479,612,226,137,543,340,302,406,-89,495
853,210000,936168bd4850913d,9,0,816,696,727,851,758,485,709,730,631,387,271,733,502,464,462,-116,578
285,500000,936168bd4850913d,9,0,222,152,145,208,248,87,111,125,128,35,39,154,96,76,115,4,111
434,610000,936168bd4850913d,9,0,429,415,400,482,463,229,331,386,360,198,125,357,241,227,232,-73,305
630,230000,936168bd4850913d,9,0,621,450,630,549,617,346,607,485,461,268,130,519,324,306,389,-138,527
227,310000,cc21c7e91a3b5a0c,9,0,287,238,345,456,114,153,205,172,211,259,235,234,234,243,-1,-24,23
420,530000,cc21c7e91a3b5a0c,9,0,327,285,338,442,406,203,364,347,383,359,548,448,498,452,-100,189,-289
305,150000,cc21c7e91a3b5a0c,9,0,246,282,331,382,195,193,311,298,379,324,426,353,390,368,-73,102,-175
150,110000,cc21c7e91a3b5a0c,9,0,303,262,356,580,121,115,186,128,156,127,143,113,128,128,-30,16,-46
494,510000,cc21c7e91a3b5a0c,9,0,636,487,569,804,459,234,390,378,467,472,512,561,536,515,49,40,9
523,340000,cc21c7e91a3b5a0c,9,0,439,428,489,503,403,244,376,434,485,530,589,548,568,556,-41,59,-100
895,370000,cc21c7e91a3b5a0c,9,0,815,855,912,1164,554,505,703,953,906,900,978,952,965,943,-26,78,-104
333,140000,cc21c7e91a3b5a0c,9,0,310,284,316,428,223,193,301,299,310,314,437,371,404,374,-66,123,-189
2906,440000,cc21c7e91a3b5a0c,9,0,2478,2450,3345,3730,1930,1262,2615,2284,2880,3003,3073,3157,3115,3078,84,70,14
386,450000,cc21c7e91a3b5a0c,9,0,290,313,377,417,266,187,309,304,370,332,440,396,418,389,-44,108,-152
1127,320000,cc21c7e91a3b5a0c,9,0,1193,1114,1454,1527,877,754,1069,1130,1243,1239,1359,1276,1318,1291,-83,120,-203
346,360000,cc21c7e91a3b5a0c,9,0,340,317,350,507,305,161,323,377,500,498,505,477,491,493,-28,7,-35
738,130000,cc21c7e91a3b5a0c,9,0,590,551,574,797,453,434,572,723,877,842,1076,876,976,931,-200,234,-434
822,410000,cc21c7e91a3b5a0c,9,0,687,548,872,1036,630,391,702,797,764,826,1251,974,1112,1017,-277,425,-702
1013,330000,cc21c7e91a3b5a0c,9,0,800,942,1151,1258,739,529,861,969,1092,1188,1336,1191,1264,1238,-145,148,-293
844,420000,cc21c7e91a3b5a0c,9,0,1065,918,1189,1511,963,454,719,775,822,1002,1247,1129,1188,1126,-118,245,-363
466,430000,cc21c7e91a3b5a0c,9,0,456,452,506,737,420,189,443,430,470,484,597,615,606,565,18,113,-95
521,350000,cc21c7e91a3b5a0c,9,0,556,643,734,779,473,353,640,561,659,677,791,724,758,731,-67,114,-181
508,210000,cc21c7e91a3b5a0c,9,0,437,390,480,602,285,241,431,475,512,466,627,589,608,561,-38,161,-199
180,500000,cc21c7e91a3b5a0c,9,0,203,186,200,305,185,95,179,155,153,233,211,194,202,213,-17,-22,5
274,610000,cc21c7e91a3b5a0c,9,0,293,309,345,496,293,157,234,292,346,246,352,406,379,335,54,106,-52
359,230000,cc21c7e91a3b5a0c,9,0,347,306,404,422,214,206,322,309,385,388,444,380,412,404,-64,56,-120
183,310000,7aab7fca2470987e,9,0,248,166,277,348,224,140,212,313,130,176,126,150,138,151,24,-50,74
13,530000,7aab7fca2470987e,9,0,22,12,22,33,19,19,18,22,20,12,9,9,9,10,0,-3,3
19,150000,7aab7fca2470987e,9,0,20,16,19,22,21,19,29,36,17,19,26,22,24,22,-4,7,-11
314,110000,7aab7fca2470987e,9,0,433,353,372,511,424,244,378,320,244,260,250,268,259,259,18,-10,28
22,510000,7aab7fca2470987e,9,0,53,34,42,64,69,42,47,33,29,34,13,37,25,28,24,-21,45
37,340000,7aab7fca2470987e,9,0,65,52,74,75,83,59,59,57,45,62,31,45,38,46,14,-31,45
242,370000,7aab7fca2470987e,9,0,349,309,286,341,430,189,295,303,192,237,256,222,239,238,-34,19,-53
109,140000,7aab7fca2470987e,9,0,76,58,62,78,105,64,83,78,62,75,85,83,84,81,-2,10,-12
906,440000,7aab7fca2470987e,9,0,959,887,972,1235,1009,443,848,749,579,865,757,844,800,822,87,-108,195
17,450000,7aab7fca2470987e,9,0,23,23,13,26,34,17,20,12,20,22,16,21,18,20,5,-6,11
353,320000,7aab7fca2470987e,9,0,352,323,380,481,397,258,351,301,241,305,301,319,310,308,18,-4,22
29,360000,7aab7fca2470987e,9,0,44,29,35,37,61,16,26,40,25,30,32,20,26,27,-12,2,-14
258,130000,7aab7fca2470987e,9,0,229,234,231,316,308,172,236,271,218,215,233,230,232,226,-3,18,-21
153,410000,7aab7fca2470987e,9,0,192,150,188,209,242,134,155,146,105,140,155,161,158,152,6,15,-9
365,330000,7aab7fca2470987e,9,0,252,293,323,375,353,222,270,371,311,449,354,283,318,362,-71,-95,24
48,420000,7aab7fca2470987e,9,0,58,26,64,62,54,47,52,51,39,64,44,59,52,56,15,-20,35
28,430000,7aab7fca2470987e,9,0,47,25,31,44,54,26,27,28,26,30,22,38,30,30,16,-8,24
54,350000,7aab7fca2470987e,9,0,42,57,83,105,92,41,56,43,37,75,57,57,57,63,0,-18,18
128,210000,7aab7fca2470987e,9,0,181,127,153,187,158,103,124,129,115,148,126,163,144,146,37,-22,59
16,500000,7aab7fca2470987e,9,0,19,17,12,27,22,12,27,12,19,15,18,21,20,18,3,3,0
22,610000,7aab7fca2470987e,9,0,19,25,29,46,61,16,38,37,27,23,27,20,24,23,-7,4,-11
58,230000,7aab7fca2470987e,9,0,77,62,61,65,66,41,61,62,37,56,42,70,56,56,28,-14,42
284,310000,fde95ea242abd896,9,0,237,260,331,369,161,142,190,140,165,214,189,313,251,239,124,-25,149
387,530000,fde95ea242abd896,9,0,388,519,521,651,386,202,309,233,292,232,382,379,380,331,-3,150,-153
208,150000,fde95ea242abd896,9,0,181,185,190,234,146,90,139,127,131,111,141,187,164,146,46,30,16
167,110000,fde95ea242abd896,9,0,313,223,301,382,210,141,181,149,153,130,100,130,115,120,30,-30,60
773,510000,fde95ea242abd896,9,0,645,492,617,839,509,240,360,342,344,334,430,617,524,460,187,96,91
368,340000,fde95ea242abd896,9,0,508,453,504,690,387,163,254,266,293,273,348,415,382,345,67,75,-8
877,370000,fde95ea242abd896,9,0,825,774,709,964,444,303,464,570,555,507,649,847,748,668,198,142,56
373,140000,fde95ea242abd896,9,0,278,277,302,443,175,132,238,204,221,191,257,331,294,260,74,66,8
3858,440000,fde95ea242abd896,9,0,3967,4449,4901,5547,3229,1517,2906,3040,2996,3064,2940,3296,3118,3100,356,-124,480
423,450000,fde95ea242abd896,9,0,362,434,458,665,381,181,321,247,278,230,271,353,312,285,82,41,41
861,320000,fde95ea242abd896,9,0,875,888,974,1139,690,508,722,614,698,656,855,923,889,811,68,199,-131
387,360000,fde95ea242abd896,9,0,440,408,499,625,381,184,276,300,321,252,286,354,320,297,68,34,34
756,130000,fde95ea242abd896,9,0,591,602,602,830,407,320,433,514,507,400,601,794,698,598,193,201,-8
641,410000,fde95ea242abd896,9,0,666,620,614,920,507,247,499,530,473,405,626,853,740,628,227,221,6
1091,330000,fde95ea242abd896,9,0,1148,998,1169,1424,732,558,806,842,817,859,969,1255,1112,1028,286,110,176
908,420000,fde95ea242abd896,9,0,987,818,1066,1347,698,270,511,498,504,540,672,774,723,662,102,132,-30
628,430000,fde95ea242abd896,9,0,752,630,700,988,570,203,418,421,498,401,577,729,653,569,152,176,-24
815,350000,fde95ea242abd896,9,0,676,754,796,1043,605,368,580,595,656,635,615,765,690,672,150,-20,170
567,210000,fde95ea242abd896,9,0,553,433,460,600,253,193,341,357,363,293,369,581,475,414,212,76,136
253,500000,fde95ea242abd896,9,0,243,227,222,229,139,105,116,140,127,159,132,163,148,151,31,-27,58
297,610000,fde95ea242abd896,9,0,191,253,229,293,140,96,140,126,155,135,199,252,226,195,53,64,-11
264,230000,fde95ea242abd896,9,0,256,198,199,322,111,123,264,218,232,182,233,390,312,268,157,51,106
374,310000,97f15de12cfabbd5,9,0,455,354,457,516,264,193,369,368,312,223,311,325,318,286,14,88,-74
116,530000,97f15de12cfabbd5,9,0,168,236,233,253,206,111,144,116,120,119,120,92,106,110,-28,1,-29
180,150000,97f15de12cfabbd5,9,0,180,212,200,238,219,114,172,145,184,185,176,175,176,179,-1,-9,8
493,110000,97f15de12cfabbd5,9,0,733,603,754,1094,601,390,482,397,375,385,359,390,374,378,31,-26,57
472,510000,97f15de12cfabbd5,9,0,498,363,489,543,391,237,325,296,251,270,231,353,292,285,122,-39,161
316,340000,97f15de12cfabbd5,9,0,472,444,568,578,495,153,185,233,254,279,190,233,212,234,43,-89,132
888,370000,97f15de12cfabbd5,9,0,1001,1018,1094,1221,1031,476,846,727,791,753,709,746,728,736,37,-44,81
458,140000,97f15de12cfabbd5,9,0,381,370,395,605,316,221,369,335,297,249,379,331,355,320,-48,130,-178
2790,440000,97f15de12cfabbd5,9,0,2762,3019,3563,3747,2666,1125,2377,2460,2143,2250,2148,2251,2200,2216,103,-102,205
136,450000,97f15de12cfabbd5,9,0,134,146,194,174,193,92,119,101,114,104,103,130,116,112,27,-1,28
980,320000,97f15de12cfabbd5,9,0,1155,1292,1491,1524,1070,552,1008,901,895,803,803,813,808,806,10,0,10
207,360000,97f15de12cfabbd5,9,0,280,258,340,409,346,81,166,179,201,165,187,208,198,187,21,22,-1
941,130000,97f15de12cfabbd5,9,0,812,975,971,1119,789,422,734,762,790,652,806,800,803,753,-6,154,-160
510,410000,97f15de12cfabbd5,9,0,592,609,805,866,692,326,488,531,450,448,469,417,443,445,-52,21,-73
1522,330000,97f15de12cfabbd5,9,0,1259,1371,1516,1515,1138,549,969,1010,1108,1385,1507,1239,1373,1377,-268,122,-390
521,420000,97f15de12cfabbd5,9,0,707,729,779,906,749,253,446,434,381,436,412,489,450,446,77,-24,101
459,430000,97f15de12cfabbd5,9,0,626,645,767,839,710,238,437,402,430,431,398,373,386,401,-25,-33,8
360,350000,97f15de12cfabbd5,9,0,434,571,612,638,509,288,542,508,519,527,327,322,324,392,-5,-200,195
950,210000,97f15de12cfabbd5,9,0,1256,1020,1269,1395,898,506,962,872,971,851,914,875,894,880,-39,63,-102
141,500000,97f15de12cfabbd5,9,0,183,170,200,213,159,106,164,130,104,160,133,125,129,139,-8,-27,19
195,610000,97f15de12cfabbd5,9,0,251,273,309,371,227,159,225,195,179,129,173,160,166,154,-13,44,-57
375,230000,97f15de12cfabbd5,9,0,536,422,639,783,366,217,537,358,448,306,533,522,528,454,-11,227,-238
288,310000,f5d69960089c3614,9,0,263,186,304,291,260,125,252,169,218,208,195,239,217,214,44,-13,57
53,530000,f5d69960089c3614,9,0,45,62,97,95,78,48,59,48,61,43,79,64,72,62,-15,36,-51
72,150000,f5d69960089c3614,9,0,53,57,54,64,35,18,51,53,69,55,61,64,62,60,3,6,-3
578,110000,f5d69960089c3614,9,0,542,458,551,739,435,233,445,341,391,396,426,482,454,435,56,30,26
444,510000,f5d69960089c3614,9,0,406,218,246,296,270,133,178,212,190,231,208,233,220,224,25,-23,48
150,340000,f5d69960089c3614,9,0,108,119,125,125,156,59,89,69,81,70,72,75,74,72,3,2,1
344,370000,f5d69960089c3614,9,0,259,209,228,356,218,112,223,197,226,179,193,249,221,207,56,14,42
57,140000,f5d69960089c3614,9,0,29,27,53,51,47,21,35,29,43,35,45,44,44,41,-1,10,-11
444,440000,f5d69960089c3614,9,0,319,341,442,572,437,152,310,246,338,497,305,362,334,388,57,-192,249
68,450000,f5d69960089c3614,9,0,48,35,38,46,44,34,25,32,38,35,50,44,47,43,-6,15,-21
290,320000,f5d69960089c3614,9,0,235,218,248,301,251,138,200,177,214,189,187,223,205,200,36,-2,38
97,360000,f5d69960089c3614,9,0,74,57,75,92,84,32,51,53,76,51,70,67,68,63,-3,19,-22
213,130000,f5d69960089c3614,9,0,81,95,123,131,106,79,112,113,144,111,129,162,146,134,33,18,15
164,410000,f5d69960089c3614,9,0,136,137,144,187,131,57,111,155,108,118,135,163,149,139,28,17,11
142,330000,f5d69960089c3614,9,0,127,129,149,230,149,78,139,107,108,142,110,130,120,127,20,-32,52
162,420000,f5d69960089c3614,9,0,128,132,148,184,148,61,111,94,101,110,110,157,134,126,47,0,47
209,430000,f5d69960089c3614,9,0,125,121,157,211,135,74,132,109,108,118,96,135,116,116,39,-22,61
112,350000,f5d69960089c3614,9,0,63,93,111,124,108,57,77,71,97,95,75,85,80,85,10,-20,30
173,210000,f5d69960089c3614,9,0,93,93,126,129,69,51,75,76,107,67,96,152,124,105,56,29,27
157,500000,f5d69960089c3614,9,0,113,105,132,160,125,77,112,97,87,149,112,142,127,134,30,-37,67
202,610000,f5d69960089c3614,9,0,118,176,150,182,148,77,137,111,172,117,112,144,128,124,32,-5,37
75,230000,f5d69960089c3614,9,0,64,44,71,77,53,34,68,53,50,51,50,100,75,67,50,-1,51
93,310000,5b1c11c3efed5312,9,0,195,186,244,388,154,85,126,92,105,104,90,95,92,96,5,-14,19
68,530000,5b1c11c3efed5312,9,0,199,190,214,267,194,91,60,53,77,69,54,60,57,61,6,-15,21
64,150000,5b1c11c3efed5312,9,0,117,180,167,259,127,62,61,62,68,40,53,87,70,60,34,13,21
13,110000,5b1c11c3efed5312,9,0,195,143,181,370,71,41,51,25,21,23,21,16,18,20,-5,-2,-3
138,510000,5b1c11c3efed5312,9,0,451,335,432,691,448,194,129,110,118,105,113,152,132,123,39,8,31
284,340000,5b1c11c3efed5312,9,0,665,719,699,1253,712,250,227,217,259,222,209,229,219,220,20,-13,33
412,370000,5b1c11c3efed5312,9,0,799,850,792,1449,549,320,297,347,332,246,290,297,294,278,7,44,-37
80,140000,5b1c11c3efed5312,9,0,176,226,231,426,153,81,103,83,114,108,86,92,89,95,6,-22,28
470,440000,5b1c11c3efed5312,9,0,810,953,1204,1628,496,168,342,246,344,349,247,271,259,289,24,-102,126
41,450000,5b1c11c3efed5312,9,0,96,119,135,240,121,56,54,26,39,23,31,45,38,33,14,8,6
446,320000,5b1c11c3efed5312,9,0,928,1050,1083,1908,768,543,404,402,487,371,340,347,344,353,7,-31,38
222,360000,5b1c11c3efed5312,9,0,368,358,434,733,453,153,150,168,191,126,131,163,147,140,32,5,27
274,130000,5b1c11c3efed5312,9,0,576,665,667,1158,476,272,257,300,350,276,304,321,312,300,17,28,-11
401,410000,5b1c11c3efed5312,9,0,823,894,1006,1883,910,372,312,380,366,295,321,290,306,302,-31,26,-57
487,330000,5b1c11c3efed5312,9,0,968,1022,1202,2202,744,430,386,337,361,407,360,410,385,392,50,-47,97
165,420000,5b1c11c3efed5312,9,0,278,353,409,749,443,143,138,130,145,146,117,118,118,127,1,-29,30
189,430000,5b1c11c3efed5312,9,0,352,322,439,744,378,131,137,149,138,134,113,150,132,132,37,-21,58
140,350000,5b1c11c3efed5312,9,0,242,345,391,594,265,149,173,130,137,127,100,127,114,118,27,-27,54
55,210000,5b1c11c3efed5312,9,0,151,176,186,256,75,62,80,75,84,47,39,66,52,51,27,-8,35
36,500000,5b1c11c3efed5312,9,0,101,86,92,172,124,38,29,23,20,27,17,21,19,22,4,-10,14
80,610000,5b1c11c3efed5312,9,0,155,205,212,325,144,79,70,64,97,57,67,82,74,69,15,10,5
43,230000,5b1c11c3efed5312,9,0,116,107,126,152,43,36,52,38,43,41,34,44,39,40,10,-7,17
136,310000,17363f08d683d52b,9,0,94,69,88,96,65,19,37,175,5,12,7,8,8,9,1,-5,6
46,530000,17363f08d683d52b,9,0,192,214,209,182,216,75,82,86,83,57,67,66,66,63,-1,10,-11
34,150000,17363f08d683d52b,9,0,174,176,130,141,132,46,66,45,69,41,38,46,42,42,8,-3,11
60,110000,17363f08d683d52b,9,0,259,158,186,277,124,81,65,48,29,26,33,15,24,25,-18,7,-25
63,510000,17363f08d683d52b,9,0,374,267,205,292,350,117,93,78,81,64,97,44,70,68,-53,33,-86
88,340000,17363f08d683d52b,9,0,407,332,341,384,513,121,108,92,90,118,107,99,103,108,-8,-11,3
346,370000,17363f08d683d52b,9,0,669,572,480,596,555,214,153,209,203,175,145,127,136,149,-18,-30,12
3,140000,17363f08d683d52b,9,0,82,89,70,67,66,26,12,22,19,12,23,3,13,13,-20,11,-31
17,440000,17363f08d683d52b,9,0,99,91,101,84,62,19,63,37,30,29,26,25,26,27,-1,-3,2
11,450000,17363f08d683d52b,9,0,57,42,39,50,45,14,26,20,6,2,8,5,6,5,-3,6,-9
151,320000,17363f08d683d52b,9,0,534,502,474,569,538,214,216,188,191,134,129,86,108,116,-43,-5,-38
58,360000,17363f08d683d52b,9,0,423,281,274,309,360,94,101,91,90,79,82,62,72,74,-20,3,-23
180,130000,17363f08d683d52b,9,0,378,372,326,383,353,154,150,162,149,131,144,91,118,122,-53,13,-66
93,410000,17363f08d683d52b,9,0,505,471,372,457,538,139,100,129,104,87,70,63,66,73,-7,-17,10
167,330000,17363f08d683d52b,9,0,525,437,429,453,388,129,152,151,108,106,91,89,90,95,-2,-15,13
89,420000,17363f08d683d52b,9,0,470,379,317,421,474,120,139,119,158,186,109,65,87,120,-44,-77,33
163,430000,17363f08d683d52b,9,0,455,353,348,428,459,95,148,114,114,115,100,92,96,102,-8,-15,7
29,350000,17363f08d683d52b,9,0,150,148,127,159,136,38,44,37,55,51,15,28,22,31,13,-36,49
51,210000,17363f08d683d52b,9,0,239,216,174,238,151,59,93,137,105,53,60,48,54,54,-12,7,-19
14,500000,17363f08d683d52b,9,0,119,108,151,126,110,41,27,16,19,16,22,15,18,18,-7,6,-13
60,610000,17363f08d683d52b,9,0,219,279,210,288,180,80,67,82,94,70,81,86,84,79,5,11,-6
17,230000,17363f08d683d52b,9,0,126,121,118,156,75,46,57,45,34,22,28,31,30,27,3,6,-3
379,310000,06880909932890ca,9,0,330,188,341,384,208,78,136,169,219,267,195,272,234,245,77,-72,149
142,530000,06880909932890ca,9,0,177,216,186,206,142,56,68,79,116,111,106,126,116,114,20,-5,25
69,150000,06880909932890ca,9,0,103,121,125,115,74,44,45,52,72,39,48,70,59,52,22,9,13
170,110000,06880909932890ca,9,0,646,461,553,771,253,139,206,162,160,198,159,181,170,179,22,-39,61
768,510000,06880909932890ca,9,0,770,548,657,933,673,263,243,304,396,459,464,505,484,476,41,5,36
780,340000,06880909932890ca,9,0,849,800,764,993,964,338,340,389,526,609,640,679,660,643,39,31,8
912,370000,06880909932890ca,9,0,1068,979,957,1332,1011,383,430,537,623,546,597,690,644,611,93,51,42
151,140000,06880909932890ca,9,0,200,213,203,275,128,67,102,111,136,137,121,130,126,129,9,-16,25
1150,440000,06880909932890ca,9,0,1341,1182,1660,1546,767,278,638,579,734,773,669,732,700,725,63,-104,167
150,450000,06880909932890ca,9,0,192,181,188,276,186,86,105,86,125,135,129,121,125,128,-8,-6,-2
1956,320000,06880909932890ca,9,0,2054,2015,2022,2642,2094,991,984,1074,1356,1448,1465,1619,1542,1511,154,17,137
614,360000,06880909932890ca,9,0,481,368,453,691,614,157,211,274,326,317,295,445,370,352,150,-22,172
507,130000,06880909932890ca,9,0,728,665,667,773,530,290,330,342,436,385,393,514,454,431,121,8,113
1439,410000,06880909932890ca,9,0,1676,1390,1577,2409,1865,640,650,891,1055,1267,1138,1176,1157,1194,38,-129,167
1624,330000,06880909932890ca,9,0,1572,1696,1832,2222,1022,501,663,715,913,1088,1232,1489,1360,1270,257,144,113
526,420000,06880909932890ca,9,0,525,475,492,661,605,178,211,256,312,333,394,414,404,380,20,61,-41
540,430000,06880909932890ca,9,0,561,481,547,698,488,170,228,287,352,372,388,447,418,402,59,16,43
408,350000,06880909932890ca,9,0,427,469,556,601,361,197,246,246,307,332,263,303,283,299,40,-69,109
182,210000,06880909932890ca,9,0,335,246,211,328,161,100,120,120,168,137,149,154,152,147,5,12,-7
352,500000,06880909932890ca,9,0,445,330,373,430,326,140,158,145,189,295,272,251,262,273,-21,-23,2
259,610000,06880909932890ca,9,0,350,449,347,562,349,119,145,167,210,170,185,229,207,195,44,15,29
77,230000,06880909932890ca,9,0,133,82,97,100,69,37,53,48,62,47,72,53,62,57,-19,25,-44
11,310000,9c1c7ee8ebdda299,9,0,10,4,41,46,32,19,54,17,10,12,11,6,8,10,-5,-1,-4
120,530000,9c1c7ee8ebdda299,9,0,159,126,119,169,142,104,91,53,62,66,54,100,77,73,46,-12,58
172,150000,9c1c7ee8ebdda299,9,0,327,297,353,430,278,168,258,163,176,174,153,161,157,163,8,-21,29
21,110000,9c1c7ee8ebdda299,9,0,96,46,78,112,52,38,30,13,7,12,11,3,7,9,-8,-1,-7
211,510000,9c1c7ee8ebdda299,9,0,723,408,517,641,617,336,250,134,145,143,161,174,168,159,13,18,-5
153,340000,9c1c7ee8ebdda299,9,0,211,71,198,190,278,146,119,59,72,88,63,82,72,78,19,-25,44
554,370000,9c1c7ee8ebdda299,9,0,1782,1445,1562,2281,1763,885,746,509,752,650,656,635,646,647,-21,6,-27
321,140000,9c1c7ee8ebdda299,9,0,842,579,768,886,691,295,401,285,317,252,283,337,310,291,54,31,23
160,440000,9c1c7ee8ebdda299,9,0,821,619,710,1008,472,229,471,212,177,139,130,131,130,133,1,-9,10
148,450000,9c1c7ee8ebdda299,9,0,191,132,192,308,251,110,119,55,137,102,134,127,130,121,-7,32,-39
124,320000,9c1c7ee8ebdda299,9,0,195,95,307,309,370,299,211,106,111,126,119,95,107,113,-24,-7,-17
96,360000,9c1c7ee8ebdda299,9,0,145,60,177,182,224,84,107,42,42,52,41,45,43,46,4,-11,15
807,130000,9c1c7ee8ebdda299,9,0,1949,1092,1644,1840,1468,940,941,733,782,635,713,852,782,733,139,78,61
399,410000,9c1c7ee8ebdda299,9,0,546,306,774,911,1101,433,362,211,283,281,280,284,282,282,4,-1,5
277,330000,9c1c7ee8ebdda299,9,0,149,42,380,352,327,197,195,168,241,204,240,223,232,222,-17,36,-53
51,420000,9c1c7ee8ebdda299,9,0,100,46,116,125,211,58,65,32,39,46,41,44,42,44,3,-5,8
92,430000,9c1c7ee8ebdda299,9,0,140,74,141,165,230,105,87,42,50,62,55,47,51,55,-8,-7,-1
86,350000,9c1c7ee8ebdda299,9,0,159,110,281,215,204,105,130,66,70,71,48,58,53,59,10,-23,33
317,210000,9c1c7ee8ebdda299,9,0,654,384,528,619,375,317,409,425,215,168,173,244,208,195,71,5,66
25,500000,9c1c7ee8ebdda299,9,0,119,62,80,104,116,61,54,25,34,33,27,26,26,29,-1,-6,5
127,610000,9c1c7ee8ebdda299,9,0,168,145,214,250,261,108,136,75,123,125,148,123,136,132,-25,23,-48
219,230000,9c1c7ee8ebdda299,9,0,302,291,350,342,207,144,192,137,117,137,97,118,108,117,21,-40,61
381,310000,c6833cb891626c17,9,0,371,283,435,596,174,80,151,177,200,272,204,286,245,254,82,-68,150
242,530000,c6833cb891626c17,9,0,477,514,538,699,444,236,185,176,241,235,239,233,236,236,-6,4,-10
226,150000,c6833cb891626c17,9,0,337,354,323,485,221,94,125,138,233,182,202,244,223,209,42,20,22
285,110000,c6833cb891626c17,9,0,877,636,879,1517,309,174,289,242,251,279,287,271,279,279,-16,8,-24
612,510000,c6833cb891626c17,9,0,1020,712,770,1305,743,339,285,287,359,363,364,444,404,390,80,1,79
847,340000,c6833cb891626c17,9,0,1066,894,964,1597,855,344,344,422,524,660,677,843,760,727,166,17,149
972,370000,c6833cb891626c17,9,0,1278,1160,1107,1740,687,383,327,543,829,670,841,808,824,773,-33,171,-204
232,140000,c6833cb891626c17,9,0,280,282,301,514,192,100,117,126,207,172,186,212,199,190,26,14,12
704,440000,c6833cb891626c17,9,0,1382,1240,1586,1899,542,186,403,360,460,604,483,479,481,522,-4,-121,117
114,450000,c6833cb891626c17,9,0,277,266,309,514,260,96,110,81,120,111,123,118,120,117,-5,12,-17
1073,320000,c6833cb891626c17,9,0,1406,1396,1446,2279,939,574,593,645,899,941,918,876,897,912,-42,-23,-19
577,360000,c6833cb891626c17,9,0,638,519,571,900,502,180,199,229,302,289,342,439,390,357,97,53,44
870,130000,c6833cb891626c17,9,0,1066,990,1108,1749,708,414,412,600,843,768,843,1013,928,875,170,75,95
1173,410000,c6833cb891626c17,9,0,1525,1493,1622,2735,1331,509,557,792,1003,1139,1208,1046,1127,1131,-162,69,-231
1568,330000,c6833cb891626c17,9,0,1804,1911,2130,3255,1119,581,616,676,899,1179,1212,1449,1330,1280,237,33,204
541,420000,c6833cb891626c17,9,0,678,560,634,1014,597,202,210,256,309,467,354,417,386,413,63,-113,176
495,430000,c6833cb891626c17,9,0,712,546,606,978,498,212,209,272,280,287,311,368,340,322,57,24,33
287,350000,c6833cb891626c17,9,0,406,499,552,782,311,141,184,131,214,223,160,193,176,192,33,-63,96
202,210000,c6833cb891626c17,9,0,315,299,258,424,127,80,97,131,161,165,176,170,173,170,-6,11,-17
170,500000,c6833cb891626c17,9,0,336,267,309,532,260,104,78,93,126,161,148,159,154,156,11,-13,24
295,610000,c6833cb891626c17,9,0,373,472,366,620,315,130,154,179,263,204,263,363,313,277,100,59,41
90,230000,c6833cb891626c17,9,0,206,170,232,274,80,52,66,71,97,87,91,116,104,98,25,4,21
202,310000,3e21824be728cbec,9,0,257,239,345,396,369,177,174,163,140,140,130,154,142,141,24,-10,34
215,530000,3e21824be728cbec,9,0,358,406,373,334,203,134,207,159,159,199,202,227,214,209,25,3,22
40,150000,3e21824be728cbec,9,0,123,116,59,90,51,29,42,27,40,31,39,40,40,37,1,8,-7
55,110000,3e21824be728cbec,9,0,203,168,222,242,93,60,87,42,47,47,40,41,40,43,1,-7,8
499,510000,3e21824be728cbec,9,0,731,758,778,781,288,239,321,272,333,406,352,417,384,392,65,-54,119
293,340000,3e21824be728cbec,9,0,630,644,607,661,309,266,301,237,309,289,297,345,321,310,48,8,40
535,370000,3e21824be728cbec,9,0,772,807,782,994,540,419,572,464,433,395,383,432,408,403,49,-12,61
82,140000,3e21824be728cbec,9,0,240,200,132,201,88,44,87,60,67,72,87,105,96,88,18,15,3
499,440000,3e21824be728cbec,9,0,619,721,938,1135,331,231,477,411,394,418,380,461,420,420,81,-38,119
149,450000,3e21824be728cbec,9,0,268,247,370,403,140,92,140,131,131,161,121,124,122,135,3,-40,43
768,320000,3e21824be728cbec,9,0,1020,1227,1286,1781,805,710,885,641,740,693,656,701,678,683,45,-37,82
261,360000,3e21824be728cbec,9,0,391,438,444,431,157,97,173,170,210,195,175,219,197,196,44,-20,64
455,130000,3e21824be728cbec,9,0,729,766,589,806,391,375,484,404,455,438,404,455,430,432,51,-34,85
510,410000,3e21824be728cbec,9,0,777,834,729,896,363,334,528,418,445,554,381,446,414,460,65,-173,238
505,330000,3e21824be728cbec,9,0,573,616,797,1044,341,386,475,363,466,458,443,473,458,458,30,-15,45
192,420000,3e21824be728cbec,9,0,375,452,413,461,270,123,194,119,150,177,181,200,190,186,19,4,15
251,430000,3e21824be728cbec,9,0,394,414,458,478,157,99,182,167,188,184,200,195,198,193,-5,16,-21
227,350000,3e21824be728cbec,9,0,339,397,455,593,250,154,266,219,283,228,214,225,220,222,11,-14,25
64,210000,3e21824be728cbec,9,0,144,114,136,149,45,36,75,66,76,84,71,67,69,74,-4,-13,9
161,500000,3e21824be728cbec,9,0,422,402,422,475,136,124,148,136,160,225,137,123,130,162,-14,-88,74
187,610000,3e21824be728cbec,9,0,446,595,355,464,194,145,188,141,176,186,164,204,184,185,40,-22,62
37,230000,3e21824be728cbec,9,0,237,176,82,87,40,47,82,54,34,48,39,38,38,42,-1,-9,8
425,310000,f8a6975573af1b33,9,0,420,355,228,579,371,131,288,266,225,283,286,352,319,307,66,3,63
285,530000,f8a6975573af1b33,9,0,200,244,165,338,215,134,179,192,167,169,217,170,194,185,-47,48,-95
50,150000,f8a6975573af1b33,9,0,40,41,43,48,41,28,59,37,53,61,54,60,57,58,6,-7,13
106,110000,f8a6975573af1b33,9,0,304,268,372,383,131,61,110,108,70,103,89,94,92,95,5,-14,19
730,510000,f8a6975573af1b33,9,0,632,431,484,820,550,286,428,433,456,497,476,571,524,515,95,-21,116
654,340000,f8a6975573af1b33,9,0,521,495,362,758,508,322,432,425,545,563,499,558,528,540,59,-64,123
508,370000,f8a6975573af1b33,9,0,410,423,383,729,410,227,320,381,388,394,345,413,379,384,68,-49,117
65,140000,f8a6975573af1b33,9,0,78,61,91,136,74,57,53,62,47,59,62,56,59,59,-6,3,-9
1539,440000,f8a6975573af1b33,9,0,1298,1305,1034,2232,1023,444,1072,1007,969,1190,954,1225,1090,1123,271,-236,507
264,450000,f8a6975573af1b33,9,0,237,215,191,328,208,107,160,131,178,209,223,211,217,214,-12,14,-26
1384,320000,f8a6975573af1b33,9,0,1190,1239,807,1846,1142,747,1023,870,969,1040,1045,1132,1088,1072,87,5,82
361,360000,f8a6975573af1b33,9,0,306,226,131,436,290,111,237,235,226,237,243,304,274,261,61,6,55
469,130000,f8a6975573af1b33,9,0,360,308,272,475,287,194,265,298,335,339,355,444,400,379,89,16,73
706,410000,f8a6975573af1b33,9,0,554,543,420,747,459,249,457,513,513,571,508,547,528,542,39,-63,102
1060,330000,f8a6975573af1b33,9,0,824,856,695,1454,752,503,780,679,725,759,836,1202,1019,932,366,77,289
481,420000,f8a6975573af1b33,9,0,304,278,190,481,312,158,246,258,251,428,347,390,368,388,43,-81,124
467,430000,f8a6975573af1b33,9,0,329,289,235,425,324,139,263,238,293,308,308,344,326,320,36,0,36
547,350000,f8a6975573af1b33,9,0,469,472,415,699,508,260,395,323,426,506,406,485,446,466,79,-100,179
125,210000,f8a6975573af1b33,9,0,154,125,64,125,66,52,82,116,125,102,110,143,126,118,33,8,25
380,500000,f8a6975573af1b33,9,0,389,322,256,548,310,185,288,287,285,378,280,285,282,314,5,-98,103
227,610000,f8a6975573af1b33,9,0,188,226,181,259,170,96,124,121,134,165,167,184,176,172,17,2,15
53,230000,f8a6975573af1b33,9,0,84,67,65,115,61,52,76,85,53,52,53,68,60,58,15,1,14
310,310000,54fc07138d70374c,9,0,336,292,421,473,415,199,338,303,272,297,230,306,268,278,76,-67,143
296,530000,54fc07138d70374c,9,0,316,363,485,535,500,259,353,295,304,293,320,299,310,304,-21,27,-48
191,150000,54fc07138d70374c,9,0,224,233,229,234,273,129,208,180,191,167,194,197,196,186,3,27,-24
397,110000,54fc07138d70374c,9,0,442,429,500,681,534,295,402,398,365,374,341,360,350,358,19,-33,52
610,510000,54fc07138d70374c,9,0,659,704,743,849,933,442,540,493,508,553,476,460,468,496,-16,-77,61
206,340000,54fc07138d70374c,9,0,314,271,334,368,404,198,210,162,176,206,197,185,191,196,-12,-9,-3
642,370000,54fc07138d70374c,9,0,771,679,776,936,911,376,595,546,558,596,483,522,502,534,39,-113,152
141,140000,54fc07138d70374c,9,0,135,142,208,244,213,113,141,101,103,104,107,143,125,118,36,3,33
1188,440000,54fc07138d70374c,9,0,1408,1392,1836,2078,1526,521,1068,875,905,1067,825,969,897,954,144,-242,386
167,450000,54fc07138d70374c,9,0,207,208,246,317,323,145,236,156,189,166,140,172,156,159,32,-26,58
549,320000,54fc07138d70374c,9,0,611,660,847,820,821,461,589,458,423,545,436,500,468,494,64,-109,173
170,360000,54fc07138d70374c,9,0,215,187,249,262,297,113,164,151,133,139,150,149,150,146,-1,11,-12
519,130000,54fc07138d70374c,9,0,576,625,746,750,758,431,483,470,474,415,495,501,498,470,6,80,-74
437,410000,54fc07138d70374c,9,0,596,604,752,820,826,447,615,567,493,543,423,493,458,486,70,-120,190
340,330000,54fc07138d70374c,9,0,387,524,623,684,550,252,401,254,311,325,307,322,314,318,15,-18,33
295,420000,54fc07138d70374c,9,0,346,310,385,425,481,197,299,246,238,274,238,273,256,262,35,-36,71
378,430000,54fc07138d70374c,9,0,424,364,460,493,505,239,383,321,315,341,325,336,330,334,11,-16,27
151,350000,54fc07138d70374c,9,0,223,268,329,338,400,163,217,128,161,123,141,139,140,134,-2,18,-20
251,210000,54fc07138d70374c,9,0,364,303,369,450,249,117,274,320,298,258,236,274,255,256,38,-22,60
331,500000,54fc07138d70374c,9,0,406,400,540,575,576,284,403,314,306,439,296,285,290,340,-11,-143,132
236,610000,54fc07138d70374c,9,0,293,365,346,404,376,178,272,285,266,201,203,229,216,211,26,2,24
258,230000,54fc07138d70374c,9,0,331,302,341,410,324,206,341,242,239,273,292,251,272,272,-41,19,-60
249,310000,212083a9246d2fd3,9,0,628,446,636,846,241,179,180,191,192,253,247,261,254,254,14,-6,20
200,530000,212083a9246d2fd3,9,0,278,304,365,493,290,145,117,124,158,128,183,166,174,159,-17,55,-72
137,150000,212083a9246d2fd3,9,0,222,206,310,562,284,123,119,71,119,101,97,110,104,103,13,-4,17
65,110000,212083a9246d2fd3,9,0,498,257,444,824,105,71,55,60,50,59,51,57,54,56,6,-8,14
641,510000,212083a9246d2fd3,9,0,1042,762,1080,1730,983,504,400,394,380,436,516,607,562,520,91,80,11
1036,340000,212083a9246d2fd3,9,0,1078,1023,1260,2243,1186,528,593,566,477,521,594,770,682,628,176,73,103
994,370000,212083a9246d2fd3,9,0,1622,1536,1637,2998,1261,553,503,551,645,651,724,836,780,737,112,73,39
273,140000,212083a9246d2fd3,9,0,308,299,372,645,313,178,140,164,178,173,195,230,212,199,35,22,13
844,440000,212083a9246d2fd3,9,0,1369,1274,1967,3191,905,337,855,959,831,614,794,1007,900,805,213,180,33
332,450000,212083a9246d2fd3,9,0,232,252,337,697,471,179,227,188,213,224,204,252,228,227,48,-20,68
976,320000,212083a9246d2fd3,9,0,2163,1918,2283,3836,1631,972,777,763,993,802,889,897,893,863,8,87,-79
417,360000,212083a9246d2fd3,9,0,542,547,676,1270,658,229,229,221,283,227,273,344,308,281,71,46,25
625,130000,212083a9246d2fd3,9,0,987,969,1064,2232,950,551,442,578,697,555,544,666,605,588,122,-11,133
1393,410000,212083a9246d2fd3,9,0,1548,1431,1720,3243,1894,828,807,1011,1085,1013,1189,1300,1244,1167,111,176,-65
573,330000,212083a9246d2fd3,9,0,1067,1140,1205,1850,574,328,328,361,426,423,467,565,516,485,98,44,54
310,420000,212083a9246d2fd3,9,0,576,710,866,1354,755,244,256,243,222,247,223,230,226,233,7,-24,31
628,430000,212083a9246d2fd3,9,0,844,687,982,1756,938,322,403,371,448,412,466,511,488,463,45,54,-9
522,350000,212083a9246d2fd3,9,0,645,645,746,1041,462,182,250,215,304,238,233,338,286,270,105,-5,110
146,210000,212083a9246d2fd3,9,0,415,275,422,561,181,92,144,178,144,111,123,123,123,119,0,12,-12
306,500000,212083a9246d2fd3,9,0,722,571,643,1136,557,231,195,203,189,260,190,212,201,221,22,-70,92
525,610000,212083a9246d2fd3,9,0,652,682,805,1567,639,298,275,310,369,282,381,491,436,385,110,99,11
80,230000,212083a9246d2fd3,9,0,164,109,207,305,102,62,72,62,93,71,101,93,97,88,-8,30,-38
33,310000,4f79773e600518a6,9,0,112,64,139,159,95,31,32,33,18,19,21,31,26,24,10,2,8
70,530000,4f79773e600518a6,9,0,88,129,116,195,181,91,58,50,67,48,56,60,58,55,4,8,-4
142,150000,4f79773e600518a6,9,0,178,215,227,336,327,113,110,91,126,86,83,105,94,91,22,-3,25
32,110000,4f79773e600518a6,9,0,124,113,153,246,99,35,29,28,28,17,19,21,20,19,2,2,0
107,510000,4f79773e600518a6,9,0,260,194,267,387,398,155,108,95,80,69,76,114,95,86,38,7,31
137,340000,4f79773e600518a6,9,0,277,262,301,471,484,121,103,101,118,103,101,112,106,105,11,-2,13
372,370000,4f79773e600518a6,9,0,670,629,591,961,723,263,300,312,311,242,273,332,302,282,59,31,28
92,140000,4f79773e600518a6,9,0,92,114,133,167,149,66,59,57,51,58,45,92,68,65,47,-13,60
44,440000,4f79773e600518a6,9,0,111,142,134,176,97,19,44,38,31,35,30,38,34,34,8,-5,13
12,450000,4f79773e600518a6,9,0,27,44,52,62,66,20,31,15,25,9,23,18,20,17,-5,14,-19
87,320000,4f79773e600518a6,9,0,222,289,312,450,333,168,137,94,101,95,97,80,88,91,-17,2,-19
106,360000,4f79773e600518a6,9,0,158,141,164,252,264,69,58,63,82,66,58,86,72,70,28,-8,36
184,130000,4f79773e600518a6,9,0,268,281,338,473,362,182,165,226,205,142,157,221,189,173,64,15,49
292,410000,4f79773e600518a6,9,0,436,457,535,679,669,213,223,212,206,190,239,237,238,222,-2,49,-51
54,330000,4f79773e600518a6,9,0,152,167,161,255,131,59,54,69,64,57,47,53,50,52,6,-10,16
134,420000,4f79773e600518a6,9,0,231,258,278,385,450,105,110,104,89,90,81,127,104,99,46,-9,55
415,430000,4f79773e600518a6,9,0,453,378,533,776,857,222,262,247,257,219,243,308,276,257,65,24,41
14,350000,4f79773e600518a6,9,0,50,51,83,65,41,21,20,20,33,19,21,25,23,22,4,2,2
62,210000,4f79773e600518a6,9,0,152,128,129,166,109,50,66,72,45,46,43,59,51,49,16,-3,19
87,500000,4f79773e600518a6,9,0,157,175,189,306,256,58,77,65,70,84,67,84,76,78,17,-17,34
237,610000,4f79773e600518a6,9,0,329,421,381,634,493,193,190,176,193,161,204,222,213,196,18,43,-25
76,230000,4f79773e600518a6,9,0,141,126,204,277,131,70,96,70,62,54,66,59,62,60,-7,12,-19
108,310000,fc32b1a017b34efe,9,0,188,167,211,361,138,71,95,74,75,111,81,104,92,99,23,-30,53
361,530000,fc32b1a017b34efe,9,0,486,521,434,743,406,299,256,259,276,323,373,379,376,358,6,50,-44
378,150000,fc32b1a017b34efe,9,0,374,366,390,683,304,135,211,181,248,260,314,339,326,304,25,54,-29
129,110000,fc32b1a017b34efe,9,0,458,302,357,675,173,56,121,79,138,89,102,103,102,98,1,13,-12
1106,510000,fc32b1a017b34efe,9,0,1530,1137,1318,2057,1186,681,782,644,814,979,1044,1182,1113,1068,138,65,73
361,340000,fc32b1a017b34efe,9,0,479,476,493,865,574,194,213,248,307,345,317,346,332,336,29,-28,57
720,370000,fc32b1a017b34efe,9,0,922,870,894,1538,723,282,412,473,536,614,680,774,727,689,94,66,28
685,140000,fc32b1a017b34efe,9,0,470,495,510,974,417,214,254,346,509,560,656,816,736,677,160,96,64
575,440000,fc32b1a017b34efe,9,0,730,702,768,1105,569,259,493,354,430,585,484,578,531,549,94,-101,195
225,450000,fc32b1a017b34efe,9,0,217,208,212,406,260,101,165,105,174,218,194,217,206,210,23,-24,47
567,320000,fc32b1a017b34efe,9,0,765,828,786,1332,698,402,409,494,495,557,550,609,580,572,59,-7,66
291,360000,fc32b1a017b34efe,9,0,350,363,356,774,420,110,193,205,216,298,283,295,289,292,12,-15,27
1153,130000,fc32b1a017b34efe,9,0,936,974,964,2069,891,397,516,929,990,983,1137,1295,1216,1138,158,154,4
847,410000,fc32b1a017b34efe,9,0,924,913,934,1916,1026,330,387,521,645,908,946,966,956,940,20,38,-18
405,330000,fc32b1a017b34efe,9,0,604,663,556,982,370,195,281,311,304,395,371,467,419,411,96,-24,120
277,420000,fc32b1a017b34efe,9,0,385,300,389,721,401,105,159,186,195,272,290,243,266,268,-47,18,-65
552,430000,fc32b1a017b34efe,9,0,722,567,687,1290,631,205,298,333,363,464,424,425,424,438,1,-40,41
154,350000,fc32b1a017b34efe,9,0,217,240,253,385,180,95,138,114,150,154,163,198,180,172,35,9,26
198,210000,fc32b1a017b34efe,9,0,209,211,226,330,135,104,181,144,138,167,145,200,172,171,55,-22,77
617,500000,fc32b1a017b34efe,9,0,909,844,751,1420,661,420,464,477,481,631,557,639,598,609,82,-74,156
661,610000,fc32b1a017b34efe,9,0,574,623,639,1234,604,184,336,402,415,468,687,690,688,615,3,219,-216
146,230000,fc32b1a017b34efe,9,0,126,126,150,236,76,111,111,78,108,134,127,165,146,142,38,-7,45
461,310000,feabbf46658382b9,9,0,500,412,620,805,357,95,198,187,218,252,286,379,332,306,93,34,59
741,530000,feabbf46658382b9,9,0,851,856,921,1249,829,418,522,444,470,542,766,801,784,703,35,224,-189
789,150000,feabbf46658382b9,9,0,500,528,675,925,601,288,415,322,461,499,595,688,642,594,93,96,-3
338,110000,feabbf46658382b9,9,0,672,532,779,1421,437,212,313,278,276,253,302,320,311,292,18,49,-31
1788,510000,feabbf46658382b9,9,0,2178,1620,1861,2915,2183,903,1084,938,1042,1247,1538,1846,1692,1544,308,291,17
755,340000,feabbf46658382b9,9,0,798,757,934,1307,1141,304,330,322,356,545,585,712,648,614,127,40,87
1170,370000,feabbf46658382b9,9,0,1160,1214,1192,1610,1006,389,569,611,624,776,1014,1189,1102,993,175,238,-63
652,140000,feabbf46658382b9,9,0,505,511,601,970,406,198,368,305,370,503,552,733,642,596,181,49,132
1490,440000,feabbf46658382b9,9,0,1576,1507,1902,2685,1203,341,825,879,785,1142,1134,1550,1342,1275,416,-8,424
369,450000,feabbf46658382b9,9,0,347,352,440,665,433,149,235,168,197,226,296,330,313,284,34,70,-36
1770,320000,feabbf46658382b9,9,0,1646,1598,1955,2752,1481,650,861,854,961,1280,1420,1671,1546,1457,251,140,111
407,360000,feabbf46658382b9,9,0,510,475,511,802,624,159,229,268,266,354,440,475,458,423,35,86,-51
1432,130000,feabbf46658382b9,9,0,1009,905,1021,1551,970,478,608,767,810,890,1254,1423,1338,1189,169,364,-195
1724,410000,feabbf46658382b9,9,0,1342,1399,1530,2696,1928,502,672,701,850,1415,1787,1789,1788,1664,2,372,-370
1797,330000,feabbf46658382b9,9,0,1320,1351,1499,2124,704,292,530,641,696,932,1254,1486,1370,1224,232,322,-90
609,420000,feabbf46658382b9,9,0,653,620,794,1252,837,201,313,330,347,462,609,643,626,571,34,147,-113
1138,430000,feabbf46658382b9,9,0,1383,1339,1478,2360,1657,503,671,579,591,827,934,1043,988,935,109,107,2
543,350000,feabbf46658382b9,9,0,414,399,601,698,428,129,211,219,281,359,378,470,424,402,92,19,73
316,210000,feabbf46658382b9,9,0,331,306,361,459,235,125,226,187,250,248,334,351,342,311,17,86,-69
1572,500000,feabbf46658382b9,9,0,1671,1487,1581,2727,1846,758,896,740,908,1151,1313,1405,1359,1290,92,162,-70
991,610000,feabbf46658382b9,9,0,764,827,896,1319,905,333,426,445,444,565,798,975,886,779,177,233,-56
281,230000,feabbf46658382b9,9,0,219,256,312,397,173,117,199,155,143,190,253,271,262,238,18,63,-45
27,310000,f270f6a489c6a9d7,9,0,28,27,30,34,19,29,28,25,38,29,32,29,30,30,-3,3,-6
817,530000,f270f6a489c6a9d7,9,0,1639,1736,1547,1939,1680,1190,1187,815,815,786,875,755,815,805,-120,89,-209
70,150000,f270f6a489c6a9d7,9,0,107,93,105,108,54,78,117,71,70,60,56,65,60,60,9,-4,13
80,110000,f270f6a489c6a9d7,9,0,282,198,305,504,106,118,157,120,110,104,70,81,76,85,11,-34,45
523,510000,f270f6a489c6a9d7,9,0,717,655,773,955,603,645,678,519,472,474,468,514,491,485,46,-6,52
226,340000,f270f6a489c6a9d7,9,0,197,214,225,272,216,223,191,165,153,149,145,130,138,141,-15,-4,-11
348,370000,f270f6a489c6a9d7,9,0,622,551,636,1105,629,541,513,451,400,375,388,431,410,398,43,13,30
99,140000,f270f6a489c6a9d7,9,0,137,118,161,233,166,115,127,118,117,113,93,103,98,103,10,-20,30
464,440000,f270f6a489c6a9d7,9,0,644,624,713,866,346,505,757,513,503,519,390,440,415,450,50,-129,179
40,450000,f270f6a489c6a9d7,9,0,93,63,75,97,92,50,85,53,57,36,20,17,18,24,-3,-16,13
537,320000,f270f6a489c6a9d7,9,0,766,763,871,1150,610,843,857,623,558,495,522,542,532,520,20,27,-7
109,360000,f270f6a489c6a9d7,9,0,134,92,117,148,132,89,105,90,70,62,87,69,78,73,-18,25,-43
477,130000,f270f6a489c6a9d7,9,0,561,554,769,983,537,616,685,621,541,500,570,609,590,560,39,70,-31
950,410000,f270f6a489c6a9d7,9,0,703,746,952,1314,922,778,753,612,592,519,715,609,662,614,-106,196,-302
303,330000,f270f6a489c6a9d7,9,0,451,456,466,653,312,498,511,368,351,319,353,307,330,326,-46,34,-80
383,420000,f270f6a489c6a9d7,9,0,582,592,590,903,514,438,482,408,403,314,306,325,316,315,19,-8,27
258,430000,f270f6a489c6a9d7,9,0,366,327,426,575,405,314,375,353,267,377,276,257,266,303,-19,-101,82
94,350000,f270f6a489c6a9d7,9,0,156,179,175,195,85,140,157,133,146,133,94,101,98,109,7,-39,46
165,210000,f270f6a489c6a9d7,9,0,216,260,281,370,158,187,236,191,184,170,200,162,181,177,-38,30,-68
469,500000,f270f6a489c6a9d7,9,0,643,645,706,955,636,643,771,438,521,498,470,463,466,477,-7,-28,21
154,610000,f270f6a489c6a9d7,9,0,227,209,280,324,195,155,198,180,157,132,131,161,146,141,30,-1,31
38,230000,f270f6a489c6a9d7,9,0,70,59,76,90,35,48,67,46,41,40,28,43,36,37,15,-12,27
101,310000,d0f245b8781e3631,9,0,218,159,193,281,60,52,74,61,69,81,59,68,64,69,9,-22,31
128,530000,d0f245b8781e3631,9,0,241,224,227,356,181,119,130,103,154,125,106,113,110,115,7,-19,26
82,150000,d0f245b8781e3631,9,0,86,129,183,244,117,67,81,65,79,55,51,79,65,62,28,-4,32
133,110000,d0f245b8781e3631,9,0,472,326,417,805,105,52,132,97,103,144,172,170,171,162,-2,28,-30
583,510000,d0f245b8781e3631,9,0,1133,824,910,1456,816,454,505,463,516,491,453,624,538,523,171,-38,209
129,340000,d0f245b8781e3631,9,0,310,267,287,463,251,96,133,88,118,91,110,111,110,104,1,19,-18
347,370000,d0f245b8781e3631,9,0,797,679,738,1182,600,283,311,395,408,271,332,415,374,339,83,61,22
152,140000,d0f245b8781e3631,9,0,226,243,264,497,192,96,135,117,169,144,132,175,154,150,43,-12,55
297,440000,d0f245b8781e3631,9,0,596,574,615,869,297,127,271,262,258,278,238,265,252,260,27,-40,67
124,450000,d0f245b8781e3631,9,0,167,205,233,425,254,71,136,107,135,145,104,103,104,117,-1,-41,40
382,320000,d0f245b8781e3631,9,0,761,731,749,1017,461,270,342,363,373,289,260,265,262,271,5,-29,34
104,360000,d0f245b8781e3631,9,0,229,198,198,315,211,60,84,84,68,64,78,105,92,82,27,14,13
477,130000,d0f245b8781e3631,9,0,771,682,755,1430,754,390,398,481,498,419,459,630,544,503,171,40,131
415,410000,d0f245b8781e3631,9,0,851,876,865,1601,892,268,371,333,363,396,440,436,438,424,-4,44,-48
258,330000,d0f245b8781e3631,9,0,1437,406,420,845,174,81,170,192,246,204,243,235,239,227,-8,39,-47
57,420000,d0f245b8781e3631,9,0,110,128,133,246,134,39,47,55,60,48,51,63,57,54,12,3,9
244,430000,d0f245b8781e3631,9,0,439,335,447,756,439,130,231,191,211,178,177,209,193,188,32,-1,33
94,350000,d0f245b8781e3631,9,0,142,175,166,247,102,51,67,60,67,91,79,101,90,90,22,-12,34
18,210000,d0f245b8781e3631,9,0,68,54,102,113,47,21,29,27,30,22,21,21,21,21,0,-1,1
438,500000,d0f245b8781e3631,9,0,764,548,596,1578,630,283,298,337,395,444,428,519,474,464,91,-16,107
325,610000,d0f245b8781e3631,9,0,455,455,558,938,498,189,261,260,236,226,286,349,318,287,63,60,3
12,230000,d0f245b8781e3631,9,0,17,16,45,45,7,10,21,11,20,18,12,17,14,16,5,-6,11
404,310000,c6cd4e0e073f5ac2,9,0,1049,393,448,746,228,125,223,190,233,237,1154,290,722,560,-864,917,-1781
75,530000,c6cd4e0e073f5ac2,9,0,410,266,224,235,105,67,68,72,70,100,79,62,70,80,-17,-21,4
111,150000,c6cd4e0e073f5ac2,9,0,263,289,273,340,208,63,95,64,75,89,75,89,82,84,14,-14,28
51,110000,c6cd4e0e073f5ac2,9,0,2528,156,179,362,72,29,64,61,50,56,417,666,542,380,249,361,-112
368,510000,c6cd4e0e073f5ac2,9,0,1666,730,631,1027,542,251,246,265,230,226,834,315,574,458,-519,608,-1127
583,340000,c6cd4e0e073f5ac2,9,0,961,755,678,1434,792,244,232,308,344,363,315,452,384,377,137,-48,185
630,370000,c6cd4e0e073f5ac2,9,0,2646,1380,1053,1685,823,326,341,453,371,362,372,520,446,418,148,10,138
187,140000,c6cd4e0e073f5ac2,9,0,660,386,479,604,321,126,162,162,182,154,558,292,425,335,-266,404,-670
478,440000,c6cd4e0e073f5ac2,9,0,1623,936,1038,1493,451,130,374,366,407,481,329,409,369,406,80,-152,232
204,450000,c6cd4e0e073f5ac2,9,0,360,349,312,543,250,76,136,99,136,130,103,145,124,126,42,-27,69
1015,320000,c6cd4e0e073f5ac2,9,0,2388,1650,1467,2828,1205,656,751,787,807,758,1395,929,1162,1027,-466,637,-1103
418,360000,c6cd4e0e073f5ac2,9,0,752,626,577,1241,549,138,232,271,262,250,268,377,322,298,109,18,91
411,130000,c6cd4e0e073f5ac2,9,0,1606,840,561,1020,602,249,293,362,351,329,285,374,330,329,89,-44,133
1189,410000,c6cd4e0e073f5ac2,9,0,1669,959,1021,1584,992,320,512,660,557,721,719,991,855,810,272,-2,274
499,330000,c6cd4e0e073f5ac2,9,0,1203,828,859,1272,386,193,342,341,375,377,337,402,370,372,65,-40,105
371,420000,c6cd4e0e073f5ac2,9,0,769,691,751,1208,523,161,272,326,270,280,775,316,546,457,-459,495,-954
457,430000,c6cd4e0e073f5ac2,9,0,847,522,619,891,508,132,232,212,222,268,261,329,295,286,68,-7,75
131,350000,c6cd4e0e073f5ac2,9,0,304,268,291,431,173,74,106,104,121,115,77,91,84,94,14,-38,52
79,210000,c6cd4e0e073f5ac2,9,0,291,139,186,225,91,51,75,101,66,42,52,68,60,54,16,10,6
63,500000,c6cd4e0e073f5ac2,9,0,310,182,148,242,128,33,53,51,65,76,57,46,52,60,-11,-19,8
271,610000,c6cd4e0e073f5ac2,9,0,661,278,275,432,182,64,143,136,155,142,754,199,476,365,-555,612,-1167
21,230000,c6cd4e0e073f5ac2,9,0,137,83,61,140,53,29,33,28,48,27,21,28,24,25,7,-6,13
92,310000,a9a43d1a7ecbe75d,9,0,161,113,162,163,142,84,128,99,108,102,143,141,142,129,-2,41,-43
95,530000,a9a43d1a7ecbe75d,9,0,111,95,152,131,146,84,119,80,84,87,136,120,128,114,-16,49,-65
69,150000,a9a43d1a7ecbe75d,9,0,81,97,81,90,83,41,62,87,86,67,58,68,63,64,10,-9,19
55,110000,a9a43d1a7ecbe75d,9,0,131,79,100,123,88,65,74,70,62,63,53,50,52,55,-3,-10,7
301,510000,a9a43d1a7ecbe75d,9,0,447,284,279,330,341,184,223,201,224,188,192,262,227,214,70,4,66
138,340000,a9a43d1a7ecbe75d,9,0,182,170,183,198,254,107,149,150,152,146,136,174,155,152,38,-10,48
179,370000,a9a43d1a7ecbe75d,9,0,198,152,160,191,159,74,162,163,162,117,116,158,137,130,42,-1,43
32,140000,a9a43d1a7ecbe75d,9,0,34,32,31,28,41,25,46,41,28,30,28,32,30,30,4,-2,6
480,440000,a9a43d1a7ecbe75d,9,0,593,541,658,638,568,264,527,387,410,437,440,502,471,460,62,3,59
143,450000,a9a43d1a7ecbe75d,9,0,208,163,172,213,297,121,197,152,163,152,143,162,152,152,19,-9,28
342,320000,a9a43d1a7ecbe75d,9,0,402,385,402,439,430,213,408,324,345,284,373,290,332,316,-83,89,-172
75,360000,a9a43d1a7ecbe75d,9,0,94,87,76,120,103,50,101,76,71,82,82,105,94,90,23,0,23
121,130000,a9a43d1a7ecbe75d,9,0,92,82,85,95,109,50,116,95,137,104,134,131,132,123,-3,30,-33
132,410000,a9a43d1a7ecbe75d,9,0,153,141,134,164,130,78,142,114,90,124,140,149,144,138,9,16,-7
287,330000,a9a43d1a7ecbe75d,9,0,308,339,364,397,466,185,307,317,322,277,351,327,339,318,-24,74,-98
164,420000,a9a43d1a7ecbe75d,9,0,232,184,244,236,270,129,200,183,140,190,186,222,204,199,36,-4,40
282,430000,a9a43d1a7ecbe75d,9,0,395,308,355,445,519,215,330,301,296,262,319,373,346,318,54,57,-3
100,350000,a9a43d1a7ecbe75d,9,0,93,87,125,99,145,57,96,88,101,91,78,106,92,92,28,-13,41
123,210000,a9a43d1a7ecbe75d,9,0,194,115,126,155,89,59,109,102,100,85,79,140,110,101,61,-6,67
117,500000,a9a43d1a7ecbe75d,9,0,203,173,179,214,160,89,140,134,104,264,151,136,144,184,-15,-113,98
207,610000,a9a43d1a7ecbe75d,9,0,256,263,252,263,274,154,228,212,258,163,256,338,297,252,82,93,-11
62,230000,a9a43d1a7ecbe75d,9,0,68,54,66,57,65,35,91,67,47,50,39,70,54,53,31,-11,42
270,310000,3c974920a76ac9c1,10,0,228,369,374,305,193,309,264,241,251,240,298,308,303,282,10,58,-48
298,530000,3c974920a76ac9c1,10,0,310,402,456,434,194,302,243,321,230,362,323,306,314,330,-17,-39,22
134,150000,3c974920a76ac9c1,10,0,178,204,219,180,128,201,176,192,155,199,170,176,173,182,6,-29,35
226,110000,3c974920a76ac9c1,10,0,371,460,563,468,432,472,340,407,314,302,310,293,302,302,-17,8,-25
303,510000,3c974920a76ac9c1,10,0,350,453,570,500,253,378,337,331,336,304,330,449,390,361,119,26,93
153,340000,3c974920a76ac9c1,10,0,136,179,226,198,76,132,155,144,166,155,166,192,179,171,26,11,15
371,370000,3c974920a76ac9c1,10,0,394,483,601,468,290,412,484,450,432,449,413,563,488,475,150,-36,186
166,140000,3c974920a76ac9c1,10,0,233,215,260,248,146,249,182,251,173,213,197,239,218,216,42,-16,58
2740,440000,3c974920a76ac9c1,10,0,2711,3532,3800,2692,1680,2958,2368,2754,2696,2582,2782,2822,2802,2729,40,200,-160
304,450000,3c974920a76ac9c1,10,0,349,472,505,425,248,383,277,377,293,309,331,402,366,347,71,22,49
664,320000,3c974920a76ac9c1,10,0,764,871,1010,800,486,817,617,720,689,718,682,759,720,720,77,-36,113
152,360000,3c974920a76ac9c1,10,0,166,204,262,236,78,191,154,186,149,156,168,164,166,163,-4,12,-16
288,130000,3c974920a76ac9c1,10,0,228,291,305,260,190,297,311,328,293,325,352,363,358,347,11,27,-16
274,410000,3c974920a76ac9c1,10,0,351,521,505,405,250,355,393,307,297,380,309,344,326,344,35,-71,106
620,330000,3c974920a76ac9c1,10,0,702,660,865,633,409,621,561,562,591,624,669,649,659,647,-20,45,-65
246,420000,3c974920a76ac9c1,10,0,447,480,474,497,228,445,423,403,455,424,361,409,385,398,48,-63,111
238,430000,3c974920a76ac9c1,10,0,327,364,474,347,174,297,304,284,259,316,280,304,292,300,24,-36,60
299,350000,3c974920a76ac9c1,10,0,368,331,404,292,181,307,209,324,299,311,316,288,302,305,-28,5,-33
592,210000,3c974920a76ac9c1,10,0,769,941,997,650,566,775,692,738,626,805,715,744,730,755,29,-90,119
88,500000,3c974920a76ac9c1,10,0,120,155,199,115,72,126,107,119,138,135,104,119,112,119,15,-31,46
289,610000,3c974920a76ac9c1,10,0,324,393,440,305,219,295,292,328,285,305,307,293,300,302,-14,2,-16
234,230000,3c974920a76ac9c1,10,0,310,458,461,292,234,401,305,324,284,313,335,248,292,299,-87,22,-109
423,310000,3d7554f1f56dd664,10,0,271,639,518,268,263,442,321,383,408,481,506,615,560,534,109,25,84
430,530000,3d7554f1f56dd664,10,0,334,609,519,292,264,403,325,415,354,487,506,484,495,492,-22,19,-41
348,150000,3d7554f1f56dd664,10,0,216,370,337,175,149,316,260,258,252,263,332,312,322,302,-20,69,-89
261,110000,3d7554f1f56dd664,10,0,231,675,811,368,359,470,369,376,352,396,326,421,374,381,95,-70,165
668,510000,3d7554f1f56dd664,10,0,469,1053,1125,657,560,806,700,679,724,721,901,1021,961,881,120,180,-60
468,340000,3d7554f1f56dd664,10,0,253,574,507,301,225,317,315,350,352,460,517,524,520,500,7,57,-50
1251,370000,3d7554f1f56dd664,10,0,876,1567,1574,775,729,1060,1229,1119,1113,1342,1502,1693,1598,1512,191,160,31
477,140000,3d7554f1f56dd664,10,0,320,590,571,290,239,407,358,384,335,452,519,543,531,505,24,67,-43
10502,440000,3d7554f1f56dd664,10,0,6925,13598,11515,5136,4688,10371,8733,8990,9100,9110,10367,11177,10772,10218,810,1257,-447
949,450000,3d7554f1f56dd664,10,0,642,1386,1258,750,559,1074,832,939,901,1075,1222,1237,1230,1178,15,147,-132
2160,320000,3d7554f1f56dd664,10,0,1763,3112,2877,1445,1635,2184,1828,1916,1948,2090,2406,2465,2436,2320,59,316,-257
470,360000,3d7554f1f56dd664,10,0,356,595,741,435,311,545,463,483,513,576,577,634,606,596,57,1,56
1018,130000,3d7554f1f56dd664,10,0,520,1137,974,498,486,847,1025,993,829,1052,1183,1231,1207,1155,48,131,-83
861,410000,3d7554f1f56dd664,10,0,565,1273,1234,645,486,968,944,932,1043,1153,1163,1133,1148,1150,-30,10,-40
1801,330000,3d7554f1f56dd664,10,0,1293,2709,2467,1135,1205,1969,1744,1919,1847,2165,2419,2373,2396,2319,-46,254,-300
795,420000,3d7554f1f56dd664,10,0,742,1001,1050,703,508,734,619,699,876,984,989,1033,1011,1002,44,5,39
750,430000,3d7554f1f56dd664,10,0,582,1112,1192,689,445,769,687,748,707,821,1006,917,962,915,-89,185,-274
1443,350000,3d7554f1f56dd664,10,0,817,2205,1578,856,899,1607,1181,1494,1511,1522,1699,1828,1764,1683,129,177,-48
1842,210000,3d7554f1f56dd664,10,0,1064,2892,2161,1110,1306,1905,1837,1784,1845,2218,2361,2147,2254,2242,-214,143,-357
226,500000,3d7554f1f56dd664,10,0,173,470,398,244,215,285,259,240,371,328,317,303,310,316,-14,-11,-3
505,610000,3d7554f1f56dd664,10,0,375,582,607,340,260,369,435,466,394,526,525,529,527,527,4,-1,5
782,230000,3d7554f1f56dd664,10,0,480,1076,1018,447,521,1186,639,827,849,957,1229,987,1108,1058,-242,272,-514
105,310000,2d0d2c3403909fdb,10,0,112,163,167,157,101,187,162,155,200,158,195,163,179,172,-32,37,-69
296,530000,2d0d2c3403909fdb,10,0,218,354,350,290,213,293,226,236,265,410,329,332,330,357,3,-81,84
183,150000,2d0d2c3403909fdb,10,0,155,184,233,279,174,228,241,255,251,306,251,232,242,263,-19,-55,36
404,110000,2d0d2c3403909fdb,10,0,457,611,677,549,387,627,524,389,503,552,475,412,444,480,-63,-77,14
264,510000,2d0d2c3403909fdb,10,0,300,411,434,516,235,377,355,370,404,481,373,432,402,429,59,-108,167
116,340000,2d0d2c3403909fdb,10,0,129,128,138,176,83,127,116,129,142,151,124,165,144,147,41,-27,68
322,370000,2d0d2c3403909fdb,10,0,327,415,400,420,235,353,334,323,407,400,410,471,440,427,61,10,51
125,140000,2d0d2c3403909fdb,10,0,111,141,197,179,103,189,173,157,177,211,167,160,164,179,-7,-44,37
1468,440000,2d0d2c3403909fdb,10,0,1421,1989,1829,1713,1159,1738,1536,1581,1833,1828,1593,1985,1789,1802,392,-235,627
158,450000,2d0d2c3403909fdb,10,0,165,181,173,211,121,197,149,174,163,216,133,185,159,178,52,-83,135
350,320000,2d0d2c3403909fdb,10,0,333,437,427,470,296,446,386,375,444,454,461,476,468,464,15,7,8
120,360000,2d0d2c3403909fdb,10,0,90,107,109,126,55,113,112,112,126,130,154,177,166,154,23,24,-1
300,130000,2d0d2c3403909fdb,10,0,274,302,328,389,251,371,364,437,425,531,444,375,410,450,-69,-87,18
301,410000,2d0d2c3403909fdb,10,0,262,352,337,377,202,331,306,338,396,390,320,382,351,364,62,-70,132
383,330000,2d0d2c3403909fdb,10,0,342,428,424,401,264,349,335,366,380,435,444,478,461,452,34,9,25
194,420000,2d0d2c3403909fdb,10,0,211,267,280,321,189,271,255,230,322,292,267,293,280,284,26,-25,51
216,430000,2d0d2c3403909fdb,10,0,211,244,275,284,146,275,262,250,285,292,286,299,292,292,13,-6,19
102,350000,2d0d2c3403909fdb,10,0,106,151,157,167,81,107,85,111,132,133,94,129,112,119,35,-39,74
506,210000,2d0d2c3403909fdb,10,0,346,464,567,506,316,529,433,489,457,606,708,531,620,615,-177,102,-279
114,500000,2d0d2c3403909fdb,10,0,138,184,155,213,116,188,148,168,179,203,176,174,175,184,-2,-27,25
201,610000,2d0d2c3403909fdb,10,0,195,252,267,297,206,288,291,280,277,346,254,290,272,297,36,-92,128
191,230000,2d0d2c3403909fdb,10,0,208,258,336,315,155,306,267,240,317,304,316,199,258,273,-117,12,-129
204,310000,a28bb927b6fcb33c,10,0,166,212,210,117,96,135,131,161,142,167,201,221,211,196,20,34,-14
317,530000,a28bb927b6fcb33c,10,0,209,270,308,173,110,159,185,191,176,253,332,399,366,328,67,79,-12
226,150000,a28bb927b6fcb33c,10,0,128,165,176,89,72,136,148,139,117,145,167,204,186,172,37,22,15
150,110000,a28bb927b6fcb33c,10,0,179,246,342,136,109,179,166,96,85,131,159,164,162,151,5,28,-23
370,510000,a28bb927b6fcb33c,10,0,401,438,436,351,212,361,425,290,324,427,553,667,610,549,114,126,-12
363,340000,a28bb927b6fcb33c,10,0,250,325,348,264,151,204,182,203,195,266,313,338,326,306,25,47,-22
587,370000,a28bb927b6fcb33c,10,0,454,468,556,225,175,357,467,449,285,377,522,729,626,543,207,145,62
208,140000,a28bb927b6fcb33c,10,0,181,144,181,92,70,148,181,165,127,190,198,230,214,206,32,8,24
4889,440000,a28bb927b6fcb33c,10,0,4012,4216,4195,2391,1639,3992,3988,3668,3906,4522,4949,5596,5272,5022,647,427,220
553,450000,a28bb927b6fcb33c,10,0,331,432,386,248,166,443,418,434,344,461,540,630,585,544,90,79,11
1213,320000,a28bb927b6fcb33c,10,0,943,1033,1154,680,651,982,1039,1051,947,1072,1268,1400,1334,1247,132,196,-64
466,360000,a28bb927b6fcb33c,10,0,260,302,351,208,96,254,328,298,271,331,451,520,486,434,69,120,-51
615,130000,a28bb927b6fcb33c,10,0,385,397,419,248,284,584,570,485,345,559,623,645,634,609,22,64,-42
726,410000,a28bb927b6fcb33c,10,0,556,567,651,338,242,578,638,439,516,644,816,854,835,771,38,172,-134
1466,330000,a28bb927b6fcb33c,10,0,1228,1343,1310,747,739,1438,1404,1200,1131,1522,1730,1887,1808,1713,157,208,-51
873,420000,a28bb927b6fcb33c,10,0,726,677,787,450,226,461,459,468,446,524,665,780,722,656,115,141,-26
679,430000,a28bb927b6fcb33c,10,0,436,474,674,394,223,436,554,554,548,663,787,891,839,780,104,124,-20
837,350000,a28bb927b6fcb33c,10,0,563,615,519,231,173,535,612,676,709,737,966,1034,1000,912,68,229,-161
690,210000,a28bb927b6fcb33c,10,0,522,652,848,213,233,610,646,562,459,596,792,810,801,733,18,196,-178
168,500000,a28bb927b6fcb33c,10,0,150,157,208,123,85,166,157,116,162,140,173,200,186,171,27,33,-6
333,610000,a28bb927b6fcb33c,10,0,219,225,317,148,105,202,242,221,226,279,358,344,351,327,-14,79,-93
327,230000,a28bb927b6fcb33c,10,0,222,288,303,90,85,233,244,241,205,236,349,303,326,296,-46,113,-159
192,310000,17bc272c93f19d56,10,0,168,249,477,199,177,267,169,193,170,168,208,216,212,197,8,40,-32
3585,530000,17bc272c93f19d56,10,0,3096,3216,4503,4785,3067,2754,2281,2227,1995,2206,1981,2469,2225,2219,488,-225,713
506,150000,17bc272c93f19d56,10,0,360,520,675,504,451,680,487,440,356,384,433,467,450,428,34,49,-15
106,110000,17bc272c93f19d56,10,0,199,305,514,151,92,197,124,132,112,101,80,136,108,106,56,-21,77
1321,510000,17bc272c93f19d56,10,0,1007,1411,1954,1724,1537,1481,1090,1021,990,1018,1119,1242,1180,1126,123,101,22
1339,340000,17bc272c93f19d56,10,0,1238,1535,2328,2152,1881,1518,1284,1266,1165,1072,1126,1266,1196,1155,140,54,86
3229,370000,17bc272c93f19d56,10,0,3268,3907,6576,4483,3060,2839,2545,2879,2279,2583,2917,2744,2830,2748,-173,334,-507
1662,140000,17bc272c93f19d56,10,0,1354,1585,2844,2093,1361,1353,1118,1259,955,1154,1235,1338,1286,1242,103,81,22
1696,440000,17bc272c93f19d56,10,0,1555,2007,3029,1611,1579,2180,1684,1684,1682,1409,1573,1720,1646,1567,147,164,-17
1586,450000,17bc272c93f19d56,10,0,2293,2687,4443,3084,1836,2310,1540,1616,1343,1308,1943,1360,1652,1537,-583,635,-1218
1865,320000,17bc272c93f19d56,10,0,1493,1942,3067,2165,2419,2029,1601,1578,1375,1523,1501,1651,1576,1558,150,-22,172
811,360000,17bc272c93f19d56,10,0,824,980,1510,1290,922,875,668,648,536,537,656,666,661,620,10,119,-109
3344,130000,17bc272c93f19d56,10,0,2808,3641,6231,3870,3403,2945,3015,3119,2522,2789,2808,2753,2780,2783,-55,19,-74
3259,410000,17bc272c93f19d56,10,0,3821,4668,7650,5825,3564,3197,2704,2715,2598,2658,2563,2664,2614,2628,101,-95,196
1309,330000,17bc272c93f19d56,10,0,1112,1294,2062,1260,1629,1592,1156,1224,1121,1218,1188,1319,1254,1242,131,-30,161
1151,420000,17bc272c93f19d56,10,0,958,1353,2198,1919,1140,1262,895,1069,835,836,949,1018,984,934,69,113,-44
1214,430000,17bc272c93f19d56,10,0,1354,1770,2693,2364,1506,1541,1174,1020,997,939,1035,1185,1110,1053,150,96,54
437,350000,17bc272c93f19d56,10,0,523,688,892,592,650,741,463,546,473,389,402,400,401,397,-2,13,-15
839,210000,17bc272c93f19d56,10,0,824,1154,1710,924,939,1322,959,988,854,912,964,1041,1002,972,77,52,25
244,500000,17bc272c93f19d56,10,0,201,250,357,250,248,235,212,191,173,197,218,241,230,219,23,21,2
1562,610000,17bc272c93f19d56,10,0,1590,1877,3217,2072,1105,1314,1222,1105,910,1051,1117,1406,1262,1191,289,66,223
569,230000,17bc272c93f19d56,10,0,518,816,982,506,518,806,657,585,602,530,544,540,542,538,-4,14,-18
276,310000,2a2ab41f8f6ff1cb,10,0,272,582,623,382,114,351,229,285,289,234,347,399,373,327,52,113,-61
556,530000,2a2ab41f8f6ff1cb,10,0,553,546,680,484,300,452,403,419,390,633,639,493,566,588,-146,6,-152
628,150000,2a2ab41f8f6ff1cb,10,0,715,836,832,551,317,489,505,604,525,595,623,640,632,619,17,28,-11
95,110000,2a2ab41f8f6ff1cb,10,0,362,440,598,212,102,180,142,124,93,130,133,130,132,131,-3,3,-6
933,510000,2a2ab41f8f6ff1cb,10,0,1050,1385,1850,1223,671,850,790,838,870,1020,1346,1101,1224,1156,-245,326,-571
1138,340000,2a2ab41f8f6ff1cb,10,0,1256,1491,1666,1515,717,1018,980,1077,1165,1206,1280,1168,1224,1218,-112,74,-186
2178,370000,2a2ab41f8f6ff1cb,10,0,2061,2146,2737,1706,842,1734,1902,2031,1983,2192,2226,2022,2124,2147,-204,34,-238
692,140000,2a2ab41f8f6ff1cb,10,0,724,762,993,533,312,595,582,569,606,683,717,614,666,671,-103,34,-137
5896,440000,2a2ab41f8f6ff1cb,10,0,6582,6734,6492,5607,2647,5713,4896,5717,5445,4899,5914,5863,5888,5559,-51,1015,-1066
660,450000,2a2ab41f8f6ff1cb,10,0,743,853,894,799,409,719,453,603,532,611,719,734,726,688,15,108,-93
1874,320000,2a2ab41f8f6ff1cb,10,0,2283,2584,2672,1728,1016,1729,1498,1701,1735,1850,1857,1722,1790,1810,-135,7,-142
884,360000,2a2ab41f8f6ff1cb,10,0,1065,1086,1291,1027,356,690,687,838,753,813,1041,905,973,920,-136,228,-364
2420,130000,2a2ab41f8f6ff1cb,10,0,2277,2327,2703,2119,1271,2126,2486,2863,2426,2914,2989,2361,2675,2755,-628,75,-703
2531,410000,2a2ab41f8f6ff1cb,10,0,2827,2797,3447,2952,1308,2514,2566,2841,2880,3363,3319,2677,2998,3120,-642,-44,-598
1255,330000,2a2ab41f8f6ff1cb,10,0,1262,1632,1972,795,459,876,905,1141,1077,1165,1379,1241,1310,1262,-138,214,-352
1247,420000,2a2ab41f8f6ff1cb,10,0,1686,1663,2151,1566,597,1095,1029,1047,1133,1293,1344,1288,1316,1308,-56,51,-107
1432,430000,2a2ab41f8f6ff1cb,10,0,2247,1966,2770,1651,844,1487,1573,1636,1382,1564,1802,1482,1642,1616,-320,238,-558
415,350000,2a2ab41f8f6ff1cb,10,0,371,447,476,264,148,314,267,427,418,348,436,384,410,389,-52,88,-140
449,210000,2a2ab41f8f6ff1cb,10,0,317,403,513,241,211,360,293,362,342,372,462,408,435,414,-54,90,-144
475,500000,2a2ab41f8f6ff1cb,10,0,646,803,1149,803,328,472,453,543,623,549,633,579,606,587,-54,84,-138
626,610000,2a2ab41f8f6ff1cb,10,0,665,655,845,620,247,468,497,551,436,566,577,553,565,565,-24,11,-35
502,230000,2a2ab41f8f6ff1cb,10,0,544,740,1032,399,306,506,449,585,503,512,594,572,583,559,-22,82,-104
958,310000,c06a2a387c0ee510,10,0,710,977,1212,1265,890,1247,1119,1184,1456,1316,1194,1258,1226,1256,64,-122,186
190,530000,c06a2a387c0ee510,10,0,45,66,119,104,63,214,133,132,248,173,187,150,168,170,-37,14,-51
137,150000,c06a2a387c0ee510,10,0,43,56,75,86,64,154,131,164,163,146,193,187,190,175,-6,47,-53
1056,110000,c06a2a387c0ee510,10,0,677,793,1627,1352,1114,1508,1132,1430,1670,1367,1416,1463,1440,1415,47,49,-2
254,510000,c06a2a387c0ee510,10,0,102,145,321,208,187,254,335,308,285,276,420,431,426,376,11,144,-133
291,340000,c06a2a387c0ee510,10,0,145,176,251,253,175,322,340,315,352,311,384,398,391,364,14,73,-59
1189,370000,c06a2a387c0ee510,10,0,494,739,1047,878,649,1303,1248,1216,1405,1283,1284,1321,1302,1296,37,1,36
209,140000,c06a2a387c0ee510,10,0,83,105,184,165,123,244,320,272,242,233,292,344,318,290,52,59,-7
946,440000,c06a2a387c0ee510,10,0,463,571,819,762,448,944,1100,1025,1038,994,984,1134,1059,1037,150,-10,160
97,450000,c06a2a387c0ee510,10,0,87,45,96,92,54,103,134,119,86,123,99,126,112,116,27,-24,51
1121,320000,c06a2a387c0ee510,10,0,563,731,1002,974,650,1188,1289,1048,1276,1137,1253,1328,1290,1239,75,116,-41
178,360000,c06a2a387c0ee510,10,0,43,74,97,118,85,164,140,153,162,165,154,204,179,174,50,-11,61
579,130000,c06a2a387c0ee510,10,0,232,288,493,470,361,599,660,769,569,656,773,873,823,767,100,117,-17
743,410000,c06a2a387c0ee510,10,0,282,366,596,517,345,763,731,685,764,754,849,909,879,837,60,95,-35
743,330000,c06a2a387c0ee510,10,0,278,533,736,534,424,754,915,865,808,908,999,1113,1056,1007,114,91,23
205,420000,c06a2a387c0ee510,10,0,66,94,173,151,103,240,253,187,234,272,286,270,278,276,-16,14,-30
170,430000,c06a2a387c0ee510,10,0,60,83,119,101,59,203,163,182,206,192,239,250,244,227,11,47,-36
181,350000,c06a2a387c0ee510,10,0,106,97,170,123,106,206,303,187,204,204,249,241,245,231,-8,45,-53
296,210000,c06a2a387c0ee510,10,0,111,151,300,181,154,357,324,363,378,413,435,413,424,420,-22,22,-44
111,500000,c06a2a387c0ee510,10,0,43,58,100,60,71,130,181,128,151,124,150,168,159,147,18,26,-8
291,610000,c06a2a387c0ee510,10,0,136,164,313,234,179,320,305,340,358,313,390,434,412,379,44,77,-33
192,230000,c06a2a387c0ee510,10,0,76,95,177,129,74,323,185,255,260,224,227,281,254,244,54,3,51
325,310000,7023efdab9cedc03,10,0,431,543,697,325,168,288,309,527,516,379,272,357,314,336,85,-107,192
89,530000,7023efdab9cedc03,10,0,64,106,112,40,25,38,54,68,55,75,116,109,112,100,-7,41,-48
46,150000,7023efdab9cedc03,10,0,48,60,75,31,18,29,46,51,51,61,78,46,62,62,-32,17,-49
85,110000,7023efdab9cedc03,10,0,59,86,132,40,51,59,50,54,60,151,111,68,90,110,-43,-40,-3
295,510000,7023efdab9cedc03,10,0,187,278,408,216,117,192,175,229,259,209,437,371,404,339,-66,228,-294
356,340000,7023efdab9cedc03,10,0,363,447,587,357,148,207,278,368,463,445,401,385,393,410,-16,-44,28
263,370000,7023efdab9cedc03,10,0,437,477,555,320,180,373,400,374,355,402,517,287,402,402,-230,115,-345
63,140000,7023efdab9cedc03,10,0,59,55,64,30,23,28,38,44,60,71,103,47,75,74,-56,32,-88
420,440000,7023efdab9cedc03,10,0,225,342,408,121,39,166,158,211,185,222,453,438,446,371,-15,231,-246
131,450000,7023efdab9cedc03,10,0,66,86,129,68,34,47,50,71,60,56,125,119,122,100,-6,69,-75
797,320000,7023efdab9cedc03,10,0,1156,1271,1767,893,628,788,879,1067,1002,995,690,648,669,778,-42,-305,263
189,360000,7023efdab9cedc03,10,0,175,224,302,169,92,161,188,202,170,233,263,198,230,231,-65,30,-95
211,130000,7023efdab9cedc03,10,0,129,127,215,80,56,93,108,163,149,199,289,190,240,226,-99,90,-189
272,410000,7023efdab9cedc03,10,0,257,320,368,183,97,185,329,340,259,262,298,278,288,279,-20,36,-56
593,330000,7023efdab9cedc03,10,0,742,941,1163,445,309,478,511,775,845,706,532,466,499,568,-66,-174,108
251,420000,7023efdab9cedc03,10,0,233,287,401,211,94,172,184,195,243,185,256,244,250,228,-12,71,-83
183,430000,7023efdab9cedc03,10,0,182,259,315,201,83,173,167,198,189,202,231,221,226,218,-10,29,-39
185,350000,7023efdab9cedc03,10,0,70,117,145,54,20,51,78,114,140,134,168,156,162,153,-12,34,-46
81,210000,7023efdab9cedc03,10,0,81,68,104,28,21,52,82,45,37,92,119,77,98,96,-42,27,-69
99,500000,7023efdab9cedc03,10,0,40,57,62,28,20,37,37,33,64,92,101,91,96,95,-10,9,-19
146,610000,7023efdab9cedc03,10,0,141,113,177,107,51,78,83,124,102,102,142,134,138,126,-8,40,-48
21,230000,7023efdab9cedc03,10,0,29,28,30,11,11,8,18,20,17,27,60,33,46,40,-27,33,-60
870,310000,af6f4f548684e14d,10,0,851,1537,1734,940,540,957,807,919,933,755,914,982,948,884,68,159,-91
355,530000,af6f4f548684e14d,10,0,464,639,732,400,288,346,301,327,290,401,329,345,337,358,16,-72,88
398,150000,af6f4f548684e14d,10,0,433,493,573,322,195,323,333,363,302,240,293,382,338,305,89,53,36
373,110000,af6f4f548684e14d,10,0,532,915,1057,659,394,601,489,595,532,503,449,472,460,475,23,-54,77
888,510000,af6f4f548684e14d,10,0,1020,1293,1876,1072,611,873,761,808,800,793,898,1218,1058,970,320,105,215
977,340000,af6f4f548684e14d,10,0,1018,1287,1597,1015,457,773,664,769,751,688,875,1020,948,861,145,187,-42
1080,370000,af6f4f548684e14d,10,0,1547,1722,2394,1077,522,1253,1236,1215,1019,955,1078,1388,1233,1140,310,123,187
532,140000,af6f4f548684e14d,10,0,489,581,742,375,248,450,310,404,335,340,378,448,413,389,70,38,32
1071,440000,af6f4f548684e14d,10,0,1508,2163,2594,949,463,1024,892,976,1062,838,972,1048,1010,953,76,134,-58
338,450000,af6f4f548684e14d,10,0,373,502,713,341,210,322,222,345,302,257,262,298,280,272,36,5,31
1407,320000,af6f4f548684e14d,10,0,1635,2059,2647,1466,939,1519,1181,1355,1281,1072,1305,1574,1440,1317,269,233,36
1037,360000,af6f4f548684e14d,10,0,900,1083,1527,753,397,757,746,837,677,745,886,1080,983,904,194,141,53
740,130000,af6f4f548684e14d,10,0,828,1012,1235,691,404,655,694,773,655,680,691,793,742,721,102,11,91
1099,410000,af6f4f548684e14d,10,0,1191,1470,2122,1000,589,1119,1013,903,937,951,1080,1247,1164,1093,167,129,38
1153,330000,af6f4f548684e14d,10,0,1090,1626,2068,1003,537,978,796,1015,879,797,986,1136,1061,973,150,189,-39
1214,420000,af6f4f548684e14d,10,0,1284,1519,1632,1025,485,1058,873,1015,949,835,965,1376,1170,1059,411,130,281
1057,430000,af6f4f548684e14d,10,0,1168,1619,2178,1217,467,1068,962,1084,875,893,959,1329,1144,1060,370,66,304
518,350000,af6f4f548684e14d,10,0,568,767,913,522,257,433,373,497,408,356,398,487,442,414,89,42,47
320,210000,af6f4f548684e14d,10,0,407,443,594,254,172,277,329,290,263,262,428,438,433,376,10,166,-156
312,500000,af6f4f548684e14d,10,0,354,500,762,420,252,342,321,324,387,329,286,390,338,335,104,-43,147
398,610000,af6f4f548684e14d,10,0,444,478,651,365,184,306,238,357,732,447,312,423,368,394,111,-135,246
179,230000,af6f4f548684e14d,10,0,203,289,372,142,121,207,187,231,186,143,232,203,218,193,-29,89,-118
691,310000,7cf283430b3b5e38,10,0,1261,1546,1428,635,513,975,1070,1137,2596,1172,1207,1337,1272,1239,130,35,95
362,530000,7cf283430b3b5e38,10,0,350,412,626,249,167,333,316,408,510,602,649,565,607,605,-84,47,-131
372,150000,7cf283430b3b5e38,10,0,451,516,701,285,178,320,330,439,413,440,575,685,630,567,110,135,-25
37,110000,7cf283430b3b5e38,10,0,174,264,913,106,74,113,101,453,335,314,124,110,117,183,-14,-190,176
1415,510000,7cf283430b3b5e38,10,0,1555,1783,2691,1134,763,1522,1501,1649,1954,1996,2318,2175,2246,2163,-143,322,-465
1480,340000,7cf283430b3b5e38,10,0,2110,2138,2356,1607,968,1908,2068,2171,2517,2384,2828,2098,2463,2437,-730,444,-1174
2802,370000,7cf283430b3b5e38,10,0,3911,3787,4830,2048,1323,3138,3779,4223,3954,4263,5234,4184,4709,4560,-1050,971,-2021
750,140000,7cf283430b3b5e38,10,0,678,852,1073,317,283,629,610,883,1085,1017,1391,967,1179,1125,-424,374,-798
2176,440000,7cf283430b3b5e38,10,0,1912,2435,2500,695,488,1495,1512,1848,2203,1964,2643,2750,2696,2452,107,679,-572
598,450000,7cf283430b3b5e38,10,0,646,783,869,475,293,738,554,830,966,1021,1065,1006,1036,1031,-59,44,-103
3479,320000,7cf283430b3b5e38,10,0,5170,5016,5865,2657,2401,4119,4083,4704,4995,4877,5866,4453,5160,5065,-1413,989,-2402
1261,360000,7cf283430b3b5e38,10,0,1175,1376,1737,923,549,1502,1828,1895,1662,1811,1988,1776,1882,1858,-212,177,-389
1711,130000,7cf283430b3b5e38,10,0,1672,1926,2621,900,720,1379,2198,2809,2761,2856,3219,1969,2594,2681,-1250,363,-1613
2328,410000,7cf283430b3b5e38,10,0,2644,2874,3243,1683,1042,2558,3199,3067,3400,3871,4333,3047,3690,3750,-1286,462,-1748
2554,330000,7cf283430b3b5e38,10,0,3003,3295,3490,1289,1038,1965,1876,2506,2778,3135,3712,3209,3460,3352,-503,577,-1080
1162,420000,7cf283430b3b5e38,10,0,1500,1547,1624,929,480,1234,1278,1437,1882,1699,1835,1719,1777,1751,-116,136,-252
1239,430000,7cf283430b3b5e38,10,0,1457,1585,1952,989,516,1513,1616,1696,1720,1686,2057,2090,2074,1944,33,371,-338
1081,350000,7cf283430b3b5e38,10,0,836,1130,958,546,402,859,878,1319,1184,1258,1327,1317,1322,1301,-10,69,-79
497,210000,7cf283430b3b5e38,10,0,540,619,821,205,149,446,498,474,571,727,964,874,919,855,-90,237,-327
413,500000,7cf283430b3b5e38,10,0,422,419,597,296,163,296,401,429,660,507,590,674,632,590,84,83,1
626,610000,7cf283430b3b5e38,10,0,891,912,1151,413,242,475,689,883,1688,1091,1205,1047,1126,1114,-158,114,-272
247,230000,7cf283430b3b5e38,10,0,250,347,415,118,130,301,193,254,310,279,412,382,397,358,-30,133,-163
99,310000,d4efbebb087fd03f,10,0,144,225,270,79,27,45,95,103,101,83,103,129,116,105,26,20,6
422,530000,d4efbebb087fd03f,10,0,192,267,384,296,172,285,192,231,213,247,282,327,304,285,45,35,10
274,150000,d4efbebb087fd03f,10,0,237,359,450,248,124,211,203,178,177,181,202,244,223,209,42,21,21
268,110000,d4efbebb087fd03f,10,0,684,938,1287,118,74,556,952,1106,818,968,836,546,691,783,-290,-132,-158
1092,510000,d4efbebb087fd03f,10,0,707,1002,2805,1326,797,891,676,702,734,761,905,1065,985,910,160,144,16
828,340000,d4efbebb087fd03f,10,0,716,977,1443,903,436,535,520,582,612,532,660,692,676,628,32,128,-96
1960,370000,d4efbebb087fd03f,10,0,1752,2198,3785,1878,1009,1343,1575,1488,1335,1337,1747,1744,1746,1609,-3,410,-413
746,140000,d4efbebb087fd03f,10,0,370,1993,2925,603,248,417,464,574,426,448,540,518,529,502,-22,92,-114
1591,440000,d4efbebb087fd03f,10,0,1065,2044,2419,914,399,1078,1095,1082,1215,1038,1245,1500,1372,1261,255,207,48
719,450000,d4efbebb087fd03f,10,0,368,493,935,666,303,492,403,512,470,474,495,629,562,533,134,21,113
1078,320000,d4efbebb087fd03f,10,0,1184,1531,2308,910,648,752,1041,985,944,821,908,982,945,904,74,87,-13
910,360000,d4efbebb087fd03f,10,0,701,917,1377,999,364,509,561,555,561,469,643,721,682,611,78,174,-96
1362,130000,d4efbebb087fd03f,10,0,754,1144,2067,1110,641,741,953,1002,876,936,1050,1031,1040,1006,-19,114,-133
2212,410000,d4efbebb087fd03f,10,0,1090,1965,3560,2272,888,1199,1423,1368,1487,1652,1740,1822,1781,1738,82,88,-6
2752,330000,d4efbebb087fd03f,10,0,2287,3147,4324,1028,639,1114,1097,2340,1882,1700,2222,2001,2112,1974,-221,522,-743
723,420000,d4efbebb087fd03f,10,0,521,941,1534,1004,347,476,456,410,475,460,525,1167,846,717,642,65,577
980,430000,d4efbebb087fd03f,10,0,762,1142,1719,1133,438,685,688,650,716,659,750,1015,882,808,265,91,174
965,350000,d4efbebb087fd03f,10,0,468,762,1967,434,268,656,565,712,722,602,609,775,692,662,166,7,159
253,210000,d4efbebb087fd03f,10,0,239,291,520,199,149,205,202,188,167,160,157,192,174,170,35,-3,38
485,500000,d4efbebb087fd03f,10,0,253,326,532,432,291,409,310,302,286,280,366,470,418,372,104,86,18
1331,610000,d4efbebb087fd03f,10,0,830,1010,1651,919,422,609,612,587,580,1155,818,1081,950,1018,263,-337,600
80,230000,d4efbebb087fd03f,10,0,114,204,257,135,104,114,128,104,132,112,136,138,137,129,2,24,-22
47,310000,7245e0ee27b195cd,10,0,75,125,158,63,40,60,51,45,46,45,48,64,56,52,16,3,13
421,530000,7245e0ee27b195cd,10,0,425,375,535,421,246,288,240,252,266,378,341,384,362,368,43,-37,80
330,150000,7245e0ee27b195cd,10,0,287,448,676,363,164,250,212,180,206,169,180,292,236,214,112,11,101
56,110000,7245e0ee27b195cd,10,0,289,360,496,86,74,109,80,71,61,54,68,80,74,67,12,14,-2
881,510000,7245e0ee27b195cd,10,0,870,831,1260,724,451,621,526,535,628,654,720,912,816,762,192,66,126
556,340000,7245e0ee27b195cd,10,0,478,510,806,576,272,358,315,316,346,322,391,446,418,386,55,69,-14
1444,370000,7245e0ee27b195cd,10,0,1660,1778,2915,1529,762,977,1071,1025,958,930,1153,1156,1154,1080,3,223,-220
804,140000,7245e0ee27b195cd,10,0,689,668,1092,615,366,578,543,590,543,530,702,862,782,698,160,172,-12
961,440000,7245e0ee27b195cd,10,0,1170,1384,1437,718,363,821,836,734,867,743,867,1000,934,870,133,124,9
428,450000,7245e0ee27b195cd,10,0,321,463,659,452,233,370,288,292,316,346,373,423,398,381,50,27,23
651,320000,7245e0ee27b195cd,10,0,691,743,1008,543,405,518,460,406,448,428,481,488,484,466,7,53,-46
444,360000,7245e0ee27b195cd,10,0,518,577,816,634,247,323,301,331,301,285,348,422,385,352,74,63,11
1511,130000,7245e0ee27b195cd,10,0,1308,1432,2365,1304,951,1023,1070,1210,930,1140,1221,1304,1262,1222,83,81,2
1386,410000,7245e0ee27b195cd,10,0,1148,1406,2228,1526,717,888,888,823,850,1053,1131,1233,1182,1139,102,78,24
628,330000,7245e0ee27b195cd,10,0,660,874,1121,438,306,511,460,520,507,491,573,625,599,563,52,82,-30
502,420000,7245e0ee27b195cd,10,0,534,655,903,635,255,364,342,325,362,407,342,478,410,409,136,-65,201
693,430000,7245e0ee27b195cd,10,0,609,763,1216,773,321,479,531,540,517,429,513,640,576,527,127,84,43
264,350000,7245e0ee27b195cd,10,0,218,239,420,249,153,274,195,252,248,212,300,311,306,274,11,88,-77
358,210000,7245e0ee27b195cd,10,0,328,514,641,287,222,321,326,279,247,251,291,348,320,297,57,40,17
335,500000,7245e0ee27b195cd,10,0,272,292,402,296,142,238,207,233,232,240,260,352,306,284,92,20,72
802,610000,7245e0ee27b195cd,10,0,729,755,1158,815,410,484,484,492,471,470,664,857,760,664,193,194,-1
279,230000,7245e0ee27b195cd,10,0,176,328,336,166,145,205,161,183,216,199,211,200,206,203,-11,12,-23
70,310000,8c915fe4632fb9fa,10,0,158,314,461,180,102,190,125,145,92,77,83,77,80,79,-6,6,-12
737,530000,8c915fe4632fb9fa,10,0,627,757,1396,1059,575,778,650,682,486,654,573,601,587,609,28,-81,109
477,150000,8c915fe4632fb9fa,10,0,324,527,720,520,270,473,409,472,356,344,415,453,434,404,38,71,-33
36,110000,8c915fe4632fb9fa,10,0,199,242,487,101,86,162,127,117,78,41,43,61,52,48,18,2,16
1043,510000,8c915fe4632fb9fa,10,0,1243,1605,2433,1860,1194,1302,1156,1192,925,872,1055,1302,1178,1076,247,183,64
974,340000,8c915fe4632fb9fa,10,0,1269,1370,2298,1440,720,878,861,934,738,651,739,952,846,781,213,88,125
1648,370000,8c915fe4632fb9fa,10,0,1686,2126,3804,2217,1109,1504,1812,1956,1321,1432,1563,1725,1644,1573,162,131,31
673,140000,8c915fe4632fb9fa,10,0,642,748,1215,772,404,591,661,732,531,562,597,623,610,594,26,35,-9
797,440000,8c915fe4632fb9fa,10,0,848,1467,2021,1040,446,977,1064,948,854,663,649,829,739,714,180,-14,194
395,450000,8c915fe4632fb9fa,10,0,388,511,880,738,330,660,454,586,385,399,303,460,382,387,157,-96,253
1065,320000,8c915fe4632fb9fa,10,0,1451,1816,2525,1540,1130,1441,1246,1265,930,913,863,957,910,911,94,-50,144
678,360000,8c915fe4632fb9fa,10,0,733,889,1320,1015,377,598,631,632,491,445,477,574,526,499,97,32,65
1628,130000,8c915fe4632fb9fa,10,0,1548,2026,3281,1882,1126,1456,2041,2368,1518,1714,1628,1540,1584,1627,-88,-86,-2
1530,410000,8c915fe4632fb9fa,10,0,1473,1843,2975,2324,1002,1413,1518,1509,1135,1362,1395,1473,1434,1410,78,33,45
965,330000,8c915fe4632fb9fa,10,0,1175,1502,2235,958,565,880,893,948,697,814,804,930,867,849,126,-10,136
791,420000,8c915fe4632fb9fa,10,0,924,1339,1557,1148,463,782,723,758,663,696,627,825,726,716,198,-69,267
664,430000,8c915fe4632fb9fa,10,0,772,835,1281,1235,439,733,664,655,498,506,508,651,580,555,143,2,141
330,350000,8c915fe4632fb9fa,10,0,414,622,877,518,365,529,461,541,380,328,306,337,322,324,31,-22,53
298,210000,8c915fe4632fb9fa,10,0,296,396,542,311,224,349,397,405,266,303,286,359,322,316,73,-17,90
284,500000,8c915fe4632fb9fa,10,0,316,419,666,489,274,346,334,368,358,284,258,335,296,292,77,-26,103
672,610000,8c915fe4632fb9fa,10,0,627,715,1549,1036,394,463,535,597,405,487,551,603,577,547,52,64,-12
481,230000,8c915fe4632fb9fa,10,0,411,616,998,401,372,684,679,736,526,592,672,585,628,616,-87,80,-167
244,310000,6155b214590c66e6,10,0,472,781,1047,423,192,279,354,355,429,362,376,371,374,370,-5,14,-19
1360,530000,6155b214590c66e6,10,0,1148,1159,1879,1354,680,631,992,1295,955,1148,1036,994,1015,1059,-42,-112,70
923,150000,6155b214590c66e6,10,0,701,941,1442,814,347,566,786,1042,724,802,839,925,882,855,86,37,49
235,110000,6155b214590c66e6,10,0,474,569,1295,274,176,281,280,376,386,433,291,293,292,339,2,-142,144
1859,510000,6155b214590c66e6,10,0,1556,2162,4188,2540,1081,1111,1488,1668,1412,1619,1860,2342,2101,1940,482,241,241
1690,340000,6155b214590c66e6,10,0,1889,2073,3650,2495,863,893,1218,1582,1360,1404,1555,1685,1620,1548,130,151,-21
3085,370000,6155b214590c66e6,10,0,3252,3594,6275,3467,1356,2002,3249,3444,2666,3057,2942,3377,3160,3125,435,-115,550
936,140000,6155b214590c66e6,10,0,800,914,1576,743,357,500,790,998,720,798,855,911,883,855,56,57,-1
2021,440000,6155b214590c66e6,10,0,2902,3269,4342,1784,653,1364,1722,2162,2247,2038,2128,2302,2215,2156,174,90,84
620,450000,6155b214590c66e6,10,0,621,739,1316,892,381,556,538,802,574,699,609,693,651,667,84,-90,174
2663,320000,6155b214590c66e6,10,0,3560,3776,5864,3032,1760,2316,2607,3244,2604,2564,2570,2743,2656,2626,173,6,167
1043,360000,6155b214590c66e6,10,0,1195,1285,2160,1579,453,603,962,960,811,902,887,1133,1010,974,246,-15,261
2211,130000,6155b214590c66e6,10,0,2298,2594,4551,2375,1231,1427,2467,3049,2213,2567,2481,2466,2474,2505,-15,-86,71
3184,410000,6155b214590c66e6,10,0,3427,4047,8018,5309,1586,1915,2716,3025,2701,2930,3143,3339,3241,3137,196,213,-17
2198,330000,6155b214590c66e6,10,0,2724,3014,4336,1679,826,1161,1890,2275,1899,2230,2234,2335,2284,2266,101,4,97
1417,420000,6155b214590c66e6,10,0,1512,1848,3179,2049,551,906,1028,1278,1264,1359,1217,1693,1455,1423,476,-142,618
1640,430000,6155b214590c66e6,10,0,1872,2355,3747,2461,732,1157,1395,1621,1288,1479,1482,1887,1684,1616,405,3,402
786,350000,6155b214590c66e6,10,0,859,1140,1306,596,364,463,616,759,757,740,708,723,716,724,15,-32,47
952,210000,6155b214590c66e6,10,0,970,1188,1784,769,415,765,1227,1203,969,1200,1102,1144,1123,1149,42,-98,140
742,500000,6155b214590c66e6,10,0,622,761,1417,877,373,399,529,594,627,619,620,836,728,692,216,1,215
1016,610000,6155b214590c66e6,10,0,899,841,1546,1008,303,361,648,917,661,790,773,918,846,827,145,-17,162
758,230000,6155b214590c66e6,10,0,517,944,1290,579,365,604,725,778,831,876,865,867,866,869,2,-11,13
517,310000,28e29f2c03dcd84c,10,0,623,807,1293,851,433,764,667,727,689,522,968,719,844,736,-249,446,-695
370,530000,28e29f2c03dcd84c,10,0,394,535,639,509,300,415,361,462,414,443,436,471,454,450,35,-7,42
533,150000,28e29f2c03dcd84c,10,0,477,451,580,494,276,556,527,562,528,446,576,531,554,518,-45,130,-175
705,110000,28e29f2c03dcd84c,10,0,969,1288,2146,1327,923,1308,982,1002,1096,834,1075,842,958,917,-233,241,-474
604,510000,28e29f2c03dcd84c,10,0,634,781,1105,856,454,680,597,621,651,776,861,835,848,824,-26,85,-111
786,340000,28e29f2c03dcd84c,10,0,774,803,1070,953,364,644,584,685,706,708,895,856,876,820,-39,187,-226
1113,370000,28e29f2c03dcd84c,10,0,1224,1513,1837,1329,778,1244,1284,1298,1141,1319,1334,1363,1348,1339,29,15,14
659,140000,28e29f2c03dcd84c,10,0,770,798,1203,945,474,746,713,727,660,639,991,794,892,808,-197,352,-549
381,440000,28e29f2c03dcd84c,10,0,425,536,825,423,180,427,549,477,696,389,618,526,572,511,-92,229,-321
116,450000,28e29f2c03dcd84c,10,0,135,160,243,179,71,140,141,183,151,137,141,191,166,156,50,4,46
1295,320000,28e29f2c03dcd84c,10,0,1848,1951,2643,1820,1058,1565,1288,1340,1313,1263,1676,1620,1648,1520,-56,413,-469
320,360000,28e29f2c03dcd84c,10,0,377,424,571,408,151,325,301,312,293,255,351,379,365,328,28,96,-68
1285,130000,28e29f2c03dcd84c,10,0,1264,1433,1923,1604,884,1377,1523,1631,1539,1425,1590,1515,1552,1510,-75,165,-240
988,410000,28e29f2c03dcd84c,10,0,952,1113,1482,1178,548,1003,1062,1044,1052,1125,1238,1016,1127,1126,-222,113,-335
614,330000,28e29f2c03dcd84c,10,0,722,894,1112,767,352,679,681,651,616,628,814,733,774,725,-81,186,-267
300,420000,28e29f2c03dcd84c,10,0,329,377,483,446,164,271,261,296,275,330,388,373,380,364,-15,58,-73
425,430000,28e29f2c03dcd84c,10,0,438,477,783,487,262,452,359,428,383,395,447,527,487,456,80,52,28
256,350000,28e29f2c03dcd84c,10,0,212,345,456,397,140,227,217,291,297,182,259,217,238,219,-42,77,-119
176,210000,28e29f2c03dcd84c,10,0,247,251,310,270,165,356,218,179,255,221,255,217,236,231,-38,34,-72
311,500000,28e29f2c03dcd84c,10,0,426,491,644,555,263,408,381,378,462,374,447,448,448,423,1,73,-72
522,610000,28e29f2c03dcd84c,10,0,617,622,758,719,361,603,579,645,499,553,624,536,580,571,-88,71,-159
100,230000,28e29f2c03dcd84c,10,0,142,152,169,104,79,149,106,141,121,123,121,96,108,113,-25,-2,-23
43,310000,37aa9169b575ef79,10,0,395,67,117,63,37,86,109,100,151,123,42,55,48,73,13,-81,94
1333,530000,37aa9169b575ef79,10,0,988,1142,1590,946,692,1035,755,884,765,1277,1207,1465,1336,1316,258,-70,328
1060,150000,37aa9169b575ef79,10,0,802,945,982,602,413,714,724,743,629,652,1139,1161,1150,984,22,487,-465
277,110000,37aa9169b575ef79,10,0,477,625,985,300,271,404,282,274,292,278,289,341,315,303,52,11,41
2401,510000,37aa9169b575ef79,10,0,1733,2221,3340,1470,1639,3175,2405,2457,2398,2530,2754,3201,2978,2828,447,224,223
493,340000,37aa9169b575ef79,10,0,424,410,575,248,260,384,279,286,452,366,371,478,424,405,107,5,102
3505,370000,37aa9169b575ef79,10,0,3617,3662,4024,1903,1708,2748,2376,2932,2420,2797,3096,3668,3382,3187,572,299,273
1465,140000,37aa9169b575ef79,10,0,1243,1188,1616,679,442,672,792,892,815,1028,1189,1434,1312,1217,245,161,84
2044,440000,37aa9169b575ef79,10,0,1906,2111,2398,1196,1075,2249,1558,2005,1936,1682,1885,2157,2021,1908,272,203,69
369,450000,37aa9169b575ef79,10,0,384,459,435,440,301,449,664,501,523,446,573,488,530,502,-85,127,-212
917,320000,37aa9169b575ef79,10,0,781,777,930,527,626,655,605,586,670,623,694,810,752,709,116,71,45
425,360000,37aa9169b575ef79,10,0,488,482,540,354,189,356,270,359,296,244,355,399,377,333,44,111,-67
3840,130000,37aa9169b575ef79,10,0,3483,3233,4206,2068,1780,2633,2656,3148,2856,3242,3648,3843,3746,3578,195,406,-211
2086,410000,37aa9169b575ef79,10,0,1931,2018,2962,1570,1050,1823,1515,1509,1506,1785,1836,2094,1965,1905,258,51,207
660,330000,37aa9169b575ef79,10,0,606,634,886,424,422,628,555,606,538,517,542,822,682,627,280,25,255
573,420000,37aa9169b575ef79,10,0,585,544,920,483,270,442,304,376,403,430,440,533,486,468,93,10,83
1174,430000,37aa9169b575ef79,10,0,1444,1489,2336,1714,653,1232,835,1023,1076,1149,1284,1450,1367,1294,166,135,31
640,350000,37aa9169b575ef79,10,0,690,597,622,308,292,460,424,486,428,470,413,661,537,515,248,-57,305
1557,210000,37aa9169b575ef79,10,0,1308,1478,1878,681,691,1319,1119,1215,1237,1419,1601,1582,1592,1534,-19,182,-201
262,500000,37aa9169b575ef79,10,0,184,172,247,131,105,125,160,126,176,161,199,234,216,198,35,38,-3
886,610000,37aa9169b575ef79,10,0,580,634,1051,558,384,605,487,577,560,603,780,777,778,720,-3,177,-180
1730,230000,37aa9169b575ef79,10,0,1308,1636,1781,730,952,1556,1254,1336,1463,1649,2283,2187,2235,2040,-96,634,-730
887,310000,63065128401bb3ff,10,0,1674,2362,3060,1909,501,2672,4039,883,4181,1421,1782,1879,1830,1694,97,361,-264
1252,530000,63065128401bb3ff,10,0,1038,1033,1402,656,504,651,603,785,827,1300,1307,1367,1337,1325,60,7,53
772,150000,63065128401bb3ff,10,0,468,630,827,268,214,376,413,543,491,575,777,749,763,700,-28,202,-230
265,110000,63065128401bb3ff,10,0,516,1494,2145,217,200,2331,1550,280,361,498,297,355,326,383,58,-201,259
2053,510000,63065128401bb3ff,10,0,1708,2119,2450,1355,937,1478,2078,1399,1459,1801,2351,2567,2459,2240,216,550,-334
2516,340000,63065128401bb3ff,10,0,2529,2927,3132,1460,775,1436,1362,1591,1598,1947,2510,2710,2610,2389,200,563,-363
4122,370000,63065128401bb3ff,10,0,4129,4087,5401,1885,1225,2010,2269,2615,2569,3263,3929,4366,4148,3853,437,666,-229
1828,140000,63065128401bb3ff,10,0,1452,1547,2066,692,491,877,974,1192,1135,1670,2019,1865,1942,1851,-154,349,-503
1687,440000,63065128401bb3ff,10,0,2036,2188,2519,625,462,1475,1506,1216,1544,1515,1754,1731,1742,1667,-23,239,-262
586,450000,63065128401bb3ff,10,0,568,596,616,308,176,366,289,407,451,518,551,689,620,586,138,33,105
4745,320000,63065128401bb3ff,10,0,4475,5007,5643,2143,1862,2644,2631,3008,3307,4299,4173,4430,4302,4301,257,-126,383
1615,360000,63065128401bb3ff,10,0,1627,1981,2357,973,442,916,895,1031,1009,1333,1810,1734,1772,1626,-76,477,-553
4377,130000,63065128401bb3ff,10,0,3277,3711,5424,1723,1261,2043,2652,2981,2611,4091,4869,4197,4533,4386,-672,778,-1450
4481,410000,63065128401bb3ff,10,0,3793,4237,5119,2463,1238,2429,2562,2723,3091,4009,4961,4989,4975,4653,28,952,-924
2259,330000,63065128401bb3ff,10,0,2324,2401,2755,895,768,1359,1321,1533,1474,1767,2205,2322,2264,2098,117,438,-321
1474,420000,63065128401bb3ff,10,0,1296,1466,1985,1002,357,841,848,822,1085,1431,1415,1567,1491,1471,152,-16,168
1856,430000,63065128401bb3ff,10,0,1670,2078,2533,1085,531,1104,1014,1204,1328,1663,1969,2202,2086,1945,233,306,-73
1298,350000,63065128401bb3ff,10,0,1170,1218,1549,440,400,775,721,1235,973,1141,1223,1242,1232,1202,19,82,-63
692,210000,63065128401bb3ff,10,0,700,869,1098,268,212,386,587,555,690,977,861,746,804,861,-115,-116,1
870,500000,63065128401bb3ff,10,0,824,938,1120,617,359,603,607,619,800,1027,1072,1122,1097,1074,50,45,5
1777,610000,63065128401bb3ff,10,0,1165,1199,1748,631,397,661,1831,842,1735,1691,1436,1577,1506,1568,141,-255,396
427,230000,63065128401bb3ff,10,0,286,466,480,162,156,276,218,323,452,354,467,458,462,426,-9,113,-122
238,310000,ea489c253676aafc,10,0,314,574,754,315,362,767,319,351,300,314,334,352,343,333,18,20,-2
835,530000,ea489c253676aafc,10,0,635,692,866,452,295,448,404,525,442,543,578,599,588,573,21,35,-14
805,150000,ea489c253676aafc,10,0,495,612,941,427,254,591,556,550,476,504,704,679,692,629,-25,200,-225
75,110000,ea489c253676aafc,10,0,199,341,546,125,89,159,100,115,114,150,110,113,112,124,3,-40,43
1013,510000,ea489c253676aafc,10,0,838,1187,1812,1017,704,1344,1235,1081,1056,878,1050,1236,1143,1055,186,172,14
1004,340000,ea489c253676aafc,10,0,813,952,1669,741,475,869,701,638,694,733,857,812,834,801,-45,124,-169
3700,370000,ea489c253676aafc,10,0,2995,3812,5496,2330,1515,2865,2841,2834,2558,2825,3266,3132,3199,3074,-134,441,-575
1762,140000,ea489c253676aafc,10,0,1126,1234,2626,1165,641,1247,1425,1531,1329,1557,1538,1282,1410,1459,-256,-19,-237
408,440000,ea489c253676aafc,10,0,384,525,1055,368,255,433,540,513,805,467,681,614,648,587,-67,214,-281
185,450000,ea489c253676aafc,10,0,362,355,448,365,155,240,485,249,405,222,128,107,118,152,-21,-94,73
993,320000,ea489c253676aafc,10,0,1310,1728,2261,1167,1028,1507,1281,827,792,892,955,1053,1004,967,98,63,35
282,360000,ea489c253676aafc,10,0,356,946,847,641,223,316,236,253,238,242,217,309,263,256,92,-25,117
3615,130000,ea489c253676aafc,10,0,2586,3058,5478,1932,1551,2981,3513,3250,2524,3284,3386,2904,3145,3191,-482,102,-584
1924,410000,ea489c253676aafc,10,0,1472,1941,3092,1731,893,1695,1504,1408,1487,1714,1721,1597,1659,1677,-124,7,-131
523,330000,ea489c253676aafc,10,0,638,706,1205,504,467,741,598,514,446,578,432,623,528,544,191,-146,337
208,420000,ea489c253676aafc,10,0,272,348,657,298,154,273,222,166,164,170,172,198,185,180,26,2,24
410,430000,ea489c253676aafc,10,0,568,587,1351,576,253,448,437,409,373,484,393,425,409,434,32,-91,123
251,350000,ea489c253676aafc,10,0,307,452,617,215,148,255,232,240,199,231,301,352,326,295,51,70,-19
982,210000,ea489c253676aafc,10,0,572,853,1026,394,408,768,721,776,679,667,892,902,897,820,10,225,-215
246,500000,ea489c253676aafc,10,0,408,379,694,353,248,346,329,249,207,249,199,233,216,227,34,-50,84
930,610000,ea489c253676aafc,10,0,693,804,1400,754,418,791,600,553,553,625,614,777,696,672,163,-11,174
658,230000,ea489c253676aafc,10,0,324,496,710,280,266,503,464,518,466,471,859,943,901,758,84,388,-304
241,310000,cd5841d44fd7625e,10,0,148,312,359,339,177,321,249,248,328,254,307,237,272,266,-70,53,-123
355,530000,cd5841d44fd7625e,10,0,344,442,485,409,248,357,375,412,347,430,418,363,390,404,-55,-12,-43
497,150000,cd5841d44fd7625e,10,0,432,401,434,519,319,522,443,583,484,431,411,444,428,429,33,-20,53
791,110000,cd5841d44fd7625e,10,0,795,1121,1802,1263,877,1267,1047,1549,1033,967,860,855,858,894,-5,-107,102
823,510000,cd5841d44fd7625e,10,0,610,732,1083,1390,565,951,827,852,794,845,1009,1048,1028,967,39,164,-125
552,340000,cd5841d44fd7625e,10,0,440,519,629,667,315,471,534,553,570,581,499,590,544,557,91,-82,173
1727,370000,cd5841d44fd7625e,10,0,1370,1666,1642,1861,878,1578,1694,1792,1554,1627,1927,1942,1934,1832,15,300,-285
463,140000,cd5841d44fd7625e,10,0,480,421,414,426,317,451,395,445,395,431,409,455,432,432,46,-22,68
889,440000,cd5841d44fd7625e,10,0,704,995,1243,727,322,827,693,791,804,769,839,878,858,829,39,70,-31
217,450000,cd5841d44fd7625e,10,0,159,192,214,225,119,204,139,193,190,168,192,190,191,183,-2,24,-26
1162,320000,cd5841d44fd7625e,10,0,881,1099,1374,1336,868,1301,1124,1278,1241,1197,1296,1046,1171,1180,-250,99,-349
301,360000,cd5841d44fd7625e,10,0,237,276,329,364,141,291,237,315,278,285,309,268,288,287,-41,24,-65
1625,130000,cd5841d44fd7625e,10,0,1052,1461,1615,1768,1165,1697,1805,2074,1714,1806,1864,1750,1807,1807,-114,58,-172
1582,410000,cd5841d44fd7625e,10,0,1357,1223,1443,1429,856,1325,1403,1419,1413,1478,1579,1504,1542,1520,-75,101,-176
734,330000,cd5841d44fd7625e,10,0,512,747,863,742,356,707,633,707,646,663,732,701,716,699,-31,69,-100
501,420000,cd5841d44fd7625e,10,0,374,473,566,558,262,443,396,470,482,493,546,551,548,530,5,53,-48
410,430000,cd5841d44fd7625e,10,0,248,418,494,519,230,424,383,397,379,387,399,409,404,398,10,12,-2
431,350000,cd5841d44fd7625e,10,0,285,325,402,404,188,330,251,340,301,284,315,604,460,401,289,31,258
793,210000,cd5841d44fd7625e,10,0,738,644,1082,704,546,870,783,781,790,785,765,828,796,793,63,-20,83
373,500000,cd5841d44fd7625e,10,0,251,282,391,433,202,335,319,317,436,335,381,329,355,348,-52,46,-98
768,610000,cd5841d44fd7625e,10,0,276,346,497,487,257,378,390,460,393,519,500,482,491,500,-18,-19,1
813,230000,cd5841d44fd7625e,10,0,657,664,964,785,666,1198,1070,1179,970,890,1044,870,957,935,-174,154,-328
404,310000,b25c4e2e3856af22,10,0,1010,1563,1504,815,447,731,532,612,632,552,602,639,620,598,37,50,-13
371,530000,b25c4e2e3856af22,10,0,759,692,785,585,277,403,310,422,368,501,439,383,411,441,-56,-62,6
127,150000,b25c4e2e3856af22,10,0,407,342,430,303,110,229,177,183,153,136,170,141,156,149,-29,34,-63
206,110000,b25c4e2e3856af22,10,0,740,925,1127,376,284,427,371,462,336,275,270,272,271,272,2,-5,7
542,510000,b25c4e2e3856af22,10,0,1100,1320,1775,1096,562,764,657,680,772,616,717,828,772,720,111,101,10
608,340000,b25c4e2e3856af22,10,0,1001,1064,1490,952,364,600,581,589,605,632,685,690,688,669,5,53,-48
835,370000,b25c4e2e3856af22,10,0,1303,1408,1739,940,501,805,813,957,836,892,940,1047,994,960,107,48,59
108,140000,b25c4e2e3856af22,10,0,333,332,371,229,113,151,138,130,107,102,135,123,129,120,-12,33,-45
819,440000,b25c4e2e3856af22,10,0,1463,1644,2216,854,451,986,862,846,947,768,780,800,790,783,20,12,8
175,450000,b25c4e2e3856af22,10,0,280,255,372,218,114,237,155,197,163,181,169,173,171,174,4,-12,16
952,320000,b25c4e2e3856af22,10,0,1872,2263,3132,1586,987,1345,1015,1158,1068,1086,1181,1123,1152,1130,-58,95,-153
423,360000,b25c4e2e3856af22,10,0,798,870,1144,754,284,498,430,503,444,457,461,471,466,463,10,4,6
499,130000,b25c4e2e3856af22,10,0,883,944,1218,652,442,599,687,716,543,668,679,581,630,643,-98,11,-109
445,410000,b25c4e2e3856af22,10,0,1021,1121,1578,856,471,700,719,644,669,703,653,571,612,642,-82,-50,-32
1146,330000,b25c4e2e3856af22,10,0,2323,2703,3371,1749,893,1369,1150,1156,1037,1172,1334,1278,1306,1261,-56,162,-218
456,420000,b25c4e2e3856af22,10,0,1033,988,1333,941,363,579,523,593,600,621,519,533,526,558,14,-102,116
494,430000,b25c4e2e3856af22,10,0,973,1081,1561,1003,386,716,610,659,562,594,642,673,658,636,31,48,-17
360,350000,b25c4e2e3856af22,10,0,853,905,1102,667,370,551,387,534,372,366,372,338,355,359,-34,6,-40
226,210000,b25c4e2e3856af22,10,0,437,403,555,253,188,258,212,206,203,265,272,248,260,262,-24,7,-31
200,500000,b25c4e2e3856af22,10,0,428,496,740,452,184,293,290,264,303,274,250,248,249,257,-2,-24,22
191,610000,b25c4e2e3856af22,10,0,450,479,533,395,223,292,216,328,233,285,238,205,222,243,-33,-47,14
150,230000,b25c4e2e3856af22,10,0,320,352,428,213,219,281,217,259,239,210,238,179,208,209,-59,28,-87
687,310000,4a103c30d593fbbe,10,0,450,685,688,275,231,396,369,368,427,353,607,636,622,532,29,254,-225
776,530000,4a103c30d593fbbe,10,0,687,714,1001,409,321,443,427,437,368,556,556,634,595,582,78,0,78
829,150000,4a103c30d593fbbe,10,0,650,671,789,370,239,440,455,525,460,522,607,660,634,596,53,85,-32
493,110000,4a103c30d593fbbe,10,0,1045,1332,1807,402,360,619,496,497,491,482,542,549,546,524,7,60,-53
2341,510000,4a103c30d593fbbe,10,0,2017,2913,3590,1589,1106,1523,1538,1537,1666,1861,2475,3069,2772,2468,594,614,-20
1809,340000,4a103c30d593fbbe,10,0,1491,1717,1968,921,593,995,1124,1199,1070,1346,1713,1638,1676,1566,-75,367,-442
2964,370000,4a103c30d593fbbe,10,0,2547,2776,3299,1329,945,1856,2083,2108,1738,2082,2655,2980,2818,2572,325,573,-248
915,140000,4a103c30d593fbbe,10,0,813,782,1130,401,261,510,549,610,526,688,866,791,828,782,-75,178,-253
1712,440000,4a103c30d593fbbe,10,0,1702,2171,2397,475,354,1081,908,1044,1235,994,1368,1488,1428,1283,120,374,-254
502,450000,4a103c30d593fbbe,10,0,395,493,595,225,179,348,224,290,274,316,397,424,410,379,27,81,-54
3744,320000,4a103c30d593fbbe,10,0,3228,3579,4302,1623,1477,2234,2129,2434,2155,2485,3088,3158,3123,2910,70,603,-533
1004,360000,4a103c30d593fbbe,10,0,781,885,1016,398,230,537,551,590,548,652,808,842,825,767,34,156,-122
4164,130000,4a103c30d593fbbe,10,0,2877,2989,3954,1565,1311,2239,2725,3260,2705,3344,4173,4034,4104,3850,-139,829,-968
3430,410000,4a103c30d593fbbe,10,0,2358,2638,3291,1489,872,1684,1948,1801,1780,2489,2996,3374,3185,2953,378,507,-129
3040,330000,4a103c30d593fbbe,10,0,2163,2458,2897,961,793,1491,1417,1453,1417,1645,2472,2753,2612,2290,281,827,-546
1166,420000,4a103c30d593fbbe,10,0,948,1247,1304,805,357,634,667,656,762,898,966,1182,1074,1015,216,68,148
998,430000,4a103c30d593fbbe,10,0,757,948,1222,427,264,565,544,561,563,728,991,1080,1036,933,89,263,-174
859,350000,4a103c30d593fbbe,10,0,837,946,924,385,327,518,415,620,444,541,690,728,709,653,38,149,-111
1131,210000,4a103c30d593fbbe,10,0,1007,1160,1513,414,423,828,916,847,707,895,1272,1162,1217,1110,-110,377,-487
585,500000,4a103c30d593fbbe,10,0,407,493,612,296,209,288,300,336,388,329,435,559,497,441,124,106,18
1108,610000,4a103c30d593fbbe,10,0,945,946,1143,404,239,410,468,587,452,654,835,911,873,800,76,181,-105
859,230000,4a103c30d593fbbe,10,0,753,1190,1198,462,436,1058,713,772,690,729,1100,842,971,890,-258,371,-629
810,310000,7a7885e2d7c00bcf,10,0,633,790,925,325,455,653,555,624,740,612,758,1004,881,791,246,146,100
338,530000,7a7885e2d7c00bcf,10,0,431,527,546,194,218,317,270,316,211,290,290,300,295,293,10,0,10
323,150000,7a7885e2d7c00bcf,10,0,371,359,418,168,163,287,292,335,266,288,328,334,331,317,6,40,-34
482,110000,7a7885e2d7c00bcf,10,0,915,1162,1615,471,523,831,698,714,664,617,559,655,607,610,96,-58,154
665,510000,7a7885e2d7c00bcf,10,0,772,961,1167,445,516,738,665,640,630,656,820,1044,932,840,224,164,60
792,340000,7a7885e2d7c00bcf,10,0,878,933,1003,374,418,658,653,606,565,618,791,819,805,743,28,173,-145
2148,370000,7a7885e2d7c00bcf,10,0,2307,2370,2766,875,984,1739,1860,1899,1420,1615,2002,2507,2254,2041,505,387,118
274,140000,7a7885e2d7c00bcf,10,0,320,355,484,139,184,247,243,229,225,247,307,331,319,295,24,60,-36
876,440000,7a7885e2d7c00bcf,10,0,1092,1209,1464,402,402,896,629,772,826,680,829,845,837,785,16,149,-133
224,450000,7a7885e2d7c00bcf,10,0,259,290,384,118,109,224,157,222,215,154,183,203,193,180,20,29,-9
2396,320000,7a7885e2d7c00bcf,10,0,2595,2801,3241,1057,1612,2234,1953,2227,1909,2048,2422,2463,2442,2311,41,374,-333
370,360000,7a7885e2d7c00bcf,10,0,498,481,511,213,176,385,307,351,273,345,404,431,418,393,27,59,-32
1771,130000,7a7885e2d7c00bcf,10,0,1603,1929,2115,754,885,1533,1690,1813,1571,1661,1916,1901,1908,1826,-15,255,-270
1347,410000,7a7885e2d7c00bcf,10,0,1309,1461,1740,591,724,1200,1228,1058,967,1158,1211,1356,1284,1242,145,53,92
2171,330000,7a7885e2d7c00bcf,10,0,2033,2127,2662,818,1237,1764,1676,1729,1525,1884,2258,2311,2284,2151,53,374,-321
493,420000,7a7885e2d7c00bcf,10,0,603,616,685,305,279,470,356,444,412,438,504,557,530,500,53,66,-13
413,430000,7a7885e2d7c00bcf,10,0,501,559,768,256,278,497,347,424,341,409,480,525,502,471,45,71,-26
428,350000,7a7885e2d7c00bcf,10,0,473,480,608,216,257,389,262,395,326,356,356,363,360,358,7,0,7
344,210000,7a7885e2d7c00bcf,10,0,489,516,595,169,217,412,408,386,321,346,352,385,368,361,33,6,27
123,500000,7a7885e2d7c00bcf,10,0,159,216,258,69,99,133,100,129,180,126,116,163,140,135,47,-10,57
507,610000,7a7885e2d7c00bcf,10,0,510,487,657,185,238,361,306,395,301,417,437,460,448,438,23,20,3
314,230000,7a7885e2d7c00bcf,10,0,443,413,533,157,228,535,404,398,359,345,475,357,416,392,-118,130,-248
27,310000,346393c2c6305fb1,10,0,104,114,215,76,41,45,61,38,52,37,39,38,38,38,-1,2,-3
52,530000,346393c2c6305fb1,10,0,139,121,182,95,41,34,36,31,58,44,55,41,48,47,-14,11,-25
66,150000,346393c2c6305fb1,10,0,108,174,205,99,66,95,76,72,76,74,85,79,82,79,-6,11,-17
40,110000,346393c2c6305fb1,10,0,161,243,439,74,40,54,53,41,27,32,51,39,45,41,-12,19,-31
129,510000,346393c2c6305fb1,10,0,291,297,513,309,153,136,133,149,150,134,136,183,160,151,47,2,45
358,340000,346393c2c6305fb1,10,0,600,692,1047,578,273,312,307,331,314,279,347,395,371,340,48,68,-20
646,370000,346393c2c6305fb1,10,0,1097,1099,1844,902,381,538,572,675,544,536,649,690,670,625,41,113,-72
271,140000,346393c2c6305fb1,10,0,277,308,545,238,158,237,226,236,217,178,237,265,251,227,28,59,-31
114,440000,346393c2c6305fb1,10,0,277,289,373,126,71,118,103,101,96,92,121,141,131,118,20,29,-9
61,450000,346393c2c6305fb1,10,0,100,115,162,93,53,69,35,53,40,48,50,56,53,51,6,2,4
225,320000,346393c2c6305fb1,10,0,406,397,621,300,168,197,206,183,203,185,213,207,210,202,-6,28,-34
62,360000,346393c2c6305fb1,10,0,164,143,266,151,36,61,68,60,40,53,57,59,58,56,2,4,-2
517,130000,346393c2c6305fb1,10,0,699,808,1460,748,389,430,459,518,401,452,524,544,534,507,20,72,-52
354,410000,346393c2c6305fb1,10,0,471,617,1100,524,174,251,240,290,254,290,316,303,310,303,-13,26,-39
78,330000,346393c2c6305fb1,10,0,211,191,260,101,55,63,66,67,90,77,72,74,73,74,2,-5,7
178,420000,346393c2c6305fb1,10,0,324,313,534,275,79,103,125,96,138,125,127,182,154,145,55,2,53
159,430000,346393c2c6305fb1,10,0,286,335,535,308,119,163,126,142,139,138,161,166,164,155,5,23,-18
34,350000,346393c2c6305fb1,10,0,89,87,129,60,25,51,31,35,42,33,28,56,42,39,28,-5,33
119,210000,346393c2c6305fb1,10,0,278,265,371,149,91,133,121,130,132,148,200,180,190,176,-20,52,-72
68,500000,346393c2c6305fb1,10,0,189,199,335,168,84,69,66,80,88,67,79,85,82,77,6,12,-6
130,610000,346393c2c6305fb1,10,0,197,186,360,209,62,83,76,106,84,83,85,110,98,93,25,2,23
70,230000,346393c2c6305fb1,10,0,169,223,312,126,95,154,101,143,86,105,123,132,128,120,9,18,-9
627,310000,02aab221aabc03b9,10,0,489,558,362,679,494,731,600,672,772,704,727,654,690,695,-73,23,-96
213,530000,02aab221aabc03b9,10,0,174,160,155,229,130,223,186,188,194,250,267,174,220,230,-93,17,-110
79,150000,02aab221aabc03b9,10,0,99,82,59,106,63,136,99,113,83,99,112,92,102,101,-20,13,-33
544,110000,02aab221aabc03b9,10,0,642,654,521,798,532,838,575,694,618,670,630,659,644,653,29,-40,69
629,510000,02aab221aabc03b9,10,0,471,430,474,703,394,653,524,606,614,549,576,507,542,544,-69,27,-96
325,340000,02aab221aabc03b9,10,0,248,228,187,338,203,372,311,341,346,340,353,335,344,343,-18,13,-31
504,370000,02aab221aabc03b9,10,0,474,421,353,610,362,607,527,608,548,531,526,473,500,510,-53,-5,-48
114,140000,02aab221aabc03b9,10,0,105,117,105,129,94,160,139,138,152,130,124,119,122,124,-5,-6,1
1178,440000,02aab221aabc03b9,10,0,1049,976,1007,1207,847,1361,1093,1267,1219,1095,1304,1161,1232,1187,-143,209,-352
149,450000,02aab221aabc03b9,10,0,126,138,119,159,102,172,121,154,153,137,153,146,150,145,-7,16,-23
1428,320000,02aab221aabc03b9,10,0,1270,1186,1077,1735,1066,1713,1523,1554,1639,1493,1583,1338,1460,1471,-245,90,-335
199,360000,02aab221aabc03b9,10,0,164,154,152,242,146,291,216,232,253,206,215,224,220,215,9,9,0
325,130000,02aab221aabc03b9,10,0,307,254,182,340,242,360,379,362,327,372,362,376,369,370,14,-10,24
310,410000,02aab221aabc03b9,10,0,239,284,223,320,199,311,289,319,320,350,407,332,370,363,-75,57,-132
1401,330000,02aab221aabc03b9,10,0,1239,1136,1024,1529,973,1602,1326,1507,1501,1473,1537,1190,1364,1400,-347,64,-411
311,420000,02aab221aabc03b9,10,0,272,273,274,370,238,369,296,339,369,331,321,338,330,330,17,-10,27
270,430000,02aab221aabc03b9,10,0,213,205,215,305,186,346,275,278,289,275,275,299,287,283,24,0,24
401,350000,02aab221aabc03b9,10,0,353,321,324,518,242,572,350,498,528,403,477,413,445,431,-64,74,-138
226,210000,02aab221aabc03b9,10,0,229,207,174,292,205,321,225,242,252,295,316,266,291,292,-50,21,-71
261,500000,02aab221aabc03b9,10,0,197,217,217,267,199,277,240,244,232,258,263,190,226,237,-73,5,-78
232,610000,02aab221aabc03b9,10,0,263,205,197,285,151,281,203,248,250,270,252,210,231,244,-42,-18,-24
79,230000,02aab221aabc03b9,10,0,81,63,53,93,68,133,85,82,113,113,134,92,113,113,-42,21,-63
307,310000,5d7fb682edd0f937,10,0,281,247,225,315,160,297,263,287,314,230,299,290,294,273,-9,69,-78
139,530000,5d7fb682edd0f937,10,0,167,133,176,164,108,164,133,153,126,180,169,187,178,179,18,-11,29
85,150000,5d7fb682edd0f937,10,0,96,85,86,86,62,103,111,102,97,88,89,103,96,93,14,1,13
227,110000,5d7fb682edd0f937,10,0,308,324,417,323,190,356,270,290,257,234,246,289,268,256,43,12,31
298,510000,5d7fb682edd0f937,10,0,305,301,337,483,166,411,313,351,316,288,271,389,330,316,118,-17,135
180,340000,5d7fb682edd0f937,10,0,162,169,174,188,119,173,183,210,172,186,222,219,220,209,-3,36,-39
281,370000,5d7fb682edd0f937,10,0,265,227,253,339,160,306,297,331,234,253,292,332,312,292,40,39,1
75,140000,5d7fb682edd0f937,10,0,83,81,91,111,56,97,101,97,84,91,94,102,98,96,8,3,5
502,440000,5d7fb682edd0f937,10,0,462,510,512,581,314,531,409,540,562,422,478,505,492,468,27,56,-29
94,450000,5d7fb682edd0f937,10,0,102,103,109,128,57,103,59,104,114,85,94,92,93,90,-2,9,-11
673,320000,5d7fb682edd0f937,10,0,642,661,734,807,456,741,678,793,643,655,701,797,749,718,96,46,50
158,360000,5d7fb682edd0f937,10,0,115,129,138,165,79,158,126,152,118,104,127,138,132,123,11,23,-12
198,130000,5d7fb682edd0f937,10,0,184,180,178,203,126,201,195,251,175,165,222,247,234,211,25,57,-32
183,410000,5d7fb682edd0f937,10,0,161,189,173,186,103,191,191,194,156,186,216,215,216,206,-1,30,-31
681,330000,5d7fb682edd0f937,10,0,587,599,595,656,382,738,625,720,647,584,732,718,725,678,-14,148,-162
216,420000,5d7fb682edd0f937,10,0,219,258,266,270,142,257,214,255,256,231,241,262,252,245,21,10,11
168,430000,5d7fb682edd0f937,10,0,160,168,191,210,114,205,161,191,162,167,198,213,206,193,15,31,-16
226,350000,5d7fb682edd0f937,10,0,202,201,205,241,127,267,183,283,239,197,201,237,219,212,36,4,32
114,210000,5d7fb682edd0f937,10,0,130,138,128,140,90,113,125,138,146,129,145,130,138,135,-15,16,-31
134,500000,5d7fb682edd0f937,10,0,123,106,134,131,54,117,102,136,130,124,110,144,127,126,34,-14,48
149,610000,5d7fb682edd0f937,10,0,172,135,145,159,85,142,119,156,144,123,140,138,139,134,-2,17,-19
56,230000,5d7fb682edd0f937,10,0,50,53,61,68,34,78,65,79,70,61,83,81,82,75,-2,22,-24
524,310000,a207df29ec9583f0,10,0,428,493,474,835,424,592,562,626,644,634,694,593,644,640,-101,60,-161
175,530000,a207df29ec9583f0,10,0,204,210,215,310,178,234,223,203,223,258,250,238,244,249,-12,-8,-4
107,150000,a207df29ec9583f0,10,0,72,82,74,139,87,116,104,125,105,116,128,105,116,116,-23,12,-35
607,110000,a207df29ec9583f0,10,0,604,747,817,1033,648,841,763,792,726,727,824,751,788,767,-73,97,-170
366,510000,a207df29ec9583f0,10,0,382,361,382,695,383,524,456,456,507,479,440,615,528,511,175,-39,214
231,340000,a207df29ec9583f0,10,0,183,176,177,354,152,225,259,222,223,254,259,255,257,256,-4,5,-9
361,370000,a207df29ec9583f0,10,0,338,348,336,608,328,530,488,475,451,429,468,468,468,455,0,39,-39
125,140000,a207df29ec9583f0,10,0,84,93,100,165,96,130,118,97,142,140,152,138,145,143,-14,12,-26
990,440000,a207df29ec9583f0,10,0,627,766,825,1178,690,1101,964,1020,962,1084,1109,1111,1110,1101,2,25,-23
137,450000,a207df29ec9583f0,10,0,72,100,114,160,106,163,133,138,136,134,129,148,138,137,19,-5,24
891,320000,a207df29ec9583f0,10,0,791,915,1007,1591,766,1115,1026,1072,1033,982,1080,1012,1046,1025,-68,98,-166
164,360000,a207df29ec9583f0,10,0,101,129,108,227,115,167,214,182,168,165,197,175,186,179,-22,32,-54
239,130000,a207df29ec9583f0,10,0,202,203,219,376,209,316,289,290,301,301,298,260,279,286,-38,-3,-35
268,410000,a207df29ec9583f0,10,0,194,283,262,357,201,287,304,275,256,289,287,329,308,302,42,-2,44
896,330000,a207df29ec9583f0,10,0,733,849,908,1436,623,970,967,965,954,954,1063,930,996,982,-133,109,-242
336,420000,a207df29ec9583f0,10,0,230,315,356,436,202,366,316,282,393,360,384,379,382,374,-5,24,-29
213,430000,a207df29ec9583f0,10,0,143,174,192,302,179,246,255,226,219,246,249,252,250,249,3,3,0
323,350000,a207df29ec9583f0,10,0,197,227,256,500,212,338,297,357,330,288,330,361,346,326,31,42,-11
233,210000,a207df29ec9583f0,10,0,176,194,227,304,176,286,261,241,263,276,299,268,284,281,-31,23,-54
169,500000,a207df29ec9583f0,10,0,151,174,194,265,152,205,197,174,223,187,198,223,210,203,25,11,14
202,610000,a207df29ec9583f0,10,0,210,194,216,307,140,222,205,251,252,248,224,226,225,233,2,-24,26
77,230000,a207df29ec9583f0,10,0,74,83,85,102,84,125,116,121,127,86,123,92,108,100,-31,37,-68
219,310000,b4be3a4917289c82,10,0,188,201,262,80,97,160,113,154,142,142,182,210,196,178,28,40,-12
61,530000,b4be3a4917289c82,10,0,76,100,59,26,35,34,50,78,51,74,46,58,52,59,12,-28,40
23,150000,b4be3a4917289c82,10,0,42,40,37,22,17,26,37,25,21,17,27,25,26,23,-2,10,-12
169,110000,b4be3a4917289c82,10,0,200,230,226,93,117,153,137,139,94,88,112,163,138,121,51,24,27
125,510000,b4be3a4917289c82,10,0,166,240,223,57,76,90,137,164,128,144,184,277,230,202,93,40,53
113,340000,b4be3a4917289c82,10,0,110,130,121,57,59,72,81,74,76,100,108,95,102,101,-13,8,-21
232,370000,b4be3a4917289c82,10,0,215,231,199,113,137,218,152,167,149,160,180,268,224,203,88,20,68
36,140000,b4be3a4917289c82,10,0,31,28,33,16,10,28,22,76,22,26,27,34,30,29,7,1,6
206,440000,b4be3a4917289c82,10,0,309,396,384,120,115,231,223,244,188,202,225,232,228,220,7,23,-16
32,450000,b4be3a4917289c82,10,0,34,41,40,20,18,18,25,33,31,30,38,53,46,40,15,8,7
487,320000,b4be3a4917289c82,10,0,420,635,591,225,325,414,342,390,329,340,426,503,464,423,77,86,-9
43,360000,b4be3a4917289c82,10,0,52,66,85,10,18,37,40,39,37,38,50,58,54,49,8,12,-4
156,130000,b4be3a4917289c82,10,0,141,166,161,78,99,131,131,102,71,97,118,127,122,114,9,21,-12
128,410000,b4be3a4917289c82,10,0,117,128,163,57,77,90,88,75,84,92,121,128,124,114,7,29,-22
426,330000,b4be3a4917289c82,10,0,422,523,567,168,290,344,386,300,355,415,511,575,543,500,64,96,-32
77,420000,b4be3a4917289c82,10,0,92,120,142,48,54,76,88,66,69,75,103,111,107,96,8,28,-20
69,430000,b4be3a4917289c82,10,0,79,112,124,41,43,61,74,75,46,72,85,92,88,83,7,13,-6
54,350000,b4be3a4917289c82,10,0,85,108,127,23,28,50,51,59,58,62,64,70,67,65,6,2,4
57,210000,b4be3a4917289c82,10,0,77,106,83,28,38,67,45,65,40,54,75,89,82,73,14,21,-7
32,500000,b4be3a4917289c82,10,0,43,77,67,17,20,19,34,34,37,30,40,56,48,42,16,10,6
83,610000,b4be3a4917289c82,10,0,83,68,82,41,52,48,66,99,56,51,90,75,82,72,-15,39,-54
25,230000,b4be3a4917289c82,10,0,40,48,45,18,18,48,30,46,28,19,30,30,30,26,0,11,-11
487,310000,ef76a85c4b39f693,10,0,129,306,492,378,283,374,311,427,498,475,609,825,717,636,216,134,82
213,530000,ef76a85c4b39f693,10,0,75,142,154,140,101,145,149,178,192,272,277,259,268,269,-18,5,-23
176,150000,ef76a85c4b39f693,10,0,48,67,109,121,79,109,124,169,140,135,176,185,180,165,9,41,-32
557,110000,ef76a85c4b39f693,10,0,175,311,576,511,299,438,522,580,543,591,697,730,714,673,33,106,-73
541,510000,ef76a85c4b39f693,10,0,206,340,526,495,291,361,444,497,529,571,643,1038,840,751,395,72,323
402,340000,ef76a85c4b39f693,10,0,111,219,307,304,148,259,319,271,331,363,453,565,509,460,112,90,22
568,370000,ef76a85c4b39f693,10,0,241,312,378,406,284,400,479,557,520,550,741,941,841,744,200,191,9
168,140000,ef76a85c4b39f693,10,0,46,58,83,94,61,99,97,93,99,121,177,185,181,161,8,56,-48
934,440000,ef76a85c4b39f693,10,0,282,593,912,598,355,607,642,701,764,756,899,1094,996,916,195,143,52
129,450000,ef76a85c4b39f693,10,0,30,50,68,74,33,77,72,113,104,139,145,158,152,147,13,6,7
1253,320000,ef76a85c4b39f693,10,0,351,609,1028,993,652,891,910,1046,1085,1159,1451,1727,1589,1446,276,292,-16
206,360000,ef76a85c4b39f693,10,0,59,107,208,200,69,151,150,175,152,209,258,344,301,270,86,49,37
455,130000,ef76a85c4b39f693,10,0,141,298,340,342,250,323,382,440,423,438,563,630,596,544,67,125,-58
422,410000,ef76a85c4b39f693,10,0,136,170,239,290,184,293,341,325,356,405,492,560,526,486,68,87,-19
1479,330000,ef76a85c4b39f693,10,0,498,965,1300,996,708,969,1088,1209,1284,1524,1958,2180,2069,1887,222,434,-212
371,420000,ef76a85c4b39f693,10,0,101,212,331,334,134,250,279,305,303,339,437,473,455,416,36,98,-62
339,430000,ef76a85c4b39f693,10,0,92,180,310,284,146,251,271,354,267,331,429,484,456,415,55,98,-43
274,350000,ef76a85c4b39f693,10,0,95,138,176,229,97,153,164,270,221,253,308,353,330,305,45,55,-10
397,210000,ef76a85c4b39f693,10,0,157,189,261,256,190,274,317,341,370,440,648,531,590,540,-117,208,-325
142,500000,ef76a85c4b39f693,10,0,35,76,157,115,82,120,97,175,209,162,190,256,223,203,66,28,38
357,610000,ef76a85c4b39f693,10,0,96,127,205,223,136,166,239,247,199,284,366,387,376,346,21,82,-61
129,230000,ef76a85c4b39f693,10,0,56,108,145,104,92,153,138,145,157,161,240,210,225,204,-30,79,-109
434,310000,bb9fbec9a2833839,10,0,298,341,507,266,214,347,256,335,387,323,471,449,460,414,-22,148,-170
158,530000,bb9fbec9a2833839,10,0,180,169,225,142,99,142,158,164,176,231,206,157,182,198,-49,-25,-24
179,150000,bb9fbec9a2833839,10,0,157,121,169,76,74,105,133,145,136,151,168,178,173,166,10,17,-7
267,110000,bb9fbec9a2833839,10,0,355,417,450,177,170,259,234,290,279,265,274,353,314,297,79,9,70
393,510000,bb9fbec9a2833839,10,0,403,433,394,242,224,324,333,361,319,358,452,596,524,469,144,94,50
290,340000,bb9fbec9a2833839,10,0,172,256,310,160,139,211,231,217,227,254,298,323,310,292,25,44,-19
509,370000,bb9fbec9a2833839,10,0,453,469,507,305,251,332,402,428,398,413,574,597,586,528,23,161,-138
150,140000,bb9fbec9a2833839,10,0,117,124,97,55,43,101,86,111,100,106,169,173,171,149,4,63,-59
776,440000,bb9fbec9a2833839,10,0,710,821,895,435,271,630,599,641,694,710,772,788,780,757,16,62,-46
143,450000,bb9fbec9a2833839,10,0,85,114,124,79,66,108,95,119,99,124,137,118,128,126,-19,13,-32
1157,320000,bb9fbec9a2833839,10,0,688,937,1154,552,589,835,807,903,879,877,1098,1019,1058,998,-79,221,-300
235,360000,bb9fbec9a2833839,10,0,186,189,178,106,91,145,142,176,146,152,202,227,214,194,25,50,-25
402,130000,bb9fbec9a2833839,10,0,324,327,378,179,188,251,302,319,290,307,411,362,386,360,-49,104,-153
286,410000,bb9fbec9a2833839,10,0,237,276,308,156,143,260,258,238,212,252,290,348,319,297,58,38,20
1216,330000,bb9fbec9a2833839,10,0,917,1072,1169,550,543,759,841,892,995,1035,1285,1388,1336,1236,103,250,-147
443,420000,bb9fbec9a2833839,10,0,270,308,378,261,177,285,262,281,264,324,372,438,405,378,66,48,18
299,430000,bb9fbec9a2833839,10,0,193,226,309,145,129,251,238,285,222,261,332,310,321,301,-22,71,-93
305,350000,bb9fbec9a2833839,10,0,253,214,293,168,110,183,202,270,233,236,280,255,268,257,-25,44,-69
143,210000,bb9fbec9a2833839,10,0,174,177,213,86,85,121,151,164,140,139,209,233,221,194,24,70,-46
114,500000,bb9fbec9a2833839,10,0,96,89,130,65,59,92,68,101,131,82,96,144,120,107,48,14,34
226,610000,bb9fbec9a2833839,10,0,165,164,174,112,81,131,150,180,137,151,189,198,194,179,9,38,-29
82,230000,bb9fbec9a2833839,10,0,82,95,85,44,40,74,82,95,78,104,128,90,109,107,-38,24,-62
391,310000,da457d15788fe8ee,10,0,402,593,748,538,251,456,315,445,485,411,558,671,614,547,113,147,-34
261,530000,da457d15788fe8ee,10,0,316,323,344,263,166,191,198,263,290,341,252,328,290,307,76,-89,165
149,150000,da457d15788fe8ee,10,0,207,206,200,197,109,152,165,213,178,177,172,194,183,181,22,-5,27
743,110000,da457d15788fe8ee,10,0,715,939,1050,755,424,693,651,781,754,805,949,920,934,891,-29,144,-173
435,510000,da457d15788fe8ee,10,0,583,560,641,624,348,443,468,502,547,611,673,959,816,748,286,62,224
291,340000,da457d15788fe8ee,10,0,282,331,409,330,200,229,256,264,317,284,317,394,356,332,77,33,44
491,370000,da457d15788fe8ee,10,0,438,630,646,659,309,458,540,534,523,541,632,768,700,647,136,91,45
129,140000,da457d15788fe8ee,10,0,139,142,103,120,44,90,120,136,128,136,187,160,174,161,-27,51,-78
1221,440000,da457d15788fe8ee,10,0,1295,1408,1829,1269,499,1006,894,1099,1203,1068,1323,1501,1412,1297,178,255,-77
169,450000,da457d15788fe8ee,10,0,162,142,255,213,82,152,117,156,149,174,198,193,196,188,-5,24,-29
983,320000,da457d15788fe8ee,10,0,1040,1108,1430,1304,649,954,933,1003,955,1112,1268,1354,1311,1245,86,156,-70
219,360000,da457d15788fe8ee,10,0,218,275,247,282,85,186,198,229,203,249,256,341,298,282,85,7,78
398,130000,da457d15788fe8ee,10,0,407,417,527,425,254,337,412,434,405,458,546,548,547,517,2,88,-86
339,410000,da457d15788fe8ee,10,0,405,382,502,442,251,354,426,325,372,375,398,412,405,395,14,23,-9
1157,330000,da457d15788fe8ee,10,0,932,1214,1500,938,567,836,888,1017,1178,1317,1460,1660,1560,1479,200,143,57
382,420000,da457d15788fe8ee,10,0,447,473,526,572,259,428,363,377,445,438,468,503,486,470,35,30,5
359,430000,da457d15788fe8ee,10,0,369,391,505,374,207,342,370,431,366,451,421,470,446,447,49,-30,79
276,350000,da457d15788fe8ee,10,0,298,320,358,335,144,206,194,282,238,262,319,348,334,310,29,57,-28
306,210000,da457d15788fe8ee,10,0,357,335,454,281,156,268,293,330,277,371,482,484,483,446,2,111,-109
164,500000,da457d15788fe8ee,10,0,188,209,244,199,108,153,121,186,284,146,224,267,246,212,43,78,-35
274,610000,da457d15788fe8ee,10,0,366,242,346,325,174,210,225,299,236,330,298,331,314,320,33,-32,65
95,230000,da457d15788fe8ee,10,0,123,190,198,139,94,144,137,133,149,128,210,136,173,158,-74,82,-156
503,310000,6858d6dfe680bdf7,10,0,357,513,576,543,384,696,487,649,633,685,664,518,591,622,-146,-21,-125
166,530000,6858d6dfe680bdf7,10,0,117,236,257,243,199,312,234,314,249,292,267,233,250,264,-34,-25,-9
58,150000,6858d6dfe680bdf7,10,0,37,60,80,54,43,84,76,64,93,74,68,76,72,73,8,-6,14
411,110000,6858d6dfe680bdf7,10,0,328,585,816,536,311,688,527,617,587,668,640,578,609,629,-62,-28,-34
365,510000,6858d6dfe680bdf7,10,0,290,447,593,591,337,640,478,571,603,551,645,659,652,618,14,94,-80
336,340000,6858d6dfe680bdf7,10,0,233,275,385,322,230,435,350,391,362,386,364,400,382,383,36,-22,58
332,370000,6858d6dfe680bdf7,10,0,285,401,440,468,289,622,538,593,498,535,586,540,563,554,-46,51,-97
72,140000,6858d6dfe680bdf7,10,0,30,61,103,57,64,78,79,91,70,76,114,91,102,94,-23,38,-61
1116,440000,6858d6dfe680bdf7,10,0,773,983,1319,1274,618,1449,1061,1394,1469,1265,1360,1372,1366,1332,12,95,-83
125,450000,6858d6dfe680bdf7,10,0,94,126,167,115,84,164,123,176,156,157,172,190,181,173,18,15,3
894,320000,6858d6dfe680bdf7,10,0,862,988,1160,1203,919,1681,1193,1428,1269,1375,1458,1073,1266,1302,-385,83,-468
138,360000,6858d6dfe680bdf7,10,0,96,129,200,185,89,224,198,224,201,206,230,203,216,213,-27,24,-51
277,130000,6858d6dfe680bdf7,10,0,192,281,283,417,232,460,496,484,423,463,437,409,423,436,-28,-26,-2
275,410000,6858d6dfe680bdf7,10,0,174,237,350,258,224,388,425,429,397,410,418,393,406,407,-25,8,-33
1310,330000,6858d6dfe680bdf7,10,0,929,1465,1724,1540,1004,2273,1596,1876,1650,1852,1906,1579,1742,1779,-327,54,-381
242,420000,6858d6dfe680bdf7,10,0,144,218,283,271,143,325,266,300,353,314,383,331,357,343,-52,69,-121
243,430000,6858d6dfe680bdf7,10,0,203,255,374,375,195,380,321,402,363,372,409,397,403,393,-12,37,-49
305,350000,6858d6dfe680bdf7,10,0,214,251,346,352,161,369,304,419,307,353,366,384,375,368,18,13,5
189,210000,6858d6dfe680bdf7,10,0,91,159,186,215,146,225,256,285,240,260,305,212,258,259,-93,45,-138
164,500000,6858d6dfe680bdf7,10,0,105,200,253,198,131,290,195,274,315,277,268,213,240,253,-55,-9,-46
188,610000,6858d6dfe680bdf7,10,0,132,134,174,188,135,235,193,286,212,215,219,199,209,211,-20,4,-24
44,230000,6858d6dfe680bdf7,10,0,28,58,76,70,44,104,104,97,90,78,104,69,86,84,-35,26,-61
157,310000,79de4e4b24c35b04,10,0,299,501,825,333,136,253,217,192,208,169,209,261,235,213,52,40,12
817,530000,79de4e4b24c35b04,10,0,926,928,1393,1050,634,598,559,552,559,568,496,633,564,566,137,-72,209
188,150000,79de4e4b24c35b04,10,0,230,272,405,185,132,207,141,156,128,146,189,194,192,176,5,43,-38
84,110000,79de4e4b24c35b04,10,0,330,446,852,178,127,199,127,128,132,116,105,91,98,104,-14,-11,-3
394,510000,79de4e4b24c35b04,10,0,792,934,1509,1063,565,512,413,385,387,456,447,479,463,461,32,-9,41
1004,340000,79de4e4b24c35b04,10,0,1263,1461,2601,1965,1072,936,771,749,842,897,904,1032,968,944,128,7,121
2072,370000,79de4e4b24c35b04,10,0,2975,3077,5360,2858,1598,1729,1694,1756,1539,1936,1912,2146,2029,1998,234,-24,258
537,140000,79de4e4b24c35b04,10,0,791,803,1442,701,396,447,437,462,390,470,484,542,513,499,58,14,44
3213,440000,79de4e4b24c35b04,10,0,5032,5800,8421,3465,1872,3263,2465,2754,2779,2551,2831,3372,3102,2918,541,280,261
1953,450000,79de4e4b24c35b04,10,0,3025,3479,6171,2981,1510,1845,1206,1444,1326,1376,2120,1771,1946,1756,-349,744,-1093
1551,320000,79de4e4b24c35b04,10,0,1978,2153,3757,2028,1542,1465,1325,1301,1251,1387,1382,1410,1396,1393,28,-5,33
502,360000,79de4e4b24c35b04,10,0,703,736,1319,827,443,434,359,341,393,389,426,463,444,426,37,37,0
1339,130000,79de4e4b24c35b04,10,0,1500,1789,2863,1366,1047,1021,1146,1168,1072,1294,1269,1276,1272,1280,7,-25,32
3382,410000,79de4e4b24c35b04,10,0,4700,5194,9539,6024,2842,2528,2423,2523,2603,3162,2973,3080,3026,3072,107,-189,296
995,330000,79de4e4b24c35b04,10,0,1528,1653,2646,934,580,745,680,733,621,813,822,894,858,843,72,9,63
540,420000,79de4e4b24c35b04,10,0,696,982,1629,1137,521,524,406,468,397,454,447,595,521,499,148,-7,155
856,430000,79de4e4b24c35b04,10,0,1234,1513,2352,1658,771,808,663,615,657,743,779,889,834,804,110,36,74
355,350000,79de4e4b24c35b04,10,0,724,738,1086,453,316,456,314,359,319,319,322,371,346,337,49,3,46
500,210000,79de4e4b24c35b04,10,0,644,694,1039,408,313,505,468,482,534,500,483,512,498,498,29,-17,46
141,500000,79de4e4b24c35b04,10,0,279,304,514,324,210,169,172,136,158,183,160,169,164,171,9,-23,32
679,610000,79de4e4b24c35b04,10,0,855,1045,1704,937,403,499,452,488,436,535,576,634,605,582,58,41,17
428,230000,79de4e4b24c35b04,10,0,638,832,1045,394,365,562,482,469,565,521,543,559,551,541,16,22,-6
537,310000,12f8b7e14947c34d,10,0,1032,1283,1483,389,338,505,521,647,608,619,726,770,748,705,44,107,-63
248,530000,12f8b7e14947c34d,10,0,396,360,567,208,160,208,214,226,198,297,263,248,256,269,-15,-34,19
413,150000,12f8b7e14947c34d,10,0,648,698,789,413,215,340,311,387,355,326,370,370,370,355,0,44,-44
53,110000,12f8b7e14947c34d,10,0,276,389,488,143,102,126,84,102,87,71,101,86,94,86,-15,30,-45
558,510000,12f8b7e14947c34d,10,0,786,820,1117,531,374,577,521,559,581,527,664,831,748,674,167,137,30
450,340000,12f8b7e14947c34d,10,0,594,615,705,385,198,241,246,257,285,305,420,360,390,362,-60,115,-175
1154,370000,12f8b7e14947c34d,10,0,1435,1352,1707,803,424,738,843,928,824,912,1138,1251,1194,1100,113,226,-113
267,140000,12f8b7e14947c34d,10,0,347,352,464,131,87,174,169,231,178,188,345,260,302,264,-85,157,-242
211,440000,12f8b7e14947c34d,10,0,342,407,475,130,117,221,195,239,246,184,249,327,288,253,78,65,13
105,450000,12f8b7e14947c34d,10,0,167,158,231,93,43,77,54,89,79,95,76,109,92,93,33,-19,52
1434,320000,12f8b7e14947c34d,10,0,1880,1868,2181,991,782,1094,1007,1280,1090,1058,1318,1361,1340,1246,43,260,-217
328,360000,12f8b7e14947c34d,10,0,430,438,495,251,128,183,180,217,188,232,281,331,306,281,50,49,1
645,130000,12f8b7e14947c34d,10,0,782,978,1229,546,360,592,598,847,611,670,860,765,812,765,-95,190,-285
697,410000,12f8b7e14947c34d,10,0,750,835,1053,508,259,492,410,471,586,659,755,577,666,664,-178,96,-274
755,330000,12f8b7e14947c34d,10,0,884,1063,1213,348,291,556,450,632,576,610,714,681,698,668,-33,104,-137
222,420000,12f8b7e14947c34d,10,0,336,358,440,200,80,136,138,174,236,210,228,238,233,225,10,18,-8
369,430000,12f8b7e14947c34d,10,0,528,670,749,385,150,254,224,307,284,328,398,464,431,397,66,70,-4
280,350000,12f8b7e14947c34d,10,0,302,385,408,188,136,178,176,297,240,200,252,252,252,235,0,52,-52
80,210000,12f8b7e14947c34d,10,0,156,195,210,53,54,81,84,109,71,94,144,110,127,116,-34,50,-84
97,500000,12f8b7e14947c34d,10,0,178,181,295,131,85,113,117,117,161,107,136,118,127,120,-18,29,-47
958,610000,12f8b7e14947c34d,10,0,958,1012,1286,412,280,531,610,649,548,736,763,674,718,724,-89,27,-116
123,230000,12f8b7e14947c34d,10,0,202,210,228,66,80,160,104,150,105,113,153,106,130,124,-47,40,-87
271,310000,04e66e578f653ab9,10,0,337,524,679,950,175,263,226,214,231,1376,364,429,396,723,65,-1012,1077
170,530000,04e66e578f653ab9,10,0,173,215,293,131,118,135,108,106,85,183,133,193,163,170,60,-50,110
84,150000,04e66e578f653ab9,10,0,94,102,118,60,38,63,48,62,45,54,52,67,60,58,15,-2,17
105,110000,04e66e578f653ab9,10,0,166,231,280,180,87,167,105,117,108,135,120,201,160,152,81,-15,96
151,510000,04e66e578f653ab9,10,0,226,291,404,151,140,210,163,126,156,158,240,401,320,266,161,82,79
131,340000,04e66e578f653ab9,10,0,127,176,201,116,64,85,74,80,96,91,141,190,166,141,49,50,-1
311,370000,04e66e578f653ab9,10,0,274,383,451,230,146,276,296,237,243,266,313,411,362,330,98,47,51
54,140000,04e66e578f653ab9,10,0,75,85,95,42,23,68,34,43,37,45,67,94,80,69,27,22,5
132,440000,04e66e578f653ab9,10,0,175,225,268,104,54,144,101,111,106,100,115,132,124,116,17,15,2
32,450000,04e66e578f653ab9,10,0,39,42,71,30,28,32,17,42,31,35,34,44,39,38,10,-1,11
405,320000,04e66e578f653ab9,10,0,501,644,669,334,279,388,278,361,289,335,427,537,482,433,110,92,18
53,360000,04e66e578f653ab9,10,0,83,104,86,64,32,40,53,58,44,58,62,97,80,72,35,4,31
202,130000,04e66e578f653ab9,10,0,192,206,272,140,97,162,151,190,159,151,222,288,255,220,66,71,-5
177,410000,04e66e578f653ab9,10,0,169,219,319,144,90,156,142,133,159,150,253,275,264,226,22,103,-81
223,330000,04e66e578f653ab9,10,0,289,400,452,190,120,235,179,236,184,200,265,399,332,288,134,65,69
64,420000,04e66e578f653ab9,10,0,47,81,82,146,33,61,41,44,47,128,75,99,87,101,24,-53,77
127,430000,04e66e578f653ab9,10,0,115,135,228,105,59,115,89,71,92,97,142,167,154,135,25,45,-20
95,350000,04e66e578f653ab9,10,0,107,132,139,77,43,64,62,76,55,207,71,81,76,120,10,-136,146
41,210000,04e66e578f653ab9,10,0,52,62,81,42,40,28,19,48,46,42,41,57,49,47,16,-1,17
76,500000,04e66e578f653ab9,10,0,46,77,87,44,31,56,52,34,81,74,75,97,86,82,22,1,21
131,610000,04e66e578f653ab9,10,0,170,201,238,124,83,169,151,120,99,145,151,182,166,159,31,6,25
36,230000,04e66e578f653ab9,10,0,45,56,48,22,17,60,50,40,34,50,39,45,42,45,6,-11,17
178,310000,dff803b4024d261d,10,0,129,206,317,238,124,175,178,198,247,172,229,295,262,232,66,57,9
71,530000,dff803b4024d261d,10,0,68,61,94,64,55,50,58,59,74,82,64,64,64,70,0,-18,18
119,150000,dff803b4024d261d,10,0,69,77,114,119,58,88,84,113,93,124,126,127,126,126,1,2,-1
464,110000,dff803b4024d261d,10,0,411,466,954,488,303,463,422,404,405,524,536,639,588,566,103,12,91
437,510000,dff803b4024d261d,10,0,219,270,560,493,212,308,310,321,356,354,476,541,508,457,65,122,-57
225,340000,dff803b4024d261d,10,0,131,164,192,238,108,126,152,161,181,221,244,275,260,247,31,23,8
828,370000,dff803b4024d261d,10,0,391,462,714,609,352,736,802,743,732,752,968,895,932,872,-73,216,-289
218,140000,dff803b4024d261d,10,0,104,152,230,168,75,152,133,162,155,176,214,192,203,194,-22,38,-60
2393,440000,dff803b4024d261d,10,0,887,1988,1893,1283,554,1157,1342,1371,1506,1365,1632,2543,2088,1847,911,267,644
302,450000,dff803b4024d261d,10,0,167,204,333,316,132,218,179,232,209,214,240,299,270,251,59,26,33
890,320000,dff803b4024d261d,10,0,489,602,865,785,520,701,575,790,696,727,808,884,846,806,76,81,-5
263,360000,dff803b4024d261d,10,0,168,194,280,264,100,195,178,199,185,190,228,334,281,251,106,38,68
446,130000,dff803b4024d261d,10,0,275,250,454,387,248,489,372,444,470,561,546,540,543,549,-6,-15,9
278,410000,dff803b4024d261d,10,0,168,191,300,319,141,195,250,224,252,313,287,373,330,324,86,-26,112
766,330000,dff803b4024d261d,10,0,572,795,787,577,391,567,562,623,668,663,739,794,766,732,55,76,-21
520,420000,dff803b4024d261d,10,0,394,374,566,545,193,390,310,389,475,504,667,583,625,585,-84,163,-247
391,430000,dff803b4024d261d,10,0,203,423,412,412,410,531,262,352,341,399,402,522,462,441,120,3,117
659,350000,dff803b4024d261d,10,0,397,363,562,555,242,485,658,692,517,589,652,643,648,628,-9,63,-72
250,210000,dff803b4024d261d,10,0,239,228,340,230,163,328,229,232,286,261,346,342,344,316,-4,85,-89
273,500000,dff803b4024d261d,10,0,158,348,846,378,203,261,239,256,499,348,265,359,312,324,94,-83,177
183,610000,dff803b4024d261d,10,0,62,99,126,138,68,103,103,121,139,167,222,209,216,199,-13,55,-68
86,230000,dff803b4024d261d,10,0,46,89,107,57,72,88,195,88,95,117,126,705,416,316,579,9,570
189,310000,61e73e32ad101892,10,0,222,276,374,264,140,173,111,133,219,252,305,253,279,270,-52,53,-105
342,530000,61e73e32ad101892,10,0,420,444,423,403,246,278,240,349,251,370,328,322,325,340,-6,-42,36
520,150000,61e73e32ad101892,10,0,608,505,619,534,251,398,363,397,446,439,554,594,574,529,40,115,-75
555,110000,61e73e32ad101892,10,0,845,1016,1441,741,459,672,521,645,648,738,710,716,713,721,6,-28,34
787,510000,61e73e32ad101892,10,0,712,743,1078,940,507,616,610,516,696,747,853,964,908,855,111,106,5
256,340000,61e73e32ad101892,10,0,217,212,273,247,107,152,149,170,178,202,240,274,257,239,34,38,-4
906,370000,61e73e32ad101892,10,0,764,681,1011,688,350,548,657,631,628,667,792,970,881,810,178,125,53
407,140000,61e73e32ad101892,10,0,280,288,348,274,115,219,218,272,224,246,326,337,332,303,11,80,-69
2270,440000,61e73e32ad101892,10,0,2097,2144,2562,1849,777,1549,1067,1547,1898,1873,2104,2281,2192,2086,177,231,-54
351,450000,61e73e32ad101892,10,0,376,342,443,364,194,278,172,226,248,272,340,365,352,326,25,68,-43
718,320000,61e73e32ad101892,10,0,713,682,857,658,425,546,407,545,534,592,698,728,713,673,30,106,-76
316,360000,61e73e32ad101892,10,0,324,277,382,334,121,180,176,242,230,289,241,378,310,303,137,-48,185
1033,130000,61e73e32ad101892,10,0,875,790,1042,804,407,572,721,849,721,962,1094,1052,1073,1036,-42,132,-174
669,410000,61e73e32ad101892,10,0,514,567,656,654,303,427,422,450,484,638,714,768,741,707,54,76,-22
663,330000,61e73e32ad101892,10,0,707,687,970,632,338,464,407,503,544,617,739,738,738,698,-1,122,-123
1245,420000,61e73e32ad101892,10,0,1234,1296,1458,1429,526,890,740,929,1121,1218,1196,1452,1324,1289,256,-22,278
558,430000,61e73e32ad101892,10,0,532,579,879,712,262,444,376,475,496,530,587,687,637,601,100,57,43
473,350000,61e73e32ad101892,10,0,423,388,523,387,223,336,237,399,355,340,322,385,354,349,63,-18,81
761,210000,61e73e32ad101892,10,0,871,786,1105,571,424,658,595,611,583,678,909,852,880,813,-57,231,-288
447,500000,61e73e32ad101892,10,0,406,568,732,616,327,364,351,290,544,368,383,473,428,408,90,15,75
643,610000,61e73e32ad101892,10,0,618,464,618,561,288,381,522,505,419,505,615,617,616,579,2,110,-108
378,230000,61e73e32ad101892,10,0,346,348,497,267,165,333,307,314,331,413,428,410,419,417,-18,15,-33
75,310000,a432c483b5beb856,10,0,111,242,237,68,37,61,48,42,46,60,56,89,72,68,33,-4,37
159,530000,a432c483b5beb856,10,0,165,182,271,140,100,100,97,72,92,101,116,117,116,111,1,15,-14
146,150000,a432c483b5beb856,10,0,144,149,195,78,54,74,78,87,84,89,105,134,120,109,29,16,13
48,110000,a432c483b5beb856,10,0,97,128,205,34,44,59,36,32,45,41,40,42,41,41,2,-1,3
268,510000,a432c483b5beb856,10,0,284,276,560,275,186,178,154,123,197,155,287,297,292,246,10,132,-122
192,340000,a432c483b5beb856,10,0,234,289,496,209,109,109,97,103,125,123,120,141,130,128,21,-3,24
349,370000,a432c483b5beb856,10,0,430,397,599,241,156,188,181,193,211,187,260,255,258,234,-5,73,-78
132,140000,a432c483b5beb856,10,0,187,192,226,67,52,65,70,76,81,82,108,105,106,98,-3,26,-29
978,440000,a432c483b5beb856,10,0,1096,1273,1753,510,290,467,429,504,568,492,615,692,654,600,77,123,-46
206,450000,a432c483b5beb856,10,0,183,209,314,161,76,113,66,89,103,111,120,142,131,124,22,9,13
571,320000,a432c483b5beb856,10,0,720,808,1176,484,399,360,358,395,364,346,423,460,442,410,37,77,-40
317,360000,a432c483b5beb856,10,0,282,281,556,258,99,139,120,123,138,130,192,210,201,177,18,62,-44
293,130000,a432c483b5beb856,10,0,284,290,435,164,126,133,165,184,178,191,217,243,230,217,26,26,0
457,410000,a432c483b5beb856,10,0,283,364,562,252,130,136,161,188,248,234,365,372,368,324,7,131,-124
551,330000,a432c483b5beb856,10,0,738,799,1102,332,255,331,293,293,451,433,549,507,528,496,-42,116,-158
203,420000,a432c483b5beb856,10,0,257,362,526,267,110,92,100,79,129,117,148,188,168,151,40,31,9
300,430000,a432c483b5beb856,10,0,260,313,627,286,115,133,96,119,133,162,229,236,232,209,7,67,-60
231,350000,a432c483b5beb856,10,0,315,340,500,185,128,160,130,141,134,138,134,168,151,147,34,-4,38
216,210000,a432c483b5beb856,10,0,260,209,299,101,86,133,111,127,127,138,164,160,162,154,-4,26,-30
155,500000,a432c483b5beb856,10,0,151,159,317,179,87,70,59,80,101,84,95,112,104,97,17,11,6
115,610000,a432c483b5beb856,10,0,163,141,242,89,58,62,55,62,48,76,86,87,86,83,1,10,-9
84,230000,a432c483b5beb856,10,0,103,121,126,60,44,65,66,61,78,87,93,69,81,83,-24,6,-30
288,310000,0797526c057dcf5b,10,0,336,1289,571,175,135,300,320,311,280,332,341,475,408,383,134,9,125
354,530000,0797526c057dcf5b,10,0,257,285,393,160,154,201,154,174,208,237,210,296,253,248,86,-27,113
451,150000,0797526c057dcf5b,10,0,326,339,631,236,164,278,287,352,354,352,396,368,382,372,-28,44,-72
323,110000,0797526c057dcf5b,10,0,664,656,980,232,253,315,319,299,344,411,421,374,398,402,-47,10,-57
1119,510000,0797526c057dcf5b,10,0,923,1016,1536,609,478,708,677,703,870,874,1179,1263,1221,1105,84,305,-221
737,340000,0797526c057dcf5b,10,0,666,550,750,358,257,522,447,450,474,531,638,743,690,637,105,107,-2
3176,370000,0797526c057dcf5b,10,0,3148,3502,5481,1788,1203,1635,2012,1985,2046,2150,2770,3225,2998,2715,455,620,-165
1396,140000,0797526c057dcf5b,10,0,899,919,1474,502,371,567,626,775,870,822,1077,1141,1109,1013,64,255,-191
10929,440000,0797526c057dcf5b,10,0,12710,12394,15317,5306,3718,8079,6812,7957,8612,8119,10514,11327,10920,9987,813,2395,-1582
2230,450000,0797526c057dcf5b,10,0,1709,1789,2693,1195,777,1366,1087,1463,1613,1736,2291,2448,2370,2158,157,555,-398
2915,320000,0797526c057dcf5b,10,0,2226,2622,3296,1247,1529,2148,2087,2259,2343,2472,2603,2698,2650,2591,95,131,-36
1467,360000,0797526c057dcf5b,10,0,1277,1265,1764,857,484,797,835,979,1050,1189,1342,1563,1452,1365,221,153,68
2523,130000,0797526c057dcf5b,10,0,2221,2449,3796,1214,995,1259,1697,1832,1815,2279,2449,2337,2393,2355,-112,170,-282
2004,410000,0797526c057dcf5b,10,0,1739,1951,3130,1278,848,1290,1492,1391,1525,1910,2272,2311,2292,2164,39,362,-323
1907,330000,0797526c057dcf5b,10,0,2001,2019,2088,700,801,1246,1369,1509,1644,1767,1896,1932,1914,1865,36,129,-93
1327,420000,0797526c057dcf5b,10,0,1120,1425,1562,736,376,772,827,842,1061,1101,1051,1206,1128,1119,155,-50,205
1767,430000,0797526c057dcf5b,10,0,1444,1769,3168,1244,677,1105,1093,1503,1476,1786,1858,2160,2009,1935,302,72,230
1688,350000,0797526c057dcf5b,10,0,1846,1591,1981,769,598,1058,945,1316,1163,1316,1476,1544,1510,1445,68,160,-92
2045,210000,0797526c057dcf5b,10,0,2443,2622,3705,1059,1132,1642,1541,1606,1822,1931,2151,2147,2149,2076,-4,220,-224
671,500000,0797526c057dcf5b,10,0,494,548,828,333,235,331,330,400,708,364,385,467,426,405,82,21,61
432,610000,0797526c057dcf5b,10,0,457,402,722,289,175,287,284,326,299,382,387,425,406,398,38,5,33
822,230000,0797526c057dcf5b,10,0,605,913,1064,350,347,604,509,589,621,701,1075,927,1001,901,-148,374,-522
334,310000,936168bd4850913d,10,0,234,241,272,250,161,224,213,175,131,62,223,288,256,191,65,161,-96
466,530000,936168bd4850913d,10,0,285,282,383,494,162,297,298,329,209,81,389,480,434,317,91,308,-217
355,150000,936168bd4850913d,10,0,353,331,374,412,213,364,399,353,232,84,339,393,366,272,54,255,-201
461,110000,936168bd4850913d,10,0,432,527,798,336,255,324,347,230,135,126,317,411,364,285,94,191,-97
529,510000,936168bd4850913d,10,0,353,364,502,560,198,280,354,296,108,64,382,522,452,323,140,318,-178
570,340000,936168bd4850913d,10,0,369,339,449,378,228,339,365,359,86,125,393,488,440,335,95,268,-173
1241,370000,936168bd4850913d,10,0,1014,1020,1083,1132,648,948,1214,1085,369,273,1000,1192,1096,822,192,727,-535
467,140000,936168bd4850913d,10,0,394,347,454,373,276,370,403,345,137,148,396,551,474,365,155,248,-93
3252,440000,936168bd4850913d,10,0,2810,2842,3119,2859,1337,2735,2621,2524,1566,594,2431,2956,2694,1994,525,1837,-1312
389,450000,936168bd4850913d,10,0,287,279,316,376,154,306,255,297,140,103,277,336,306,239,59,174,-115
1064,320000,936168bd4850913d,10,0,908,905,1057,1012,579,905,787,820,405,226,838,926,882,663,88,612,-524
446,360000,936168bd4850913d,10,0,325,334,414,397,195,355,439,342,151,95,317,402,360,271,85,222,-137
1078,130000,936168bd4850913d,10,0,696,646,778,797,602,842,1066,971,374,253,922,911,916,695,-11,669,-680
1278,410000,936168bd4850913d,10,0,786,979,1154,954,596,986,1159,919,330,428,1111,1295,1203,945,184,683,-499
1023,330000,936168bd4850913d,10,0,611,709,819,752,388,650,682,669,277,191,789,847,818,609,58,598,-540
1304,420000,936168bd4850913d,10,0,1111,1292,1497,1405,549,1164,1131,1057,674,316,1053,1385,1219,918,332,737,-405
695,430000,936168bd4850913d,10,0,563,649,953,623,341,556,689,570,218,194,551,712,632,486,161,357,-196
622,350000,936168bd4850913d,10,0,586,610,611,627,347,556,479,612,226,137,543,591,567,424,48,406,-358
891,210000,936168bd4850913d,10,0,696,727,851,758,485,709,730,631,387,271,733,853,793,619,120,462,-342
243,500000,936168bd4850913d,10,0,152,145,208,248,87,111,125,128,35,39,154,285,220,159,131,115,16
525,610000,936168bd4850913d,10,0,415,400,482,463,229,331,386,360,198,125,357,434,396,305,77,232,-155
543,230000,936168bd4850913d,10,0,450,630,549,617,346,607,485,461,268,130,519,630,574,426,111,389,-278
143,310000,cc21c7e91a3b5a0c,10,0,238,345,456,114,153,205,172,211,259,235,234,227,230,232,-7,-1,-6
225,530000,cc21c7e91a3b5a0c,10,0,285,338,442,406,203,364,347,383,359,548,448,420,434,472,-28,-100,72
214,150000,cc21c7e91a3b5a0c,10,0,282,331,382,195,193,311,298,379,324,426,353,305,329,361,-48,-73,25
121,110000,cc21c7e91a3b5a0c,10,0,262,356,580,121,115,186,128,156,127,143,113,150,132,135,37,-30,67
291,510000,cc21c7e91a3b5a0c,10,0,487,569,804,459,234,390,378,467,472,512,561,494,528,522,-67,49,-116
287,340000,cc21c7e91a3b5a0c,10,0,428,489,503,403,244,376,434,485,530,589,548,523,536,553,-25,-41,16
531,370000,cc21c7e91a3b5a0c,10,0,855,912,1164,554,505,703,953,906,900,978,952,895,924,942,-57,-26,-31
194,140000,cc21c7e91a3b5a0c,10,0,284,316,428,223,193,301,299,310,314,437,371,333,352,380,-38,-66,28
1622,440000,cc21c7e91a3b5a0c,10,0,2450,3345,3730,1930,1262,2615,2284,2880,3003,3073,3157,2906,3032,3045,-251,84,-335
211,450000,cc21c7e91a3b5a0c,10,0,313,377,417,266,187,309,304,370,332,440,396,386,391,407,-10,-44,34
677,320000,cc21c7e91a3b5a0c,10,0,1114,1454,1527,877,754,1069,1130,1243,1239,1359,1276,1127,1202,1254,-149,-83,-66
244,360000,cc21c7e91a3b5a0c,10,0,317,350,507,305,161,323,377,500,498,505,477,346,412,443,-131,-28,-103
454,130000,cc21c7e91a3b5a0c,10,0,551,574,797,453,434,572,723,877,842,1076,876,738,807,897,-138,-200,62
486,410000,cc21c7e91a3b5a0c,10,0,548,872,1036,630,391,702,797,764,826,1251,974,822,898,1016,-152,-277,125
688,330000,cc21c7e91a3b5a0c,10,0,942,1151,1258,739,529,861,969,1092,1188,1336,1191,1013,1102,1180,-178,-145,-33
697,420000,cc21c7e91a3b5a0c,10,0,918,1189,1511,963,454,719,775,822,1002,1247,1129,844,986,1073,-285,-118,-167
266,430000,cc21c7e91a3b5a0c,10,0,452,506,737,420,189,443,430,470,484,597,615,466,540,559,-149,18,-167
382,350000,cc21c7e91a3b5a0c,10,0,643,734,779,473,353,640,561,659,677,791,724,521,622,679,-203,-67,-136
353,210000,cc21c7e91a3b5a0c,10,0,390,480,602,285,241,431,475,512,466,627,589,508,548,575,-81,-38,-43
134,500000,cc21c7e91a3b5a0c,10,0,186,200,305,185,95,179,155,153,233,211,194,180,187,195,-14,-17,3
153,610000,cc21c7e91a3b5a0c,10,0,309,345,496,293,157,234,292,346,246,352,406,274,340,344,-132,54,-186
210,230000,cc21c7e91a3b5a0c,10,0,306,404,422,214,206,322,309,385,388,444,380,359,370,394,-21,-64,43
117,310000,7aab7fca2470987e,10,0,166,277,348,224,140,212,313,130,176,126,150,183,166,153,33,24,9
11,530000,7aab7fca2470987e,10,0,12,22,33,19,19,18,22,20,12,9,9,13,11,10,4,0,4
25,150000,7aab7fca2470987e,10,0,16,19,22,21,19,29,36,17,19,26,22,19,20,22,-3,-4,1
181,110000,7aab7fca2470987e,10,0,353,372,511,424,244,378,320,244,260,250,268,314,291,277,46,18,28
23,510000,7aab7fca2470987e,10,0,34,42,64,69,42,47,33,29,34,13,37,22,30,24,-15,24,-39
42,340000,7aab7fca2470987e,10,0,52,74,75,83,59,59,57,45,62,31,45,37,41,38,-8,14,-22
190,370000,7aab7fca2470987e,10,0,309,286,341,430,189,295,303,192,237,256,222,242,232,240,20,-34,54
96,140000,7aab7fca2470987e,10,0,58,62,78,105,64,83,78,62,75,85,83,109,96,92,26,-2,28
781,440000,7aab7fca2470987e,10,0,887,972,1235,1009,443,848,749,579,865,757,844,906,875,836,62,87,-25
17,450000,7aab7fca2470987e,10,0,23,13,26,34,17,20,12,20,22,16,21,17,19,18,-4,5,-9
284,320000,7aab7fca2470987e,10,0,323,380,481,397,258,351,301,241,305,301,319,353,336,324,34,18,16
23,360000,7aab7fca2470987e,10,0,29,35,37,61,16,26,40,25,30,32,20,29,24,27,9,-12,21
218,130000,7aab7fca2470987e,10,0,234,231,316,308,172,236,271,218,215,233,230,258,244,240,28,-3,31
126,410000,7aab7fca2470987e,10,0,150,188,209,242,134,155,146,105,140,155,161,153,157,156,-8,6,-14
291,330000,7aab7fca2470987e,10,0,293,323,375,353,222,270,371,311,449,354,283,365,324,334,82,-71,153
34,420000,7aab7fca2470987e,10,0,26,64,62,54,47,52,51,39,64,44,59,48,54,50,-11,15,-26
29,430000,7aab7fca2470987e,10,0,25,31,44,54,26,27,28,26,30,22,38,28,33,29,-10,16,-26
58,350000,7aab7fca2470987e,10,0,57,83,105,92,41,56,43,37,75,57,57,54,56,56,-3,0,-3
97,210000,7aab7fca2470987e,10,0,127,153,187,158,103,124,129,115,148,126,163,128,146,139,-35,37,-72
10,500000,7aab7fca2470987e,10,0,17,12,27,22,12,27,12,19,15,18,21,16,18,18,-5,3,-8
12,610000,7aab7fca2470987e,10,0,25,29,46,61,16,38,37,27,23,27,20,22,21,23,2,-7,9
32,230000,7aab7fca2470987e,10,0,62,61,65,66,41,61,62,37,56,42,70,58,64,57,-12,28,-40
306,310000,fde95ea242abd896,10,0,260,331,369,161,142,190,140,165,214,189,313,284,298,262,-29,124,-153
509,530000,fde95ea242abd896,10,0,519,521,651,386,202,309,233,292,232,382,379,387,383,383,8,-3,11
204,150000,fde95ea242abd896,10,0,185,190,234,146,90,139,127,131,111,141,187,208,198,179,21,46,-25
151,110000,fde95ea242abd896,10,0,223,301,382,210,141,181,149,153,130,100,130,167,148,132,37,30,7
547,510000,fde95ea242abd896,10,0,492,617,839,509,240,360,342,344,334,430,617,773,695,607,156,187,-31
351,340000,fde95ea242abd896,10,0,453,504,690,387,163,254,266,293,273,348,415,368,392,377,-47,67,-114
968,370000,fde95ea242abd896,10,0,774,709,964,444,303,464,570,555,507,649,847,877,862,791,30,198,-168
351,140000,fde95ea242abd896,10,0,277,302,443,175,132,238,204,221,191,257,331,373,352,320,42,74,-32
4197,440000,fde95ea242abd896,10,0,4449,4901,5547,3229,1517,2906,3040,2996,3064,2940,3296,3858,3577,3365,562,356,206
346,450000,fde95ea242abd896,10,0,434,458,665,381,181,321,247,278,230,271,353,423,388,349,70,82,-12
961,320000,fde95ea242abd896,10,0,888,974,1139,690,508,722,614,698,656,855,923,861,892,880,-62,68,-130
280,360000,fde95ea242abd896,10,0,408,499,625,381,184,276,300,321,252,286,354,387,370,342,33,68,-35
775,130000,fde95ea242abd896,10,0,602,602,830,407,320,433,514,507,400,601,794,756,775,717,-38,193,-231
609,410000,fde95ea242abd896,10,0,620,614,920,507,247,499,530,473,405,626,853,641,747,707,-212,227,-439
1244,330000,fde95ea242abd896,10,0,998,1169,1424,732,558,806,842,817,859,969,1255,1091,1173,1105,-164,286,-450
619,420000,fde95ea242abd896,10,0,818,1066,1347,698,270,511,498,504,540,672,774,908,841,785,134,102,32
544,430000,fde95ea242abd896,10,0,630,700,988,570,203,418,421,498,401,577,729,628,678,645,-101,152,-253
822,350000,fde95ea242abd896,10,0,754,796,1043,605,368,580,595,656,635,615,765,815,790,732,50,150,-100
618,210000,fde95ea242abd896,10,0,433,460,600,253,193,341,357,363,293,369,581,567,574,506,-14,212,-226
237,500000,fde95ea242abd896,10,0,227,222,229,139,105,116,140,127,159,132,163,253,208,183,90,31,59
330,610000,fde95ea242abd896,10,0,253,229,293,140,96,140,126,155,135,199,252,297,274,249,45,53,-8
192,230000,fde95ea242abd896,10,0,198,199,322,111,123,264,218,232,182,233,390,264,327,296,-126,157,-283
342,310000,97f15de12cfabbd5,10,0,354,457,516,264,193,369,368,312,223,311,325,374,350,337,49,14,35
114,530000,97f15de12cfabbd5,10,0,236,233,253,206,111,144,116,120,119,120,92,116,104,109,24,-28,52
177,150000,97f15de12cfabbd5,10,0,212,200,238,219,114,172,145,184,185,176,175,180,178,177,5,-1,6
438,110000,97f15de12cfabbd5,10,0,603,754,1094,601,390,482,397,375,385,359,390,493,442,414,103,31,72
247,510000,97f15de12cfabbd5,10,0,363,489,543,391,237,325,296,251,270,231,353,472,412,352,119,122,-3
289,340000,97f15de12cfabbd5,10,0,444,568,578,495,153,185,233,254,279,190,233,316,274,246,83,43,40
910,370000,97f15de12cfabbd5,10,0,1018,1094,1221,1031,476,846,727,791,753,709,746,888,817,781,142,37,105
381,140000,97f15de12cfabbd5,10,0,370,395,605,316,221,369,335,297,249,379,331,458,394,389,127,-48,175
2698,440000,97f15de12cfabbd5,10,0,3019,3563,3747,2666,1125,2377,2460,2143,2250,2148,2251,2790,2520,2396,539,103,436
127,450000,97f15de12cfabbd5,10,0,146,194,174,193,92,119,101,114,104,103,130,136,133,123,6,27,-21
1039,320000,97f15de12cfabbd5,10,0,1292,1491,1524,1070,552,1008,901,895,803,803,813,980,896,865,167,10,157
235,360000,97f15de12cfabbd5,10,0,258,340,409,346,81,166,179,201,165,187,208,207,208,201,-1,21,-22
861,130000,97f15de12cfabbd5,10,0,975,971,1119,789,422,734,762,790,652,806,800,941,870,849,141,-6,147
471,410000,97f15de12cfabbd5,10,0,609,805,866,692,326,488,531,450,448,469,417,510,464,465,93,-52,145
1512,330000,97f15de12cfabbd5,10,0,1371,1516,1515,1138,549,969,1010,1108,1385,1507,1239,1522,1380,1423,283,-268,551
449,420000,97f15de12cfabbd5,10,0,729,779,906,749,253,446,434,381,436,412,489,521,505,474,32,77,-45
387,430000,97f15de12cfabbd5,10,0,645,767,839,710,238,437,402,430,431,398,373,459,416,410,86,-25,111
452,350000,97f15de12cfabbd5,10,0,571,612,638,509,288,542,508,519,527,327,322,360,341,336,38,-5,43
831,210000,97f15de12cfabbd5,10,0,1020,1269,1395,898,506,962,872,971,851,914,875,950,912,913,75,-39,114
144,500000,97f15de12cfabbd5,10,0,170,200,213,159,106,164,130,104,160,133,125,141,133,133,16,-8,24
208,610000,97f15de12cfabbd5,10,0,273,309,371,227,159,225,195,179,129,173,160,195,178,176,35,-13,48
424,230000,97f15de12cfabbd5,10,0,422,639,783,366,217,537,358,448,306,533,522,375,448,477,-147,-11,-136
307,310000,f5d69960089c3614,10,0,186,304,291,260,125,252,169,218,208,195,239,288,264,241,49,44,5
60,530000,f5d69960089c3614,10,0,62,97,95,78,48,59,48,61,43,79,64,53,58,65,-11,-15,4
82,150000,f5d69960089c3614,10,0,57,54,64,35,18,51,53,69,55,61,64,72,68,66,8,3,5
448,110000,f5d69960089c3614,10,0,458,551,739,435,233,445,341,391,396,426,482,578,530,495,96,56,40
241,510000,f5d69960089c3614,10,0,218,246,296,270,133,178,212,190,231,208,233,444,338,295,211,25,186
124,340000,f5d69960089c3614,10,0,119,125,125,156,59,89,69,81,70,72,75,150,112,99,75,3,72
254,370000,f5d69960089c3614,10,0,209,228,356,218,112,223,197,226,179,193,249,344,296,262,95,56,39
33,140000,f5d69960089c3614,10,0,27,53,51,47,21,35,29,43,35,45,44,57,50,49,13,-1,14
473,440000,f5d69960089c3614,10,0,341,442,572,437,152,310,246,338,497,305,362,444,403,370,82,57,25
69,450000,f5d69960089c3614,10,0,35,38,46,44,34,25,32,38,35,50,44,68,56,54,24,-6,30
301,320000,f5d69960089c3614,10,0,218,248,301,251,138,200,177,214,189,187,223,290,256,233,67,36,31
77,360000,f5d69960089c3614,10,0,57,75,92,84,32,51,53,76,51,70,67,97,82,78,30,-3,33
174,130000,f5d69960089c3614,10,0,95,123,131,106,79,112,113,144,111,129,162,213,188,168,51,33,18
158,410000,f5d69960089c3614,10,0,137,144,187,131,57,111,155,108,118,135,163,164,164,154,1,28,-27
139,330000,f5d69960089c3614,10,0,129,149,230,149,78,139,107,108,142,110,130,142,136,127,12,20,-8
143,420000,f5d69960089c3614,10,0,132,148,184,148,61,111,94,101,110,110,157,162,160,143,5,47,-42
137,430000,f5d69960089c3614,10,0,121,157,211,135,74,132,109,108,118,96,135,209,172,147,74,39,35
118,350000,f5d69960089c3614,10,0,93,111,124,108,57,77,71,97,95,75,85,112,98,91,27,10,17
146,210000,f5d69960089c3614,10,0,93,126,129,69,51,75,76,107,67,96,152,173,162,140,21,56,-35
158,500000,f5d69960089c3614,10,0,105,132,160,125,77,112,97,87,149,112,142,157,150,137,15,30,-15
224,610000,f5d69960089c3614,10,0,176,150,182,148,77,137,111,172,117,112,144,202,173,153,58,32,26
78,230000,f5d69960089c3614,10,0,44,71,77,53,34,68,53,50,51,50,100,75,88,75,-25,50,-75
83,310000,5b1c11c3efed5312,10,0,186,244,388,154,85,126,92,105,104,90,95,93,94,93,-2,5,-7
102,530000,5b1c11c3efed5312,10,0,190,214,267,194,91,60,53,77,69,54,60,68,64,61,8,6,2
46,150000,5b1c11c3efed5312,10,0,180,167,259,127,62,61,62,68,40,53,87,64,76,68,-23,34,-57
11,110000,5b1c11c3efed5312,10,0,143,181,370,71,41,51,25,21,23,21,16,13,14,17,-3,-5,2
140,510000,5b1c11c3efed5312,10,0,335,432,691,448,194,129,110,118,105,113,152,138,145,134,-14,39,-53
331,340000,5b1c11c3efed5312,10,0,719,699,1253,712,250,227,217,259,222,209,229,284,256,241,55,20,35
443,370000,5b1c11c3efed5312,10,0,850,792,1449,549,320,297,347,332,246,290,297,412,354,333,115,7,108
88,140000,5b1c11c3efed5312,10,0,226,231,426,153,81,103,83,114,108,86,92,80,86,86,-12,6,-18
547,440000,5b1c11c3efed5312,10,0,953,1204,1628,496,168,342,246,344,349,247,271,470,370,329,199,24,175
46,450000,5b1c11c3efed5312,10,0,119,135,240,121,56,54,26,39,23,31,45,41,43,39,-4,14,-18
468,320000,5b1c11c3efed5312,10,0,1050,1083,1908,768,543,404,402,487,371,340,347,446,396,378,99,7,92
258,360000,5b1c11c3efed5312,10,0,358,434,733,453,153,150,168,191,126,131,163,222,192,172,59,32,27
306,130000,5b1c11c3efed5312,10,0,665,667,1158,476,272,257,300,350,276,304,321,274,298,300,-47,17,-64
454,410000,5b1c11c3efed5312,10,0,894,1006,1883,910,372,312,380,366,295,321,290,401,346,337,111,-31,142
673,330000,5b1c11c3efed5312,10,0,1022,1202,2202,744,430,386,337,361,407,360,410,487,448,419,77,50,27
198,420000,5b1c11c3efed5312,10,0,353,409,749,443,143,138,130,145,146,117,118,165,142,133,47,1,46
192,430000,5b1c11c3efed5312,10,0,322,439,744,378,131,137,149,138,134,113,150,189,170,151,39,37,2
178,350000,5b1c11c3efed5312,10,0,345,391,594,265,149,173,130,137,127,100,127,140,134,122,13,27,-14
56,210000,5b1c11c3efed5312,10,0,176,186,256,75,62,80,75,84,47,39,66,55,60,53,-11,27,-38
14,500000,5b1c11c3efed5312,10,0,86,92,172,124,38,29,23,20,27,17,21,36,28,25,15,4,11
101,610000,5b1c11c3efed5312,10,0,205,212,325,144,79,70,64,97,57,67,82,80,81,76,-2,15,-17
32,230000,5b1c11c3efed5312,10,0,107,126,152,43,36,52,38,43,41,34,44,43,44,40,-1,10,-11
3,310000,17363f08d683d52b,10,0,69,88,96,65,19,37,175,5,12,7,8,136,72,50,128,1,127
65,530000,17363f08d683d52b,10,0,214,209,182,216,75,82,86,83,57,67,66,46,56,60,-20,-1,-19
32,150000,17363f08d683d52b,10,0,176,130,141,132,46,66,45,69,41,38,46,34,40,39,-12,8,-20
11,110000,17363f08d683d52b,10,0,158,186,277,124,81,65,48,29,26,33,15,60,38,36,45,-18,63
63,510000,17363f08d683d52b,10,0,267,205,292,350,117,93,78,81,64,97,44,63,54,68,19,-53,72
111,340000,17363f08d683d52b,10,0,332,341,384,513,121,108,92,90,118,107,99,88,94,98,-11,-8,-3
326,370000,17363f08d683d52b,10,0,572,480,596,555,214,153,209,203,175,145,127,346,236,206,219,-18,237
7,140000,17363f08d683d52b,10,0,89,70,67,66,26,12,22,19,12,23,3,3,3,10,0,-20,20
16,440000,17363f08d683d52b,10,0,91,101,84,62,19,63,37,30,29,26,25,17,21,23,-8,-1,-7
8,450000,17363f08d683d52b,10,0,42,39,50,45,14,26,20,6,2,8,5,11,8,8,6,-3,9
201,320000,17363f08d683d52b,10,0,502,474,569,538,214,216,188,191,134,129,86,151,118,122,65,-43,108
77,360000,17363f08d683d52b,10,0,281,274,309,360,94,101,91,90,79,82,62,58,60,67,-4,-20,16
201,130000,17363f08d683d52b,10,0,372,326,383,353,154,150,162,149,131,144,91,180,136,138,89,-53,142
117,410000,17363f08d683d52b,10,0,471,372,457,538,139,100,129,104,87,70,63,93,78,75,30,-7,37
264,330000,17363f08d683d52b,10,0,437,429,453,388,129,152,151,108,106,91,89,167,128,116,78,-2,80
106,420000,17363f08d683d52b,10,0,379,317,421,474,120,139,119,158,186,109,65,89,77,88,24,-44,68
156,430000,17363f08d683d52b,10,0,353,348,428,459,95,148,114,114,115,100,92,163,128,118,71,-8,79
27,350000,17363f08d683d52b,10,0,148,127,159,136,38,44,37,55,51,15,28,29,28,24,1,13,-12
55,210000,17363f08d683d52b,10,0,216,174,238,151,59,93,137,105,53,60,48,51,50,53,3,-12,15
6,500000,17363f08d683d52b,10,0,108,151,126,110,41,27,16,19,16,22,15,14,14,17,-1,-7,6
43,610000,17363f08d683d52b,10,0,279,210,288,180,80,67,82,94,70,81,86,60,73,76,-26,5,-31
28,230000,17363f08d683d52b,10,0,121,118,156,75,46,57,45,34,22,28,31,17,24,25,-14,3,-17
301,310000,06880909932890ca,10,0,188,341,384,208,78,136,169,219,267,195,272,379,326,282,107,77,30
139,530000,06880909932890ca,10,0,216,186,206,142,56,68,79,116,111,106,126,142,134,125,16,20,-4
60,150000,06880909932890ca,10,0,121,125,115,74,44,45,52,72,39,48,70,69,70,62,-1,22,-23
152,110000,06880909932890ca,10,0,461,553,771,253,139,206,162,160,198,159,181,170,176,170,-11,22,-33
629,510000,06880909932890ca,10,0,548,657,933,673,263,243,304,396,459,464,505,768,636,579,263,41,222
759,340000,06880909932890ca,10,0,800,764,993,964,338,340,389,526,609,640,679,780,730,700,101,39,62
884,370000,06880909932890ca,10,0,979,957,1332,1011,383,430,537,623,546,597,690,912,801,733,222,93,129
145,140000,06880909932890ca,10,0,213,203,275,128,67,102,111,136,137,121,130,151,140,134,21,9,12
1234,440000,06880909932890ca,10,0,1182,1660,1546,767,278,638,579,734,773,669,732,1150,941,850,418,63,355
190,450000,06880909932890ca,10,0,181,188,276,186,86,105,86,125,135,129,121,150,136,133,29,-8,37
2009,320000,06880909932890ca,10,0,2015,2022,2642,2094,991,984,1074,1356,1448,1465,1619,1956,1788,1680,337,154,183
519,360000,06880909932890ca,10,0,368,453,691,614,157,211,274,326,317,295,445,614,530,451,169,150,19
523,130000,06880909932890ca,10,0,665,667,773,530,290,330,342,436,385,393,514,507,510,471,-7,121,-128
1566,410000,06880909932890ca,10,0,1390,1577,2409,1865,640,650,891,1055,1267,1138,1176,1439,1308,1251,263,38,225
1714,330000,06880909932890ca,10,0,1696,1832,2222,1022,501,663,715,913,1088,1232,1489,1624,1556,1448,135,257,-122
562,420000,06880909932890ca,10,0,475,492,661,605,178,211,256,312,333,394,414,526,470,445,112,20,92
497,430000,06880909932890ca,10,0,481,547,698,488,170,228,287,352,372,388,447,540,494,458,93,59,34
504,350000,06880909932890ca,10,0,469,556,601,361,197,246,246,307,332,263,303,408,356,325,105,40,65
162,210000,06880909932890ca,10,0,246,211,328,161,100,120,120,168,137,149,154,182,168,162,28,5,23
358,500000,06880909932890ca,10,0,330,373,430,326,140,158,145,189,295,272,251,352,302,292,101,-21,122
243,610000,06880909932890ca,10,0,449,347,562,349,119,145,167,210,170,185,229,259,244,224,30,44,-14
99,230000,06880909932890ca,10,0,82,97,100,69,37,53,48,62,47,72,53,77,65,67,24,-19,43
22,310000,9c1c7ee8ebdda299,10,0,4,41,46,32,19,54,17,10,12,11,6,11,8,9,5,-5,10
234,530000,9c1c7ee8ebdda299,10,0,126,119,169,142,104,91,53,62,66,54,100,120,110,91,20,46,-26
446,150000,9c1c7ee8ebdda299,10,0,297,353,430,278,168,258,163,176,174,153,161,172,166,162,11,8,3
34,110000,9c1c7ee8ebdda299,10,0,46,78,112,52,38,30,13,7,12,11,3,21,12,12,18,-8,26
648,510000,9c1c7ee8ebdda299,10,0,408,517,641,617,336,250,134,145,143,161,174,211,192,182,37,13,24
349,340000,9c1c7ee8ebdda299,10,0,71,198,190,278,146,119,59,72,88,63,82,153,118,99,71,19,52
1575,370000,9c1c7ee8ebdda299,10,0,1445,1562,2281,1763,885,746,509,752,650,656,635,554,594,615,-81,-21,-60
1057,140000,9c1c7ee8ebdda299,10,0,579,768,886,691,295,401,285,317,252,283,337,321,329,314,-16,54,-70
443,440000,9c1c7ee8ebdda299,10,0,619,710,1008,472,229,471,212,177,139,130,131,160,146,140,29,1,28
260,450000,9c1c7ee8ebdda299,10,0,132,192,308,251,110,119,55,137,102,134,127,148,138,136,21,-7,28
351,320000,9c1c7ee8ebdda299,10,0,95,307,309,370,299,211,106,111,126,119,95,124,110,113,29,-24,53
201,360000,9c1c7ee8ebdda299,10,0,60,177,182,224,84,107,42,42,52,41,45,96,70,61,51,4,47
2258,130000,9c1c7ee8ebdda299,10,0,1092,1644,1840,1468,940,941,733,782,635,713,852,807,830,791,-45,139,-184
1114,410000,9c1c7ee8ebdda299,10,0,306,774,911,1101,433,362,211,283,281,280,284,399,342,321,115,4,111
513,330000,9c1c7ee8ebdda299,10,0,42,380,352,327,197,195,168,241,204,240,223,277,250,247,54,-17,71
166,420000,9c1c7ee8ebdda299,10,0,46,116,125,211,58,65,32,39,46,41,44,51,48,45,7,3,4
309,430000,9c1c7ee8ebdda299,10,0,74,141,165,230,105,87,42,50,62,55,47,92,70,65,45,-8,53
260,350000,9c1c7ee8ebdda299,10,0,110,281,215,204,105,130,66,70,71,48,58,86,72,64,28,10,18
715,210000,9c1c7ee8ebdda299,10,0,384,528,619,375,317,409,425,215,168,173,244,317,280,245,73,71,2
81,500000,9c1c7ee8ebdda299,10,0,62,80,104,116,61,54,25,34,33,27,26,25,26,26,-1,-1,0
394,610000,9c1c7ee8ebdda299,10,0,145,214,250,261,108,136,75,123,125,148,123,127,125,133,4,-25,29
569,230000,9c1c7ee8ebdda299,10,0,291,350,342,207,144,192,137,117,137,97,118,219,168,145,101,21,80
357,310000,c6833cb891626c17,10,0,283,435,596,174,80,151,177,200,272,204,286,381,334,290,95,82,13
311,530000,c6833cb891626c17,10,0,514,538,699,444,236,185,176,241,235,239,233,242,238,238,9,-6,15
285,150000,c6833cb891626c17,10,0,354,323,485,221,94,125,138,233,182,202,244,226,235,224,-18,42,-60
203,110000,c6833cb891626c17,10,0,636,879,1517,309,174,289,242,251,279,287,271,285,278,281,14,-16,30
527,510000,c6833cb891626c17,10,0,712,770,1305,743,339,285,287,359,363,364,444,612,528,473,168,80,88
868,340000,c6833cb891626c17,10,0,894,964,1597,855,344,344,422,524,660,677,843,847,845,789,4,166,-162
862,370000,c6833cb891626c17,10,0,1160,1107,1740,687,383,327,543,829,670,841,808,972,890,874,164,-33,197
248,140000,c6833cb891626c17,10,0,282,301,514,192,100,117,126,207,172,186,212,232,222,210,20,26,-6
825,440000,c6833cb891626c17,10,0,1240,1586,1899,542,186,403,360,460,604,483,479,704,592,555,225,-4,229
164,450000,c6833cb891626c17,10,0,266,309,514,260,96,110,81,120,111,123,118,114,116,118,-4,-5,1
1193,320000,c6833cb891626c17,10,0,1396,1446,2279,939,574,593,645,899,941,918,876,1073,974,956,197,-42,239
631,360000,c6833cb891626c17,10,0,519,571,900,502,180,199,229,302,289,342,439,577,508,453,138,97,41
860,130000,c6833cb891626c17,10,0,990,1108,1749,708,414,412,600,843,768,843,1013,870,942,909,-143,170,-313
1225,410000,c6833cb891626c17,10,0,1493,1622,2735,1331,509,557,792,1003,1139,1208,1046,1173,1110,1142,127,-162,289
1840,330000,c6833cb891626c17,10,0,1911,2130,3255,1119,581,616,676,899,1179,1212,1449,1568,1508,1410,119,237,-118
558,420000,c6833cb891626c17,10,0,560,634,1014,597,202,210,256,309,467,354,417,541,479,437,124,63,61
434,430000,c6833cb891626c17,10,0,546,606,978,498,212,209,272,280,287,311,368,495,432,391,127,57,70
353,350000,c6833cb891626c17,10,0,499,552,782,311,141,184,131,214,223,160,193,287,240,213,94,33,61
187,210000,c6833cb891626c17,10,0,299,258,424,127,80,97,131,161,165,176,170,202,186,183,32,-6,38
178,500000,c6833cb891626c17,10,0,267,309,532,260,104,78,93,126,161,148,159,170,164,159,11,11,0
450,610000,c6833cb891626c17,10,0,472,366,620,315,130,154,179,263,204,263,363,295,329,307,-68,100,-168
100,230000,c6833cb891626c17,10,0,170,232,274,80,52,66,71,97,87,91,116,90,103,99,-26,25,-51
176,310000,3e21824be728cbec,10,0,239,345,396,369,177,174,163,140,140,130,154,202,178,162,48,24,24
226,530000,3e21824be728cbec,10,0,406,373,334,203,134,207,159,159,199,202,227,215,221,215,-12,25,-37
103,150000,3e21824be728cbec,10,0,116,59,90,51,29,42,27,40,31,39,40,40,40,40,0,1,-1
59,110000,3e21824be728cbec,10,0,168,222,242,93,60,87,42,47,47,40,41,55,48,45,14,1,13
361,510000,3e21824be728cbec,10,0,758,778,781,288,239,321,272,333,406,352,417,499,458,423,82,65,17
432,340000,3e21824be728cbec,10,0,644,607,661,309,266,301,237,309,289,297,345,293,319,312,-52,48,-100
703,370000,3e21824be728cbec,10,0,807,782,994,540,419,572,464,433,395,383,432,535,484,450,103,49,54
107,140000,3e21824be728cbec,10,0,200,132,201,88,44,87,60,67,72,87,105,82,94,91,-23,18,-41
508,440000,3e21824be728cbec,10,0,721,938,1135,331,231,477,411,394,418,380,461,499,480,447,38,81,-43
158,450000,3e21824be728cbec,10,0,247,370,403,140,92,140,131,131,161,121,124,149,136,131,25,3,22
937,320000,3e21824be728cbec,10,0,1227,1286,1781,805,710,885,641,740,693,656,701,768,734,708,67,45,22
224,360000,3e21824be728cbec,10,0,438,444,431,157,97,173,170,210,195,175,219,261,240,218,42,44,-2
703,130000,3e21824be728cbec,10,0,766,589,806,391,375,484,404,455,438,404,455,455,455,438,0,51,-51
591,410000,3e21824be728cbec,10,0,834,729,896,363,334,528,418,445,554,381,446,510,478,446,64,65,-1
595,330000,3e21824be728cbec,10,0,616,797,1044,341,386,475,363,466,458,443,473,505,489,474,32,30,2
242,420000,3e21824be728cbec,10,0,452,413,461,270,123,194,119,150,177,181,200,192,196,191,-8,19,-27
207,430000,3e21824be728cbec,10,0,414,458,478,157,99,182,167,188,184,200,195,251,223,215,56,-5,61
321,350000,3e21824be728cbec,10,0,397,455,593,250,154,266,219,283,228,214,225,227,226,222,2,11,-9
113,210000,3e21824be728cbec,10,0,114,136,149,45,36,75,66,76,84,71,67,64,66,67,-3,-4,1
136,500000,3e21824be728cbec,10,0,402,422,475,136,124,148,136,160,225,137,123,161,142,140,38,-14,52
239,610000,3e21824be728cbec,10,0,595,355,464,194,145,188,141,176,186,164,204,187,196,185,-17,40,-57
82,230000,3e21824be728cbec,10,0,176,82,87,40,47,82,54,34,48,39,38,37,38,38,-1,-1,0
361,310000,f8a6975573af1b33,10,0,355,228,579,371,131,288,266,225,283,286,352,425,388,354,73,66,7
214,530000,f8a6975573af1b33,10,0,244,165,338,215,134,179,192,167,169,217,170,285,228,224,115,-47,162
57,150000,f8a6975573af1b33,10,0,41,43,48,41,28,59,37,53,61,54,60,50,55,55,-10,6,-16
75,110000,f8a6975573af1b33,10,0,268,372,383,131,61,110,108,70,103,89,94,106,100,96,12,5,7
570,510000,f8a6975573af1b33,10,0,431,484,820,550,286,428,433,456,497,476,571,730,650,592,159,95,64
651,340000,f8a6975573af1b33,10,0,495,362,758,508,322,432,425,545,563,499,558,654,606,570,96,59,37
427,370000,f8a6975573af1b33,10,0,423,383,729,410,227,320,381,388,394,345,413,508,460,422,95,68,27
82,140000,f8a6975573af1b33,10,0,61,91,136,74,57,53,62,47,59,62,56,65,60,61,9,-6,15
1459,440000,f8a6975573af1b33,10,0,1305,1034,2232,1023,444,1072,1007,969,1190,954,1225,1539,1382,1239,314,271,43
238,450000,f8a6975573af1b33,10,0,215,191,328,208,107,160,131,178,209,223,211,264,238,233,53,-12,65
1302,320000,f8a6975573af1b33,10,0,1239,807,1846,1142,747,1023,870,969,1040,1045,1132,1384,1258,1187,252,87,165
365,360000,f8a6975573af1b33,10,0,226,131,436,290,111,237,235,226,237,243,304,361,332,303,57,61,-4
418,130000,f8a6975573af1b33,10,0,308,272,475,287,194,265,298,335,339,355,444,469,456,423,25,89,-64
610,410000,f8a6975573af1b33,10,0,543,420,747,459,249,457,513,513,571,508,547,706,626,587,159,39,120
1245,330000,f8a6975573af1b33,10,0,856,695,1454,752,503,780,679,725,759,836,1202,1060,1131,1033,-142,366,-508
444,420000,f8a6975573af1b33,10,0,278,190,481,312,158,246,258,251,428,347,390,481,436,406,91,43,48
351,430000,f8a6975573af1b33,10,0,289,235,425,324,139,263,238,293,308,308,344,467,406,373,123,36,87
533,350000,f8a6975573af1b33,10,0,472,415,699,508,260,395,323,426,506,406,485,547,516,479,62,79,-17
94,210000,f8a6975573af1b33,10,0,125,64,125,66,52,82,116,125,102,110,143,125,134,126,-18,33,-51
307,500000,f8a6975573af1b33,10,0,322,256,548,310,185,288,287,285,378,280,285,380,332,315,95,5,90
205,610000,f8a6975573af1b33,10,0,226,181,259,170,96,124,121,134,165,167,184,227,206,193,43,17,26
58,230000,f8a6975573af1b33,10,0,67,65,115,61,52,76,85,53,52,53,68,53,60,58,-15,15,-30
217,310000,54fc07138d70374c,10,0,292,421,473,415,199,338,303,272,297,230,306,310,308,282,4,76,-72
284,530000,54fc07138d70374c,10,0,363,485,535,500,259,353,295,304,293,320,299,296,298,305,-3,-21,18
163,150000,54fc07138d70374c,10,0,233,229,234,273,129,208,180,191,167,194,197,191,194,194,-6,3,-9
323,110000,54fc07138d70374c,10,0,429,500,681,534,295,402,398,365,374,341,360,397,378,366,37,19,18
426,510000,54fc07138d70374c,10,0,704,743,849,933,442,540,493,508,553,476,460,610,535,515,150,-16,166
181,340000,54fc07138d70374c,10,0,271,334,368,404,198,210,162,176,206,197,185,206,196,196,21,-12,33
489,370000,54fc07138d70374c,10,0,679,776,936,911,376,595,546,558,596,483,522,642,582,549,120,39,81
135,140000,54fc07138d70374c,10,0,142,208,244,213,113,141,101,103,104,107,143,141,142,130,-2,36,-38
973,440000,54fc07138d70374c,10,0,1392,1836,2078,1526,521,1068,875,905,1067,825,969,1188,1078,994,219,144,75
131,450000,54fc07138d70374c,10,0,208,246,317,323,145,236,156,189,166,140,172,167,170,160,-5,32,-37
440,320000,54fc07138d70374c,10,0,660,847,820,821,461,589,458,423,545,436,500,549,524,495,49,64,-15
140,360000,54fc07138d70374c,10,0,187,249,262,297,113,164,151,133,139,150,149,170,160,156,21,-1,22
421,130000,54fc07138d70374c,10,0,625,746,750,758,431,483,470,474,415,495,501,519,510,505,18,6,12
366,410000,54fc07138d70374c,10,0,604,752,820,826,447,615,567,493,543,423,493,437,465,451,-56,70,-126
344,330000,54fc07138d70374c,10,0,524,623,684,550,252,401,254,311,325,307,322,340,331,323,18,15,3
246,420000,54fc07138d70374c,10,0,310,385,425,481,197,299,246,238,274,238,273,295,284,269,22,35,-13
286,430000,54fc07138d70374c,10,0,364,460,493,505,239,383,321,315,341,325,336,378,357,346,42,11,31
131,350000,54fc07138d70374c,10,0,268,329,338,400,163,217,128,161,123,141,139,151,145,144,12,-2,14
198,210000,54fc07138d70374c,10,0,303,369,450,249,117,274,320,298,258,236,274,251,262,254,-23,38,-61
263,500000,54fc07138d70374c,10,0,400,540,575,576,284,403,314,306,439,296,285,331,308,304,46,-11,57
216,610000,54fc07138d70374c,10,0,365,346,404,376,178,272,285,266,201,203,229,236,232,223,7,26,-19
237,230000,54fc07138d70374c,10,0,302,341,410,324,206,341,242,239,273,292,251,258,254,267,7,-41,48
228,310000,212083a9246d2fd3,10,0,446,636,846,241,179,180,191,192,253,247,261,249,255,252,-12,14,-26
277,530000,212083a9246d2fd3,10,0,304,365,493,290,145,117,124,158,128,183,166,200,183,183,34,-17,51
180,150000,212083a9246d2fd3,10,0,206,310,562,284,123,119,71,119,101,97,110,137,124,115,27,13,14
85,110000,212083a9246d2fd3,10,0,257,444,824,105,71,55,60,50,59,51,57,65,61,58,8,6,2
550,510000,212083a9246d2fd3,10,0,762,1080,1730,983,504,400,394,380,436,516,607,641,624,588,34,91,-57
1137,340000,212083a9246d2fd3,10,0,1023,1260,2243,1186,528,593,566,477,521,594,770,1036,903,800,266,176,90
1041,370000,212083a9246d2fd3,10,0,1536,1637,2998,1261,553,503,551,645,651,724,836,994,915,851,158,112,46
274,140000,212083a9246d2fd3,10,0,299,372,645,313,178,140,164,178,173,195,230,273,252,233,43,35,8
769,440000,212083a9246d2fd3,10,0,1274,1967,3191,905,337,855,959,831,614,794,1007,844,926,882,-163,213,-376
309,450000,212083a9246d2fd3,10,0,252,337,697,471,179,227,188,213,224,204,252,332,292,263,80,48,32
1122,320000,212083a9246d2fd3,10,0,1918,2283,3836,1631,972,777,763,993,802,889,897,976,936,921,79,8,71
442,360000,212083a9246d2fd3,10,0,547,676,1270,658,229,229,221,283,227,273,344,417,380,345,73,71,2
757,130000,212083a9246d2fd3,10,0,969,1064,2232,950,551,442,578,697,555,544,666,625,646,612,-41,122,-163
1655,410000,212083a9246d2fd3,10,0,1431,1720,3243,1894,828,807,1011,1085,1013,1189,1300,1393,1346,1294,93,111,-18
676,330000,212083a9246d2fd3,10,0,1140,1205,1850,574,328,328,361,426,423,467,565,573,569,535,8,98,-90
348,420000,212083a9246d2fd3,10,0,710,866,1354,755,244,256,243,222,247,223,230,310,270,254,80,7,73
666,430000,212083a9246d2fd3,10,0,687,982,1756,938,322,403,371,448,412,466,511,628,570,535,117,45,72
511,350000,212083a9246d2fd3,10,0,645,746,1041,462,182,250,215,304,238,233,338,522,430,364,184,105,79
152,210000,212083a9246d2fd3,10,0,275,422,561,181,92,144,178,144,111,123,123,146,134,131,23,0,23
281,500000,212083a9246d2fd3,10,0,571,643,1136,557,231,195,203,189,260,190,212,306,259,236,94,22,72
649,610000,212083a9246d2fd3,10,0,682,805,1567,639,298,275,310,369,282,381,491,525,508,466,34,110,-76
111,230000,212083a9246d2fd3,10,0,109,207,305,102,62,72,62,93,71,101,93,80,86,91,-13,-8,-5
32,310000,4f79773e600518a6,10,0,64,139,159,95,31,32,33,18,19,21,31,33,32,28,2,10,-8
109,530000,4f79773e600518a6,10,0,129,116,195,181,91,58,50,67,48,56,60,70,65,62,10,4,6
150,150000,4f79773e600518a6,10,0,215,227,336,327,113,110,91,126,86,83,105,142,124,110,37,22,15
18,110000,4f79773e600518a6,10,0,113,153,246,99,35,29,28,28,17,19,21,32,26,24,11,2,9
93,510000,4f79773e600518a6,10,0,194,267,387,398,155,108,95,80,69,76,114,107,110,99,-7,38,-45
149,340000,4f79773e600518a6,10,0,262,301,471,484,121,103,101,118,103,101,112,137,124,117,25,11,14
387,370000,4f79773e600518a6,10,0,629,591,961,723,263,300,312,311,242,273,332,372,352,326,40,59,-19
77,140000,4f79773e600518a6,10,0,114,133,167,149,66,59,57,51,58,45,92,92,92,76,0,47,-47
35,440000,4f79773e600518a6,10,0,142,134,176,97,19,44,38,31,35,30,38,44,41,37,6,8,-2
17,450000,4f79773e600518a6,10,0,44,52,62,66,20,31,15,25,9,23,18,12,15,18,-6,-5,-1
93,320000,4f79773e600518a6,10,0,289,312,450,333,168,137,94,101,95,97,80,87,84,88,7,-17,24
109,360000,4f79773e600518a6,10,0,141,164,252,264,69,58,63,82,66,58,86,106,96,83,20,28,-8
175,130000,4f79773e600518a6,10,0,281,338,473,362,182,165,226,205,142,157,221,184,202,187,-37,64,-101
323,410000,4f79773e600518a6,10,0,457,535,679,669,213,223,212,206,190,239,237,292,264,256,55,-2,57
59,330000,4f79773e600518a6,10,0,167,161,255,131,59,54,69,64,57,47,53,54,54,51,1,6,-5
149,420000,4f79773e600518a6,10,0,258,278,385,450,105,110,104,89,90,81,127,134,130,114,7,46,-39
419,430000,4f79773e600518a6,10,0,378,533,776,857,222,262,247,257,219,243,308,415,362,322,107,65,42
25,350000,4f79773e600518a6,10,0,51,83,65,41,21,20,20,33,19,21,25,14,20,20,-11,4,-15
69,210000,4f79773e600518a6,10,0,128,129,166,109,50,66,72,45,46,43,59,62,60,55,3,16,-13
77,500000,4f79773e600518a6,10,0,175,189,306,256,58,77,65,70,84,67,84,87,86,79,3,17,-14
320,610000,4f79773e600518a6,10,0,421,381,634,493,193,190,176,193,161,204,222,237,230,221,15,18,-3
95,230000,4f79773e600518a6,10,0,126,204,277,131,70,96,70,62,54,66,59,76,68,67,17,-7,24
82,310000,fc32b1a017b34efe,10,0,167,211,361,138,71,95,74,75,111,81,104,108,106,98,4,23,-19
567,530000,fc32b1a017b34efe,10,0,521,434,743,406,299,256,259,276,323,373,379,361,370,371,-18,6,-24
412,150000,fc32b1a017b34efe,10,0,366,390,683,304,135,211,181,248,260,314,339,378,358,344,39,25,14
115,110000,fc32b1a017b34efe,10,0,302,357,675,173,56,121,79,138,89,102,103,129,116,111,26,1,25
1202,510000,fc32b1a017b34efe,10,0,1137,1318,2057,1186,681,782,644,814,979,1044,1182,1106,1144,1111,-76,138,-214
391,340000,fc32b1a017b34efe,10,0,476,493,865,574,194,213,248,307,345,317,346,361,354,341,15,29,-14
826,370000,fc32b1a017b34efe,10,0,870,894,1538,723,282,412,473,536,614,680,774,720,747,725,-54,94,-148
1059,140000,fc32b1a017b34efe,10,0,495,510,974,417,214,254,346,509,560,656,816,685,750,719,-131,160,-291
619,440000,fc32b1a017b34efe,10,0,702,768,1105,569,259,493,354,430,585,484,578,575,576,546,-3,94,-97
224,450000,fc32b1a017b34efe,10,0,208,212,406,260,101,165,105,174,218,194,217,225,221,212,8,23,-15
672,320000,fc32b1a017b34efe,10,0,828,786,1332,698,402,409,494,495,557,550,609,567,588,575,-42,59,-101
351,360000,fc32b1a017b34efe,10,0,363,356,774,420,110,193,205,216,298,283,295,291,293,290,-4,12,-16
1509,130000,fc32b1a017b34efe,10,0,974,964,2069,891,397,516,929,990,983,1137,1295,1153,1224,1195,-142,158,-300
1114,410000,fc32b1a017b34efe,10,0,913,934,1916,1026,330,387,521,645,908,946,966,847,906,920,-119,20,-139
469,330000,fc32b1a017b34efe,10,0,663,556,982,370,195,281,311,304,395,371,467,405,436,414,-62,96,-158
326,420000,fc32b1a017b34efe,10,0,300,389,721,401,105,159,186,195,272,290,243,277,260,270,34,-47,81
559,430000,fc32b1a017b34efe,10,0,567,687,1290,631,205,298,333,363,464,424,425,552,488,467,127,1,126
199,350000,fc32b1a017b34efe,10,0,240,253,385,180,95,138,114,150,154,163,198,154,176,172,-44,35,-79
175,210000,fc32b1a017b34efe,10,0,211,226,330,135,104,181,144,138,167,145,200,198,199,181,-2,55,-57
667,500000,fc32b1a017b34efe,10,0,844,751,1420,661,420,464,477,481,631,557,639,617,628,604,-22,82,-104
909,610000,fc32b1a017b34efe,10,0,623,639,1234,604,184,336,402,415,468,687,690,661,676,679,-29,3,-32
158,230000,fc32b1a017b34efe,10,0,126,150,236,76,111,111,78,108,134,127,165,146,156,146,-19,38,-57
354,310000,feabbf46658382b9,10,0,412,620,805,357,95,198,187,218,252,286,379,461,420,375,82,93,-11
996,530000,feabbf46658382b9,10,0,856,921,1249,829,418,522,444,470,542,766,801,741,771,769,-60,35,-95
875,150000,feabbf46658382b9,10,0,528,675,925,601,288,415,322,461,499,595,688,789,738,691,101,93,8
287,110000,feabbf46658382b9,10,0,532,779,1421,437,212,313,278,276,253,302,320,338,329,320,18,18,0
1737,510000,feabbf46658382b9,10,0,1620,1861,2915,2183,903,1084,938,1042,1247,1538,1846,1788,1817,1724,-58,308,-366
739,340000,feabbf46658382b9,10,0,757,934,1307,1141,304,330,322,356,545,585,712,755,734,684,43,127,-84
1211,370000,feabbf46658382b9,10,0,1214,1192,1610,1006,389,569,611,624,776,1014,1189,1170,1180,1124,-19,175,-194
718,140000,feabbf46658382b9,10,0,511,601,970,406,198,368,305,370,503,552,733,652,692,646,-81,181,-262
1748,440000,feabbf46658382b9,10,0,1507,1902,2685,1203,341,825,879,785,1142,1134,1550,1490,1520,1391,-60,416,-476
365,450000,feabbf46658382b9,10,0,352,440,665,433,149,235,168,197,226,296,330,369,350,332,39,34,5
1868,320000,feabbf46658382b9,10,0,1598,1955,2752,1481,650,861,854,961,1280,1420,1671,1770,1720,1620,99,251,-152
474,360000,feabbf46658382b9,10,0,475,511,802,624,159,229,268,266,354,440,475,407,441,441,-68,35,-103
1560,130000,feabbf46658382b9,10,0,905,1021,1551,970,478,608,767,810,890,1254,1423,1432,1428,1370,9,169,-160
2048,410000,feabbf46658382b9,10,0,1399,1530,2696,1928,502,672,701,850,1415,1787,1789,1724,1756,1767,-65,2,-67
1857,330000,feabbf46658382b9,10,0,1351,1499,2124,704,292,530,641,696,932,1254,1486,1797,1642,1512,311,232,79
716,420000,feabbf46658382b9,10,0,620,794,1252,837,201,313,330,347,462,609,643,609,626,620,-34,34,-68
1066,430000,feabbf46658382b9,10,0,1339,1478,2360,1657,503,671,579,591,827,934,1043,1138,1090,1038,95,109,-14
521,350000,feabbf46658382b9,10,0,399,601,698,428,129,211,219,281,359,378,470,543,506,464,73,92,-19
290,210000,feabbf46658382b9,10,0,306,361,459,235,125,226,187,250,248,334,351,316,334,334,-35,17,-52
1555,500000,feabbf46658382b9,10,0,1487,1581,2727,1846,758,896,740,908,1151,1313,1405,1572,1488,1430,167,92,75
1110,610000,feabbf46658382b9,10,0,827,896,1319,905,333,426,445,444,565,798,975,991,983,921,16,177,-161
258,230000,feabbf46658382b9,10,0,256,312,397,173,117,199,155,143,190,253,271,281,276,268,10,18,-8
26,310000,f270f6a489c6a9d7,10,0,27,30,34,19,29,28,25,38,29,32,29,27,28,29,-2,-3,1
1016,530000,f270f6a489c6a9d7,10,0,1736,1547,1939,1680,1190,1187,815,815,786,875,755,817,786,816,62,-120,182
61,150000,f270f6a489c6a9d7,10,0,93,105,108,54,78,117,71,70,60,56,65,70,68,64,5,9,-4
59,110000,f270f6a489c6a9d7,10,0,198,305,504,106,118,157,120,110,104,70,81,80,80,77,-1,11,-12
495,510000,f270f6a489c6a9d7,10,0,655,773,955,603,645,678,519,472,474,468,514,523,518,502,9,46,-37
119,340000,f270f6a489c6a9d7,10,0,214,225,272,216,223,191,165,153,149,145,130,226,178,167,96,-15,111
319,370000,f270f6a489c6a9d7,10,0,551,636,1105,629,541,513,451,400,375,388,431,348,390,389,-83,43,-126
118,140000,f270f6a489c6a9d7,10,0,118,161,233,166,115,127,118,117,113,93,103,99,101,98,-4,10,-14
326,440000,f270f6a489c6a9d7,10,0,624,713,866,346,505,757,513,503,519,390,440,464,452,431,24,50,-26
26,450000,f270f6a489c6a9d7,10,0,63,75,97,92,50,85,53,57,36,20,17,40,28,26,23,-3,26
383,320000,f270f6a489c6a9d7,10,0,763,871,1150,610,843,857,623,558,495,522,542,537,540,534,-5,20,-25
55,360000,f270f6a489c6a9d7,10,0,92,117,148,132,89,105,90,70,62,87,69,109,89,88,40,-18,58
446,130000,f270f6a489c6a9d7,10,0,554,769,983,537,616,685,621,541,500,570,609,477,543,552,-132,39,-171
530,410000,f270f6a489c6a9d7,10,0,746,952,1314,922,778,753,612,592,519,715,609,950,780,758,341,-106,447
303,330000,f270f6a489c6a9d7,10,0,456,466,653,312,498,511,368,351,319,353,307,303,305,321,-4,-46,42
287,420000,f270f6a489c6a9d7,10,0,592,590,903,514,438,482,408,403,314,306,325,383,354,338,58,19,39
207,430000,f270f6a489c6a9d7,10,0,327,426,575,405,314,375,353,267,377,276,257,258,258,264,1,-19,20
103,350000,f270f6a489c6a9d7,10,0,179,175,195,85,140,157,133,146,133,94,101,94,98,96,-7,7,-14
162,210000,f270f6a489c6a9d7,10,0,260,281,370,158,187,236,191,184,170,200,162,165,164,176,3,-38,41
462,500000,f270f6a489c6a9d7,10,0,645,706,955,636,643,771,438,521,498,470,463,469,466,467,6,-7,13
118,610000,f270f6a489c6a9d7,10,0,209,280,324,195,155,198,180,157,132,131,161,154,158,149,-7,30,-37
20,230000,f270f6a489c6a9d7,10,0,59,76,90,35,48,67,46,41,40,28,43,38,40,36,-5,15,-20
59,310000,d0f245b8781e3631,10,0,159,193,281,60,52,74,61,69,81,59,68,101,84,76,33,9,24
230,530000,d0f245b8781e3631,10,0,224,227,356,181,119,130,103,154,125,106,113,128,120,116,15,7,8
89,150000,d0f245b8781e3631,10,0,129,183,244,117,67,81,65,79,55,51,79,82,80,71,3,28,-25
91,110000,d0f245b8781e3631,10,0,326,417,805,105,52,132,97,103,144,172,170,133,152,158,-37,-2,-35
533,510000,d0f245b8781e3631,10,0,824,910,1456,816,454,505,463,516,491,453,624,583,604,553,-41,171,-212
108,340000,d0f245b8781e3631,10,0,267,287,463,251,96,133,88,118,91,110,111,129,120,117,18,1,17
344,370000,d0f245b8781e3631,10,0,679,738,1182,600,283,311,395,408,271,332,415,347,381,365,-68,83,-151
197,140000,d0f245b8781e3631,10,0,243,264,497,192,96,135,117,169,144,132,175,152,164,153,-23,43,-66
267,440000,d0f245b8781e3631,10,0,574,615,869,297,127,271,262,258,278,238,265,297,281,267,32,27,5
139,450000,d0f245b8781e3631,10,0,205,233,425,254,71,136,107,135,145,104,103,124,114,110,21,-1,22
334,320000,d0f245b8781e3631,10,0,731,749,1017,461,270,342,363,373,289,260,265,382,324,302,117,5,112
111,360000,d0f245b8781e3631,10,0,198,198,315,211,60,84,84,68,64,78,105,104,104,96,-1,27,-28
524,130000,d0f245b8781e3631,10,0,682,755,1430,754,390,398,481,498,419,459,630,477,554,522,-153,171,-324
417,410000,d0f245b8781e3631,10,0,876,865,1601,892,268,371,333,363,396,440,436,415,426,430,-21,-4,-17
263,330000,d0f245b8781e3631,10,0,406,420,845,174,81,170,192,246,204,243,235,258,246,245,23,-8,31
69,420000,d0f245b8781e3631,10,0,128,133,246,134,39,47,55,60,48,51,63,57,60,57,-6,12,-18
199,430000,d0f245b8781e3631,10,0,335,447,756,439,130,231,191,211,178,177,209,244,226,210,35,32,3
80,350000,d0f245b8781e3631,10,0,175,166,247,102,51,67,60,67,91,79,101,94,98,91,-7,22,-29
20,210000,d0f245b8781e3631,10,0,54,102,113,47,21,29,27,30,22,21,21,18,20,20,-3,0,-3
436,500000,d0f245b8781e3631,10,0,548,596,1578,630,283,298,337,395,444,428,519,438,478,462,-81,91,-172
354,610000,d0f245b8781e3631,10,0,455,558,938,498,189,261,260,236,226,286,349,325,337,320,-24,63,-87
8,230000,d0f245b8781e3631,10,0,16,45,45,7,10,21,11,20,18,12,17,12,14,14,-5,5,-10
302,310000,c6cd4e0e073f5ac2,10,0,393,448,746,228,125,223,190,233,237,1154,290,404,347,616,114,-864,978
86,530000,c6cd4e0e073f5ac2,10,0,266,224,235,105,67,68,72,70,100,79,62,75,68,72,13,-17,30
84,150000,c6cd4e0e073f5ac2,10,0,289,273,340,208,63,95,64,75,89,75,89,111,100,92,22,14,8
34,110000,c6cd4e0e073f5ac2,10,0,156,179,362,72,29,64,61,50,56,417,666,51,358,378,-615,249,-864
297,510000,c6cd4e0e073f5ac2,10,0,730,631,1027,542,251,246,265,230,226,834,315,368,342,506,53,-519,572
523,340000,c6cd4e0e073f5ac2,10,0,755,678,1434,792,244,232,308,344,363,315,452,583,518,450,131,137,-6
555,370000,c6cd4e0e073f5ac2,10,0,1380,1053,1685,823,326,341,453,371,362,372,520,630,575,507,110,148,-38
206,140000,c6cd4e0e073f5ac2,10,0,386,479,604,321,126,162,162,182,154,558,292,187,240,346,-105,-266,161
509,440000,c6cd4e0e073f5ac2,10,0,936,1038,1493,451,130,374,366,407,481,329,409,478,444,405,69,80,-11
198,450000,c6cd4e0e073f5ac2,10,0,349,312,543,250,76,136,99,136,130,103,145,204,174,151,59,42,17
1091,320000,c6cd4e0e073f5ac2,10,0,1650,1467,2828,1205,656,751,787,807,758,1395,929,1015,972,1113,86,-466,552
451,360000,c6cd4e0e073f5ac2,10,0,626,577,1241,549,138,232,271,262,250,268,377,418,398,354,41,109,-68
366,130000,c6cd4e0e073f5ac2,10,0,840,561,1020,602,249,293,362,351,329,285,374,411,392,357,37,89,-52
1206,410000,c6cd4e0e073f5ac2,10,0,959,1021,1584,992,320,512,660,557,721,719,991,1189,1090,966,198,272,-74
496,330000,c6cd4e0e073f5ac2,10,0,828,859,1272,386,193,342,341,375,377,337,402,499,450,413,97,65,32
390,420000,c6cd4e0e073f5ac2,10,0,691,751,1208,523,161,272,326,270,280,775,316,371,344,487,55,-459,514
434,430000,c6cd4e0e073f5ac2,10,0,522,619,891,508,132,232,212,222,268,261,329,457,393,349,128,68,60
145,350000,c6cd4e0e073f5ac2,10,0,268,291,431,173,74,106,104,121,115,77,91,131,111,100,40,14,26
54,210000,c6cd4e0e073f5ac2,10,0,139,186,225,91,51,75,101,66,42,52,68,79,74,66,11,16,-5
70,500000,c6cd4e0e073f5ac2,10,0,182,148,242,128,33,53,51,65,76,57,46,63,54,55,17,-11,28
274,610000,c6cd4e0e073f5ac2,10,0,278,275,432,182,64,143,136,155,142,754,199,271,235,408,72,-555,627
14,230000,c6cd4e0e073f5ac2,10,0,83,61,140,53,29,33,28,48,27,21,28,21,24,23,-7,7,-14
87,310000,a9a43d1a7ecbe75d,10,0,113,162,163,142,84,128,99,108,102,143,141,92,116,125,-49,-2,-47
78,530000,a9a43d1a7ecbe75d,10,0,95,152,131,146,84,119,80,84,87,136,120,95,108,117,-25,-16,-9
69,150000,a9a43d1a7ecbe75d,10,0,97,81,90,83,41,62,87,86,67,58,68,69,68,65,1,10,-9
67,110000,a9a43d1a7ecbe75d,10,0,79,100,123,88,65,74,70,62,63,53,50,55,52,53,5,-3,8
197,510000,a9a43d1a7ecbe75d,10,0,284,279,330,341,184,223,201,224,188,192,262,301,282,252,39,70,-31
155,340000,a9a43d1a7ecbe75d,10,0,170,183,198,254,107,149,150,152,146,136,174,138,156,149,-36,38,-74
155,370000,a9a43d1a7ecbe75d,10,0,152,160,191,159,74,162,163,162,117,116,158,179,168,151,21,42,-21
26,140000,a9a43d1a7ecbe75d,10,0,32,31,28,41,25,46,41,28,30,28,32,32,32,31,0,4,-4
480,440000,a9a43d1a7ecbe75d,10,0,541,658,638,568,264,527,387,410,437,440,502,480,491,474,-22,62,-84
132,450000,a9a43d1a7ecbe75d,10,0,163,172,213,297,121,197,152,163,152,143,162,143,152,149,-19,19,-38
314,320000,a9a43d1a7ecbe75d,10,0,385,402,439,430,213,408,324,345,284,373,290,342,316,335,52,-83,135
85,360000,a9a43d1a7ecbe75d,10,0,87,76,120,103,50,101,76,71,82,82,105,75,90,87,-30,23,-53
110,130000,a9a43d1a7ecbe75d,10,0,82,85,95,109,50,116,95,137,104,134,131,121,126,129,-10,-3,-7
125,410000,a9a43d1a7ecbe75d,10,0,141,134,164,130,78,142,114,90,124,140,149,132,140,140,-17,9,-26
278,330000,a9a43d1a7ecbe75d,10,0,339,364,397,466,185,307,317,322,277,351,327,287,307,322,-40,-24,-16
183,420000,a9a43d1a7ecbe75d,10,0,184,244,236,270,129,200,183,140,190,186,222,164,193,191,-58,36,-94
230,430000,a9a43d1a7ecbe75d,10,0,308,355,445,519,215,330,301,296,262,319,373,282,328,325,-91,54,-145
89,350000,a9a43d1a7ecbe75d,10,0,87,125,99,145,57,96,88,101,91,78,106,100,103,95,-6,28,-34
99,210000,a9a43d1a7ecbe75d,10,0,115,126,155,89,59,109,102,100,85,79,140,123,132,114,-17,61,-78
92,500000,a9a43d1a7ecbe75d,10,0,173,179,214,160,89,140,134,104,264,151,136,117,126,135,-19,-15,-4
301,610000,a9a43d1a7ecbe75d,10,0,263,252,263,274,154,228,212,258,163,256,338,207,272,267,-131,82,-213
56,230000,a9a43d1a7ecbe75d,10,0,54,66,57,65,35,91,67,47,50,39,70,62,66,57,-8,31,-39
286,310000,3c974920a76ac9c1,11,0,369,374,305,193,309,264,241,251,240,298,308,270,289,292,-38,10,-48
333,530000,3c974920a76ac9c1,11,0,402,456,434,194,302,243,321,230,362,323,306,298,302,309,-8,-17,9
180,150000,3c974920a76ac9c1,11,0,204,219,180,128,201,176,192,155,199,170,176,134,155,160,-42,6,-48
297,110000,3c974920a76ac9c1,11,0,460,563,468,432,472,340,407,314,302,310,293,226,260,276,-67,-17,-50
332,510000,3c974920a76ac9c1,11,0,453,570,500,253,378,337,331,336,304,330,449,303,376,361,-146,119,-265
158,340000,3c974920a76ac9c1,11,0,179,226,198,76,132,155,144,166,155,166,192,153,172,170,-39,26,-65
467,370000,3c974920a76ac9c1,11,0,483,601,468,290,412,484,450,432,449,413,563,371,467,449,-192,150,-342
188,140000,3c974920a76ac9c1,11,0,215,260,248,146,249,182,251,173,213,197,239,166,202,201,-73,42,-115
2953,440000,3c974920a76ac9c1,11,0,3532,3800,2692,1680,2958,2368,2754,2696,2582,2782,2822,2740,2781,2781,-82,40,-122
307,450000,3c974920a76ac9c1,11,0,472,505,425,248,383,277,377,293,309,331,402,304,353,346,-98,71,-169
694,320000,3c974920a76ac9c1,11,0,871,1010,800,486,817,617,720,689,718,682,759,664,712,702,-95,77,-172
189,360000,3c974920a76ac9c1,11,0,204,262,236,78,191,154,186,149,156,168,164,152,158,161,-12,-4,-8
305,130000,3c974920a76ac9c1,11,0,291,305,260,190,297,311,328,293,325,352,363,288,326,334,-75,11,-86
282,410000,3c974920a76ac9c1,11,0,521,505,405,250,355,393,307,297,380,309,344,274,309,309,-70,35,-105
676,330000,3c974920a76ac9c1,11,0,660,865,633,409,621,561,562,591,624,669,649,620,634,646,-29,-20,-9
307,420000,3c974920a76ac9c1,11,0,480,474,497,228,445,423,403,455,424,361,409,246,328,339,-163,48,-211
308,430000,3c974920a76ac9c1,11,0,364,474,347,174,297,304,284,259,316,280,304,238,271,274,-66,24,-90
291,350000,3c974920a76ac9c1,11,0,331,404,292,181,307,209,324,299,311,316,288,299,294,301,11,-28,39
725,210000,3c974920a76ac9c1,11,0,941,997,650,566,775,692,738,626,805,715,744,592,668,684,-152,29,-181
116,500000,3c974920a76ac9c1,11,0,155,199,115,72,126,107,119,138,135,104,119,88,104,104,-31,15,-46
342,610000,3c974920a76ac9c1,11,0,393,440,305,219,295,292,328,285,305,307,293,289,291,296,-4,-14,10
302,230000,3c974920a76ac9c1,11,0,458,461,292,234,401,305,324,284,313,335,248,234,241,272,-14,-87,73
528,310000,3d7554f1f56dd664,11,0,639,518,268,263,442,321,383,408,481,506,615,423,519,515,-192,109,-301
474,530000,3d7554f1f56dd664,11,0,609,519,292,264,403,325,415,354,487,506,484,430,457,473,-54,-22,-32
334,150000,3d7554f1f56dd664,11,0,370,337,175,149,316,260,258,252,263,332,312,348,330,331,36,-20,56
344,110000,3d7554f1f56dd664,11,0,675,811,368,359,470,369,376,352,396,326,421,261,341,336,-160,95,-255
951,510000,3d7554f1f56dd664,11,0,1053,1125,657,560,806,700,679,724,721,901,1021,668,844,863,-353,120,-473
556,340000,3d7554f1f56dd664,11,0,574,507,301,225,317,315,350,352,460,517,524,468,496,503,-56,7,-63
1337,370000,3d7554f1f56dd664,11,0,1567,1574,775,729,1060,1229,1119,1113,1342,1502,1693,1251,1472,1482,-442,191,-633
486,140000,3d7554f1f56dd664,11,0,590,571,290,239,407,358,384,335,452,519,543,477,510,513,-66,24,-90
10371,440000,3d7554f1f56dd664,11,0,13598,11515,5136,4688,10371,8733,8990,9100,9110,10367,11177,10502,10840,10682,-675,810,-1485
1026,450000,3d7554f1f56dd664,11,0,1386,1258,750,559,1074,832,939,901,1075,1222,1237,949,1093,1136,-288,15,-303
2416,320000,3d7554f1f56dd664,11,0,3112,2877,1445,1635,2184,1828,1916,1948,2090,2406,2465,2160,2312,2344,-305,59,-364
499,360000,3d7554f1f56dd664,11,0,595,741,435,311,545,463,483,513,576,577,634,470,552,560,-164,57,-221
1146,130000,3d7554f1f56dd664,11,0,1137,974,498,486,847,1025,993,829,1052,1183,1231,1018,1124,1144,-213,48,-261
1082,410000,3d7554f1f56dd664,11,0,1273,1234,645,486,968,944,932,1043,1153,1163,1133,861,997,1052,-272,-30,-242
2107,330000,3d7554f1f56dd664,11,0,2709,2467,1135,1205,1969,1744,1919,1847,2165,2419,2373,1801,2087,2198,-572,-46,-526
944,420000,3d7554f1f56dd664,11,0,1001,1050,703,508,734,619,699,876,984,989,1033,795,914,939,-238,44,-282
869,430000,3d7554f1f56dd664,11,0,1112,1192,689,445,769,687,748,707,821,1006,917,750,834,891,-167,-89,-78
1626,350000,3d7554f1f56dd664,11,0,2205,1578,856,899,1607,1181,1494,1511,1522,1699,1828,1443,1636,1657,-385,129,-514
2177,210000,3d7554f1f56dd664,11,0,2892,2161,1110,1306,1905,1837,1784,1845,2218,2361,2147,1842,1994,2117,-305,-214,-91
315,500000,3d7554f1f56dd664,11,0,470,398,244,215,285,259,240,371,328,317,303,226,264,282,-77,-14,-63
572,610000,3d7554f1f56dd664,11,0,582,607,340,260,369,435,466,394,526,525,529,505,517,520,-24,4,-28
1050,230000,3d7554f1f56dd664,11,0,1076,1018,447,521,1186,639,827,849,957,1229,987,782,884,999,-205,-242,37
146,310000,2d0d2c3403909fdb,11,0,163,167,157,101,187,162,155,200,158,195,163,105,134,154,-58,-32,-26
336,530000,2d0d2c3403909fdb,11,0,354,350,290,213,293,226,236,265,410,329,332,296,314,319,-36,3,-39
204,150000,2d0d2c3403909fdb,11,0,184,233,279,174,228,241,255,251,306,251,232,183,208,222,-49,-19,-30
331,110000,2d0d2c3403909fdb,11,0,611,677,549,387,627,524,389,503,552,475,412,404,408,430,-8,-63,55
442,510000,2d0d2c3403909fdb,11,0,411,434,516,235,377,355,370,404,481,373,432,264,348,356,-168,59,-227
140,340000,2d0d2c3403909fdb,11,0,128,138,176,83,127,116,129,142,151,124,165,116,140,135,-49,41,-90
400,370000,2d0d2c3403909fdb,11,0,415,400,420,235,353,334,323,407,400,410,471,322,396,401,-149,61,-210
164,140000,2d0d2c3403909fdb,11,0,141,197,179,103,189,173,157,177,211,167,160,125,142,151,-35,-7,-28
1849,440000,2d0d2c3403909fdb,11,0,1989,1829,1713,1159,1738,1536,1581,1833,1828,1593,1985,1468,1726,1682,-517,392,-909
222,450000,2d0d2c3403909fdb,11,0,181,173,211,121,197,149,174,163,216,133,185,158,172,159,-27,52,-79
444,320000,2d0d2c3403909fdb,11,0,437,427,470,296,446,386,375,444,454,461,476,350,413,429,-126,15,-141
135,360000,2d0d2c3403909fdb,11,0,107,109,126,55,113,112,112,126,130,154,177,120,148,150,-57,23,-80
363,130000,2d0d2c3403909fdb,11,0,302,328,389,251,371,364,437,425,531,444,375,300,338,373,-75,-69,-6
333,410000,2d0d2c3403909fdb,11,0,352,337,377,202,331,306,338,396,390,320,382,301,342,334,-81,62,-143
410,330000,2d0d2c3403909fdb,11,0,428,424,401,264,349,335,366,380,435,444,478,383,430,435,-95,34,-129
219,420000,2d0d2c3403909fdb,11,0,267,280,321,189,271,255,230,322,292,267,293,194,244,251,-99,26,-125
222,430000,2d0d2c3403909fdb,11,0,244,275,284,146,275,262,250,285,292,286,299,216,258,267,-83,13,-96
123,350000,2d0d2c3403909fdb,11,0,151,157,167,81,107,85,111,132,133,94,129,102,116,108,-27,35,-62
552,210000,2d0d2c3403909fdb,11,0,464,567,506,316,529,433,489,457,606,708,531,506,518,582,-25,-177,152
143,500000,2d0d2c3403909fdb,11,0,184,155,213,116,188,148,168,179,203,176,174,114,144,155,-60,-2,-58
173,610000,2d0d2c3403909fdb,11,0,252,267,297,206,288,291,280,277,346,254,290,201,246,248,-89,36,-125
233,230000,2d0d2c3403909fdb,11,0,258,336,315,155,306,267,240,317,304,316,199,191,195,235,-8,-117,109
244,310000,a28bb927b6fcb33c,11,0,212,210,117,96,135,131,161,142,167,201,221,204,212,209,-17,20,-37
430,530000,a28bb927b6fcb33c,11,0,270,308,173,110,159,185,191,176,253,332,399,317,358,349,-82,67,-149
182,150000,a28bb927b6fcb33c,11,0,165,176,89,72,136,148,139,117,145,167,204,226,215,199,22,37,-15
176,110000,a28bb927b6fcb33c,11,0,246,342,136,109,179,166,96,85,131,159,164,150,157,158,-14,5,-19
470,510000,a28bb927b6fcb33c,11,0,438,436,351,212,361,425,290,324,427,553,667,370,518,530,-297,114,-411
329,340000,a28bb927b6fcb33c,11,0,325,348,264,151,204,182,203,195,266,313,338,363,350,338,25,25,0
608,370000,a28bb927b6fcb33c,11,0,468,556,225,175,357,467,449,285,377,522,729,587,658,613,-142,207,-349
227,140000,a28bb927b6fcb33c,11,0,144,181,92,70,148,181,165,127,190,198,230,208,219,212,-22,32,-54
5245,440000,a28bb927b6fcb33c,11,0,4216,4195,2391,1639,3992,3988,3668,3906,4522,4949,5596,4889,5242,5145,-707,647,-1354
544,450000,a28bb927b6fcb33c,11,0,432,386,248,166,443,418,434,344,461,540,630,553,592,574,-77,90,-167
1183,320000,a28bb927b6fcb33c,11,0,1033,1154,680,651,982,1039,1051,947,1072,1268,1400,1213,1306,1294,-187,132,-319
388,360000,a28bb927b6fcb33c,11,0,302,351,208,96,254,328,298,271,331,451,520,466,493,479,-54,69,-123
535,130000,a28bb927b6fcb33c,11,0,397,419,248,284,584,570,485,345,559,623,645,615,630,628,-30,22,-52
725,410000,a28bb927b6fcb33c,11,0,567,651,338,242,578,638,439,516,644,816,854,726,790,799,-128,38,-166
1612,330000,a28bb927b6fcb33c,11,0,1343,1310,747,739,1438,1404,1200,1131,1522,1730,1887,1466,1676,1694,-421,157,-578
715,420000,a28bb927b6fcb33c,11,0,677,787,450,226,461,459,468,446,524,665,780,873,826,773,93,115,-22
645,430000,a28bb927b6fcb33c,11,0,474,674,394,223,436,554,554,548,663,787,891,679,785,786,-212,104,-316
825,350000,a28bb927b6fcb33c,11,0,615,519,231,173,535,612,676,709,737,966,1034,837,936,946,-197,68,-265
865,210000,a28bb927b6fcb33c,11,0,652,848,213,233,610,646,562,459,596,792,810,690,750,764,-120,18,-138
168,500000,a28bb927b6fcb33c,11,0,157,208,123,85,166,157,116,162,140,173,200,168,184,180,-32,27,-59
331,610000,a28bb927b6fcb33c,11,0,225,317,148,105,202,242,221,226,279,358,344,333,338,345,-11,-14,3
519,230000,a28bb927b6fcb33c,11,0,288,303,90,85,233,244,241,205,236,349,303,327,315,326,24,-46,70
208,310000,17bc272c93f19d56,11,0,249,477,199,177,267,169,193,170,168,208,216,192,204,205,-24,8,-32
3111,530000,17bc272c93f19d56,11,0,3216,4503,4785,3067,2754,2281,2227,1995,2206,1981,2469,3585,3027,2678,1116,488,628
620,150000,17bc272c93f19d56,11,0,520,675,504,451,680,487,440,356,384,433,467,506,486,469,39,34,5
116,110000,17bc272c93f19d56,11,0,305,514,151,92,197,124,132,112,101,80,136,106,121,107,-30,56,-86
1366,510000,17bc272c93f19d56,11,0,1411,1954,1724,1537,1481,1090,1021,990,1018,1119,1242,1321,1282,1227,79,123,-44
1314,340000,17bc272c93f19d56,11,0,1535,2328,2152,1881,1518,1284,1266,1165,1072,1126,1266,1339,1302,1244,73,140,-67
2974,370000,17bc272c93f19d56,11,0,3907,6576,4483,3060,2839,2545,2879,2279,2583,2917,2744,3229,2986,2963,485,-173,658
1670,140000,17bc272c93f19d56,11,0,1585,2844,2093,1361,1353,1118,1259,955,1154,1235,1338,1662,1500,1412,324,103,221
1650,440000,17bc272c93f19d56,11,0,2007,3029,1611,1579,2180,1684,1684,1682,1409,1573,1720,1696,1708,1663,-24,147,-171
1801,450000,17bc272c93f19d56,11,0,2687,4443,3084,1836,2310,1540,1616,1343,1308,1943,1360,1586,1473,1630,226,-583,809
1898,320000,17bc272c93f19d56,11,0,1942,3067,2165,2419,2029,1601,1578,1375,1523,1501,1651,1865,1758,1672,214,150,64
761,360000,17bc272c93f19d56,11,0,980,1510,1290,922,875,668,648,536,537,656,666,811,738,711,145,10,135
3669,130000,17bc272c93f19d56,11,0,3641,6231,3870,3403,2945,3015,3119,2522,2789,2808,2753,3344,3048,2968,591,-55,646
3278,410000,17bc272c93f19d56,11,0,4668,7650,5825,3564,3197,2704,2715,2598,2658,2563,2664,3259,2962,2829,595,101,494
1393,330000,17bc272c93f19d56,11,0,1294,2062,1260,1629,1592,1156,1224,1121,1218,1188,1319,1309,1314,1272,-10,131,-141
1055,420000,17bc272c93f19d56,11,0,1353,2198,1919,1140,1262,895,1069,835,836,949,1018,1151,1084,1039,133,69,64
1290,430000,17bc272c93f19d56,11,0,1770,2693,2364,1506,1541,1174,1020,997,939,1035,1185,1214,1200,1145,29,150,-121
440,350000,17bc272c93f19d56,11,0,688,892,592,650,741,463,546,473,389,402,400,437,418,413,37,-2,39
1156,210000,17bc272c93f19d56,11,0,1154,1710,924,939,1322,959,988,854,912,964,1041,839,940,948,-202,77,-279
273,500000,17bc272c93f19d56,11,0,250,357,250,248,235,212,191,173,197,218,241,244,242,234,3,23,-20
1664,610000,17bc272c93f19d56,11,0,1877,3217,2072,1105,1314,1222,1105,910,1051,1117,1406,1562,1484,1362,156,289,-133
743,230000,17bc272c93f19d56,11,0,816,982,506,518,806,657,585,602,530,544,540,569,554,551,29,-4,33
363,310000,2a2ab41f8f6ff1cb,11,0,582,623,382,114,351,229,285,289,234,347,399,276,338,341,-123,52,-175
594,530000,2a2ab41f8f6ff1cb,11,0,546,680,484,300,452,403,419,390,633,639,493,556,524,563,63,-146,209
626,150000,2a2ab41f8f6ff1cb,11,0,836,832,551,317,489,505,604,525,595,623,640,628,634,630,-12,17,-29
126,110000,2a2ab41f8f6ff1cb,11,0,440,598,212,102,180,142,124,93,130,133,130,95,112,119,-35,-3,-32
1042,510000,2a2ab41f8f6ff1cb,11,0,1385,1850,1223,671,850,790,838,870,1020,1346,1101,933,1017,1127,-168,-245,77
990,340000,2a2ab41f8f6ff1cb,11,0,1491,1666,1515,717,1018,980,1077,1165,1206,1280,1168,1138,1153,1195,-30,-112,82
2008,370000,2a2ab41f8f6ff1cb,11,0,2146,2737,1706,842,1734,1902,2031,1983,2192,2226,2022,2178,2100,2142,156,-204,360
659,140000,2a2ab41f8f6ff1cb,11,0,762,993,533,312,595,582,569,606,683,717,614,692,653,674,78,-103,181
5979,440000,2a2ab41f8f6ff1cb,11,0,6734,6492,5607,2647,5713,4896,5717,5445,4899,5914,5863,5896,5880,5891,33,-51,84
643,450000,2a2ab41f8f6ff1cb,11,0,853,894,799,409,719,453,603,532,611,719,734,660,697,704,-74,15,-89
1842,320000,2a2ab41f8f6ff1cb,11,0,2584,2672,1728,1016,1729,1498,1701,1735,1850,1857,1722,1874,1798,1818,152,-135,287
830,360000,2a2ab41f8f6ff1cb,11,0,1086,1291,1027,356,690,687,838,753,813,1041,905,884,894,943,-21,-136,115
2498,130000,2a2ab41f8f6ff1cb,11,0,2327,2703,2119,1271,2126,2486,2863,2426,2914,2989,2361,2420,2390,2590,59,-628,687
2633,410000,2a2ab41f8f6ff1cb,11,0,2797,3447,2952,1308,2514,2566,2841,2880,3363,3319,2677,2531,2604,2842,-146,-642,496
1301,330000,2a2ab41f8f6ff1cb,11,0,1632,1972,795,459,876,905,1141,1077,1165,1379,1241,1255,1248,1292,14,-138,152
1304,420000,2a2ab41f8f6ff1cb,11,0,1663,2151,1566,597,1095,1029,1047,1133,1293,1344,1288,1247,1268,1293,-41,-56,15
1538,430000,2a2ab41f8f6ff1cb,11,0,1966,2770,1651,844,1487,1573,1636,1382,1564,1802,1482,1432,1457,1572,-50,-320,270
479,350000,2a2ab41f8f6ff1cb,11,0,447,476,264,148,314,267,427,418,348,436,384,415,400,412,31,-52,83
502,210000,2a2ab41f8f6ff1cb,11,0,403,513,241,211,360,293,362,342,372,462,408,449,428,440,41,-54,95
575,500000,2a2ab41f8f6ff1cb,11,0,803,1149,803,328,472,453,543,623,549,633,579,475,527,562,-104,-54,-50
533,610000,2a2ab41f8f6ff1cb,11,0,655,845,620,247,468,497,551,436,566,577,553,626,590,585,73,-24,97
654,230000,2a2ab41f8f6ff1cb,11,0,740,1032,399,306,506,449,585,503,512,594,572,502,537,556,-70,-22,-48
1329,310000,c06a2a387c0ee510,11,0,977,1212,1265,890,1247,1119,1184,1456,1316,1194,1258,958,1108,1137,-300,64,-364
144,530000,c06a2a387c0ee510,11,0,66,119,104,63,214,133,132,248,173,187,150,190,170,176,40,-37,77
144,150000,c06a2a387c0ee510,11,0,56,75,86,64,154,131,164,163,146,193,187,137,162,172,-50,-6,-44
1425,110000,c06a2a387c0ee510,11,0,793,1627,1352,1114,1508,1132,1430,1670,1367,1416,1463,1056,1260,1312,-407,47,-454
309,510000,c06a2a387c0ee510,11,0,145,321,208,187,254,335,308,285,276,420,431,254,342,368,-177,11,-188
357,340000,c06a2a387c0ee510,11,0,176,251,253,175,322,340,315,352,311,384,398,291,344,358,-107,14,-121
1365,370000,c06a2a387c0ee510,11,0,739,1047,878,649,1303,1248,1216,1405,1283,1284,1321,1189,1255,1265,-132,37,-169
376,140000,c06a2a387c0ee510,11,0,105,184,165,123,244,320,272,242,233,292,344,209,276,282,-135,52,-187
1148,440000,c06a2a387c0ee510,11,0,571,819,762,448,944,1100,1025,1038,994,984,1134,946,1040,1021,-188,150,-338
133,450000,c06a2a387c0ee510,11,0,45,96,92,54,103,134,119,86,123,99,126,97,112,107,-29,27,-56
1341,320000,c06a2a387c0ee510,11,0,731,1002,974,650,1188,1289,1048,1276,1137,1253,1328,1121,1224,1234,-207,75,-282
201,360000,c06a2a387c0ee510,11,0,74,97,118,85,164,140,153,162,165,154,204,178,191,179,-26,50,-76
821,130000,c06a2a387c0ee510,11,0,288,493,470,361,599,660,769,569,656,773,873,579,726,742,-294,100,-394
742,410000,c06a2a387c0ee510,11,0,366,596,517,345,763,731,685,764,754,849,909,743,826,834,-166,60,-226
1029,330000,c06a2a387c0ee510,11,0,533,736,534,424,754,915,865,808,908,999,1113,743,928,952,-370,114,-484
266,420000,c06a2a387c0ee510,11,0,94,173,151,103,240,253,187,234,272,286,270,205,238,254,-65,-16,-49
213,430000,c06a2a387c0ee510,11,0,83,119,101,59,203,163,182,206,192,239,250,170,210,220,-80,11,-91
243,350000,c06a2a387c0ee510,11,0,97,170,123,106,206,303,187,204,204,249,241,181,211,224,-60,-8,-52
399,210000,c06a2a387c0ee510,11,0,151,300,181,154,357,324,363,378,413,435,413,296,354,381,-117,-22,-95
139,500000,c06a2a387c0ee510,11,0,58,100,60,71,130,181,128,151,124,150,168,111,140,143,-57,18,-75
339,610000,c06a2a387c0ee510,11,0,164,313,234,179,320,305,340,358,313,390,434,291,362,372,-143,44,-187
276,230000,c06a2a387c0ee510,11,0,95,177,129,74,323,185,255,260,224,227,281,192,236,233,-89,54,-143
514,310000,7023efdab9cedc03,11,0,543,697,325,168,288,309,527,516,379,272,357,325,341,318,-32,85,-117
134,530000,7023efdab9cedc03,11,0,106,112,40,25,38,54,68,55,75,116,109,89,99,105,-20,-7,-13
54,150000,7023efdab9cedc03,11,0,60,75,31,18,29,46,51,51,61,78,46,46,46,57,0,-32,32
105,110000,7023efdab9cedc03,11,0,86,132,40,51,59,50,54,60,151,111,68,85,76,88,17,-43,60
259,510000,7023efdab9cedc03,11,0,278,408,216,117,192,175,229,259,209,437,371,295,333,368,-76,-66,-10
460,340000,7023efdab9cedc03,11,0,447,587,357,148,207,278,368,463,445,401,385,356,370,381,-29,-16,-13
333,370000,7023efdab9cedc03,11,0,477,555,320,180,373,400,374,355,402,517,287,263,275,356,-24,-230,206
79,140000,7023efdab9cedc03,11,0,55,64,30,23,28,38,44,60,71,103,47,63,55,71,16,-56,72
538,440000,7023efdab9cedc03,11,0,342,408,121,39,166,158,211,185,222,453,438,420,429,437,-18,-15,-3
111,450000,7023efdab9cedc03,11,0,86,129,68,34,47,50,71,60,56,125,119,131,125,125,12,-6,18
1072,320000,7023efdab9cedc03,11,0,1271,1767,893,628,788,879,1067,1002,995,690,648,797,722,712,149,-42,191
283,360000,7023efdab9cedc03,11,0,224,302,169,92,161,188,202,170,233,263,198,189,194,217,-9,-65,56
214,130000,7023efdab9cedc03,11,0,127,215,80,56,93,108,163,149,199,289,190,211,200,230,21,-99,120
313,410000,7023efdab9cedc03,11,0,320,368,183,97,185,329,340,259,262,298,278,272,275,283,-6,-20,14
691,330000,7023efdab9cedc03,11,0,941,1163,445,309,478,511,775,845,706,532,466,593,530,530,127,-66,193
275,420000,7023efdab9cedc03,11,0,287,401,211,94,172,184,195,243,185,256,244,251,248,250,7,-12,19
298,430000,7023efdab9cedc03,11,0,259,315,201,83,173,167,198,189,202,231,221,183,202,212,-38,-10,-28
156,350000,7023efdab9cedc03,11,0,117,145,54,20,51,78,114,140,134,168,156,185,170,170,29,-12,41
81,210000,7023efdab9cedc03,11,0,68,104,28,21,52,82,45,37,92,119,77,81,79,92,4,-42,46
133,500000,7023efdab9cedc03,11,0,57,62,28,20,37,37,33,64,92,101,91,99,95,97,8,-10,18
140,610000,7023efdab9cedc03,11,0,113,177,107,51,78,83,124,102,102,142,134,146,140,141,12,-8,20
34,230000,7023efdab9cedc03,11,0,28,30,11,11,8,18,20,17,27,60,33,21,27,38,-12,-27,15
1135,310000,af6f4f548684e14d,11,0,1537,1734,940,540,957,807,919,933,755,914,982,870,926,922,-112,68,-180
366,530000,af6f4f548684e14d,11,0,639,732,400,288,346,301,327,290,401,329,345,355,350,343,10,16,-6
354,150000,af6f4f548684e14d,11,0,493,573,322,195,323,333,363,302,240,293,382,398,390,358,16,89,-73
574,110000,af6f4f548684e14d,11,0,915,1057,659,394,601,489,595,532,503,449,472,373,422,431,-99,23,-122
1018,510000,af6f4f548684e14d,11,0,1293,1876,1072,611,873,761,808,800,793,898,1218,888,1053,1001,-330,320,-650
994,340000,af6f4f548684e14d,11,0,1287,1597,1015,457,773,664,769,751,688,875,1020,977,998,957,-43,145,-188
1407,370000,af6f4f548684e14d,11,0,1722,2394,1077,522,1253,1236,1215,1019,955,1078,1388,1080,1234,1182,-308,310,-618
597,140000,af6f4f548684e14d,11,0,581,742,375,248,450,310,404,335,340,378,448,532,490,453,84,70,14
1472,440000,af6f4f548684e14d,11,0,2163,2594,949,463,1024,892,976,1062,838,972,1048,1071,1060,1030,23,76,-53
411,450000,af6f4f548684e14d,11,0,502,713,341,210,322,222,345,302,257,262,298,338,318,299,40,36,4
1600,320000,af6f4f548684e14d,11,0,2059,2647,1466,939,1519,1181,1355,1281,1072,1305,1574,1407,1490,1429,-167,269,-436
1127,360000,af6f4f548684e14d,11,0,1083,1527,753,397,757,746,837,677,745,886,1080,1037,1058,1001,-43,194,-237
923,130000,af6f4f548684e14d,11,0,1012,1235,691,404,655,694,773,655,680,691,793,740,766,741,-53,102,-155
1363,410000,af6f4f548684e14d,11,0,1470,2122,1000,589,1119,1013,903,937,951,1080,1247,1099,1173,1142,-148,167,-315
1265,330000,af6f4f548684e14d,11,0,1626,2068,1003,537,978,796,1015,879,797,986,1136,1153,1144,1092,17,150,-133
1261,420000,af6f4f548684e14d,11,0,1519,1632,1025,485,1058,873,1015,949,835,965,1376,1214,1295,1185,-162,411,-573
1310,430000,af6f4f548684e14d,11,0,1619,2178,1217,467,1068,962,1084,875,893,959,1329,1057,1193,1115,-272,370,-642
526,350000,af6f4f548684e14d,11,0,767,913,522,257,433,373,497,408,356,398,487,518,502,468,31,89,-58
413,210000,af6f4f548684e14d,11,0,443,594,254,172,277,329,290,263,262,428,438,320,379,395,-118,10,-128
436,500000,af6f4f548684e14d,11,0,500,762,420,252,342,321,324,387,329,286,390,312,351,329,-78,104,-182
433,610000,af6f4f548684e14d,11,0,478,651,365,184,306,238,357,732,447,312,423,398,410,378,-25,111,-136
234,230000,af6f4f548684e14d,11,0,289,372,142,121,207,187,231,186,143,232,203,179,191,205,-24,-29,5
798,310000,7cf283430b3b5e38,11,0,1546,1428,635,513,975,1070,1137,2596,1172,1207,1337,691,1014,1078,-646,130,-776
313,530000,7cf283430b3b5e38,11,0,412,626,249,167,333,316,408,510,602,649,565,362,464,525,-203,-84,-119
350,150000,7cf283430b3b5e38,11,0,516,701,285,178,320,330,439,413,440,575,685,372,528,544,-313,110,-423
81,110000,7cf283430b3b5e38,11,0,264,913,106,74,113,101,453,335,314,124,110,37,74,90,-73,-14,-59
1425,510000,7cf283430b3b5e38,11,0,1783,2691,1134,763,1522,1501,1649,1954,1996,2318,2175,1415,1795,1969,-760,-143,-617
1747,340000,7cf283430b3b5e38,11,0,2138,2356,1607,968,1908,2068,2171,2517,2384,2828,2098,1480,1789,2135,-618,-730,112
2819,370000,7cf283430b3b5e38,11,0,3787,4830,2048,1323,3138,3779,4223,3954,4263,5234,4184,2802,3493,4073,-1382,-1050,-332
729,140000,7cf283430b3b5e38,11,0,852,1073,317,283,629,610,883,1085,1017,1391,967,750,858,1036,-217,-424,207
1693,440000,7cf283430b3b5e38,11,0,2435,2500,695,488,1495,1512,1848,2203,1964,2643,2750,2176,2463,2523,-574,107,-681
719,450000,7cf283430b3b5e38,11,0,783,869,475,293,738,554,830,966,1021,1065,1006,598,802,890,-408,-59,-349
3686,320000,7cf283430b3b5e38,11,0,5016,5865,2657,2401,4119,4083,4704,4995,4877,5866,4453,3479,3966,4599,-974,-1413,439
1656,360000,7cf283430b3b5e38,11,0,1376,1737,923,549,1502,1828,1895,1662,1811,1988,1776,1261,1518,1675,-515,-212,-303
1899,130000,7cf283430b3b5e38,11,0,1926,2621,900,720,1379,2198,2809,2761,2856,3219,1969,1711,1840,2300,-258,-1250,992
3052,410000,7cf283430b3b5e38,11,0,2874,3243,1683,1042,2558,3199,3067,3400,3871,4333,3047,2328,2688,3236,-719,-1286,567
2117,330000,7cf283430b3b5e38,11,0,3295,3490,1289,1038,1965,1876,2506,2778,3135,3712,3209,2554,2882,3158,-655,-503,-152
1291,420000,7cf283430b3b5e38,11,0,1547,1624,929,480,1234,1278,1437,1882,1699,1835,1719,1162,1440,1572,-557,-116,-441
1356,430000,7cf283430b3b5e38,11,0,1585,1952,989,516,1513,1616,1696,1720,1686,2057,2090,1239,1664,1795,-851,33,-884
840,350000,7cf283430b3b5e38,11,0,1130,958,546,402,859,878,1319,1184,1258,1327,1317,1081,1199,1242,-236,-10,-226
533,210000,7cf283430b3b5e38,11,0,619,821,205,149,446,498,474,571,727,964,874,497,686,778,-377,-90,-287
337,500000,7cf283430b3b5e38,11,0,419,597,296,163,296,401,429,660,507,590,674,413,544,559,-261,84,-345
569,610000,7cf283430b3b5e38,11,0,912,1151,413,242,475,689,883,1688,1091,1205,1047,626,836,959,-421,-158,-263
186,230000,7cf283430b3b5e38,11,0,347,415,118,130,301,193,254,310,279,412,382,247,314,347,-135,-30,-105
145,310000,d4efbebb087fd03f,11,0,225,270,79,27,45,95,103,101,83,103,129,99,114,110,-30,26,-56
431,530000,d4efbebb087fd03f,11,0,267,384,296,172,285,192,231,213,247,282,327,422,374,344,95,45,50
322,150000,d4efbebb087fd03f,11,0,359,450,248,124,211,203,178,177,181,202,244,274,259,240,30,42,-12
322,110000,d4efbebb087fd03f,11,0,938,1287,118,74,556,952,1106,818,968,836,546,268,407,550,-278,-290,12
1163,510000,d4efbebb087fd03f,11,0,1002,2805,1326,797,891,676,702,734,761,905,1065,1092,1078,1021,27,160,-133
845,340000,d4efbebb087fd03f,11,0,977,1443,903,436,535,520,582,612,532,660,692,828,760,727,136,32,104
1965,370000,d4efbebb087fd03f,11,0,2198,3785,1878,1009,1343,1575,1488,1335,1337,1747,1744,1960,1852,1817,216,-3,219
814,140000,d4efbebb087fd03f,11,0,1993,2925,603,248,417,464,574,426,448,540,518,746,632,601,228,-22,250
1867,440000,d4efbebb087fd03f,11,0,2044,2419,914,399,1078,1095,1082,1215,1038,1245,1500,1591,1546,1445,91,255,-164
806,450000,d4efbebb087fd03f,11,0,493,935,666,303,492,403,512,470,474,495,629,719,674,614,90,134,-44
1100,320000,d4efbebb087fd03f,11,0,1531,2308,910,648,752,1041,985,944,821,908,982,1078,1030,989,96,74,22
952,360000,d4efbebb087fd03f,11,0,917,1377,999,364,509,561,555,561,469,643,721,910,816,758,189,78,111
1448,130000,d4efbebb087fd03f,11,0,1144,2067,1110,641,741,953,1002,876,936,1050,1031,1362,1196,1148,331,-19,350
2155,410000,d4efbebb087fd03f,11,0,1965,3560,2272,888,1199,1423,1368,1487,1652,1740,1822,2212,2017,1925,390,82,308
4073,330000,d4efbebb087fd03f,11,0,3147,4324,1028,639,1114,1097,2340,1882,1700,2222,2001,2752,2376,2325,751,-221,972
753,420000,d4efbebb087fd03f,11,0,941,1534,1004,347,476,456,410,475,460,525,1167,723,945,805,-444,642,-1086
1001,430000,d4efbebb087fd03f,11,0,1142,1719,1133,438,685,688,650,716,659,750,1015,980,998,915,-35,265,-300
976,350000,d4efbebb087fd03f,11,0,762,1967,434,268,656,565,712,722,602,609,775,965,870,783,190,166,24
319,210000,d4efbebb087fd03f,11,0,291,520,199,149,205,202,188,167,160,157,192,253,222,201,61,35,26
545,500000,d4efbebb087fd03f,11,0,326,532,432,291,409,310,302,286,280,366,470,485,478,440,15,104,-89
1915,610000,d4efbebb087fd03f,11,0,1010,1651,919,422,609,612,587,580,1155,818,1081,1331,1206,1077,250,263,-13
126,230000,d4efbebb087fd03f,11,0,204,257,135,104,114,128,104,132,112,136,138,80,109,118,-58,2,-60
74,310000,7245e0ee27b195cd,11,0,125,158,63,40,60,51,45,46,45,48,64,47,56,53,-17,16,-33
469,530000,7245e0ee27b195cd,11,0,375,535,421,246,288,240,252,266,378,341,384,421,402,382,37,43,-6
410,150000,7245e0ee27b195cd,11,0,448,676,363,164,250,212,180,206,169,180,292,330,311,267,38,112,-74
77,110000,7245e0ee27b195cd,11,0,360,496,86,74,109,80,71,61,54,68,80,56,68,68,-24,12,-36
794,510000,7245e0ee27b195cd,11,0,831,1260,724,451,621,526,535,628,654,720,912,881,896,838,-31,192,-223
617,340000,7245e0ee27b195cd,11,0,510,806,576,272,358,315,316,346,322,391,446,556,501,464,110,55,55
1428,370000,7245e0ee27b195cd,11,0,1778,2915,1529,762,977,1071,1025,958,930,1153,1156,1444,1300,1251,288,3,285
954,140000,7245e0ee27b195cd,11,0,668,1092,615,366,578,543,590,543,530,702,862,804,833,789,-58,160,-218
1391,440000,7245e0ee27b195cd,11,0,1384,1437,718,363,821,836,734,867,743,867,1000,961,980,943,-39,133,-172
645,450000,7245e0ee27b195cd,11,0,463,659,452,233,370,288,292,316,346,373,423,428,426,408,5,50,-45
828,320000,7245e0ee27b195cd,11,0,743,1008,543,405,518,460,406,448,428,481,488,651,570,540,163,7,156
545,360000,7245e0ee27b195cd,11,0,577,816,634,247,323,301,331,301,285,348,422,444,433,405,22,74,-52
1557,130000,7245e0ee27b195cd,11,0,1432,2365,1304,951,1023,1070,1210,930,1140,1221,1304,1511,1408,1345,207,83,124
1268,410000,7245e0ee27b195cd,11,0,1406,2228,1526,717,888,888,823,850,1053,1131,1233,1386,1310,1250,153,102,51
936,330000,7245e0ee27b195cd,11,0,874,1121,438,306,511,460,520,507,491,573,625,628,626,609,3,52,-49
562,420000,7245e0ee27b195cd,11,0,655,903,635,255,364,342,325,362,407,342,478,502,490,441,24,136,-112
667,430000,7245e0ee27b195cd,11,0,763,1216,773,321,479,531,540,517,429,513,640,693,666,615,53,127,-74
381,350000,7245e0ee27b195cd,11,0,239,420,249,153,274,195,252,248,212,300,311,264,288,292,-47,11,-58
578,210000,7245e0ee27b195cd,11,0,514,641,287,222,321,326,279,247,251,291,348,358,353,332,10,57,-47
350,500000,7245e0ee27b195cd,11,0,292,402,296,142,238,207,233,232,240,260,352,335,344,316,-17,92,-109
911,610000,7245e0ee27b195cd,11,0,755,1158,815,410,484,484,492,471,470,664,857,802,830,774,-55,193,-248
399,230000,7245e0ee27b195cd,11,0,328,336,166,145,205,161,183,216,199,211,200,279,240,230,79,-11,90
89,310000,8c915fe4632fb9fa,11,0,314,461,180,102,190,125,145,92,77,83,77,70,74,77,-7,-6,-1
746,530000,8c915fe4632fb9fa,11,0,757,1396,1059,575,778,650,682,486,654,573,601,737,669,637,136,28,108
480,150000,8c915fe4632fb9fa,11,0,527,720,520,270,473,409,472,356,344,415,453,477,465,448,24,38,-14
66,110000,8c915fe4632fb9fa,11,0,242,487,101,86,162,127,117,78,41,43,61,36,48,47,-25,18,-43
1171,510000,8c915fe4632fb9fa,11,0,1605,2433,1860,1194,1302,1156,1192,925,872,1055,1302,1043,1172,1133,-259,247,-506
954,340000,8c915fe4632fb9fa,11,0,1370,2298,1440,720,878,861,934,738,651,739,952,974,963,888,22,213,-191
1598,370000,8c915fe4632fb9fa,11,0,2126,3804,2217,1109,1504,1812,1956,1321,1432,1563,1725,1648,1686,1645,-77,162,-239
692,140000,8c915fe4632fb9fa,11,0,748,1215,772,404,591,661,732,531,562,597,623,673,648,631,50,26,24
933,440000,8c915fe4632fb9fa,11,0,1467,2021,1040,446,977,1064,948,854,663,649,829,797,813,758,-32,180,-212
496,450000,8c915fe4632fb9fa,11,0,511,880,738,330,660,454,586,385,399,303,460,395,428,386,-65,157,-222
1077,320000,8c915fe4632fb9fa,11,0,1816,2525,1540,1130,1441,1246,1265,930,913,863,957,1065,1011,962,108,94,14
645,360000,8c915fe4632fb9fa,11,0,889,1320,1015,377,598,631,632,491,445,477,574,678,626,576,104,97,7
1737,130000,8c915fe4632fb9fa,11,0,2026,3281,1882,1126,1456,2041,2368,1518,1714,1628,1540,1628,1584,1599,88,-88,176
1501,410000,8c915fe4632fb9fa,11,0,1843,2975,2324,1002,1413,1518,1509,1135,1362,1395,1473,1530,1502,1466,57,78,-21
959,330000,8c915fe4632fb9fa,11,0,1502,2235,958,565,880,893,948,697,814,804,930,965,948,900,35,126,-91
880,420000,8c915fe4632fb9fa,11,0,1339,1557,1148,463,782,723,758,663,696,627,825,791,808,748,-34,198,-232
797,430000,8c915fe4632fb9fa,11,0,835,1281,1235,439,733,664,655,498,506,508,651,664,658,608,13,143,-130
453,350000,8c915fe4632fb9fa,11,0,622,877,518,365,529,461,541,380,328,306,337,330,334,324,-7,31,-38
341,210000,8c915fe4632fb9fa,11,0,396,542,311,224,349,397,405,266,303,286,359,298,328,314,-61,73,-134
301,500000,8c915fe4632fb9fa,11,0,419,666,489,274,346,334,368,358,284,258,335,284,310,292,-51,77,-128
616,610000,8c915fe4632fb9fa,11,0,715,1549,1036,394,463,535,597,405,487,551,603,672,638,609,69,52,17
632,230000,8c915fe4632fb9fa,11,0,616,998,401,372,684,679,736,526,592,672,585,481,533,579,-104,-87,-17
388,310000,6155b214590c66e6,11,0,781,1047,423,192,279,354,355,429,362,376,371,244,308,330,-127,-5,-122
1355,530000,6155b214590c66e6,11,0,1159,1879,1354,680,631,992,1295,955,1148,1036,994,1360,1177,1130,366,-42,408
1180,150000,6155b214590c66e6,11,0,941,1442,814,347,566,786,1042,724,802,839,925,923,924,896,-2,86,-88
405,110000,6155b214590c66e6,11,0,569,1295,274,176,281,280,376,386,433,291,293,235,264,273,-58,2,-60
2496,510000,6155b214590c66e6,11,0,2162,4188,2540,1081,1111,1488,1668,1412,1619,1860,2342,1859,2100,2020,-483,482,-965
1970,340000,6155b214590c66e6,11,0,2073,3650,2495,863,893,1218,1582,1360,1404,1555,1685,1690,1688,1643,5,130,-125
3780,370000,6155b214590c66e6,11,0,3594,6275,3467,1356,2002,3249,3444,2666,3057,2942,3377,3085,3231,3135,-292,435,-727
1098,140000,6155b214590c66e6,11,0,914,1576,743,357,500,790,998,720,798,855,911,936,924,901,25,56,-31
3107,440000,6155b214590c66e6,11,0,3269,4342,1784,653,1364,1722,2162,2247,2038,2128,2302,2021,2162,2150,-281,174,-455
871,450000,6155b214590c66e6,11,0,739,1316,892,381,556,538,802,574,699,609,693,620,656,641,-73,84,-157
3457,320000,6155b214590c66e6,11,0,3776,5864,3032,1760,2316,2607,3244,2604,2564,2570,2743,2663,2703,2659,-80,173,-253
1296,360000,6155b214590c66e6,11,0,1285,2160,1579,453,603,962,960,811,902,887,1133,1043,1088,1021,-90,246,-336
2880,130000,6155b214590c66e6,11,0,2594,4551,2375,1231,1427,2467,3049,2213,2567,2481,2466,2211,2338,2386,-255,-15,-240
4188,410000,6155b214590c66e6,11,0,4047,8018,5309,1586,1915,2716,3025,2701,2930,3143,3339,3184,3262,3222,-155,196,-351
3021,330000,6155b214590c66e6,11,0,3014,4336,1679,826,1161,1890,2275,1899,2230,2234,2335,2198,2266,2256,-137,101,-238
1849,420000,6155b214590c66e6,11,0,1848,3179,2049,551,906,1028,1278,1264,1359,1217,1693,1417,1555,1442,-276,476,-752
2246,430000,6155b214590c66e6,11,0,2355,3747,2461,732,1157,1395,1621,1288,1479,1482,1887,1640,1764,1670,-247,405,-652
928,350000,6155b214590c66e6,11,0,1140,1306,596,364,463,616,759,757,740,708,723,786,754,739,63,15,48
1415,210000,6155b214590c66e6,11,0,1188,1784,769,415,765,1227,1203,969,1200,1102,1144,952,1048,1066,-192,42,-234
844,500000,6155b214590c66e6,11,0,761,1417,877,373,399,529,594,627,619,620,836,742,789,733,-94,216,-310
1193,610000,6155b214590c66e6,11,0,841,1546,1008,303,361,648,917,661,790,773,918,1016,967,902,98,145,-47
1022,230000,6155b214590c66e6,11,0,944,1290,579,365,604,725,778,831,876,865,867,758,812,830,-109,2,-111
661,310000,28e29f2c03dcd84c,11,0,807,1293,851,433,764,667,727,689,522,968,719,517,618,735,-202,-249,47
430,530000,28e29f2c03dcd84c,11,0,535,639,509,300,415,361,462,414,443,436,471,370,420,426,-101,35,-136
499,150000,28e29f2c03dcd84c,11,0,451,580,494,276,556,527,562,528,446,576,531,533,532,547,2,-45,47
996,110000,28e29f2c03dcd84c,11,0,1288,2146,1327,923,1308,982,1002,1096,834,1075,842,705,774,874,-137,-233,96
738,510000,28e29f2c03dcd84c,11,0,781,1105,856,454,680,597,621,651,776,861,835,604,720,767,-231,-26,-205
924,340000,28e29f2c03dcd84c,11,0,803,1070,953,364,644,584,685,706,708,895,856,786,821,846,-70,-39,-31
1322,370000,28e29f2c03dcd84c,11,0,1513,1837,1329,778,1244,1284,1298,1141,1319,1334,1363,1113,1238,1270,-250,29,-279
777,140000,28e29f2c03dcd84c,11,0,798,1203,945,474,746,713,727,660,639,991,794,659,726,815,-135,-197,62
555,440000,28e29f2c03dcd84c,11,0,536,825,423,180,427,549,477,696,389,618,526,381,454,508,-145,-92,-53
136,450000,28e29f2c03dcd84c,11,0,160,243,179,71,140,141,183,151,137,141,191,116,154,149,-75,50,-125
1548,320000,28e29f2c03dcd84c,11,0,1951,2643,1820,1058,1565,1288,1340,1313,1263,1676,1620,1295,1458,1530,-325,-56,-269
372,360000,28e29f2c03dcd84c,11,0,424,571,408,151,325,301,312,293,255,351,379,320,350,350,-59,28,-87
1653,130000,28e29f2c03dcd84c,11,0,1433,1923,1604,884,1377,1523,1631,1539,1425,1590,1515,1285,1400,1463,-230,-75,-155
1131,410000,28e29f2c03dcd84c,11,0,1113,1482,1178,548,1003,1062,1044,1052,1125,1238,1016,988,1002,1081,-28,-222,194
823,330000,28e29f2c03dcd84c,11,0,894,1112,767,352,679,681,651,616,628,814,733,614,674,720,-119,-81,-38
273,420000,28e29f2c03dcd84c,11,0,377,483,446,164,271,261,296,275,330,388,373,300,336,354,-73,-15,-58
461,430000,28e29f2c03dcd84c,11,0,477,783,487,262,452,359,428,383,395,447,527,425,476,466,-102,80,-182
253,350000,28e29f2c03dcd84c,11,0,345,456,397,140,227,217,291,297,182,259,217,256,236,244,39,-42,81
183,210000,28e29f2c03dcd84c,11,0,251,310,270,165,356,218,179,255,221,255,217,176,196,216,-41,-38,-3
353,500000,28e29f2c03dcd84c,11,0,491,644,555,263,408,381,378,462,374,447,448,311,380,402,-137,1,-138
551,610000,28e29f2c03dcd84c,11,0,622,758,719,361,603,579,645,499,553,624,536,522,529,561,-14,-88,74
74,230000,28e29f2c03dcd84c,11,0,152,169,104,79,149,106,141,121,123,121,96,100,98,106,4,-25,29
69,310000,37aa9169b575ef79,11,0,67,117,63,37,86,109,100,151,123,42,55,43,49,47,-12,13,-25
1653,530000,37aa9169b575ef79,11,0,1142,1590,946,692,1035,755,884,765,1277,1207,1465,1333,1399,1335,-132,258,-390
1217,150000,37aa9169b575ef79,11,0,945,982,602,413,714,724,743,629,652,1139,1161,1060,1110,1120,-101,22,-123
438,110000,37aa9169b575ef79,11,0,625,985,300,271,404,282,274,292,278,289,341,277,309,302,-64,52,-116
2911,510000,37aa9169b575ef79,11,0,2221,3340,1470,1639,3175,2405,2457,2398,2530,2754,3201,2401,2801,2785,-800,447,-1247
479,340000,37aa9169b575ef79,11,0,410,575,248,260,384,279,286,452,366,371,478,493,486,447,15,107,-92
3426,370000,37aa9169b575ef79,11,0,3662,4024,1903,1708,2748,2376,2932,2420,2797,3096,3668,3505,3586,3423,-163,572,-735
1372,140000,37aa9169b575ef79,11,0,1188,1616,679,442,672,792,892,815,1028,1189,1434,1465,1450,1363,31,245,-214
2682,440000,37aa9169b575ef79,11,0,2111,2398,1196,1075,2249,1558,2005,1936,1682,1885,2157,2044,2100,2029,-113,272,-385
373,450000,37aa9169b575ef79,11,0,459,435,440,301,449,664,501,523,446,573,488,369,428,477,-119,-85,-34
910,320000,37aa9169b575ef79,11,0,777,930,527,626,655,605,586,670,623,694,810,917,864,807,107,116,-9
430,360000,37aa9169b575ef79,11,0,482,540,354,189,356,270,359,296,244,355,399,425,412,393,26,44,-18
3797,130000,37aa9169b575ef79,11,0,3233,4206,2068,1780,2633,2656,3148,2856,3242,3648,3843,3840,3842,3777,-3,195,-198
2076,410000,37aa9169b575ef79,11,0,2018,2962,1570,1050,1823,1515,1509,1506,1785,1836,2094,2086,2090,2005,-8,258,-266
837,330000,37aa9169b575ef79,11,0,634,886,424,422,628,555,606,538,517,542,822,660,741,675,-162,280,-442
565,420000,37aa9169b575ef79,11,0,544,920,483,270,442,304,376,403,430,440,533,573,553,515,40,93,-53
1327,430000,37aa9169b575ef79,11,0,1489,2336,1714,653,1232,835,1023,1076,1149,1284,1450,1174,1312,1303,-276,166,-442
624,350000,37aa9169b575ef79,11,0,597,622,308,292,460,424,486,428,470,413,661,640,650,571,-21,248,-269
1850,210000,37aa9169b575ef79,11,0,1478,1878,681,691,1319,1119,1215,1237,1419,1601,1582,1557,1570,1580,-25,-19,-6
286,500000,37aa9169b575ef79,11,0,172,247,131,105,125,160,126,176,161,199,234,262,248,232,28,35,-7
963,610000,37aa9169b575ef79,11,0,634,1051,558,384,605,487,577,560,603,780,777,886,832,814,109,-3,112
2069,230000,37aa9169b575ef79,11,0,1636,1781,730,952,1556,1254,1336,1463,1649,2283,2187,1730,1958,2067,-457,-96,-361
1453,310000,63065128401bb3ff,11,0,2362,3060,1909,501,2672,4039,883,4181,1421,1782,1879,887,1383,1516,-992,97,-1089
1286,530000,63065128401bb3ff,11,0,1033,1402,656,504,651,603,785,827,1300,1307,1367,1252,1310,1309,-115,60,-175
819,150000,63065128401bb3ff,11,0,630,827,268,214,376,413,543,491,575,777,749,772,760,766,23,-28,51
923,110000,63065128401bb3ff,11,0,1494,2145,217,200,2331,1550,280,361,498,297,355,265,310,306,-90,58,-148
2483,510000,63065128401bb3ff,11,0,2119,2450,1355,937,1478,2078,1399,1459,1801,2351,2567,2053,2310,2324,-514,216,-730
2761,340000,63065128401bb3ff,11,0,2927,3132,1460,775,1436,1362,1591,1598,1947,2510,2710,2516,2613,2579,-194,200,-394
4579,370000,63065128401bb3ff,11,0,4087,5401,1885,1225,2010,2269,2615,2569,3263,3929,4366,4122,4244,4139,-244,437,-681
1763,140000,63065128401bb3ff,11,0,1547,2066,692,491,877,974,1192,1135,1670,2019,1865,1828,1846,1904,-37,-154,117
1766,440000,63065128401bb3ff,11,0,2188,2519,625,462,1475,1506,1216,1544,1515,1754,1731,1687,1709,1724,-44,-23,-21
649,450000,63065128401bb3ff,11,0,596,616,308,176,366,289,407,451,518,551,689,586,638,609,-103,138,-241
5223,320000,63065128401bb3ff,11,0,5007,5643,2143,1862,2644,2631,3008,3307,4299,4173,4430,4745,4588,4449,315,257,58
1930,360000,63065128401bb3ff,11,0,1981,2357,973,442,916,895,1031,1009,1333,1810,1734,1615,1674,1720,-119,-76,-43
4580,130000,63065128401bb3ff,11,0,3711,5424,1723,1261,2043,2652,2981,2611,4091,4869,4197,4377,4287,4481,180,-672,852
4887,410000,63065128401bb3ff,11,0,4237,5119,2463,1238,2429,2562,2723,3091,4009,4961,4989,4481,4735,4810,-508,28,-536
2546,330000,63065128401bb3ff,11,0,2401,2755,895,768,1359,1321,1533,1474,1767,2205,2322,2259,2290,2262,-63,117,-180
1785,420000,63065128401bb3ff,11,0,1466,1985,1002,357,841,848,822,1085,1431,1415,1567,1474,1520,1485,-93,152,-245
2467,430000,63065128401bb3ff,11,0,2078,2533,1085,531,1104,1014,1204,1328,1663,1969,2202,1856,2029,2009,-346,233,-579
1293,350000,63065128401bb3ff,11,0,1218,1549,440,400,775,721,1235,973,1141,1223,1242,1298,1270,1254,56,19,37
979,210000,63065128401bb3ff,11,0,869,1098,268,212,386,587,555,690,977,861,746,692,719,766,-54,-115,61
978,500000,63065128401bb3ff,11,0,938,1120,617,359,603,607,619,800,1027,1072,1122,870,996,1021,-252,50,-302
1588,610000,63065128401bb3ff,11,0,1199,1748,631,397,661,1831,842,1735,1691,1436,1577,1777,1677,1597,200,141,59
445,230000,63065128401bb3ff,11,0,466,480,162,156,276,218,323,452,354,467,458,427,442,451,-31,-9,-22
335,310000,ea489c253676aafc,11,0,574,754,315,362,767,319,351,300,314,334,352,238,295,308,-114,18,-132
753,530000,ea489c253676aafc,11,0,692,866,452,295,448,404,525,442,543,578,599,835,717,671,236,21,215
969,150000,ea489c253676aafc,11,0,612,941,427,254,591,556,550,476,504,704,679,805,742,729,126,-25,151
167,110000,ea489c253676aafc,11,0,341,546,125,89,159,100,115,114,150,110,113,75,94,99,-38,3,-41
1386,510000,ea489c253676aafc,11,0,1187,1812,1017,704,1344,1235,1081,1056,878,1050,1236,1013,1124,1100,-223,186,-409
1382,340000,ea489c253676aafc,11,0,952,1669,741,475,869,701,638,694,733,857,812,1004,908,891,192,-45,237
4698,370000,ea489c253676aafc,11,0,3812,5496,2330,1515,2865,2841,2834,2558,2825,3266,3132,3700,3416,3366,568,-134,702
2132,140000,ea489c253676aafc,11,0,1234,2626,1165,641,1247,1425,1531,1329,1557,1538,1282,1762,1522,1527,480,-256,736
685,440000,ea489c253676aafc,11,0,525,1055,368,255,433,540,513,805,467,681,614,408,511,568,-206,-67,-139
206,450000,ea489c253676aafc,11,0,355,448,365,155,240,485,249,405,222,128,107,185,146,140,78,-21,99
1433,320000,ea489c253676aafc,11,0,1728,2261,1167,1028,1507,1281,827,792,892,955,1053,993,1023,1000,-60,98,-158
453,360000,ea489c253676aafc,11,0,946,847,641,223,316,236,253,238,242,217,309,282,296,269,-27,92,-119
5099,130000,ea489c253676aafc,11,0,3058,5478,1932,1551,2981,3513,3250,2524,3284,3386,2904,3615,3260,3302,711,-482,1193
2619,410000,ea489c253676aafc,11,0,1941,3092,1731,893,1695,1504,1408,1487,1714,1721,1597,1924,1760,1747,327,-124,451
753,330000,ea489c253676aafc,11,0,706,1205,504,467,741,598,514,446,578,432,623,523,573,526,-100,191,-291
244,420000,ea489c253676aafc,11,0,348,657,298,154,273,222,166,164,170,172,198,208,203,193,10,26,-16
464,430000,ea489c253676aafc,11,0,587,1351,576,253,448,437,409,373,484,393,425,410,418,409,-15,32,-47
383,350000,ea489c253676aafc,11,0,452,617,215,148,255,232,240,199,231,301,352,251,302,301,-101,51,-152
1252,210000,ea489c253676aafc,11,0,853,1026,394,408,768,721,776,679,667,892,902,982,942,925,80,10,70
277,500000,ea489c253676aafc,11,0,379,694,353,248,346,329,249,207,249,199,233,246,240,226,13,34,-21
1142,610000,ea489c253676aafc,11,0,804,1400,754,418,791,600,553,553,625,614,777,930,854,774,153,163,-10
999,230000,ea489c253676aafc,11,0,496,710,280,266,503,464,518,466,471,859,943,658,800,820,-285,84,-369
314,310000,cd5841d44fd7625e,11,0,312,359,339,177,321,249,248,328,254,307,237,241,239,262,4,-70,74
506,530000,cd5841d44fd7625e,11,0,442,485,409,248,357,375,412,347,430,418,363,355,359,379,-8,-55,47
501,150000,cd5841d44fd7625e,11,0,401,434,519,319,522,443,583,484,431,411,444,497,470,451,53,33,20
996,110000,cd5841d44fd7625e,11,0,1121,1802,1263,877,1267,1047,1549,1033,967,860,855,791,823,835,-64,-5,-59
948,510000,cd5841d44fd7625e,11,0,732,1083,1390,565,951,827,852,794,845,1009,1048,823,936,960,-225,39,-264
657,340000,cd5841d44fd7625e,11,0,519,629,667,315,471,534,553,570,581,499,590,552,571,547,-38,91,-129
2049,370000,cd5841d44fd7625e,11,0,1666,1642,1861,878,1578,1694,1792,1554,1627,1927,1942,1727,1834,1865,-215,15,-230
508,140000,cd5841d44fd7625e,11,0,421,414,426,317,451,395,445,395,431,409,455,463,459,442,8,46,-38
996,440000,cd5841d44fd7625e,11,0,995,1243,727,322,827,693,791,804,769,839,878,889,884,869,11,39,-28
221,450000,cd5841d44fd7625e,11,0,192,214,225,119,204,139,193,190,168,192,190,217,204,200,27,-2,29
1396,320000,cd5841d44fd7625e,11,0,1099,1374,1336,868,1301,1124,1278,1241,1197,1296,1046,1162,1104,1168,116,-250,366
381,360000,cd5841d44fd7625e,11,0,276,329,364,141,291,237,315,278,285,309,268,301,284,293,33,-41,74
1780,130000,cd5841d44fd7625e,11,0,1461,1615,1768,1165,1697,1805,2074,1714,1806,1864,1750,1625,1688,1746,-125,-114,-11
1735,410000,cd5841d44fd7625e,11,0,1223,1443,1429,856,1325,1403,1419,1413,1478,1579,1504,1582,1543,1555,78,-75,153
955,330000,cd5841d44fd7625e,11,0,747,863,742,356,707,633,707,646,663,732,701,734,718,722,33,-31,64
557,420000,cd5841d44fd7625e,11,0,473,566,558,262,443,396,470,482,493,546,551,501,526,533,-50,5,-55
492,430000,cd5841d44fd7625e,11,0,418,494,519,230,424,383,397,379,387,399,409,410,410,406,1,10,-9
529,350000,cd5841d44fd7625e,11,0,325,402,404,188,330,251,340,301,284,315,604,431,518,450,-173,289,-462
792,210000,cd5841d44fd7625e,11,0,644,1082,704,546,870,783,781,790,785,765,828,793,810,795,-35,63,-98
351,500000,cd5841d44fd7625e,11,0,282,391,433,202,335,319,317,436,335,381,329,373,351,361,44,-52,96
590,610000,cd5841d44fd7625e,11,0,346,497,487,257,378,390,460,393,519,500,482,768,625,583,286,-18,304
1027,230000,cd5841d44fd7625e,11,0,664,964,785,666,1198,1070,1179,970,890,1044,870,813,842,909,-57,-174,117
495,310000,b25c4e2e3856af22,11,0,1563,1504,815,447,731,532,612,632,552,602,639,404,522,548,-235,37,-272
382,530000,b25c4e2e3856af22,11,0,692,785,585,277,403,310,422,368,501,439,383,371,377,398,-12,-56,44
115,150000,b25c4e2e3856af22,11,0,342,430,303,110,229,177,183,153,136,170,141,127,134,146,-14,-29,15
198,110000,b25c4e2e3856af22,11,0,925,1127,376,284,427,371,462,336,275,270,272,206,239,249,-66,2,-68
499,510000,b25c4e2e3856af22,11,0,1320,1775,1096,562,764,657,680,772,616,717,828,542,685,696,-286,111,-397
574,340000,b25c4e2e3856af22,11,0,1064,1490,952,364,600,581,589,605,632,685,690,608,649,661,-82,5,-87
856,370000,b25c4e2e3856af22,11,0,1408,1739,940,501,805,813,957,836,892,940,1047,835,941,941,-212,107,-319
86,140000,b25c4e2e3856af22,11,0,332,371,229,113,151,138,130,107,102,135,123,108,116,122,-15,-12,-3
825,440000,b25c4e2e3856af22,11,0,1644,2216,854,451,986,862,846,947,768,780,800,819,810,800,19,20,-1
153,450000,b25c4e2e3856af22,11,0,255,372,218,114,237,155,197,163,181,169,173,175,174,172,2,4,-2
921,320000,b25c4e2e3856af22,11,0,2263,3132,1586,987,1345,1015,1158,1068,1086,1181,1123,952,1038,1085,-171,-58,-113
426,360000,b25c4e2e3856af22,11,0,870,1144,754,284,498,430,503,444,457,461,471,423,447,452,-48,10,-58
505,130000,b25c4e2e3856af22,11,0,944,1218,652,442,599,687,716,543,668,679,581,499,540,586,-82,-98,16
437,410000,b25c4e2e3856af22,11,0,1121,1578,856,471,700,719,644,669,703,653,571,445,508,556,-126,-82,-44
1084,330000,b25c4e2e3856af22,11,0,2703,3371,1749,893,1369,1150,1156,1037,1172,1334,1278,1146,1212,1253,-132,-56,-76
435,420000,b25c4e2e3856af22,11,0,988,1333,941,363,579,523,593,600,621,519,533,456,494,503,-77,14,-91
526,430000,b25c4e2e3856af22,11,0,1081,1561,1003,386,716,610,659,562,594,642,673,494,584,603,-179,31,-210
306,350000,b25c4e2e3856af22,11,0,905,1102,667,370,551,387,534,372,366,372,338,360,349,357,22,-34,56
236,210000,b25c4e2e3856af22,11,0,403,555,253,188,258,212,206,203,265,272,248,226,237,249,-22,-24,2
193,500000,b25c4e2e3856af22,11,0,496,740,452,184,293,290,264,303,274,250,248,200,224,233,-48,-2,-46
169,610000,b25c4e2e3856af22,11,0,479,533,395,223,292,216,328,233,285,238,205,191,198,211,-14,-33,19
155,230000,b25c4e2e3856af22,11,0,352,428,213,219,281,217,259,239,210,238,179,150,164,189,-29,-59,30
666,310000,4a103c30d593fbbe,11,0,685,688,275,231,396,369,368,427,353,607,636,687,662,643,51,29,22
798,530000,4a103c30d593fbbe,11,0,714,1001,409,321,443,427,437,368,556,556,634,776,705,655,142,78,64
779,150000,4a103c30d593fbbe,11,0,671,789,370,239,440,455,525,460,522,607,660,829,744,699,169,53,116
616,110000,4a103c30d593fbbe,11,0,1332,1807,402,360,619,496,497,491,482,542,549,493,521,528,-56,7,-63
2533,510000,4a103c30d593fbbe,11,0,2913,3590,1589,1106,1523,1538,1537,1666,1861,2475,3069,2341,2705,2628,-728,594,-1322
1647,340000,4a103c30d593fbbe,11,0,1717,1968,921,593,995,1124,1199,1070,1346,1713,1638,1809,1724,1720,171,-75,246
2721,370000,4a103c30d593fbbe,11,0,2776,3299,1329,945,1856,2083,2108,1738,2082,2655,2980,2964,2972,2866,-16,325,-341
926,140000,4a103c30d593fbbe,11,0,782,1130,401,261,510,549,610,526,688,866,791,915,853,857,124,-75,199
1916,440000,4a103c30d593fbbe,11,0,2171,2397,475,354,1081,908,1044,1235,994,1368,1488,1712,1600,1523,224,120,104
451,450000,4a103c30d593fbbe,11,0,493,595,225,179,348,224,290,274,316,397,424,502,463,441,78,27,51
3224,320000,4a103c30d593fbbe,11,0,3579,4302,1623,1477,2234,2129,2434,2155,2485,3088,3158,3744,3451,3330,586,70,516
916,360000,4a103c30d593fbbe,11,0,885,1016,398,230,537,551,590,548,652,808,842,1004,923,885,162,34,128
3884,130000,4a103c30d593fbbe,11,0,2989,3954,1565,1311,2239,2725,3260,2705,3344,4173,4034,4164,4099,4124,130,-139,269
3303,410000,4a103c30d593fbbe,11,0,2638,3291,1489,872,1684,1948,1801,1780,2489,2996,3374,3430,3402,3267,56,378,-322
2713,330000,4a103c30d593fbbe,11,0,2458,2897,961,793,1491,1417,1453,1417,1645,2472,2753,3040,2896,2755,287,281,6
938,420000,4a103c30d593fbbe,11,0,1247,1304,805,357,634,667,656,762,898,966,1182,1166,1174,1105,-16,216,-232
1178,430000,4a103c30d593fbbe,11,0,948,1222,427,264,565,544,561,563,728,991,1080,998,1039,1023,-82,89,-171
918,350000,4a103c30d593fbbe,11,0,946,924,385,327,518,415,620,444,541,690,728,859,794,759,131,38,93
1259,210000,4a103c30d593fbbe,11,0,1160,1513,414,423,828,916,847,707,895,1272,1162,1131,1146,1188,-31,-110,79
545,500000,4a103c30d593fbbe,11,0,493,612,296,209,288,300,336,388,329,435,559,585,572,526,26,124,-98
886,610000,4a103c30d593fbbe,11,0,946,1143,404,239,410,468,587,452,654,835,911,1108,1010,951,197,76,121
1078,230000,4a103c30d593fbbe,11,0,1190,1198,462,436,1058,713,772,690,729,1100,842,859,850,934,17,-258,275
1382,310000,7a7885e2d7c00bcf,11,0,790,925,325,455,653,555,624,740,612,758,1004,810,907,857,-194,246,-440
342,530000,7a7885e2d7c00bcf,11,0,527,546,194,218,317,270,316,211,290,290,300,338,319,309,38,10,28
334,150000,7a7885e2d7c00bcf,11,0,359,418,168,163,287,292,335,266,288,328,334,323,328,328,-11,6,-17
726,110000,7a7885e2d7c00bcf,11,0,1162,1615,471,523,831,698,714,664,617,559,655,482,568,565,-173,96,-269
802,510000,7a7885e2d7c00bcf,11,0,961,1167,445,516,738,665,640,630,656,820,1044,665,854,843,-379,224,-603
825,340000,7a7885e2d7c00bcf,11,0,933,1003,374,418,658,653,606,565,618,791,819,792,806,801,-27,28,-55
2497,370000,7a7885e2d7c00bcf,11,0,2370,2766,875,984,1739,1860,1899,1420,1615,2002,2507,2148,2328,2219,-359,505,-864
309,140000,7a7885e2d7c00bcf,11,0,355,484,139,184,247,243,229,225,247,307,331,274,302,304,-57,24,-81
919,440000,7a7885e2d7c00bcf,11,0,1209,1464,402,402,896,629,772,826,680,829,845,876,860,850,31,16,15
236,450000,7a7885e2d7c00bcf,11,0,290,384,118,109,224,157,222,215,154,183,203,224,214,203,21,20,1
2598,320000,7a7885e2d7c00bcf,11,0,2801,3241,1057,1612,2234,1953,2227,1909,2048,2422,2463,2396,2430,2427,-67,41,-108
388,360000,7a7885e2d7c00bcf,11,0,481,511,213,176,385,307,351,273,345,404,431,370,400,402,-61,27,-88
1881,130000,7a7885e2d7c00bcf,11,0,1929,2115,754,885,1533,1690,1813,1571,1661,1916,1901,1771,1836,1863,-130,-15,-115
1448,410000,7a7885e2d7c00bcf,11,0,1461,1740,591,724,1200,1228,1058,967,1158,1211,1356,1347,1352,1305,-9,145,-154
2155,330000,7a7885e2d7c00bcf,11,0,2127,2662,818,1237,1764,1676,1729,1525,1884,2258,2311,2171,2241,2247,-140,53,-193
433,420000,7a7885e2d7c00bcf,11,0,616,685,305,279,470,356,444,412,438,504,557,493,525,518,-64,53,-117
527,430000,7a7885e2d7c00bcf,11,0,559,768,256,278,497,347,424,341,409,480,525,413,469,473,-112,45,-157
434,350000,7a7885e2d7c00bcf,11,0,480,608,216,257,389,262,395,326,356,356,363,428,396,382,65,7,58
400,210000,7a7885e2d7c00bcf,11,0,516,595,169,217,412,408,386,321,346,352,385,344,364,360,-41,33,-74
156,500000,7a7885e2d7c00bcf,11,0,216,258,69,99,133,100,129,180,126,116,163,123,143,134,-40,47,-87
470,610000,7a7885e2d7c00bcf,11,0,487,657,185,238,361,306,395,301,417,437,460,507,484,468,47,23,24
335,230000,7a7885e2d7c00bcf,11,0,413,533,157,228,535,404,398,359,345,475,357,314,336,382,-43,-118,75
26,310000,346393c2c6305fb1,11,0,114,215,76,41,45,61,38,52,37,39,38,27,32,35,-11,-1,-10
57,530000,346393c2c6305fb1,11,0,121,182,95,41,34,36,31,58,44,55,41,52,46,49,11,-14,25
85,150000,346393c2c6305fb1,11,0,174,205,99,66,95,76,72,76,74,85,79,66,72,77,-13,-6,-7
36,110000,346393c2c6305fb1,11,0,243,439,74,40,54,53,41,27,32,51,39,40,40,43,1,-12,13
148,510000,346393c2c6305fb1,11,0,297,513,309,153,136,133,149,150,134,136,183,129,156,149,-54,47,-101
404,340000,346393c2c6305fb1,11,0,692,1047,578,273,312,307,331,314,279,347,395,358,376,367,-37,48,-85
674,370000,346393c2c6305fb1,11,0,1099,1844,902,381,538,572,675,544,536,649,690,646,668,662,-44,41,-85
262,140000,346393c2c6305fb1,11,0,308,545,238,158,237,226,236,217,178,237,265,271,268,258,6,28,-22
105,440000,346393c2c6305fb1,11,0,289,373,126,71,118,103,101,96,92,121,141,114,128,125,-27,20,-47
70,450000,346393c2c6305fb1,11,0,115,162,93,53,69,35,53,40,48,50,56,61,58,56,5,6,-1
239,320000,346393c2c6305fb1,11,0,397,621,300,168,197,206,183,203,185,213,207,225,216,215,18,-6,24
57,360000,346393c2c6305fb1,11,0,143,266,151,36,61,68,60,40,53,57,59,62,60,59,3,2,1
550,130000,346393c2c6305fb1,11,0,808,1460,748,389,430,459,518,401,452,524,544,517,530,528,-27,20,-47
329,410000,346393c2c6305fb1,11,0,617,1100,524,174,251,240,290,254,290,316,303,354,328,324,51,-13,64
75,330000,346393c2c6305fb1,11,0,191,260,101,55,63,66,67,90,77,72,74,78,76,75,4,2,2
155,420000,346393c2c6305fb1,11,0,313,534,275,79,103,125,96,138,125,127,182,178,180,162,-4,55,-59
176,430000,346393c2c6305fb1,11,0,335,535,308,119,163,126,142,139,138,161,166,159,162,162,-7,5,-12
32,350000,346393c2c6305fb1,11,0,87,129,60,25,51,31,35,42,33,28,56,34,45,39,-22,28,-50
203,210000,346393c2c6305fb1,11,0,265,371,149,91,133,121,130,132,148,200,180,119,150,166,-61,-20,-41
53,500000,346393c2c6305fb1,11,0,199,335,168,84,69,66,80,88,67,79,85,68,76,77,-17,6,-23
105,610000,346393c2c6305fb1,11,0,186,360,209,62,83,76,106,84,83,85,110,130,120,108,20,25,-5
154,230000,346393c2c6305fb1,11,0,223,312,126,95,154,101,143,86,105,123,132,70,101,108,-62,9,-71
624,310000,02aab221aabc03b9,11,0,558,362,679,494,731,600,672,772,704,727,654,627,640,669,-27,-73,46
221,530000,02aab221aabc03b9,11,0,160,155,229,130,223,186,188,194,250,267,174,213,194,218,39,-93,132
72,150000,02aab221aabc03b9,11,0,82,59,106,63,136,99,113,83,99,112,92,79,86,94,-13,-20,7
647,110000,02aab221aabc03b9,11,0,654,521,798,532,838,575,694,618,670,630,659,544,602,611,-115,29,-144
544,510000,02aab221aabc03b9,11,0,430,474,703,394,653,524,606,614,549,576,507,629,568,571,122,-69,191
345,340000,02aab221aabc03b9,11,0,228,187,338,203,372,311,341,346,340,353,335,325,330,338,-10,-18,8
529,370000,02aab221aabc03b9,11,0,421,353,610,362,607,527,608,548,531,526,473,504,488,501,31,-53,84
110,140000,02aab221aabc03b9,11,0,117,105,129,94,160,139,138,152,130,124,119,114,116,119,-5,-5,0
1233,440000,02aab221aabc03b9,11,0,976,1007,1207,847,1361,1093,1267,1219,1095,1304,1161,1178,1170,1214,17,-143,160
132,450000,02aab221aabc03b9,11,0,138,119,159,102,172,121,154,153,137,153,146,149,148,149,3,-7,10
1399,320000,02aab221aabc03b9,11,0,1186,1077,1735,1066,1713,1523,1554,1639,1493,1583,1338,1428,1383,1450,90,-245,335
233,360000,02aab221aabc03b9,11,0,154,152,242,146,291,216,232,253,206,215,224,199,212,213,-25,9,-34
346,130000,02aab221aabc03b9,11,0,254,182,340,242,360,379,362,327,372,362,376,325,350,354,-51,14,-65
322,410000,02aab221aabc03b9,11,0,284,223,320,199,311,289,319,320,350,407,332,310,321,350,-22,-75,53
1357,330000,02aab221aabc03b9,11,0,1136,1024,1529,973,1602,1326,1507,1501,1473,1537,1190,1401,1296,1376,211,-347,558
327,420000,02aab221aabc03b9,11,0,273,274,370,238,369,296,339,369,331,321,338,311,324,323,-27,17,-44
266,430000,02aab221aabc03b9,11,0,205,215,305,186,346,275,278,289,275,275,299,270,284,281,-29,24,-53
478,350000,02aab221aabc03b9,11,0,321,324,518,242,572,350,498,528,403,477,413,401,407,430,-12,-64,52
255,210000,02aab221aabc03b9,11,0,207,174,292,205,321,225,242,252,295,316,266,226,246,269,-40,-50,10
210,500000,02aab221aabc03b9,11,0,217,217,267,199,277,240,244,232,258,263,190,261,226,238,71,-73,144
204,610000,02aab221aabc03b9,11,0,205,197,285,151,281,203,248,250,270,252,210,232,221,231,22,-42,64
76,230000,02aab221aabc03b9,11,0,63,53,93,68,133,85,82,113,113,134,92,79,86,102,-13,-42,29
324,310000,5d7fb682edd0f937,11,0,247,225,315,160,297,263,287,314,230,299,290,307,298,299,17,-9,26
179,530000,5d7fb682edd0f937,11,0,133,176,164,108,164,133,153,126,180,169,187,139,163,165,-48,18,-66
91,150000,5d7fb682edd0f937,11,0,85,86,86,62,103,111,102,97,88,89,103,85,94,92,-18,14,-32
292,110000,5d7fb682edd0f937,11,0,324,417,323,190,356,270,290,257,234,246,289,227,258,254,-62,43,-105
353,510000,5d7fb682edd0f937,11,0,301,337,483,166,411,313,351,316,288,271,389,298,344,319,-91,118,-209
232,340000,5d7fb682edd0f937,11,0,169,174,188,119,173,183,210,172,186,222,219,180,200,207,-39,-3,-36
323,370000,5d7fb682edd0f937,11,0,227,253,339,160,306,297,331,234,253,292,332,281,306,302,-51,40,-91
77,140000,5d7fb682edd0f937,11,0,81,91,111,56,97,101,97,84,91,94,102,75,88,90,-27,8,-35
589,440000,5d7fb682edd0f937,11,0,510,512,581,314,531,409,540,562,422,478,505,502,504,495,-3,27,-30
107,450000,5d7fb682edd0f937,11,0,103,109,128,57,103,59,104,114,85,94,92,94,93,93,2,-2,4
806,320000,5d7fb682edd0f937,11,0,661,734,807,456,741,678,793,643,655,701,797,673,735,724,-124,96,-220
140,360000,5d7fb682edd0f937,11,0,129,138,165,79,158,126,152,118,104,127,138,158,148,141,20,11,9
194,130000,5d7fb682edd0f937,11,0,180,178,203,126,201,195,251,175,165,222,247,198,222,222,-49,25,-74
191,410000,5d7fb682edd0f937,11,0,189,173,186,103,191,191,194,156,186,216,215,183,199,205,-32,-1,-31
710,330000,5d7fb682edd0f937,11,0,599,595,656,382,738,625,720,647,584,732,718,681,700,710,-37,-14,-23
268,420000,5d7fb682edd0f937,11,0,258,266,270,142,257,214,255,256,231,241,262,216,239,240,-46,21,-67
187,430000,5d7fb682edd0f937,11,0,168,191,210,114,205,161,191,162,167,198,213,168,190,193,-45,15,-60
219,350000,5d7fb682edd0f937,11,0,201,205,241,127,267,183,283,239,197,201,237,226,232,221,-11,36,-47
155,210000,5d7fb682edd0f937,11,0,138,128,140,90,113,125,138,146,129,145,130,114,122,130,-16,-15,-1
137,500000,5d7fb682edd0f937,11,0,106,134,131,54,117,102,136,130,124,110,144,134,139,129,-10,34,-44
133,610000,5d7fb682edd0f937,11,0,135,145,159,85,142,119,156,144,123,140,138,149,144,142,11,-2,13
48,230000,5d7fb682edd0f937,11,0,53,61,68,34,78,65,79,70,61,83,81,56,68,73,-25,-2,-23
572,310000,a207df29ec9583f0,11,0,493,474,835,424,592,562,626,644,634,694,593,524,558,604,-69,-101,32
252,530000,a207df29ec9583f0,11,0,210,215,310,178,234,223,203,223,258,250,238,175,206,221,-63,-12,-51
97,150000,a207df29ec9583f0,11,0,82,74,139,87,116,104,125,105,116,128,105,107,106,113,2,-23,25
773,110000,a207df29ec9583f0,11,0,747,817,1033,648,841,763,792,726,727,824,751,607,679,727,-144,-73,-71
469,510000,a207df29ec9583f0,11,0,361,382,695,383,524,456,456,507,479,440,615,366,490,474,-249,175,-424
246,340000,a207df29ec9583f0,11,0,176,177,354,152,225,259,222,223,254,259,255,231,243,248,-24,-4,-20
427,370000,a207df29ec9583f0,11,0,348,336,608,328,530,488,475,451,429,468,468,361,414,432,-107,0,-107
143,140000,a207df29ec9583f0,11,0,93,100,165,96,130,118,97,142,140,152,138,125,132,138,-13,-14,1
946,440000,a207df29ec9583f0,11,0,766,825,1178,690,1101,964,1020,962,1084,1109,1111,990,1050,1070,-121,2,-123
150,450000,a207df29ec9583f0,11,0,100,114,160,106,163,133,138,136,134,129,148,137,142,138,-11,19,-30
978,320000,a207df29ec9583f0,11,0,915,1007,1591,766,1115,1026,1072,1033,982,1080,1012,891,952,994,-121,-68,-53
177,360000,a207df29ec9583f0,11,0,129,108,227,115,167,214,182,168,165,197,175,164,170,179,-11,-22,11
251,130000,a207df29ec9583f0,11,0,203,219,376,209,316,289,290,301,301,298,260,239,250,266,-21,-38,17
301,410000,a207df29ec9583f0,11,0,283,262,357,201,287,304,275,256,289,287,329,268,298,295,-61,42,-103
805,330000,a207df29ec9583f0,11,0,849,908,1436,623,970,967,965,954,954,1063,930,896,913,963,-34,-133,99
340,420000,a207df29ec9583f0,11,0,315,356,436,202,366,316,282,393,360,384,379,336,358,366,-43,-5,-38
211,430000,a207df29ec9583f0,11,0,174,192,302,179,246,255,226,219,246,249,252,213,232,238,-39,3,-42
344,350000,a207df29ec9583f0,11,0,227,256,500,212,338,297,357,330,288,330,361,323,342,338,-38,31,-69
247,210000,a207df29ec9583f0,11,0,194,227,304,176,286,261,241,263,276,299,268,233,250,267,-35,-31,-4
183,500000,a207df29ec9583f0,11,0,174,194,265,152,205,197,174,223,187,198,223,169,196,197,-54,25,-79
230,610000,a207df29ec9583f0,11,0,194,216,307,140,222,205,251,252,248,224,226,202,214,217,-24,2,-26
84,230000,a207df29ec9583f0,11,0,83,85,102,84,125,116,121,127,86,123,92,77,84,97,-15,-31,16
168,310000,b4be3a4917289c82,11,0,201,262,80,97,160,113,154,142,142,182,210,219,214,204,9,28,-19
81,530000,b4be3a4917289c82,11,0,100,59,26,35,34,50,78,51,74,46,58,61,60,55,3,12,-9
32,150000,b4be3a4917289c82,11,0,40,37,22,17,26,37,25,21,17,27,25,23,24,25,-2,-2,0
148,110000,b4be3a4917289c82,11,0,230,226,93,117,153,137,139,94,88,112,163,169,166,148,6,51,-45
154,510000,b4be3a4917289c82,11,0,240,223,57,76,90,137,164,128,144,184,277,125,201,195,-152,93,-245
95,340000,b4be3a4917289c82,11,0,130,121,57,59,72,81,74,76,100,108,95,113,104,105,18,-13,31
188,370000,b4be3a4917289c82,11,0,231,199,113,137,218,152,167,149,160,180,268,232,250,227,-36,88,-124
30,140000,b4be3a4917289c82,11,0,28,33,16,10,28,22,76,22,26,27,34,36,35,32,2,7,-5
270,440000,b4be3a4917289c82,11,0,396,384,120,115,231,223,244,188,202,225,232,206,219,221,-26,7,-33
41,450000,b4be3a4917289c82,11,0,41,40,20,18,18,25,33,31,30,38,53,32,42,41,-21,15,-36
468,320000,b4be3a4917289c82,11,0,635,591,225,325,414,342,390,329,340,426,503,487,495,472,-16,77,-93
56,360000,b4be3a4917289c82,11,0,66,85,10,18,37,40,39,37,38,50,58,43,50,50,-15,8,-23
140,130000,b4be3a4917289c82,11,0,166,161,78,99,131,131,102,71,97,118,127,156,142,134,29,9,20
102,410000,b4be3a4917289c82,11,0,128,163,57,77,90,88,75,84,92,121,128,128,128,126,0,7,-7
526,330000,b4be3a4917289c82,11,0,523,567,168,290,344,386,300,355,415,511,575,426,500,504,-149,64,-213
89,420000,b4be3a4917289c82,11,0,120,142,48,54,76,88,66,69,75,103,111,77,94,97,-34,8,-42
62,430000,b4be3a4917289c82,11,0,112,124,41,43,61,74,75,46,72,85,92,69,80,82,-23,7,-30
58,350000,b4be3a4917289c82,11,0,108,127,23,28,50,51,59,58,62,64,70,54,62,63,-16,6,-22
75,210000,b4be3a4917289c82,11,0,106,83,28,38,67,45,65,40,54,75,89,57,73,74,-32,14,-46
56,500000,b4be3a4917289c82,11,0,77,67,17,20,19,34,34,37,30,40,56,32,44,43,-24,16,-40
64,610000,b4be3a4917289c82,11,0,68,82,41,52,48,66,99,56,51,90,75,83,79,83,8,-15,23
16,230000,b4be3a4917289c82,11,0,48,45,18,18,48,30,46,28,19,30,30,25,28,28,-5,0,-5
659,310000,ef76a85c4b39f693,11,0,306,492,378,283,374,311,427,498,475,609,825,487,656,640,-338,216,-554
219,530000,ef76a85c4b39f693,11,0,142,154,140,101,145,149,178,192,272,277,259,213,236,250,-46,-18,-28
166,150000,ef76a85c4b39f693,11,0,67,109,121,79,109,124,169,140,135,176,185,176,180,179,-9,9,-18
639,110000,ef76a85c4b39f693,11,0,311,576,511,299,438,522,580,543,591,697,730,557,644,661,-173,33,-206
610,510000,ef76a85c4b39f693,11,0,340,526,495,291,361,444,497,529,571,643,1038,541,790,741,-497,395,-892
464,340000,ef76a85c4b39f693,11,0,219,307,304,148,259,319,271,331,363,453,565,402,484,473,-163,112,-275
645,370000,ef76a85c4b39f693,11,0,312,378,406,284,400,479,557,520,550,741,941,568,754,750,-373,200,-573
164,140000,ef76a85c4b39f693,11,0,58,83,94,61,99,97,93,99,121,177,185,168,176,177,-17,8,-25
958,440000,ef76a85c4b39f693,11,0,593,912,598,355,607,642,701,764,756,899,1094,934,1014,976,-160,195,-355
132,450000,ef76a85c4b39f693,11,0,50,68,74,33,77,72,113,104,139,145,158,129,144,144,-29,13,-42
1408,320000,ef76a85c4b39f693,11,0,609,1028,993,652,891,910,1046,1085,1159,1451,1727,1253,1490,1477,-474,276,-750
272,360000,ef76a85c4b39f693,11,0,107,208,200,69,151,150,175,152,209,258,344,206,275,269,-138,86,-224
508,130000,ef76a85c4b39f693,11,0,298,340,342,250,323,382,440,423,438,563,630,455,542,549,-175,67,-242
427,410000,ef76a85c4b39f693,11,0,170,239,290,184,293,341,325,356,405,492,560,422,491,491,-138,68,-206
1666,330000,ef76a85c4b39f693,11,0,965,1300,996,708,969,1088,1209,1284,1524,1958,2180,1479,1830,1872,-701,222,-923
410,420000,ef76a85c4b39f693,11,0,212,331,334,134,250,279,305,303,339,437,473,371,422,427,-102,36,-138
366,430000,ef76a85c4b39f693,11,0,180,310,284,146,251,271,354,267,331,429,484,339,412,417,-145,55,-200
306,350000,ef76a85c4b39f693,11,0,138,176,229,97,153,164,270,221,253,308,353,274,314,312,-79,45,-124
431,210000,ef76a85c4b39f693,11,0,189,261,256,190,274,317,341,370,440,648,531,397,464,525,-134,-117,-17
200,500000,ef76a85c4b39f693,11,0,76,157,115,82,120,97,175,209,162,190,256,142,199,196,-114,66,-180
344,610000,ef76a85c4b39f693,11,0,127,205,223,136,166,239,247,199,284,366,387,357,372,370,-30,21,-51
159,230000,ef76a85c4b39f693,11,0,108,145,104,92,153,138,145,157,161,240,210,129,170,193,-81,-30,-51
528,310000,bb9fbec9a2833839,11,0,341,507,266,214,347,256,335,387,323,471,449,434,442,451,-15,-22,7
222,530000,bb9fbec9a2833839,11,0,169,225,142,99,142,158,164,176,231,206,157,158,158,174,1,-49,50
172,150000,bb9fbec9a2833839,11,0,121,169,76,74,105,133,145,136,151,168,178,179,178,175,1,10,-9
381,110000,bb9fbec9a2833839,11,0,417,450,177,170,259,234,290,279,265,274,353,267,310,298,-86,79,-165
398,510000,bb9fbec9a2833839,11,0,433,394,242,224,324,333,361,319,358,452,596,393,494,480,-203,144,-347
307,340000,bb9fbec9a2833839,11,0,256,310,160,139,211,231,217,227,254,298,323,290,306,304,-33,25,-58
607,370000,bb9fbec9a2833839,11,0,469,507,305,251,332,402,428,398,413,574,597,509,553,560,-88,23,-111
174,140000,bb9fbec9a2833839,11,0,124,97,55,43,101,86,111,100,106,169,173,150,162,164,-23,4,-27
849,440000,bb9fbec9a2833839,11,0,821,895,435,271,630,599,641,694,710,772,788,776,782,779,-12,16,-28
133,450000,bb9fbec9a2833839,11,0,114,124,79,66,108,95,119,99,124,137,118,143,130,133,25,-19,44
1139,320000,bb9fbec9a2833839,11,0,937,1154,552,589,835,807,903,879,877,1098,1019,1157,1088,1091,138,-79,217
230,360000,bb9fbec9a2833839,11,0,189,178,106,91,145,142,176,146,152,202,227,235,231,221,8,25,-17
398,130000,bb9fbec9a2833839,11,0,327,378,179,188,251,302,319,290,307,411,362,402,382,392,40,-49,89
346,410000,bb9fbec9a2833839,11,0,276,308,156,143,260,258,238,212,252,290,348,286,317,308,-62,58,-120
1398,330000,bb9fbec9a2833839,11,0,1072,1169,550,543,759,841,892,995,1035,1285,1388,1216,1302,1296,-172,103,-275
366,420000,bb9fbec9a2833839,11,0,308,378,261,177,285,262,281,264,324,372,438,443,440,418,5,66,-61
299,430000,bb9fbec9a2833839,11,0,226,309,145,129,251,238,285,222,261,332,310,299,304,314,-11,-22,11
311,350000,bb9fbec9a2833839,11,0,214,293,168,110,183,202,270,233,236,280,255,305,280,280,50,-25,75
187,210000,bb9fbec9a2833839,11,0,177,213,86,85,121,151,164,140,139,209,233,143,188,195,-90,24,-114
131,500000,bb9fbec9a2833839,11,0,89,130,65,59,92,68,101,131,82,96,144,114,129,118,-30,48,-78
155,610000,bb9fbec9a2833839,11,0,164,174,112,81,131,150,180,137,151,189,198,226,212,204,28,9,19
74,230000,bb9fbec9a2833839,11,0,95,85,44,40,74,82,95,78,104,128,90,82,86,100,-8,-38,30
672,310000,da457d15788fe8ee,11,0,593,748,538,251,456,315,445,485,411,558,671,391,531,540,-280,113,-393
267,530000,da457d15788fe8ee,11,0,323,344,263,166,191,198,263,290,341,252,328,261,294,280,-67,76,-143
185,150000,da457d15788fe8ee,11,0,206,200,197,109,152,165,213,178,177,172,194,149,172,172,-45,22,-67
1158,110000,da457d15788fe8ee,11,0,939,1050,755,424,693,651,781,754,805,949,920,743,832,871,-177,-29,-148
590,510000,da457d15788fe8ee,11,0,560,641,624,348,443,468,502,547,611,673,959,435,697,689,-524,286,-810
394,340000,da457d15788fe8ee,11,0,331,409,330,200,229,256,264,317,284,317,394,291,342,334,-103,77,-180
603,370000,da457d15788fe8ee,11,0,630,646,659,309,458,540,534,523,541,632,768,491,630,630,-277,136,-413
168,140000,da457d15788fe8ee,11,0,142,103,120,44,90,120,136,128,136,187,160,129,144,159,-31,-27,-4
1433,440000,da457d15788fe8ee,11,0,1408,1829,1269,499,1006,894,1099,1203,1068,1323,1501,1221,1361,1348,-280,178,-458
169,450000,da457d15788fe8ee,11,0,142,255,213,82,152,117,156,149,174,198,193,169,181,187,-24,-5,-19
1276,320000,da457d15788fe8ee,11,0,1108,1430,1304,649,954,933,1003,955,1112,1268,1354,983,1168,1202,-371,86,-457
291,360000,da457d15788fe8ee,11,0,275,247,282,85,186,198,229,203,249,256,341,219,280,272,-122,85,-207
497,130000,da457d15788fe8ee,11,0,417,527,425,254,337,412,434,405,458,546,548,398,473,497,-150,2,-152
431,410000,da457d15788fe8ee,11,0,382,502,442,251,354,426,325,372,375,398,412,339,376,383,-73,14,-87
1678,330000,da457d15788fe8ee,11,0,1214,1500,938,567,836,888,1017,1178,1317,1460,1660,1157,1408,1426,-503,200,-703
559,420000,da457d15788fe8ee,11,0,473,526,572,259,428,363,377,445,438,468,503,382,442,451,-121,35,-156
483,430000,da457d15788fe8ee,11,0,391,505,374,207,342,370,431,366,451,421,470,359,414,417,-111,49,-160
355,350000,da457d15788fe8ee,11,0,320,358,335,144,206,194,282,238,262,319,348,276,312,314,-72,29,-101
516,210000,da457d15788fe8ee,11,0,335,454,281,156,268,293,330,277,371,482,484,306,395,424,-178,2,-180
244,500000,da457d15788fe8ee,11,0,209,244,199,108,153,121,186,284,146,224,267,164,216,218,-103,43,-146
311,610000,da457d15788fe8ee,11,0,242,346,325,174,210,225,299,236,330,298,331,274,302,301,-57,33,-90
172,230000,da457d15788fe8ee,11,0,190,198,139,94,144,137,133,149,128,210,136,95,116,147,-41,-74,33
567,310000,6858d6dfe680bdf7,11,0,513,576,543,384,696,487,649,633,685,664,518,503,510,562,-15,-146,131
210,530000,6858d6dfe680bdf7,11,0,236,257,243,199,312,234,314,249,292,267,233,166,200,222,-67,-34,-33
71,150000,6858d6dfe680bdf7,11,0,60,80,54,43,84,76,64,93,74,68,76,58,67,67,-18,8,-26
581,110000,6858d6dfe680bdf7,11,0,585,816,536,311,688,527,617,587,668,640,578,411,494,543,-167,-62,-105
510,510000,6858d6dfe680bdf7,11,0,447,593,591,337,640,478,571,603,551,645,659,365,512,556,-294,14,-308
325,340000,6858d6dfe680bdf7,11,0,275,385,322,230,435,350,391,362,386,364,400,336,368,367,-64,36,-100
443,370000,6858d6dfe680bdf7,11,0,401,440,468,289,622,538,593,498,535,586,540,332,436,486,-208,-46,-162
83,140000,6858d6dfe680bdf7,11,0,61,103,57,64,78,79,91,70,76,114,91,72,82,92,-19,-23,4
1163,440000,6858d6dfe680bdf7,11,0,983,1319,1274,618,1449,1061,1394,1469,1265,1360,1372,1116,1244,1283,-256,12,-268
138,450000,6858d6dfe680bdf7,11,0,126,167,115,84,164,123,176,156,157,172,190,125,158,162,-65,18,-83
1153,320000,6858d6dfe680bdf7,11,0,988,1160,1203,919,1681,1193,1428,1269,1375,1458,1073,894,984,1142,-179,-385,206
173,360000,6858d6dfe680bdf7,11,0,129,200,185,89,224,198,224,201,206,230,203,138,170,190,-65,-27,-38
360,130000,6858d6dfe680bdf7,11,0,281,283,417,232,460,496,484,423,463,437,409,277,343,374,-132,-28,-104
329,410000,6858d6dfe680bdf7,11,0,237,350,258,224,388,425,429,397,410,418,393,275,334,362,-118,-25,-93
1686,330000,6858d6dfe680bdf7,11,0,1465,1724,1540,1004,2273,1596,1876,1650,1852,1906,1579,1310,1444,1598,-269,-327,58
312,420000,6858d6dfe680bdf7,11,0,218,283,271,143,325,266,300,353,314,383,331,242,286,319,-89,-52,-37
350,430000,6858d6dfe680bdf7,11,0,255,374,375,195,380,321,402,363,372,409,397,243,320,350,-154,-12,-142
333,350000,6858d6dfe680bdf7,11,0,251,346,352,161,369,304,419,307,353,366,384,305,344,352,-79,18,-97
228,210000,6858d6dfe680bdf7,11,0,159,186,215,146,225,256,285,240,260,305,212,189,200,235,-23,-93,70
247,500000,6858d6dfe680bdf7,11,0,200,253,198,131,290,195,274,315,277,268,213,164,188,215,-49,-55,6
186,610000,6858d6dfe680bdf7,11,0,134,174,188,135,235,193,286,212,215,219,199,188,194,202,-11,-20,9
94,230000,6858d6dfe680bdf7,11,0,58,76,70,44,104,104,97,90,78,104,69,44,56,72,-25,-35,10
325,310000,79de4e4b24c35b04,11,0,501,825,333,136,253,217,192,208,169,209,261,157,209,209,-104,52,-156
622,530000,79de4e4b24c35b04,11,0,928,1393,1050,634,598,559,552,559,568,496,633,817,725,649,184,137,47
211,150000,79de4e4b24c35b04,11,0,272,405,185,132,207,141,156,128,146,189,194,188,191,190,-6,5,-11
126,110000,79de4e4b24c35b04,11,0,446,852,178,127,199,127,128,132,116,105,91,84,88,93,-7,-14,7
423,510000,79de4e4b24c35b04,11,0,934,1509,1063,565,512,413,385,387,456,447,479,394,436,440,-85,32,-117
994,340000,79de4e4b24c35b04,11,0,1461,2601,1965,1072,936,771,749,842,897,904,1032,1004,1018,980,-28,128,-156
2048,370000,79de4e4b24c35b04,11,0,3077,5360,2858,1598,1729,1694,1756,1539,1936,1912,2146,2072,2109,2043,-74,234,-308
572,140000,79de4e4b24c35b04,11,0,803,1442,701,396,447,437,462,390,470,484,542,537,540,521,-5,58,-63
3185,440000,79de4e4b24c35b04,11,0,5800,8421,3465,1872,3263,2465,2754,2779,2551,2831,3372,3213,3292,3139,-159,541,-700
1932,450000,79de4e4b24c35b04,11,0,3479,6171,2981,1510,1845,1206,1444,1326,1376,2120,1771,1953,1862,1948,182,-349,531
1529,320000,79de4e4b24c35b04,11,0,2153,3757,2028,1542,1465,1325,1301,1251,1387,1382,1410,1551,1480,1448,141,28,113
520,360000,79de4e4b24c35b04,11,0,736,1319,827,443,434,359,341,393,389,426,463,502,482,464,39,37,2
1412,130000,79de4e4b24c35b04,11,0,1789,2863,1366,1047,1021,1146,1168,1072,1294,1269,1276,1339,1308,1295,63,7,56
3241,410000,79de4e4b24c35b04,11,0,5194,9539,6024,2842,2528,2423,2523,2603,3162,2973,3080,3382,3231,3145,302,107,195
1020,330000,79de4e4b24c35b04,11,0,1653,2646,934,580,745,680,733,621,813,822,894,995,944,904,101,72,29
450,420000,79de4e4b24c35b04,11,0,982,1629,1137,521,524,406,468,397,454,447,595,540,568,527,-55,148,-203
851,430000,79de4e4b24c35b04,11,0,1513,2352,1658,771,808,663,615,657,743,779,889,856,872,841,-33,110,-143
542,350000,79de4e4b24c35b04,11,0,738,1086,453,316,456,314,359,319,319,322,371,355,363,349,-16,49,-65
698,210000,79de4e4b24c35b04,11,0,694,1039,408,313,505,468,482,534,500,483,512,500,506,498,-12,29,-41
157,500000,79de4e4b24c35b04,11,0,304,514,324,210,169,172,136,158,183,160,169,141,155,157,-28,9,-37
692,610000,79de4e4b24c35b04,11,0,1045,1704,937,403,499,452,488,436,535,576,634,679,656,630,45,58,-13
606,230000,79de4e4b24c35b04,11,0,832,1045,394,365,562,482,469,565,521,543,559,428,494,510,-131,16,-147
944,310000,12f8b7e14947c34d,11,0,1283,1483,389,338,505,521,647,608,619,726,770,537,654,678,-233,44,-277
339,530000,12f8b7e14947c34d,11,0,360,567,208,160,208,214,226,198,297,263,248,248,248,253,0,-15,15
451,150000,12f8b7e14947c34d,11,0,698,789,413,215,340,311,387,355,326,370,370,413,392,384,43,0,43
85,110000,12f8b7e14947c34d,11,0,389,488,143,102,126,84,102,87,71,101,86,53,70,80,-33,-15,-18
780,510000,12f8b7e14947c34d,11,0,820,1117,531,374,577,521,559,581,527,664,831,558,694,684,-273,167,-440
462,340000,12f8b7e14947c34d,11,0,615,705,385,198,241,246,257,285,305,420,360,450,405,410,90,-60,150
1149,370000,12f8b7e14947c34d,11,0,1352,1707,803,424,738,843,928,824,912,1138,1251,1154,1202,1181,-97,113,-210
296,140000,12f8b7e14947c34d,11,0,352,464,131,87,174,169,231,178,188,345,260,267,264,291,7,-85,92
291,440000,12f8b7e14947c34d,11,0,407,475,130,117,221,195,239,246,184,249,327,211,269,262,-116,78,-194
108,450000,12f8b7e14947c34d,11,0,158,231,93,43,77,54,89,79,95,76,109,105,107,97,-4,33,-37
1500,320000,12f8b7e14947c34d,11,0,1868,2181,991,782,1094,1007,1280,1090,1058,1318,1361,1434,1398,1371,73,43,30
426,360000,12f8b7e14947c34d,11,0,438,495,251,128,183,180,217,188,232,281,331,328,330,313,-3,50,-53
710,130000,12f8b7e14947c34d,11,0,978,1229,546,360,592,598,847,611,670,860,765,645,705,757,-120,-95,-25
765,410000,12f8b7e14947c34d,11,0,835,1053,508,259,492,410,471,586,659,755,577,697,637,676,120,-178,298
881,330000,12f8b7e14947c34d,11,0,1063,1213,348,291,556,450,632,576,610,714,681,755,718,717,74,-33,107
273,420000,12f8b7e14947c34d,11,0,358,440,200,80,136,138,174,236,210,228,238,222,230,229,-16,10,-26
463,430000,12f8b7e14947c34d,11,0,670,749,385,150,254,224,307,284,328,398,464,369,416,410,-95,66,-161
302,350000,12f8b7e14947c34d,11,0,385,408,188,136,178,176,297,240,200,252,252,280,266,261,28,0,28
102,210000,12f8b7e14947c34d,11,0,195,210,53,54,81,84,109,71,94,144,110,80,95,111,-30,-34,4
128,500000,12f8b7e14947c34d,11,0,181,295,131,85,113,117,117,161,107,136,118,97,108,117,-21,-18,-3
1013,610000,12f8b7e14947c34d,11,0,1012,1286,412,280,531,610,649,548,736,763,674,958,816,798,284,-89,373
117,230000,12f8b7e14947c34d,11,0,210,228,66,80,160,104,150,105,113,153,106,123,114,127,17,-47,64
431,310000,04e66e578f653ab9,11,0,524,679,950,175,263,226,214,231,1376,364,429,271,350,355,-158,65,-223
219,530000,04e66e578f653ab9,11,0,215,293,131,118,135,108,106,85,183,133,193,170,182,165,-23,60,-83
86,150000,04e66e578f653ab9,11,0,102,118,60,38,63,48,62,45,54,52,67,84,76,68,17,15,2
148,110000,04e66e578f653ab9,11,0,231,280,180,87,167,105,117,108,135,120,201,105,153,142,-96,81,-177
299,510000,04e66e578f653ab9,11,0,291,404,151,140,210,163,126,156,158,240,401,151,276,264,-250,161,-411
225,340000,04e66e578f653ab9,11,0,176,201,116,64,85,74,80,96,91,141,190,131,160,154,-59,49,-108
495,370000,04e66e578f653ab9,11,0,383,451,230,146,276,296,237,243,266,313,411,311,361,345,-100,98,-198
109,140000,04e66e578f653ab9,11,0,85,95,42,23,68,34,43,37,45,67,94,54,74,72,-40,27,-67
135,440000,04e66e578f653ab9,11,0,225,268,104,54,144,101,111,106,100,115,132,132,132,126,0,17,-17
40,450000,04e66e578f653ab9,11,0,42,71,30,28,32,17,42,31,35,34,44,32,38,37,-12,10,-22
723,320000,04e66e578f653ab9,11,0,644,669,334,279,388,278,361,289,335,427,537,405,471,456,-132,110,-242
129,360000,04e66e578f653ab9,11,0,104,86,64,32,40,53,58,44,58,62,97,53,75,71,-44,35,-79
316,130000,04e66e578f653ab9,11,0,206,272,140,97,162,151,190,159,151,222,288,202,245,237,-86,66,-152
360,410000,04e66e578f653ab9,11,0,219,319,144,90,156,142,133,159,150,253,275,177,226,235,-98,22,-120
510,330000,04e66e578f653ab9,11,0,400,452,190,120,235,179,236,184,200,265,399,223,311,296,-176,134,-310
118,420000,04e66e578f653ab9,11,0,81,82,146,33,61,41,44,47,128,75,99,64,82,79,-35,24,-59
193,430000,04e66e578f653ab9,11,0,135,228,105,59,115,89,71,92,97,142,167,127,147,145,-40,25,-65
102,350000,04e66e578f653ab9,11,0,132,139,77,43,64,62,76,55,207,71,81,95,88,82,14,10,4
66,210000,04e66e578f653ab9,11,0,62,81,42,40,28,19,48,46,42,41,57,41,49,46,-16,16,-32
133,500000,04e66e578f653ab9,11,0,77,87,44,31,56,52,34,81,74,75,97,76,86,83,-21,22,-43
211,610000,04e66e578f653ab9,11,0,201,238,124,83,169,151,120,99,145,151,182,131,156,155,-51,31,-82
50,230000,04e66e578f653ab9,11,0,56,48,22,17,60,50,40,34,50,39,45,36,40,40,-9,6,-15
186,310000,dff803b4024d261d,11,0,206,317,238,124,175,178,198,247,172,229,295,178,236,234,-117,66,-183
93,530000,dff803b4024d261d,11,0,61,94,64,55,50,58,59,74,82,64,64,71,68,66,7,0,7
94,150000,dff803b4024d261d,11,0,77,114,119,58,88,84,113,93,124,126,127,119,123,124,-8,1,-9
491,110000,dff803b4024d261d,11,0,466,954,488,303,463,422,404,405,524,536,639,464,552,546,-175,103,-278
373,510000,dff803b4024d261d,11,0,270,560,493,212,308,310,321,356,354,476,541,437,489,485,-104,65,-169
225,340000,dff803b4024d261d,11,0,164,192,238,108,126,152,161,181,221,244,275,225,250,248,-50,31,-81
667,370000,dff803b4024d261d,11,0,462,714,609,352,736,802,743,732,752,968,895,828,862,897,-67,-73,6
193,140000,dff803b4024d261d,11,0,152,230,168,75,152,133,162,155,176,214,192,218,205,208,26,-22,48
1966,440000,dff803b4024d261d,11,0,1988,1893,1283,554,1157,1342,1371,1506,1365,1632,2543,2393,2468,2189,-150,911,-1061
319,450000,dff803b4024d261d,11,0,204,333,316,132,218,179,232,209,214,240,299,302,300,280,3,59,-56
866,320000,dff803b4024d261d,11,0,602,865,785,520,701,575,790,696,727,808,884,890,887,861,6,76,-70
249,360000,dff803b4024d261d,11,0,194,280,264,100,195,178,199,185,190,228,334,263,298,275,-71,106,-177
469,130000,dff803b4024d261d,11,0,250,454,387,248,489,372,444,470,561,546,540,446,493,511,-94,-6,-88
291,410000,dff803b4024d261d,11,0,191,300,319,141,195,250,224,252,313,287,373,278,326,313,-95,86,-181
751,330000,dff803b4024d261d,11,0,795,787,577,391,567,562,623,668,663,739,794,766,780,766,-28,55,-83
592,420000,dff803b4024d261d,11,0,374,566,545,193,390,310,389,475,504,667,583,520,552,590,-63,-84,21
380,430000,dff803b4024d261d,11,0,423,412,412,410,531,262,352,341,399,402,522,391,456,438,-131,120,-251
727,350000,dff803b4024d261d,11,0,363,562,555,242,485,658,692,517,589,652,643,659,651,651,16,-9,25
273,210000,dff803b4024d261d,11,0,228,340,230,163,328,229,232,286,261,346,342,250,296,313,-92,-4,-88
292,500000,dff803b4024d261d,11,0,348,846,378,203,261,239,256,499,348,265,359,273,316,299,-86,94,-180
176,610000,dff803b4024d261d,11,0,99,126,138,68,103,103,121,139,167,222,209,183,196,205,-26,-13,-13
104,230000,dff803b4024d261d,11,0,89,107,57,72,88,195,88,95,117,126,705,86,396,306,-619,579,-1198
224,310000,61e73e32ad101892,11,0,276,374,264,140,173,111,133,219,252,305,253,189,221,249,-64,-52,-12
384,530000,61e73e32ad101892,11,0,444,423,403,246,278,240,349,251,370,328,322,342,332,331,20,-6,26
540,150000,61e73e32ad101892,11,0,505,619,534,251,398,363,397,446,439,554,594,520,557,556,-74,40,-114
804,110000,61e73e32ad101892,11,0,1016,1441,741,459,672,521,645,648,738,710,716,555,636,660,-161,6,-167
750,510000,61e73e32ad101892,11,0,743,1078,940,507,616,610,516,696,747,853,964,787,876,868,-177,111,-288
234,340000,61e73e32ad101892,11,0,212,273,247,107,152,149,170,178,202,240,274,256,265,257,-18,34,-52
824,370000,61e73e32ad101892,11,0,681,1011,688,350,548,657,631,628,667,792,970,906,938,889,-64,178,-242
371,140000,61e73e32ad101892,11,0,288,348,274,115,219,218,272,224,246,326,337,407,372,357,70,11,59
2201,440000,61e73e32ad101892,11,0,2144,2562,1849,777,1549,1067,1547,1898,1873,2104,2281,2270,2276,2218,-11,177,-188
360,450000,61e73e32ad101892,11,0,342,443,364,194,278,172,226,248,272,340,365,351,358,352,-14,25,-39
580,320000,61e73e32ad101892,11,0,682,857,658,425,546,407,545,534,592,698,728,718,723,715,-10,30,-40
286,360000,61e73e32ad101892,11,0,277,382,334,121,180,176,242,230,289,241,378,316,347,312,-62,137,-199
1012,130000,61e73e32ad101892,11,0,790,1042,804,407,572,721,849,721,962,1094,1052,1033,1042,1060,-19,-42,23
651,410000,61e73e32ad101892,11,0,567,656,654,303,427,422,450,484,638,714,768,669,718,717,-99,54,-153
674,330000,61e73e32ad101892,11,0,687,970,632,338,464,407,503,544,617,739,738,663,700,713,-75,-1,-74
1203,420000,61e73e32ad101892,11,0,1296,1458,1429,526,890,740,929,1121,1218,1196,1452,1245,1348,1298,-207,256,-463
506,430000,61e73e32ad101892,11,0,579,879,712,262,444,376,475,496,530,587,687,558,622,611,-129,100,-229
382,350000,61e73e32ad101892,11,0,388,523,387,223,336,237,399,355,340,322,385,473,429,393,88,63,25
829,210000,61e73e32ad101892,11,0,786,1105,571,424,658,595,611,583,678,909,852,761,806,841,-91,-57,-34
430,500000,61e73e32ad101892,11,0,568,732,616,327,364,351,290,544,368,383,473,447,460,434,-26,90,-116
476,610000,61e73e32ad101892,11,0,464,618,561,288,381,522,505,419,505,615,617,643,630,625,26,2,24
440,230000,61e73e32ad101892,11,0,348,497,267,165,333,307,314,331,413,428,410,378,394,405,-32,-18,-14
92,310000,a432c483b5beb856,11,0,242,237,68,37,61,48,42,46,60,56,89,75,82,73,-14,33,-47
182,530000,a432c483b5beb856,11,0,182,271,140,100,100,97,72,92,101,116,117,159,138,131,42,1,41
180,150000,a432c483b5beb856,11,0,149,195,78,54,74,78,87,84,89,105,134,146,140,128,12,29,-17
82,110000,a432c483b5beb856,11,0,128,205,34,44,59,36,32,45,41,40,42,48,45,43,6,2,4
393,510000,a432c483b5beb856,11,0,276,560,275,186,178,154,123,197,155,287,297,268,282,284,-29,10,-39
188,340000,a432c483b5beb856,11,0,289,496,209,109,109,97,103,125,123,120,141,192,166,151,51,21,30
312,370000,a432c483b5beb856,11,0,397,599,241,156,188,181,193,211,187,260,255,349,302,288,94,-5,99
143,140000,a432c483b5beb856,11,0,192,226,67,52,65,70,76,81,82,108,105,132,118,115,27,-3,30
1185,440000,a432c483b5beb856,11,0,1273,1753,510,290,467,429,504,568,492,615,692,978,835,762,286,77,209
230,450000,a432c483b5beb856,11,0,209,314,161,76,113,66,89,103,111,120,142,206,174,156,64,22,42
596,320000,a432c483b5beb856,11,0,808,1176,484,399,360,358,395,364,346,423,460,571,516,485,111,37,74
296,360000,a432c483b5beb856,11,0,281,556,258,99,139,120,123,138,130,192,210,317,264,240,107,18,89
344,130000,a432c483b5beb856,11,0,290,435,164,126,133,165,184,178,191,217,243,293,268,251,50,26,24
425,410000,a432c483b5beb856,11,0,364,562,252,130,136,161,188,248,234,365,372,457,414,398,85,7,78
587,330000,a432c483b5beb856,11,0,799,1102,332,255,331,293,293,451,433,549,507,551,529,536,44,-42,86
243,420000,a432c483b5beb856,11,0,362,526,267,110,92,100,79,129,117,148,188,203,196,180,15,40,-25
359,430000,a432c483b5beb856,11,0,313,627,286,115,133,96,119,133,162,229,236,300,268,255,64,7,57
259,350000,a432c483b5beb856,11,0,340,500,185,128,160,130,141,134,138,134,168,231,200,178,63,34,29
222,210000,a432c483b5beb856,11,0,209,299,101,86,133,111,127,127,138,164,160,216,188,180,56,-4,60
125,500000,a432c483b5beb856,11,0,159,317,179,87,70,59,80,101,84,95,112,155,134,121,43,17,26
113,610000,a432c483b5beb856,11,0,141,242,89,58,62,55,62,48,76,86,87,115,101,96,28,1,27
113,230000,a432c483b5beb856,11,0,121,126,60,44,65,66,61,78,87,93,69,84,76,82,15,-24,39
330,310000,0797526c057dcf5b,11,0,1289,571,175,135,300,320,311,280,332,341,475,288,382,368,-187,134,-321
527,530000,0797526c057dcf5b,11,0,285,393,160,154,201,154,174,208,237,210,296,354,325,287,58,86,-28
533,150000,0797526c057dcf5b,11,0,339,631,236,164,278,287,352,354,352,396,368,451,410,405,83,-28,111
378,110000,0797526c057dcf5b,11,0,656,980,232,253,315,319,299,344,411,421,374,323,348,373,-51,-47,-4
1083,510000,0797526c057dcf5b,11,0,1016,1536,609,478,708,677,703,870,874,1179,1263,1119,1191,1187,-144,84,-228
778,340000,0797526c057dcf5b,11,0,550,750,358,257,522,447,450,474,531,638,743,737,740,706,-6,105,-111
2804,370000,0797526c057dcf5b,11,0,3502,5481,1788,1203,1635,2012,1985,2046,2150,2770,3225,3176,3200,3057,-49,455,-504
1289,140000,0797526c057dcf5b,11,0,919,1474,502,371,567,626,775,870,822,1077,1141,1396,1268,1205,255,64,191
10485,440000,0797526c057dcf5b,11,0,12394,15317,5306,3718,8079,6812,7957,8612,8119,10514,11327,10929,11128,10923,-398,813,-1211
2157,450000,0797526c057dcf5b,11,0,1789,2693,1195,777,1366,1087,1463,1613,1736,2291,2448,2230,2339,2323,-218,157,-375
2532,320000,0797526c057dcf5b,11,0,2622,3296,1247,1529,2148,2087,2259,2343,2472,2603,2698,2915,2806,2739,217,95,122
1393,360000,0797526c057dcf5b,11,0,1265,1764,857,484,797,835,979,1050,1189,1342,1563,1467,1515,1457,-96,221,-317
2518,130000,0797526c057dcf5b,11,0,2449,3796,1214,995,1259,1697,1832,1815,2279,2449,2337,2523,2430,2436,186,-112,298
1999,410000,0797526c057dcf5b,11,0,1951,3130,1278,848,1290,1492,1391,1525,1910,2272,2311,2004,2158,2196,-307,39,-346
1935,330000,0797526c057dcf5b,11,0,2019,2088,700,801,1246,1369,1509,1644,1767,1896,1932,1907,1920,1912,-25,36,-61
1303,420000,0797526c057dcf5b,11,0,1425,1562,736,376,772,827,842,1061,1101,1051,1206,1327,1266,1195,121,155,-34
1696,430000,0797526c057dcf5b,11,0,1769,3168,1244,677,1105,1093,1503,1476,1786,1858,2160,1767,1964,1928,-393,302,-695
1572,350000,0797526c057dcf5b,11,0,1591,1981,769,598,1058,945,1316,1163,1316,1476,1544,1688,1616,1569,144,68,76
2285,210000,0797526c057dcf5b,11,0,2622,3705,1059,1132,1642,1541,1606,1822,1931,2151,2147,2045,2096,2114,-102,-4,-98
547,500000,0797526c057dcf5b,11,0,548,828,333,235,331,330,400,708,364,385,467,671,569,508,204,82,122
390,610000,0797526c057dcf5b,11,0,402,722,289,175,287,284,326,299,382,387,425,432,428,415,7,38,-31
1104,230000,0797526c057dcf5b,11,0,913,1064,350,347,604,509,589,621,701,1075,927,822,874,941,-105,-148,43
333,310000,936168bd4850913d,11,0,241,272,250,161,224,213,175,131,62,223,288,334,311,282,46,65,-19
533,530000,936168bd4850913d,11,0,282,383,494,162,297,298,329,209,81,389,480,466,473,445,-14,91,-105
458,150000,936168bd4850913d,11,0,331,374,412,213,364,399,353,232,84,339,393,355,374,362,-38,54,-92
689,110000,936168bd4850913d,11,0,527,798,336,255,324,347,230,135,126,317,411,461,436,396,50,94,-44
642,510000,936168bd4850913d,11,0,364,502,560,198,280,354,296,108,64,382,522,529,526,478,7,140,-133
622,340000,936168bd4850913d,11,0,339,449,378,228,339,365,359,86,125,393,488,570,529,484,82,95,-13
1423,370000,936168bd4850913d,11,0,1020,1083,1132,648,948,1214,1085,369,273,1000,1192,1241,1216,1144,49,192,-143
595,140000,936168bd4850913d,11,0,347,454,373,276,370,403,345,137,148,396,551,467,509,471,-84,155,-239
3829,440000,936168bd4850913d,11,0,2842,3119,2859,1337,2735,2621,2524,1566,594,2431,2956,3252,3104,2880,296,525,-229
407,450000,936168bd4850913d,11,0,279,316,376,154,306,255,297,140,103,277,336,389,362,334,53,59,-6
1203,320000,936168bd4850913d,11,0,905,1057,1012,579,905,787,820,405,226,838,926,1064,995,943,138,88,50
437,360000,936168bd4850913d,11,0,334,414,397,195,355,439,342,151,95,317,402,446,424,388,44,85,-41
1205,130000,936168bd4850913d,11,0,646,778,797,602,842,1066,971,374,253,922,911,1078,994,970,167,-11,178
1512,410000,936168bd4850913d,11,0,979,1154,954,596,986,1159,919,330,428,1111,1295,1278,1286,1228,-17,184,-201
1105,330000,936168bd4850913d,11,0,709,819,752,388,650,682,669,277,191,789,847,1023,935,886,176,58,118
1723,420000,936168bd4850913d,11,0,1292,1497,1405,549,1164,1131,1057,674,316,1053,1385,1304,1344,1247,-81,332,-413
816,430000,936168bd4850913d,11,0,649,953,623,341,556,689,570,218,194,551,712,695,704,653,-17,161,-178
700,350000,936168bd4850913d,11,0,610,611,627,347,556,479,612,226,137,543,591,622,606,585,31,48,-17
1081,210000,936168bd4850913d,11,0,727,851,758,485,709,730,631,387,271,733,853,891,872,826,38,120,-82
301,500000,936168bd4850913d,11,0,145,208,248,87,111,125,128,35,39,154,285,243,264,227,-42,131,-173
578,610000,936168bd4850913d,11,0,400,482,463,229,331,386,360,198,125,357,434,525,480,439,91,77,14
729,230000,936168bd4850913d,11,0,630,549,617,346,607,485,461,268,130,519,630,543,586,564,-87,111,-198
177,310000,cc21c7e91a3b5a0c,11,0,345,456,114,153,205,172,211,259,235,234,227,143,185,201,-84,-7,-77
359,530000,cc21c7e91a3b5a0c,11,0,338,442,406,203,364,347,383,359,548,448,420,225,322,364,-195,-28,-167
215,150000,cc21c7e91a3b5a0c,11,0,331,382,195,193,311,298,379,324,426,353,305,214,260,291,-91,-48,-43
198,110000,cc21c7e91a3b5a0c,11,0,356,580,121,115,186,128,156,127,143,113,150,121,136,128,-29,37,-66
364,510000,cc21c7e91a3b5a0c,11,0,569,804,459,234,390,378,467,472,512,561,494,291,392,449,-203,-67,-136
377,340000,cc21c7e91a3b5a0c,11,0,489,503,403,244,376,434,485,530,589,548,523,287,405,453,-236,-25,-211
700,370000,cc21c7e91a3b5a0c,11,0,912,1164,554,505,703,953,906,900,978,952,895,531,713,793,-364,-57,-307
278,140000,cc21c7e91a3b5a0c,11,0,316,428,223,193,301,299,310,314,437,371,333,194,264,299,-139,-38,-101
2189,440000,cc21c7e91a3b5a0c,11,0,3345,3730,1930,1262,2615,2284,2880,3003,3073,3157,2906,1622,2264,2562,-1284,-251,-1033
275,450000,cc21c7e91a3b5a0c,11,0,377,417,266,187,309,304,370,332,440,396,386,211,298,331,-175,-10,-165
913,320000,cc21c7e91a3b5a0c,11,0,1454,1527,877,754,1069,1130,1243,1239,1359,1276,1127,677,902,1027,-450,-149,-301
301,360000,cc21c7e91a3b5a0c,11,0,350,507,305,161,323,377,500,498,505,477,346,244,295,356,-102,-131,29
591,130000,cc21c7e91a3b5a0c,11,0,574,797,453,434,572,723,877,842,1076,876,738,454,596,689,-284,-138,-146
743,410000,cc21c7e91a3b5a0c,11,0,872,1036,630,391,702,797,764,826,1251,974,822,486,654,761,-336,-152,-184
900,330000,cc21c7e91a3b5a0c,11,0,1151,1258,739,529,861,969,1092,1188,1336,1191,1013,688,850,964,-325,-178,-147
736,420000,cc21c7e91a3b5a0c,11,0,1189,1511,963,454,719,775,822,1002,1247,1129,844,697,770,890,-147,-285,138
399,430000,cc21c7e91a3b5a0c,11,0,506,737,420,189,443,430,470,484,597,615,466,266,366,449,-200,-149,-51
471,350000,cc21c7e91a3b5a0c,11,0,734,779,473,353,640,561,659,677,791,724,521,382,452,542,-139,-203,64
426,210000,cc21c7e91a3b5a0c,11,0,480,602,285,241,431,475,512,466,627,589,508,353,430,483,-155,-81,-74
160,500000,cc21c7e91a3b5a0c,11,0,200,305,185,95,179,155,153,233,211,194,180,134,157,169,-46,-14,-32
229,610000,cc21c7e91a3b5a0c,11,0,345,496,293,157,234,292,346,246,352,406,274,153,214,278,-121,-132,11
246,230000,cc21c7e91a3b5a0c,11,0,404,422,214,206,322,309,385,388,444,380,359,210,284,316,-149,-21,-128
199,310000,7aab7fca2470987e,11,0,277,348,224,140,212,313,130,176,126,150,183,117,150,150,-66,33,-99
17,530000,7aab7fca2470987e,11,0,22,33,19,19,18,22,20,12,9,9,13,11,12,11,-2,4,-6
21,150000,7aab7fca2470987e,11,0,19,22,21,19,29,36,17,19,26,22,19,25,22,22,6,-3,9
257,110000,7aab7fca2470987e,11,0,372,511,424,244,378,320,244,260,250,268,314,181,248,254,-133,46,-179
31,510000,7aab7fca2470987e,11,0,42,64,69,42,47,33,29,34,13,37,22,23,22,27,1,-15,16
61,340000,7aab7fca2470987e,11,0,74,75,83,59,59,57,45,62,31,45,37,42,40,41,5,-8,13
268,370000,7aab7fca2470987e,11,0,286,341,430,189,295,303,192,237,256,222,242,190,216,218,-52,20,-72
93,140000,7aab7fca2470987e,11,0,62,78,105,64,83,78,62,75,85,83,109,96,102,96,-13,26,-39
910,440000,7aab7fca2470987e,11,0,972,1235,1009,443,848,749,579,865,757,844,906,781,844,844,-125,62,-187
20,450000,7aab7fca2470987e,11,0,13,26,34,17,20,12,20,22,16,21,17,17,17,18,0,-4,4
342,320000,7aab7fca2470987e,11,0,380,481,397,258,351,301,241,305,301,319,353,284,318,319,-69,34,-103
32,360000,7aab7fca2470987e,11,0,35,37,61,16,26,40,25,30,32,20,29,23,26,24,-6,9,-15
226,130000,7aab7fca2470987e,11,0,231,316,308,172,236,271,218,215,233,230,258,218,238,235,-40,28,-68
142,410000,7aab7fca2470987e,11,0,188,209,242,134,155,146,105,140,155,161,153,126,140,147,-27,-8,-19
299,330000,7aab7fca2470987e,11,0,323,375,353,222,270,371,311,449,354,283,365,291,328,313,-74,82,-156
63,420000,7aab7fca2470987e,11,0,64,62,54,47,52,51,39,64,44,59,48,34,41,47,-14,-11,-3
40,430000,7aab7fca2470987e,11,0,31,44,54,26,27,28,26,30,22,38,28,29,28,32,1,-10,11
65,350000,7aab7fca2470987e,11,0,83,105,92,41,56,43,37,75,57,57,54,58,56,56,4,-3,7
127,210000,7aab7fca2470987e,11,0,153,187,158,103,124,129,115,148,126,163,128,97,112,129,-31,-35,4
19,500000,7aab7fca2470987e,11,0,12,27,22,12,27,12,19,15,18,21,16,10,13,16,-6,-5,-1
31,610000,7aab7fca2470987e,11,0,29,46,61,16,38,37,27,23,27,20,22,12,17,18,-10,2,-12
39,230000,7aab7fca2470987e,11,0,61,65,66,41,61,62,37,56,42,70,58,32,45,53,-26,-12,-14
224,310000,fde95ea242abd896,11,0,331,369,161,142,190,140,165,214,189,313,284,306,295,301,22,-29,51
302,530000,fde95ea242abd896,11,0,521,651,386,202,309,233,292,232,382,379,387,509,448,425,122,8,114
142,150000,fde95ea242abd896,11,0,190,234,146,90,139,127,131,111,141,187,208,204,206,200,-4,21,-25
159,110000,fde95ea242abd896,11,0,301,382,210,141,181,149,153,130,100,130,167,151,159,149,-16,37,-53
429,510000,fde95ea242abd896,11,0,617,839,509,240,360,342,344,334,430,617,773,547,660,646,-226,156,-382
286,340000,fde95ea242abd896,11,0,504,690,387,163,254,266,293,273,348,415,368,351,360,378,-17,-47,30
697,370000,fde95ea242abd896,11,0,709,964,444,303,464,570,555,507,649,847,877,968,922,897,91,30,61
213,140000,fde95ea242abd896,11,0,302,443,175,132,238,204,221,191,257,331,373,351,362,352,-22,42,-64
3592,440000,fde95ea242abd896,11,0,4901,5547,3229,1517,2906,3040,2996,3064,2940,3296,3858,4197,4028,3784,339,562,-223
374,450000,fde95ea242abd896,11,0,458,665,381,181,321,247,278,230,271,353,423,346,384,374,-77,70,-147
683,320000,fde95ea242abd896,11,0,974,1139,690,508,722,614,698,656,855,923,861,961,911,915,100,-62,162
246,360000,fde95ea242abd896,11,0,499,625,381,184,276,300,321,252,286,354,387,280,334,340,-107,33,-140
544,130000,fde95ea242abd896,11,0,602,830,407,320,433,514,507,400,601,794,756,775,766,775,19,-38,57
449,410000,fde95ea242abd896,11,0,614,920,507,247,499,530,473,405,626,853,641,609,625,701,-32,-212,180
748,330000,fde95ea242abd896,11,0,1169,1424,732,558,806,842,817,859,969,1255,1091,1244,1168,1197,153,-164,317
630,420000,fde95ea242abd896,11,0,1066,1347,698,270,511,498,504,540,672,774,908,619,764,767,-289,134,-423
384,430000,fde95ea242abd896,11,0,700,988,570,203,418,421,498,401,577,729,628,544,586,634,-84,-101,17
678,350000,fde95ea242abd896,11,0,796,1043,605,368,580,595,656,635,615,765,815,822,818,801,7,50,-43
502,210000,fde95ea242abd896,11,0,460,600,253,193,341,357,363,293,369,581,567,618,592,589,51,-14,65
225,500000,fde95ea242abd896,11,0,222,229,139,105,116,140,127,159,132,163,253,237,245,218,-16,90,-106
178,610000,fde95ea242abd896,11,0,229,293,140,96,140,126,155,135,199,252,297,330,314,293,33,45,-12
239,230000,fde95ea242abd896,11,0,199,322,111,123,264,218,232,182,233,390,264,192,228,282,-72,-126,54
377,310000,97f15de12cfabbd5,11,0,457,516,264,193,369,368,312,223,311,325,374,342,358,347,-32,49,-81
130,530000,97f15de12cfabbd5,11,0,233,253,206,111,144,116,120,119,120,92,116,114,115,107,-2,24,-26
210,150000,97f15de12cfabbd5,11,0,200,238,219,114,172,145,184,185,176,175,180,177,178,177,-3,5,-8
628,110000,97f15de12cfabbd5,11,0,754,1094,601,390,482,397,375,385,359,390,493,438,466,440,-55,103,-158
331,510000,97f15de12cfabbd5,11,0,489,543,391,237,325,296,251,270,231,353,472,247,360,357,-225,119,-344
283,340000,97f15de12cfabbd5,11,0,568,578,495,153,185,233,254,279,190,233,316,289,302,279,-27,83,-110
988,370000,97f15de12cfabbd5,11,0,1094,1221,1031,476,846,727,791,753,709,746,888,910,899,848,22,142,-120
376,140000,97f15de12cfabbd5,11,0,395,605,316,221,369,335,297,249,379,331,458,381,420,390,-77,127,-204
2999,440000,97f15de12cfabbd5,11,0,3563,3747,2666,1125,2377,2460,2143,2250,2148,2251,2790,2698,2744,2580,-92,539,-631
131,450000,97f15de12cfabbd5,11,0,194,174,193,92,119,101,114,104,103,130,136,127,132,131,-9,6,-15
1098,320000,97f15de12cfabbd5,11,0,1491,1524,1070,552,1008,901,895,803,803,813,980,1039,1010,944,59,167,-108
216,360000,97f15de12cfabbd5,11,0,340,409,346,81,166,179,201,165,187,208,207,235,221,217,28,-1,29
973,130000,97f15de12cfabbd5,11,0,971,1119,789,422,734,762,790,652,806,800,941,861,901,867,-80,141,-221
591,410000,97f15de12cfabbd5,11,0,805,866,692,326,488,531,450,448,469,417,510,471,490,466,-39,93,-132
1557,330000,97f15de12cfabbd5,11,0,1516,1515,1138,549,969,1010,1108,1385,1507,1239,1522,1512,1517,1424,-10,283,-293
482,420000,97f15de12cfabbd5,11,0,779,906,749,253,446,434,381,436,412,489,521,449,485,486,-72,32,-104
452,430000,97f15de12cfabbd5,11,0,767,839,710,238,437,402,430,431,398,373,459,387,423,406,-72,86,-158
513,350000,97f15de12cfabbd5,11,0,612,638,509,288,542,508,519,527,327,322,360,452,406,378,92,38,54
1106,210000,97f15de12cfabbd5,11,0,1269,1395,898,506,962,872,971,851,914,875,950,831,890,885,-119,75,-194
162,500000,97f15de12cfabbd5,11,0,200,213,159,106,164,130,104,160,133,125,141,144,142,137,3,16,-13
237,610000,97f15de12cfabbd5,11,0,309,371,227,159,225,195,179,129,173,160,195,208,202,188,13,35,-22
571,230000,97f15de12cfabbd5,11,0,639,783,366,217,537,358,448,306,533,522,375,424,400,440,49,-147,196
317,310000,f5d69960089c3614,11,0,304,291,260,125,252,169,218,208,195,239,288,307,298,278,19,49,-30
89,530000,f5d69960089c3614,11,0,97,95,78,48,59,48,61,43,79,64,53,60,56,59,7,-11,18
60,150000,f5d69960089c3614,11,0,54,64,35,18,51,53,69,55,61,64,72,82,77,73,10,8,2
408,110000,f5d69960089c3614,11,0,551,739,435,233,445,341,391,396,426,482,578,448,513,503,-130,96,-226
312,510000,f5d69960089c3614,11,0,246,296,270,133,178,212,190,231,208,233,444,241,342,306,-203,211,-414
107,340000,f5d69960089c3614,11,0,125,125,156,59,89,69,81,70,72,75,150,124,137,116,-26,75,-101
263,370000,f5d69960089c3614,11,0,228,356,218,112,223,197,226,179,193,249,344,254,299,282,-90,95,-185
41,140000,f5d69960089c3614,11,0,53,51,47,21,35,29,43,35,45,44,57,33,45,45,-24,13,-37
433,440000,f5d69960089c3614,11,0,442,572,437,152,310,246,338,497,305,362,444,473,458,426,29,82,-53
57,450000,f5d69960089c3614,11,0,38,46,44,34,25,32,38,35,50,44,68,69,68,60,1,24,-23
232,320000,f5d69960089c3614,11,0,248,301,251,138,200,177,214,189,187,223,290,301,296,271,11,67,-56
76,360000,f5d69960089c3614,11,0,75,92,84,32,51,53,76,51,70,67,97,77,87,80,-20,30,-50
139,130000,f5d69960089c3614,11,0,123,131,106,79,112,113,144,111,129,162,213,174,194,183,-39,51,-90
129,410000,f5d69960089c3614,11,0,144,187,131,57,111,155,108,118,135,163,164,158,161,162,-6,1,-7
127,330000,f5d69960089c3614,11,0,149,230,149,78,139,107,108,142,110,130,142,139,140,137,-3,12,-15
138,420000,f5d69960089c3614,11,0,148,184,148,61,111,94,101,110,110,157,162,143,152,154,-19,5,-24
157,430000,f5d69960089c3614,11,0,157,211,135,74,132,109,108,118,96,135,209,137,173,160,-72,74,-146
111,350000,f5d69960089c3614,11,0,111,124,108,57,77,71,97,95,75,85,112,118,115,105,6,27,-21
141,210000,f5d69960089c3614,11,0,126,129,69,51,75,76,107,67,96,152,173,146,160,157,-27,21,-48
145,500000,f5d69960089c3614,11,0,132,160,125,77,112,97,87,149,112,142,157,158,158,152,1,15,-14
152,610000,f5d69960089c3614,11,0,150,182,148,77,137,111,172,117,112,144,202,224,213,190,22,58,-36
68,230000,f5d69960089c3614,11,0,71,77,53,34,68,53,50,51,50,100,75,78,76,84,3,-25,28
143,310000,5b1c11c3efed5312,11,0,244,388,154,85,126,92,105,104,90,95,93,83,88,90,-10,-2,-8
97,530000,5b1c11c3efed5312,11,0,214,267,194,91,60,53,77,69,54,60,68,102,85,77,34,8,26
52,150000,5b1c11c3efed5312,11,0,167,259,127,62,61,62,68,40,53,87,64,46,55,66,-18,-23,5
23,110000,5b1c11c3efed5312,11,0,181,370,71,41,51,25,21,23,21,16,13,11,12,13,-2,-3,1
173,510000,5b1c11c3efed5312,11,0,432,691,448,194,129,110,118,105,113,152,138,140,139,143,2,-14,16
381,340000,5b1c11c3efed5312,11,0,699,1253,712,250,227,217,259,222,209,229,284,331,308,281,47,55,-8
438,370000,5b1c11c3efed5312,11,0,792,1449,549,320,297,347,332,246,290,297,412,443,428,384,31,115,-84
97,140000,5b1c11c3efed5312,11,0,231,426,153,81,103,83,114,108,86,92,80,88,84,87,8,-12,20
535,440000,5b1c11c3efed5312,11,0,1204,1628,496,168,342,246,344,349,247,271,470,547,508,429,77,199,-122
67,450000,5b1c11c3efed5312,11,0,135,240,121,56,54,26,39,23,31,45,41,46,44,44,5,-4,9
640,320000,5b1c11c3efed5312,11,0,1083,1908,768,543,404,402,487,371,340,347,446,468,457,420,22,99,-77
313,360000,5b1c11c3efed5312,11,0,434,733,453,153,150,168,191,126,131,163,222,258,240,214,36,59,-23
304,130000,5b1c11c3efed5312,11,0,667,1158,476,272,257,300,350,276,304,321,274,306,290,300,32,-47,79
489,410000,5b1c11c3efed5312,11,0,1006,1883,910,372,312,380,366,295,321,290,401,454,428,382,53,111,-58
779,330000,5b1c11c3efed5312,11,0,1202,2202,744,430,386,337,361,407,360,410,487,673,580,523,186,77,109
265,420000,5b1c11c3efed5312,11,0,409,749,443,143,138,130,145,146,117,118,165,198,182,160,33,47,-14
193,430000,5b1c11c3efed5312,11,0,439,744,378,131,137,149,138,134,113,150,189,192,190,177,3,39,-36
178,350000,5b1c11c3efed5312,11,0,391,594,265,149,173,130,137,127,100,127,140,178,159,148,38,13,25
54,210000,5b1c11c3efed5312,11,0,186,256,75,62,80,75,84,47,39,66,55,56,56,59,1,-11,12
32,500000,5b1c11c3efed5312,11,0,92,172,124,38,29,23,20,27,17,21,36,14,25,24,-22,15,-37
63,610000,5b1c11c3efed5312,11,0,212,325,144,79,70,64,97,57,67,82,80,101,90,88,21,-2,23
42,230000,5b1c11c3efed5312,11,0,126,152,43,36,52,38,43,41,34,44,43,32,38,40,-11,-1,-10
21,310000,17363f08d683d52b,11,0,88,96,65,19,37,175,5,12,7,8,136,3,70,49,-133,128,-261
58,530000,17363f08d683d52b,11,0,209,182,216,75,82,86,83,57,67,66,46,65,56,59,19,-20,39
29,150000,17363f08d683d52b,11,0,130,141,132,46,66,45,69,41,38,46,34,32,33,37,-2,-12,10
26,110000,17363f08d683d52b,11,0,186,277,124,81,65,48,29,26,33,15,60,11,36,29,-49,45,-94
88,510000,17363f08d683d52b,11,0,205,292,350,117,93,78,81,64,97,44,63,63,63,57,0,19,-19
193,340000,17363f08d683d52b,11,0,341,384,513,121,108,92,90,118,107,99,88,111,100,99,23,-11,34
468,370000,17363f08d683d52b,11,0,480,596,555,214,153,209,203,175,145,127,346,326,336,266,-20,219,-239
16,140000,17363f08d683d52b,11,0,70,67,66,26,12,22,19,12,23,3,3,7,5,4,4,0,4
30,440000,17363f08d683d52b,11,0,101,84,62,19,63,37,30,29,26,25,17,16,16,19,-1,-8,7
15,450000,17363f08d683d52b,11,0,39,50,45,14,26,20,6,2,8,5,11,8,10,8,-3,6,-9
328,320000,17363f08d683d52b,11,0,474,569,538,214,216,188,191,134,129,86,151,201,176,146,50,65,-15
105,360000,17363f08d683d52b,11,0,274,309,360,94,101,91,90,79,82,62,58,77,68,66,19,-4,23
209,130000,17363f08d683d52b,11,0,326,383,353,154,150,162,149,131,144,91,180,201,190,157,21,89,-68
258,410000,17363f08d683d52b,11,0,372,457,538,139,100,129,104,87,70,63,93,117,105,91,24,30,-6
360,330000,17363f08d683d52b,11,0,429,453,388,129,152,151,108,106,91,89,167,264,216,173,97,78,19
178,420000,17363f08d683d52b,11,0,317,421,474,120,139,119,158,186,109,65,89,106,98,87,17,24,-7
282,430000,17363f08d683d52b,11,0,348,428,459,95,148,114,114,115,100,92,163,156,160,137,-7,71,-78
50,350000,17363f08d683d52b,11,0,127,159,136,38,44,37,55,51,15,28,29,27,28,28,-2,1,-3
71,210000,17363f08d683d52b,11,0,174,238,151,59,93,137,105,53,60,48,51,55,53,51,4,3,1
10,500000,17363f08d683d52b,11,0,151,126,110,41,27,16,19,16,22,15,14,6,10,12,-8,-1,-7
74,610000,17363f08d683d52b,11,0,210,288,180,80,67,82,94,70,81,86,60,43,52,63,-17,-26,9
51,230000,17363f08d683d52b,11,0,118,156,75,46,57,45,34,22,28,31,17,28,22,25,11,-14,25
407,310000,06880909932890ca,11,0,341,384,208,78,136,169,219,267,195,272,379,301,340,317,-78,107,-185
120,530000,06880909932890ca,11,0,186,206,142,56,68,79,116,111,106,126,142,139,140,136,-3,16,-19
55,150000,06880909932890ca,11,0,125,115,74,44,45,52,72,39,48,70,69,60,64,66,-9,-1,-8
213,110000,06880909932890ca,11,0,553,771,253,139,206,162,160,198,159,181,170,152,161,168,-18,-11,-7
730,510000,06880909932890ca,11,0,657,933,673,263,243,304,396,459,464,505,768,629,698,634,-139,263,-402
659,340000,06880909932890ca,11,0,764,993,964,338,340,389,526,609,640,679,780,759,770,739,-21,101,-122
749,370000,06880909932890ca,11,0,957,1332,1011,383,430,537,623,546,597,690,912,884,898,829,-28,222,-250
151,140000,06880909932890ca,11,0,203,275,128,67,102,111,136,137,121,130,151,145,148,142,-6,21,-27
1385,440000,06880909932890ca,11,0,1660,1546,767,278,638,579,734,773,669,732,1150,1234,1192,1039,84,418,-334
199,450000,06880909932890ca,11,0,188,276,186,86,105,86,125,135,129,121,150,190,170,154,40,29,11
2157,320000,06880909932890ca,11,0,2022,2642,2094,991,984,1074,1356,1448,1465,1619,1956,2009,1982,1861,53,337,-284
502,360000,06880909932890ca,11,0,453,691,614,157,211,274,326,317,295,445,614,519,566,526,-95,169,-264
510,130000,06880909932890ca,11,0,667,773,530,290,330,342,436,385,393,514,507,523,515,515,16,-7,23
1428,410000,06880909932890ca,11,0,1577,2409,1865,640,650,891,1055,1267,1138,1176,1439,1566,1502,1394,127,263,-136
1730,330000,06880909932890ca,11,0,1832,2222,1022,501,663,715,913,1088,1232,1489,1624,1714,1669,1609,90,135,-45
510,420000,06880909932890ca,11,0,492,661,605,178,211,256,312,333,394,414,526,562,544,501,36,112,-76
509,430000,06880909932890ca,11,0,547,698,488,170,228,287,352,372,388,447,540,497,518,495,-43,93,-136
538,350000,06880909932890ca,11,0,556,601,361,197,246,246,307,332,263,303,408,504,456,405,96,105,-9
212,210000,06880909932890ca,11,0,211,328,161,100,120,120,168,137,149,154,182,162,172,166,-20,28,-48
391,500000,06880909932890ca,11,0,373,430,326,140,158,145,189,295,272,251,352,358,355,320,6,101,-95
242,610000,06880909932890ca,11,0,347,562,349,119,145,167,210,170,185,229,259,243,251,244,-16,30,-46
216,230000,06880909932890ca,11,0,97,100,69,37,53,48,62,47,72,53,77,99,88,76,22,24,-2
53,310000,9c1c7ee8ebdda299,11,0,41,46,32,19,54,17,10,12,11,6,11,22,16,13,11,5,6
204,530000,9c1c7ee8ebdda299,11,0,119,169,142,104,91,53,62,66,54,100,120,234,177,151,114,20,94
334,150000,9c1c7ee8ebdda299,11,0,353,430,278,168,258,163,176,174,153,161,172,446,309,260,274,11,263
42,110000,9c1c7ee8ebdda299,11,0,78,112,52,38,30,13,7,12,11,3,21,34,28,19,13,18,-5
454,510000,9c1c7ee8ebdda299,11,0,517,641,617,336,250,134,145,143,161,174,211,648,430,344,437,37,400
313,340000,9c1c7ee8ebdda299,11,0,198,190,278,146,119,59,72,88,63,82,153,349,251,195,196,71,125
1169,370000,9c1c7ee8ebdda299,11,0,1562,2281,1763,885,746,509,752,650,656,635,554,1575,1064,921,1021,-81,1102
768,140000,9c1c7ee8ebdda299,11,0,768,886,691,295,401,285,317,252,283,337,321,1057,689,572,736,-16,752
430,440000,9c1c7ee8ebdda299,11,0,710,1008,472,229,471,212,177,139,130,131,160,443,302,245,283,29,254
278,450000,9c1c7ee8ebdda299,11,0,192,308,251,110,119,55,137,102,134,127,148,260,204,178,112,21,91
373,320000,9c1c7ee8ebdda299,11,0,307,309,370,299,211,106,111,126,119,95,124,351,238,190,227,29,198
174,360000,9c1c7ee8ebdda299,11,0,177,182,224,84,107,42,42,52,41,45,96,201,148,114,105,51,54
1482,130000,9c1c7ee8ebdda299,11,0,1644,1840,1468,940,941,733,782,635,713,852,807,2258,1532,1306,1451,-45,1496
743,410000,9c1c7ee8ebdda299,11,0,774,911,1101,433,362,211,283,281,280,284,399,1114,756,599,715,115,600
546,330000,9c1c7ee8ebdda299,11,0,380,352,327,197,195,168,241,204,240,223,277,513,395,338,236,54,182
179,420000,9c1c7ee8ebdda299,11,0,116,125,211,58,65,32,39,46,41,44,51,166,108,87,115,7,108
357,430000,9c1c7ee8ebdda299,11,0,141,165,230,105,87,42,50,62,55,47,92,309,200,149,217,45,172
305,350000,9c1c7ee8ebdda299,11,0,281,215,204,105,130,66,70,71,48,58,86,260,173,135,174,28,146
776,210000,9c1c7ee8ebdda299,11,0,528,619,375,317,409,425,215,168,173,244,317,715,516,425,398,73,325
121,500000,9c1c7ee8ebdda299,11,0,80,104,116,61,54,25,34,33,27,26,25,81,53,44,56,-1,57
274,610000,9c1c7ee8ebdda299,11,0,214,250,261,108,136,75,123,125,148,123,127,394,260,215,267,4,263
647,230000,9c1c7ee8ebdda299,11,0,350,342,207,144,192,137,117,137,97,118,219,569,394,302,350,101,249
433,310000,c6833cb891626c17,11,0,435,596,174,80,151,177,200,272,204,286,381,357,369,341,-24,95,-119
298,530000,c6833cb891626c17,11,0,538,699,444,236,185,176,241,235,239,233,242,311,276,262,69,9,60
221,150000,c6833cb891626c17,11,0,323,485,221,94,125,138,233,182,202,244,226,285,256,252,59,-18,77
331,110000,c6833cb891626c17,11,0,879,1517,309,174,289,242,251,279,287,271,285,203,244,253,-82,14,-96
497,510000,c6833cb891626c17,11,0,770,1305,743,339,285,287,359,363,364,444,612,527,570,528,-85,168,-253
889,340000,c6833cb891626c17,11,0,964,1597,855,344,344,422,524,660,677,843,847,868,858,853,21,4,17
827,370000,c6833cb891626c17,11,0,1107,1740,687,383,327,543,829,670,841,808,972,862,917,881,-110,164,-274
256,140000,c6833cb891626c17,11,0,301,514,192,100,117,126,207,172,186,212,232,248,240,231,16,20,-4
938,440000,c6833cb891626c17,11,0,1586,1899,542,186,403,360,460,604,483,479,704,825,764,669,121,225,-104
155,450000,c6833cb891626c17,11,0,309,514,260,96,110,81,120,111,123,118,114,164,139,132,50,-4,54
1192,320000,c6833cb891626c17,11,0,1446,2279,939,574,593,645,899,941,918,876,1073,1193,1133,1047,120,197,-77
653,360000,c6833cb891626c17,11,0,571,900,502,180,199,229,302,289,342,439,577,631,604,549,54,138,-84
978,130000,c6833cb891626c17,11,0,1108,1749,708,414,412,600,843,768,843,1013,870,860,865,914,-10,-143,133
1246,410000,c6833cb891626c17,11,0,1622,2735,1331,509,557,792,1003,1139,1208,1046,1173,1225,1199,1148,52,127,-75
1878,330000,c6833cb891626c17,11,0,2130,3255,1119,581,616,676,899,1179,1212,1449,1568,1840,1704,1619,272,119,153
609,420000,c6833cb891626c17,11,0,634,1014,597,202,210,256,309,467,354,417,541,558,550,505,17,124,-107
537,430000,c6833cb891626c17,11,0,606,978,498,212,209,272,280,287,311,368,495,434,464,432,-61,127,-188
357,350000,c6833cb891626c17,11,0,552,782,311,141,184,131,214,223,160,193,287,353,320,278,66,94,-28
199,210000,c6833cb891626c17,11,0,258,424,127,80,97,131,161,165,176,170,202,187,194,186,-15,32,-47
257,500000,c6833cb891626c17,11,0,309,532,260,104,78,93,126,161,148,159,170,178,174,169,8,11,-3
379,610000,c6833cb891626c17,11,0,366,620,315,130,154,179,263,204,263,363,295,450,372,369,155,-68,223
154,230000,c6833cb891626c17,11,0,232,274,80,52,66,71,97,87,91,116,90,100,95,102,10,-26,36
154,310000,3e21824be728cbec,11,0,345,396,369,177,174,163,140,140,130,154,202,176,189,177,-26,48,-74
218,530000,3e21824be728cbec,11,0,373,334,203,134,207,159,159,199,202,227,215,226,220,223,11,-12,23
45,150000,3e21824be728cbec,11,0,59,90,51,29,42,27,40,31,39,40,40,103,72,61,63,0,63
53,110000,3e21824be728cbec,11,0,222,242,93,60,87,42,47,47,40,41,55,59,57,52,4,14,-10
398,510000,3e21824be728cbec,11,0,778,781,288,239,321,272,333,406,352,417,499,361,430,426,-138,82,-220
310,340000,3e21824be728cbec,11,0,607,661,309,266,301,237,309,289,297,345,293,432,362,357,139,-52,191
469,370000,3e21824be728cbec,11,0,782,994,540,419,572,464,433,395,383,432,535,703,619,557,168,103,65
83,140000,3e21824be728cbec,11,0,132,201,88,44,87,60,67,72,87,105,82,107,94,98,25,-23,48
525,440000,3e21824be728cbec,11,0,938,1135,331,231,477,411,394,418,380,461,499,508,504,489,9,38,-29
183,450000,3e21824be728cbec,11,0,370,403,140,92,140,131,131,161,121,124,149,158,154,144,9,25,-16
856,320000,3e21824be728cbec,11,0,1286,1781,805,710,885,641,740,693,656,701,768,937,852,802,169,67,102
240,360000,3e21824be728cbec,11,0,444,431,157,97,173,170,210,195,175,219,261,224,242,235,-37,42,-79
481,130000,3e21824be728cbec,11,0,589,806,391,375,484,404,455,438,404,455,455,703,579,538,248,0,248
459,410000,3e21824be728cbec,11,0,729,896,363,334,528,418,445,554,381,446,510,591,550,516,81,64,17
543,330000,3e21824be728cbec,11,0,797,1044,341,386,475,363,466,458,443,473,505,595,550,524,90,32,58
232,420000,3e21824be728cbec,11,0,413,461,270,123,194,119,150,177,181,200,192,242,217,211,50,-8,58
207,430000,3e21824be728cbec,11,0,458,478,157,99,182,167,188,184,200,195,251,207,229,218,-44,56,-100
273,350000,3e21824be728cbec,11,0,455,593,250,154,266,219,283,228,214,225,227,321,274,258,94,2,92
104,210000,3e21824be728cbec,11,0,136,149,45,36,75,66,76,84,71,67,64,113,88,81,49,-3,52
162,500000,3e21824be728cbec,11,0,422,475,136,124,148,136,160,225,137,123,161,136,148,140,-25,38,-63
174,610000,3e21824be728cbec,11,0,355,464,194,145,188,141,176,186,164,204,187,239,213,210,52,-17,69
78,230000,3e21824be728cbec,11,0,82,87,40,47,82,54,34,48,39,38,37,82,60,52,45,-1,46
419,310000,f8a6975573af1b33,11,0,228,579,371,131,288,266,225,283,286,352,425,361,393,379,-64,73,-137
266,530000,f8a6975573af1b33,11,0,165,338,215,134,179,192,167,169,217,170,285,214,250,223,-71,115,-186
51,150000,f8a6975573af1b33,11,0,43,48,41,28,59,37,53,61,54,60,50,57,54,56,7,-10,17
102,110000,f8a6975573af1b33,11,0,372,383,131,61,110,108,70,103,89,94,106,75,90,92,-31,12,-43
689,510000,f8a6975573af1b33,11,0,484,820,550,286,428,433,456,497,476,571,730,570,650,624,-160,159,-319
661,340000,f8a6975573af1b33,11,0,362,758,508,322,432,425,545,563,499,558,654,651,652,621,-3,96,-99
535,370000,f8a6975573af1b33,11,0,383,729,410,227,320,381,388,394,345,413,508,427,468,449,-81,95,-176
70,140000,f8a6975573af1b33,11,0,91,136,74,57,53,62,47,59,62,56,65,82,74,68,17,9,8
1711,440000,f8a6975573af1b33,11,0,1034,2232,1023,444,1072,1007,969,1190,954,1225,1539,1459,1499,1408,-80,314,-394
253,450000,f8a6975573af1b33,11,0,191,328,208,107,160,131,178,209,223,211,264,238,251,238,-26,53,-79
1350,320000,f8a6975573af1b33,11,0,807,1846,1142,747,1023,870,969,1040,1045,1132,1384,1302,1343,1273,-82,252,-334
384,360000,f8a6975573af1b33,11,0,131,436,290,111,237,235,226,237,243,304,361,365,363,343,4,57,-53
474,130000,f8a6975573af1b33,11,0,272,475,287,194,265,298,335,339,355,444,469,418,444,444,-51,25,-76
638,410000,f8a6975573af1b33,11,0,420,747,459,249,457,513,513,571,508,547,706,610,658,621,-96,159,-255
1225,330000,f8a6975573af1b33,11,0,695,1454,752,503,780,679,725,759,836,1202,1060,1245,1152,1169,185,-142,327
482,420000,f8a6975573af1b33,11,0,190,481,312,158,246,258,251,428,347,390,481,444,462,438,-37,91,-128
445,430000,f8a6975573af1b33,11,0,235,425,324,139,263,238,293,308,308,344,467,351,409,387,-116,123,-239
645,350000,f8a6975573af1b33,11,0,415,699,508,260,395,323,426,506,406,485,547,533,540,522,-14,62,-76
134,210000,f8a6975573af1b33,11,0,64,125,66,52,82,116,125,102,110,143,125,94,110,121,-31,-18,-13
322,500000,f8a6975573af1b33,11,0,256,548,310,185,288,287,285,378,280,285,380,307,344,324,-73,95,-168
179,610000,f8a6975573af1b33,11,0,181,259,170,96,124,121,134,165,167,184,227,205,216,205,-22,43,-65
78,230000,f8a6975573af1b33,11,0,65,115,61,52,76,85,53,52,53,68,53,58,56,60,5,-15,20
312,310000,54fc07138d70374c,11,0,421,473,415,199,338,303,272,297,230,306,310,217,264,278,-93,4,-97
309,530000,54fc07138d70374c,11,0,485,535,500,259,353,295,304,293,320,299,296,284,290,293,-12,-3,-9
181,150000,54fc07138d70374c,11,0,229,234,273,129,208,180,191,167,194,197,191,163,177,184,-28,-6,-22
419,110000,54fc07138d70374c,11,0,500,681,534,295,402,398,365,374,341,360,397,323,360,360,-74,37,-111
533,510000,54fc07138d70374c,11,0,743,849,933,442,540,493,508,553,476,460,610,426,518,499,-184,150,-334
197,340000,54fc07138d70374c,11,0,334,368,404,198,210,162,176,206,197,185,206,181,194,191,-25,21,-46
566,370000,54fc07138d70374c,11,0,776,936,911,376,595,546,558,596,483,522,642,489,566,551,-153,120,-273
151,140000,54fc07138d70374c,11,0,208,244,213,113,141,101,103,104,107,143,141,135,138,140,-6,-2,-4
1118,440000,54fc07138d70374c,11,0,1836,2078,1526,521,1068,875,905,1067,825,969,1188,973,1080,1043,-215,219,-434
153,450000,54fc07138d70374c,11,0,246,317,323,145,236,156,189,166,140,172,167,131,149,157,-36,-5,-31
501,320000,54fc07138d70374c,11,0,847,820,821,461,589,458,423,545,436,500,549,440,494,496,-109,49,-158
130,360000,54fc07138d70374c,11,0,249,262,297,113,164,151,133,139,150,149,170,140,155,153,-30,21,-51
480,130000,54fc07138d70374c,11,0,746,750,758,431,483,470,474,415,495,501,519,421,470,480,-98,18,-116
448,410000,54fc07138d70374c,11,0,752,820,826,447,615,567,493,543,423,493,437,366,402,432,-71,-56,-15
355,330000,54fc07138d70374c,11,0,623,684,550,252,401,254,311,325,307,322,340,344,342,335,4,18,-14
247,420000,54fc07138d70374c,11,0,385,425,481,197,299,246,238,274,238,273,295,246,270,271,-49,22,-71
338,430000,54fc07138d70374c,11,0,460,493,505,239,383,321,315,341,325,336,378,286,332,333,-92,42,-134
141,350000,54fc07138d70374c,11,0,329,338,400,163,217,128,161,123,141,139,151,131,141,140,-20,12,-32
202,210000,54fc07138d70374c,11,0,369,450,249,117,274,320,298,258,236,274,251,198,224,241,-53,-23,-30
289,500000,54fc07138d70374c,11,0,540,575,576,284,403,314,306,439,296,285,331,263,297,293,-68,46,-114
225,610000,54fc07138d70374c,11,0,346,404,376,178,272,285,266,201,203,229,236,216,226,227,-20,7,-27
262,230000,54fc07138d70374c,11,0,341,410,324,206,341,242,239,273,292,251,258,237,248,249,-21,7,-28
289,310000,212083a9246d2fd3,11,0,636,846,241,179,180,191,192,253,247,261,249,228,238,246,-21,-12,-9
390,530000,212083a9246d2fd3,11,0,365,493,290,145,117,124,158,128,183,166,200,277,238,214,77,34,43
181,150000,212083a9246d2fd3,11,0,310,562,284,123,119,71,119,101,97,110,137,180,158,142,43,27,16
133,110000,212083a9246d2fd3,11,0,444,824,105,71,55,60,50,59,51,57,65,85,75,69,20,8,12
820,510000,212083a9246d2fd3,11,0,1080,1730,983,504,400,394,380,436,516,607,641,550,596,599,-91,34,-125
1281,340000,212083a9246d2fd3,11,0,1260,2243,1186,528,593,566,477,521,594,770,1036,1137,1086,981,101,266,-165
1155,370000,212083a9246d2fd3,11,0,1637,2998,1261,553,503,551,645,651,724,836,994,1041,1018,957,47,158,-111
315,140000,212083a9246d2fd3,11,0,372,645,313,178,140,164,178,173,195,230,273,274,274,259,1,43,-42
1092,440000,212083a9246d2fd3,11,0,1967,3191,905,337,855,959,831,614,794,1007,844,769,806,873,-75,-163,88
466,450000,212083a9246d2fd3,11,0,337,697,471,179,227,188,213,224,204,252,332,309,320,298,-23,80,-103
1300,320000,212083a9246d2fd3,11,0,2283,3836,1631,972,777,763,993,802,889,897,976,1122,1049,998,146,79,67
472,360000,212083a9246d2fd3,11,0,676,1270,658,229,229,221,283,227,273,344,417,442,430,401,25,73,-48
859,130000,212083a9246d2fd3,11,0,1064,2232,950,551,442,578,697,555,544,666,625,757,691,683,132,-41,173
1872,410000,212083a9246d2fd3,11,0,1720,3243,1894,828,807,1011,1085,1013,1189,1300,1393,1655,1524,1449,262,93,169
798,330000,212083a9246d2fd3,11,0,1205,1850,574,328,328,361,426,423,467,565,573,676,624,605,103,8,95
406,420000,212083a9246d2fd3,11,0,866,1354,755,244,256,243,222,247,223,230,310,348,329,296,38,80,-42
904,430000,212083a9246d2fd3,11,0,982,1756,938,322,403,371,448,412,466,511,628,666,647,602,38,117,-79
576,350000,212083a9246d2fd3,11,0,746,1041,462,182,250,215,304,238,233,338,522,511,516,457,-11,184,-195
205,210000,212083a9246d2fd3,11,0,422,561,181,92,144,178,144,111,123,123,146,152,149,140,6,23,-17
420,500000,212083a9246d2fd3,11,0,643,1136,557,231,195,203,189,260,190,212,306,281,294,266,-25,94,-119
759,610000,212083a9246d2fd3,11,0,805,1567,639,298,275,310,369,282,381,491,525,649,587,555,124,34,90
145,230000,212083a9246d2fd3,11,0,207,305,102,62,72,62,93,71,101,93,80,111,96,95,31,-13,44
30,310000,4f79773e600518a6,11,0,139,159,95,31,32,33,18,19,21,31,33,32,32,32,-1,2,-3
74,530000,4f79773e600518a6,11,0,116,195,181,91,58,50,67,48,56,60,70,109,90,80,39,10,29
176,150000,4f79773e600518a6,11,0,227,336,327,113,110,91,126,86,83,105,142,150,146,132,8,37,-29
23,110000,4f79773e600518a6,11,0,153,246,99,35,29,28,28,17,19,21,32,18,25,24,-14,11,-25
88,510000,4f79773e600518a6,11,0,267,387,398,155,108,95,80,69,76,114,107,93,100,105,-14,-7,-7
153,340000,4f79773e600518a6,11,0,301,471,484,121,103,101,118,103,101,112,137,149,143,133,12,25,-13
361,370000,4f79773e600518a6,11,0,591,961,723,263,300,312,311,242,273,332,372,387,380,364,15,40,-25
100,140000,4f79773e600518a6,11,0,133,167,149,66,59,57,51,58,45,92,92,77,84,87,-15,0,-15
58,440000,4f79773e600518a6,11,0,134,176,97,19,44,38,31,35,30,38,44,35,40,39,-9,6,-15
23,450000,4f79773e600518a6,11,0,52,62,66,20,31,15,25,9,23,18,12,17,14,16,5,-6,11
107,320000,4f79773e600518a6,11,0,312,450,333,168,137,94,101,95,97,80,87,93,90,87,6,7,-1
99,360000,4f79773e600518a6,11,0,164,252,264,69,58,63,82,66,58,86,106,109,108,100,3,20,-17
195,130000,4f79773e600518a6,11,0,338,473,362,182,165,226,205,142,157,221,184,175,180,193,-9,-37,28
297,410000,4f79773e600518a6,11,0,535,679,669,213,223,212,206,190,239,237,292,323,308,284,31,55,-24
50,330000,4f79773e600518a6,11,0,161,255,131,59,54,69,64,57,47,53,54,59,56,55,5,1,4
148,420000,4f79773e600518a6,11,0,278,385,450,105,110,104,89,90,81,127,134,149,142,137,15,7,8
451,430000,4f79773e600518a6,11,0,533,776,857,222,262,247,257,219,243,308,415,419,417,381,4,107,-103
17,350000,4f79773e600518a6,11,0,83,65,41,21,20,20,33,19,21,25,14,25,20,21,11,-11,22
76,210000,4f79773e600518a6,11,0,129,166,109,50,66,72,45,46,43,59,62,69,66,63,7,3,4
85,500000,4f79773e600518a6,11,0,189,306,256,58,77,65,70,84,67,84,87,77,82,83,-10,3,-13
276,610000,4f79773e600518a6,11,0,381,634,493,193,190,176,193,161,204,222,237,320,278,260,83,15,68
139,230000,4f79773e600518a6,11,0,204,277,131,70,96,70,62,54,66,59,76,95,86,77,19,17,2
91,310000,fc32b1a017b34efe,11,0,211,361,138,71,95,74,75,111,81,104,108,82,95,98,-26,4,-30
467,530000,fc32b1a017b34efe,11,0,434,743,406,299,256,259,276,323,373,379,361,567,464,436,206,-18,224
513,150000,fc32b1a017b34efe,11,0,390,683,304,135,211,181,248,260,314,339,378,412,395,376,34,39,-5
160,110000,fc32b1a017b34efe,11,0,357,675,173,56,121,79,138,89,102,103,129,115,122,116,-14,26,-40
1558,510000,fc32b1a017b34efe,11,0,1318,2057,1186,681,782,644,814,979,1044,1182,1106,1202,1154,1163,96,-76,172
456,340000,fc32b1a017b34efe,11,0,493,865,574,194,213,248,307,345,317,346,361,391,376,366,30,15,15
848,370000,fc32b1a017b34efe,11,0,894,1538,723,282,412,473,536,614,680,774,720,826,773,773,106,-54,160
1000,140000,fc32b1a017b34efe,11,0,510,974,417,214,254,346,509,560,656,816,685,1059,872,853,374,-131,505
790,440000,fc32b1a017b34efe,11,0,768,1105,569,259,493,354,430,585,484,578,575,619,597,591,44,-3,47
290,450000,fc32b1a017b34efe,11,0,212,406,260,101,165,105,174,218,194,217,225,224,224,222,-1,8,-9
754,320000,fc32b1a017b34efe,11,0,786,1332,698,402,409,494,495,557,550,609,567,672,620,616,105,-42,147
389,360000,fc32b1a017b34efe,11,0,356,774,420,110,193,205,216,298,283,295,291,351,321,312,60,-4,64
1715,130000,fc32b1a017b34efe,11,0,964,2069,891,397,516,929,990,983,1137,1295,1153,1509,1331,1319,356,-142,498
1276,410000,fc32b1a017b34efe,11,0,934,1916,1026,330,387,521,645,908,946,966,847,1114,980,976,267,-119,386
528,330000,fc32b1a017b34efe,11,0,556,982,370,195,281,311,304,395,371,467,405,469,437,447,64,-62,126
353,420000,fc32b1a017b34efe,11,0,389,721,401,105,159,186,195,272,290,243,277,326,302,282,49,34,15
607,430000,fc32b1a017b34efe,11,0,687,1290,631,205,298,333,363,464,424,425,552,559,556,512,7,127,-120
231,350000,fc32b1a017b34efe,11,0,253,385,180,95,138,114,150,154,163,198,154,199,176,184,45,-44,89
219,210000,fc32b1a017b34efe,11,0,226,330,135,104,181,144,138,167,145,200,198,175,186,191,-23,-2,-21
807,500000,fc32b1a017b34efe,11,0,751,1420,661,420,464,477,481,631,557,639,617,667,642,641,50,-22,72
892,610000,fc32b1a017b34efe,11,0,639,1234,604,184,336,402,415,468,687,690,661,909,785,753,248,-29,277
232,230000,fc32b1a017b34efe,11,0,150,236,76,111,111,78,108,134,127,165,146,158,152,156,12,-19,31
390,310000,feabbf46658382b9,11,0,620,805,357,95,198,187,218,252,286,379,461,354,408,398,-107,82,-189
965,530000,feabbf46658382b9,11,0,921,1249,829,418,522,444,470,542,766,801,741,996,868,846,255,-60,315
960,150000,feabbf46658382b9,11,0,675,925,601,288,415,322,461,499,595,688,789,875,832,784,86,101,-15
368,110000,feabbf46658382b9,11,0,779,1421,437,212,313,278,276,253,302,320,338,287,312,315,-51,18,-69
1869,510000,feabbf46658382b9,11,0,1861,2915,2183,903,1084,938,1042,1247,1538,1846,1788,1737,1762,1790,-51,-58,7
765,340000,feabbf46658382b9,11,0,934,1307,1141,304,330,322,356,545,585,712,755,739,747,735,-16,43,-59
1183,370000,feabbf46658382b9,11,0,1192,1610,1006,389,569,611,624,776,1014,1189,1170,1211,1190,1190,41,-19,60
658,140000,feabbf46658382b9,11,0,601,970,406,198,368,305,370,503,552,733,652,718,685,701,66,-81,147
1989,440000,feabbf46658382b9,11,0,1902,2685,1203,341,825,879,785,1142,1134,1550,1490,1748,1619,1596,258,-60,318
417,450000,feabbf46658382b9,11,0,440,665,433,149,235,168,197,226,296,330,369,365,367,355,-4,39,-43
2033,320000,feabbf46658382b9,11,0,1955,2752,1481,650,861,854,961,1280,1420,1671,1770,1868,1819,1770,98,99,-1
514,360000,feabbf46658382b9,11,0,511,802,624,159,229,268,266,354,440,475,407,474,440,452,67,-68,135
1629,130000,feabbf46658382b9,11,0,1021,1551,970,478,608,767,810,890,1254,1423,1432,1560,1496,1472,128,9,119
1912,410000,feabbf46658382b9,11,0,1530,2696,1928,502,672,701,850,1415,1787,1789,1724,2048,1886,1854,324,-65,389
1925,330000,feabbf46658382b9,11,0,1499,2124,704,292,530,641,696,932,1254,1486,1797,1857,1827,1713,60,311,-251
696,420000,feabbf46658382b9,11,0,794,1252,837,201,313,330,347,462,609,643,609,716,662,656,107,-34,141
1187,430000,feabbf46658382b9,11,0,1478,2360,1657,503,671,579,591,827,934,1043,1138,1066,1102,1082,-72,95,-167
626,350000,feabbf46658382b9,11,0,601,698,428,129,211,219,281,359,378,470,543,521,532,511,-22,73,-95
309,210000,feabbf46658382b9,11,0,361,459,235,125,226,187,250,248,334,351,316,290,303,319,-26,-35,9
1445,500000,feabbf46658382b9,11,0,1581,2727,1846,758,896,740,908,1151,1313,1405,1572,1555,1564,1511,-17,167,-184
967,610000,feabbf46658382b9,11,0,896,1319,905,333,426,445,444,565,798,975,991,1110,1050,1025,119,16,103
403,230000,feabbf46658382b9,11,0,312,397,173,117,199,155,143,190,253,271,281,258,270,270,-23,10,-33
23,310000,f270f6a489c6a9d7,11,0,30,34,19,29,28,25,38,29,32,29,27,26,26,27,-1,-2,1
720,530000,f270f6a489c6a9d7,11,0,1547,1939,1680,1190,1187,815,815,786,875,755,817,1016,916,863,199,62,137
41,150000,f270f6a489c6a9d7,11,0,105,108,54,78,117,71,70,60,56,65,70,61,66,65,-9,5,-14
99,110000,f270f6a489c6a9d7,11,0,305,504,106,118,157,120,110,104,70,81,80,59,70,73,-21,-1,-20
344,510000,f270f6a489c6a9d7,11,0,773,955,603,645,678,519,472,474,468,514,523,495,509,511,-28,9,-37
115,340000,f270f6a489c6a9d7,11,0,225,272,216,223,191,165,153,149,145,130,226,119,172,158,-107,96,-203
283,370000,f270f6a489c6a9d7,11,0,636,1105,629,541,513,451,400,375,388,431,348,319,334,366,-29,-83,54
123,140000,f270f6a489c6a9d7,11,0,161,233,166,115,127,118,117,113,93,103,99,118,108,107,19,-4,23
357,440000,f270f6a489c6a9d7,11,0,713,866,346,505,757,513,503,519,390,440,464,326,395,410,-138,24,-162
18,450000,f270f6a489c6a9d7,11,0,75,97,92,50,85,53,57,36,20,17,40,26,33,28,-14,23,-37
409,320000,f270f6a489c6a9d7,11,0,871,1150,610,843,857,623,558,495,522,542,537,383,460,487,-154,-5,-149
55,360000,f270f6a489c6a9d7,11,0,117,148,132,89,105,90,70,62,87,69,109,55,82,78,-54,40,-94
517,130000,f270f6a489c6a9d7,11,0,769,983,537,616,685,621,541,500,570,609,477,446,462,511,-31,-132,101
431,410000,f270f6a489c6a9d7,11,0,952,1314,922,778,753,612,592,519,715,609,950,530,740,696,-420,341,-761
273,330000,f270f6a489c6a9d7,11,0,466,653,312,498,511,368,351,319,353,307,303,303,303,304,0,-4,4
301,420000,f270f6a489c6a9d7,11,0,590,903,514,438,482,408,403,314,306,325,383,287,335,332,-96,58,-154
210,430000,f270f6a489c6a9d7,11,0,426,575,405,314,375,353,267,377,276,257,258,207,232,241,-51,1,-52
86,350000,f270f6a489c6a9d7,11,0,175,195,85,140,157,133,146,133,94,101,94,103,98,99,9,-7,16
172,210000,f270f6a489c6a9d7,11,0,281,370,158,187,236,191,184,170,200,162,165,162,164,163,-3,3,-6
351,500000,f270f6a489c6a9d7,11,0,706,955,636,643,771,438,521,498,470,463,469,462,466,465,-7,6,-13
145,610000,f270f6a489c6a9d7,11,0,280,324,195,155,198,180,157,132,131,161,154,118,136,144,-36,-7,-29
21,230000,f270f6a489c6a9d7,11,0,76,90,35,48,67,46,41,40,28,43,38,20,29,34,-18,-5,-13
64,310000,d0f245b8781e3631,11,0,193,281,60,52,74,61,69,81,59,68,101,59,80,76,-42,33,-75
173,530000,d0f245b8781e3631,11,0,227,356,181,119,130,103,154,125,106,113,128,230,179,157,102,15,87
101,150000,d0f245b8781e3631,11,0,183,244,117,67,81,65,79,55,51,79,82,89,86,83,7,3,4
116,110000,d0f245b8781e3631,11,0,417,805,105,52,132,97,103,144,172,170,133,91,112,131,-42,-37,-5
557,510000,d0f245b8781e3631,11,0,910,1456,816,454,505,463,516,491,453,624,583,533,558,580,-50,-41,-9
229,340000,d0f245b8781e3631,11,0,287,463,251,96,133,88,118,91,110,111,129,108,118,116,-21,18,-39
280,370000,d0f245b8781e3631,11,0,738,1182,600,283,311,395,408,271,332,415,347,344,346,369,-3,-68,65
166,140000,d0f245b8781e3631,11,0,264,497,192,96,135,117,169,144,132,175,152,197,174,175,45,-23,68
378,440000,d0f245b8781e3631,11,0,615,869,297,127,271,262,258,278,238,265,297,267,282,276,-30,32,-62
128,450000,d0f245b8781e3631,11,0,233,425,254,71,136,107,135,145,104,103,124,139,132,122,15,21,-6
313,320000,d0f245b8781e3631,11,0,749,1017,461,270,342,363,373,289,260,265,382,334,358,327,-48,117,-165
118,360000,d0f245b8781e3631,11,0,198,315,211,60,84,84,68,64,78,105,104,111,108,107,7,-1,8
519,130000,d0f245b8781e3631,11,0,755,1430,754,390,398,481,498,419,459,630,477,524,500,544,47,-153,200
417,410000,d0f245b8781e3631,11,0,865,1601,892,268,371,333,363,396,440,436,415,417,416,423,2,-21,23
241,330000,d0f245b8781e3631,11,0,420,845,174,81,170,192,246,204,243,235,258,263,260,252,5,23,-18
58,420000,d0f245b8781e3631,11,0,133,246,134,39,47,55,60,48,51,63,57,69,63,63,12,-6,18
247,430000,d0f245b8781e3631,11,0,447,756,439,130,231,191,211,178,177,209,244,199,222,217,-45,35,-80
198,350000,d0f245b8781e3631,11,0,166,247,102,51,67,60,67,91,79,101,94,80,87,92,-14,-7,-7
34,210000,d0f245b8781e3631,11,0,102,113,47,21,29,27,30,22,21,21,18,20,19,20,2,-3,5
552,500000,d0f245b8781e3631,11,0,596,1578,630,283,298,337,395,444,428,519,438,436,437,464,-2,-81,79
355,610000,d0f245b8781e3631,11,0,558,938,498,189,261,260,236,226,286,349,325,354,340,343,29,-24,53
32,230000,d0f245b8781e3631,11,0,45,45,7,10,21,11,20,18,12,17,12,8,10,12,-4,-5,1
1094,310000,c6cd4e0e073f5ac2,11,0,448,746,228,125,223,190,233,237,1154,290,404,302,353,332,-102,114,-216
105,530000,c6cd4e0e073f5ac2,11,0,224,235,105,67,68,72,70,100,79,62,75,86,80,74,11,13,-2
104,150000,c6cd4e0e073f5ac2,11,0,273,340,208,63,95,64,75,89,75,89,111,84,98,95,-27,22,-49
72,110000,c6cd4e0e073f5ac2,11,0,179,362,72,29,64,61,50,56,417,666,51,34,42,250,-17,-615,598
307,510000,c6cd4e0e073f5ac2,11,0,631,1027,542,251,246,265,230,226,834,315,368,297,332,327,-71,53,-124
551,340000,c6cd4e0e073f5ac2,11,0,678,1434,792,244,232,308,344,363,315,452,583,523,553,519,-60,131,-191
505,370000,c6cd4e0e073f5ac2,11,0,1053,1685,823,326,341,453,371,362,372,520,630,555,592,568,-75,110,-185
250,140000,c6cd4e0e073f5ac2,11,0,479,604,321,126,162,162,182,154,558,292,187,206,196,228,19,-105,124
593,440000,c6cd4e0e073f5ac2,11,0,1038,1493,451,130,374,366,407,481,329,409,478,509,494,465,31,69,-38
227,450000,c6cd4e0e073f5ac2,11,0,312,543,250,76,136,99,136,130,103,145,204,198,201,182,-6,59,-65
1085,320000,c6cd4e0e073f5ac2,11,0,1467,2828,1205,656,751,787,807,758,1395,929,1015,1091,1053,1012,76,86,-10
461,360000,c6cd4e0e073f5ac2,11,0,577,1241,549,138,232,271,262,250,268,377,418,451,434,415,33,41,-8
401,130000,c6cd4e0e073f5ac2,11,0,561,1020,602,249,293,362,351,329,285,374,411,366,388,384,-45,37,-82
1267,410000,c6cd4e0e073f5ac2,11,0,1021,1584,992,320,512,660,557,721,719,991,1189,1206,1198,1129,17,198,-181
510,330000,c6cd4e0e073f5ac2,11,0,859,1272,386,193,342,341,375,377,337,402,499,496,498,466,-3,97,-100
456,420000,c6cd4e0e073f5ac2,11,0,751,1208,523,161,272,326,270,280,775,316,371,390,380,359,19,55,-36
466,430000,c6cd4e0e073f5ac2,11,0,619,891,508,132,232,212,222,268,261,329,457,434,446,407,-23,128,-151
172,350000,c6cd4e0e073f5ac2,11,0,291,431,173,74,106,104,121,115,77,91,131,145,138,122,14,40,-26
48,210000,c6cd4e0e073f5ac2,11,0,186,225,91,51,75,101,66,42,52,68,79,54,66,67,-25,11,-36
100,500000,c6cd4e0e073f5ac2,11,0,148,242,128,33,53,51,65,76,57,46,63,70,66,60,7,17,-10
293,610000,c6cd4e0e073f5ac2,11,0,275,432,182,64,143,136,155,142,754,199,271,274,272,248,3,72,-69
20,230000,c6cd4e0e073f5ac2,11,0,61,140,53,29,33,28,48,27,21,28,21,14,18,21,-7,-7,0
172,310000,a9a43d1a7ecbe75d,11,0,162,163,142,84,128,99,108,102,143,141,92,87,90,107,-5,-49,44
103,530000,a9a43d1a7ecbe75d,11,0,152,131,146,84,119,80,84,87,136,120,95,78,86,98,-17,-25,8
79,150000,a9a43d1a7ecbe75d,11,0,81,90,83,41,62,87,86,67,58,68,69,69,69,69,0,1,-1
92,110000,a9a43d1a7ecbe75d,11,0,100,123,88,65,74,70,62,63,53,50,55,67,61,57,12,5,7
237,510000,a9a43d1a7ecbe75d,11,0,279,330,341,184,223,201,224,188,192,262,301,197,249,253,-104,39,-143
169,340000,a9a43d1a7ecbe75d,11,0,183,198,254,107,149,150,152,146,136,174,138,155,146,156,17,-36,53
169,370000,a9a43d1a7ecbe75d,11,0,160,191,159,74,162,163,162,117,116,158,179,155,167,164,-24,21,-45
40,140000,a9a43d1a7ecbe75d,11,0,31,28,41,25,46,41,28,30,28,32,32,26,29,30,-6,0,-6
728,440000,a9a43d1a7ecbe75d,11,0,658,638,568,264,527,387,410,437,440,502,480,480,480,487,0,-22,22
158,450000,a9a43d1a7ecbe75d,11,0,172,213,297,121,197,152,163,152,143,162,143,132,138,146,-11,-19,8
428,320000,a9a43d1a7ecbe75d,11,0,402,439,430,213,408,324,345,284,373,290,342,314,328,315,-28,52,-80
87,360000,a9a43d1a7ecbe75d,11,0,76,120,103,50,101,76,71,82,82,105,75,85,80,88,10,-30,40
110,130000,a9a43d1a7ecbe75d,11,0,85,95,109,50,116,95,137,104,134,131,121,110,116,121,-11,-10,-1
118,410000,a9a43d1a7ecbe75d,11,0,134,164,130,78,142,114,90,124,140,149,132,125,128,135,-7,-17,10
377,330000,a9a43d1a7ecbe75d,11,0,364,397,466,185,307,317,322,277,351,327,287,278,282,297,-9,-40,31
225,420000,a9a43d1a7ecbe75d,11,0,244,236,270,129,200,183,140,190,186,222,164,183,174,190,19,-58,77
301,430000,a9a43d1a7ecbe75d,11,0,355,445,519,215,330,301,296,262,319,373,282,230,256,295,-52,-91,39
130,350000,a9a43d1a7ecbe75d,11,0,125,99,145,57,96,88,101,91,78,106,100,89,94,98,-11,-6,-5
119,210000,a9a43d1a7ecbe75d,11,0,126,155,89,59,109,102,100,85,79,140,123,99,111,121,-24,-17,-7
123,500000,a9a43d1a7ecbe75d,11,0,179,214,160,89,140,134,104,264,151,136,117,92,104,115,-25,-19,-6
277,610000,a9a43d1a7ecbe75d,11,0,252,263,274,154,228,212,258,163,256,338,207,301,254,282,94,-131,225
83,230000,a9a43d1a7ecbe75d,11,0,66,57,65,35,91,67,47,50,39,70,62,56,59,63,-6,-8,2
312,310000,3c974920a76ac9c1,12,0,374,305,193,309,264,241,251,240,298,308,270,286,278,288,16,-38,54
331,530000,3c974920a76ac9c1,12,0,456,434,194,302,243,321,230,362,323,306,298,333,316,312,35,-8,43
173,150000,3c974920a76ac9c1,12,0,219,180,128,201,176,192,155,199,170,176,134,180,157,163,46,-42,88
275,110000,3c974920a76ac9c1,12,0,563,468,432,472,340,407,314,302,310,293,226,297,262,272,71,-67,138
456,510000,3c974920a76ac9c1,12,0,570,500,253,378,337,331,336,304,330,449,303,332,318,361,29,-146,175
204,340000,3c974920a76ac9c1,12,0,226,198,76,132,155,144,166,155,166,192,153,158,156,168,5,-39,44
471,370000,3c974920a76ac9c1,12,0,601,468,290,412,484,450,432,449,413,563,371,467,419,467,96,-192,288
200,140000,3c974920a76ac9c1,12,0,260,248,146,249,182,251,173,213,197,239,166,188,177,198,22,-73,95
2821,440000,3c974920a76ac9c1,12,0,3800,2692,1680,2958,2368,2754,2696,2582,2782,2822,2740,2953,2846,2838,213,-82,295
371,450000,3c974920a76ac9c1,12,0,505,425,248,383,277,377,293,309,331,402,304,307,306,338,3,-98,101
799,320000,3c974920a76ac9c1,12,0,1010,800,486,817,617,720,689,718,682,759,664,694,679,706,30,-95,125
181,360000,3c974920a76ac9c1,12,0,262,236,78,191,154,186,149,156,168,164,152,189,170,168,37,-12,49
349,130000,3c974920a76ac9c1,12,0,305,260,190,297,311,328,293,325,352,363,288,305,296,319,17,-75,92
369,410000,3c974920a76ac9c1,12,0,505,405,250,355,393,307,297,380,309,344,274,282,278,300,8,-70,78
853,330000,3c974920a76ac9c1,12,0,865,633,409,621,561,562,591,624,669,649,620,676,648,648,56,-29,85
502,420000,3c974920a76ac9c1,12,0,474,497,228,445,423,403,455,424,361,409,246,307,276,321,61,-163,224
369,430000,3c974920a76ac9c1,12,0,474,347,174,297,304,284,259,316,280,304,238,308,273,283,70,-66,136
308,350000,3c974920a76ac9c1,12,0,404,292,181,307,209,324,299,311,316,288,299,291,295,293,-8,11,-19
795,210000,3c974920a76ac9c1,12,0,997,650,566,775,692,738,626,805,715,744,592,725,658,687,133,-152,285
131,500000,3c974920a76ac9c1,12,0,199,115,72,126,107,119,138,135,104,119,88,116,102,108,28,-31,59
332,610000,3c974920a76ac9c1,12,0,440,305,219,295,292,328,285,305,307,293,289,342,316,308,53,-4,57
325,230000,3c974920a76ac9c1,12,0,461,292,234,401,305,324,284,313,335,248,234,302,268,261,68,-14,82
509,310000,3d7554f1f56dd664,12,0,518,268,263,442,321,383,408,481,506,615,423,528,476,522,105,-192,297
390,530000,3d7554f1f56dd664,12,0,519,292,264,403,325,415,354,487,506,484,430,474,452,463,44,-54,98
351,150000,3d7554f1f56dd664,12,0,337,175,149,316,260,258,252,263,332,312,348,334,341,331,-14,36,-50
338,110000,3d7554f1f56dd664,12,0,811,368,359,470,369,376,352,396,326,421,261,344,302,342,83,-160,243
949,510000,3d7554f1f56dd664,12,0,1125,657,560,806,700,679,724,721,901,1021,668,951,810,880,283,-353,636
699,340000,3d7554f1f56dd664,12,0,507,301,225,317,315,350,352,460,517,524,468,556,512,516,88,-56,144
1344,370000,3d7554f1f56dd664,12,0,1574,775,729,1060,1229,1119,1113,1342,1502,1693,1251,1337,1294,1427,86,-442,528
492,140000,3d7554f1f56dd664,12,0,571,290,239,407,358,384,335,452,519,543,477,486,482,502,9,-66,75
10504,440000,3d7554f1f56dd664,12,0,11515,5136,4688,10371,8733,8990,9100,9110,10367,11177,10502,10371,10436,10683,-131,-675,544
968,450000,3d7554f1f56dd664,12,0,1258,750,559,1074,832,939,901,1075,1222,1237,949,1026,988,1071,77,-288,365
2381,320000,3d7554f1f56dd664,12,0,2877,1445,1635,2184,1828,1916,1948,2090,2406,2465,2160,2416,2288,2347,256,-305,561
532,360000,3d7554f1f56dd664,12,0,741,435,311,545,463,483,513,576,577,634,470,499,484,534,29,-164,193
1142,130000,3d7554f1f56dd664,12,0,974,498,486,847,1025,993,829,1052,1183,1231,1018,1146,1082,1132,128,-213,341
1028,410000,3d7554f1f56dd664,12,0,1234,645,486,968,944,932,1043,1153,1163,1133,861,1082,972,1025,221,-272,493
2119,330000,3d7554f1f56dd664,12,0,2467,1135,1205,1969,1744,1919,1847,2165,2419,2373,1801,2107,1954,2094,306,-572,878
1169,420000,3d7554f1f56dd664,12,0,1050,703,508,734,619,699,876,984,989,1033,795,944,870,924,149,-238,387
773,430000,3d7554f1f56dd664,12,0,1192,689,445,769,687,748,707,821,1006,917,750,869,810,845,119,-167,286
1463,350000,3d7554f1f56dd664,12,0,1578,856,899,1607,1181,1494,1511,1522,1699,1828,1443,1626,1534,1632,183,-385,568
1994,210000,3d7554f1f56dd664,12,0,2161,1110,1306,1905,1837,1784,1845,2218,2361,2147,1842,2177,2010,2055,335,-305,640
349,500000,3d7554f1f56dd664,12,0,398,244,215,285,259,240,371,328,317,303,226,315,270,281,89,-77,166
547,610000,3d7554f1f56dd664,12,0,607,340,260,369,435,466,394,526,525,529,505,572,538,535,67,-24,91
892,230000,3d7554f1f56dd664,12,0,1018,447,521,1186,639,827,849,957,1229,987,782,1050,916,940,268,-205,473
175,310000,2d0d2c3403909fdb,12,0,167,157,101,187,162,155,200,158,195,163,105,146,126,138,41,-58,99
319,530000,2d0d2c3403909fdb,12,0,350,290,213,293,226,236,265,410,329,332,296,336,316,321,40,-36,76
204,150000,2d0d2c3403909fdb,12,0,233,279,174,228,241,255,251,306,251,232,183,204,194,206,21,-49,70
347,110000,2d0d2c3403909fdb,12,0,677,549,387,627,524,389,503,552,475,412,404,331,368,382,-73,-8,-65
404,510000,2d0d2c3403909fdb,12,0,434,516,235,377,355,370,404,481,373,432,264,442,353,379,178,-168,346
133,340000,2d0d2c3403909fdb,12,0,138,176,83,127,116,129,142,151,124,165,116,140,128,140,24,-49,73
386,370000,2d0d2c3403909fdb,12,0,400,420,235,353,334,323,407,400,410,471,322,400,361,398,78,-149,227
165,140000,2d0d2c3403909fdb,12,0,197,179,103,189,173,157,177,211,167,160,125,164,144,150,39,-35,74
1680,440000,2d0d2c3403909fdb,12,0,1829,1713,1159,1738,1536,1581,1833,1828,1593,1985,1468,1849,1658,1767,381,-517,898
213,450000,2d0d2c3403909fdb,12,0,173,211,121,197,149,174,163,216,133,185,158,222,190,188,64,-27,91
456,320000,2d0d2c3403909fdb,12,0,427,470,296,446,386,375,444,454,461,476,350,444,397,423,94,-126,220
111,360000,2d0d2c3403909fdb,12,0,109,126,55,113,112,112,126,130,154,177,120,135,128,144,15,-57,72
361,130000,2d0d2c3403909fdb,12,0,328,389,251,371,364,437,425,531,444,375,300,363,332,346,63,-75,138
285,410000,2d0d2c3403909fdb,12,0,337,377,202,331,306,338,396,390,320,382,301,333,317,339,32,-81,113
433,330000,2d0d2c3403909fdb,12,0,424,401,264,349,335,366,380,435,444,478,383,410,396,424,27,-95,122
238,420000,2d0d2c3403909fdb,12,0,280,321,189,271,255,230,322,292,267,293,194,219,206,235,25,-99,124
198,430000,2d0d2c3403909fdb,12,0,275,284,146,275,262,250,285,292,286,299,216,222,219,246,6,-83,89
116,350000,2d0d2c3403909fdb,12,0,157,167,81,107,85,111,132,133,94,129,102,123,112,118,21,-27,48
570,210000,2d0d2c3403909fdb,12,0,567,506,316,529,433,489,457,606,708,531,506,552,529,530,46,-25,71
150,500000,2d0d2c3403909fdb,12,0,155,213,116,188,148,168,179,203,176,174,114,143,128,144,29,-60,89
274,610000,2d0d2c3403909fdb,12,0,267,297,206,288,291,280,277,346,254,290,201,173,187,221,-28,-89,61
316,230000,2d0d2c3403909fdb,12,0,336,315,155,306,267,240,317,304,316,199,191,233,212,208,42,-8,50
241,310000,a28bb927b6fcb33c,12,0,210,117,96,135,131,161,142,167,201,221,204,244,224,223,40,-17,57
450,530000,a28bb927b6fcb33c,12,0,308,173,110,159,185,191,176,253,332,399,317,430,374,382,113,-82,195
234,150000,a28bb927b6fcb33c,12,0,176,89,72,136,148,139,117,145,167,204,226,182,204,204,-44,22,-66
192,110000,a28bb927b6fcb33c,12,0,342,136,109,179,166,96,85,131,159,164,150,176,163,163,26,-14,40
634,510000,a28bb927b6fcb33c,12,0,436,351,212,361,425,290,324,427,553,667,370,470,420,502,100,-297,397
326,340000,a28bb927b6fcb33c,12,0,348,264,151,204,182,203,195,266,313,338,363,329,346,343,-34,25,-59
608,370000,a28bb927b6fcb33c,12,0,556,225,175,357,467,449,285,377,522,729,587,608,598,641,21,-142,163
280,140000,a28bb927b6fcb33c,12,0,181,92,70,148,181,165,127,190,198,230,208,227,218,222,19,-22,41
5402,440000,a28bb927b6fcb33c,12,0,4195,2391,1639,3992,3988,3668,3906,4522,4949,5596,4889,5245,5067,5243,356,-707,1063
603,450000,a28bb927b6fcb33c,12,0,386,248,166,443,418,434,344,461,540,630,553,544,548,576,-9,-77,68
1289,320000,a28bb927b6fcb33c,12,0,1154,680,651,982,1039,1051,947,1072,1268,1400,1213,1183,1198,1265,-30,-187,157
442,360000,a28bb927b6fcb33c,12,0,351,208,96,254,328,298,271,331,451,520,466,388,427,458,-78,-54,-24
587,130000,a28bb927b6fcb33c,12,0,419,248,284,584,570,485,345,559,623,645,615,535,575,598,-80,-30,-50
750,410000,a28bb927b6fcb33c,12,0,651,338,242,578,638,439,516,644,816,854,726,725,726,768,-1,-128,127
1720,330000,a28bb927b6fcb33c,12,0,1310,747,739,1438,1404,1200,1131,1522,1730,1887,1466,1612,1539,1655,146,-421,567
831,420000,a28bb927b6fcb33c,12,0,787,450,226,461,459,468,446,524,665,780,873,715,794,789,-158,93,-251
705,430000,a28bb927b6fcb33c,12,0,674,394,223,436,554,554,548,663,787,891,679,645,662,738,-34,-212,178
906,350000,a28bb927b6fcb33c,12,0,519,231,173,535,612,676,709,737,966,1034,837,825,831,899,-12,-197,185
827,210000,a28bb927b6fcb33c,12,0,848,213,233,610,646,562,459,596,792,810,690,865,778,788,175,-120,295
214,500000,a28bb927b6fcb33c,12,0,208,123,85,166,157,116,162,140,173,200,168,168,168,179,0,-32,32
356,610000,a28bb927b6fcb33c,12,0,317,148,105,202,242,221,226,279,358,344,333,331,332,336,-2,-11,9
331,230000,a28bb927b6fcb33c,12,0,303,90,85,233,244,241,205,236,349,303,327,519,423,383,192,24,168
319,310000,17bc272c93f19d56,12,0,477,199,177,267,169,193,170,168,208,216,192,208,200,205,16,-24,40
3929,530000,17bc272c93f19d56,12,0,4503,4785,3067,2754,2281,2227,1995,2206,1981,2469,3585,3111,3348,3055,-474,1116,-1590
679,150000,17bc272c93f19d56,12,0,675,504,451,680,487,440,356,384,433,467,506,620,563,531,114,39,75
176,110000,17bc272c93f19d56,12,0,514,151,92,197,124,132,112,101,80,136,106,116,111,119,10,-30,40
1656,510000,17bc272c93f19d56,12,0,1954,1724,1537,1481,1090,1021,990,1018,1119,1242,1321,1366,1344,1310,45,79,-34
2026,340000,17bc272c93f19d56,12,0,2328,2152,1881,1518,1284,1266,1165,1072,1126,1266,1339,1314,1326,1306,-25,73,-98
4723,370000,17bc272c93f19d56,12,0,6576,4483,3060,2839,2545,2879,2279,2583,2917,2744,3229,2974,3102,2982,-255,485,-740
2474,140000,17bc272c93f19d56,12,0,2844,2093,1361,1353,1118,1259,955,1154,1235,1338,1662,1670,1666,1557,8,324,-316
2071,440000,17bc272c93f19d56,12,0,3029,1611,1579,2180,1684,1684,1682,1409,1573,1720,1696,1650,1673,1689,-46,-24,-22
3003,450000,17bc272c93f19d56,12,0,4443,3084,1836,2310,1540,1616,1343,1308,1943,1360,1586,1801,1694,1582,215,226,-11
2708,320000,17bc272c93f19d56,12,0,3067,2165,2419,2029,1601,1578,1375,1523,1501,1651,1865,1898,1882,1805,33,214,-181
1120,360000,17bc272c93f19d56,12,0,1510,1290,922,875,668,648,536,537,656,666,811,761,786,746,-50,145,-195
5765,130000,17bc272c93f19d56,12,0,6231,3870,3403,2945,3015,3119,2522,2789,2808,2753,3344,3669,3506,3255,325,591,-266
5332,410000,17bc272c93f19d56,12,0,7650,5825,3564,3197,2704,2715,2598,2658,2563,2664,3259,3278,3268,3067,19,595,-576
2159,330000,17bc272c93f19d56,12,0,2062,1260,1629,1592,1156,1224,1121,1218,1188,1319,1309,1393,1351,1340,84,-10,94
1688,420000,17bc272c93f19d56,12,0,2198,1919,1140,1262,895,1069,835,836,949,1018,1151,1055,1103,1075,-96,133,-229
1897,430000,17bc272c93f19d56,12,0,2693,2364,1506,1541,1174,1020,997,939,1035,1185,1214,1290,1252,1230,76,29,47
582,350000,17bc272c93f19d56,12,0,892,592,650,741,463,546,473,389,402,400,437,440,438,426,3,37,-34
1651,210000,17bc272c93f19d56,12,0,1710,924,939,1322,959,988,854,912,964,1041,839,1156,998,1012,317,-202,519
391,500000,17bc272c93f19d56,12,0,357,250,248,235,212,191,173,197,218,241,244,273,258,253,29,3,26
2796,610000,17bc272c93f19d56,12,0,3217,2072,1105,1314,1222,1105,910,1051,1117,1406,1562,1664,1613,1544,102,156,-54
737,230000,17bc272c93f19d56,12,0,982,506,518,806,657,585,602,530,544,540,569,743,656,617,174,29,145
636,310000,2a2ab41f8f6ff1cb,12,0,623,382,114,351,229,285,289,234,347,399,276,363,320,346,87,-123,210
644,530000,2a2ab41f8f6ff1cb,12,0,680,484,300,452,403,419,390,633,639,493,556,594,575,548,38,63,-25
750,150000,2a2ab41f8f6ff1cb,12,0,832,551,317,489,505,604,525,595,623,640,628,626,627,631,-2,-12,10
103,110000,2a2ab41f8f6ff1cb,12,0,598,212,102,180,142,124,93,130,133,130,95,126,110,117,31,-35,66
1437,510000,2a2ab41f8f6ff1cb,12,0,1850,1223,671,850,790,838,870,1020,1346,1101,933,1042,988,1025,109,-168,277
1681,340000,2a2ab41f8f6ff1cb,12,0,1666,1515,717,1018,980,1077,1165,1206,1280,1168,1138,990,1064,1099,-148,-30,-118
2607,370000,2a2ab41f8f6ff1cb,12,0,2737,1706,842,1734,1902,2031,1983,2192,2226,2022,2178,2008,2093,2069,-170,156,-326
899,140000,2a2ab41f8f6ff1cb,12,0,993,533,312,595,582,569,606,683,717,614,692,659,676,655,-33,78,-111
7407,440000,2a2ab41f8f6ff1cb,12,0,6492,5607,2647,5713,4896,5717,5445,4899,5914,5863,5896,5979,5938,5913,83,33,50
884,450000,2a2ab41f8f6ff1cb,12,0,894,799,409,719,453,603,532,611,719,734,660,643,652,679,-17,-74,57
2285,320000,2a2ab41f8f6ff1cb,12,0,2672,1728,1016,1729,1498,1701,1735,1850,1857,1722,1874,1842,1858,1813,-32,152,-184
1216,360000,2a2ab41f8f6ff1cb,12,0,1291,1027,356,690,687,838,753,813,1041,905,884,830,857,873,-54,-21,-33
3194,130000,2a2ab41f8f6ff1cb,12,0,2703,2119,1271,2126,2486,2863,2426,2914,2989,2361,2420,2498,2459,2426,78,59,19
3491,410000,2a2ab41f8f6ff1cb,12,0,3447,2952,1308,2514,2566,2841,2880,3363,3319,2677,2531,2633,2582,2614,102,-146,248
1758,330000,2a2ab41f8f6ff1cb,12,0,1972,795,459,876,905,1141,1077,1165,1379,1241,1255,1301,1278,1266,46,14,32
1787,420000,2a2ab41f8f6ff1cb,12,0,2151,1566,597,1095,1029,1047,1133,1293,1344,1288,1247,1304,1276,1280,57,-41,98
2118,430000,2a2ab41f8f6ff1cb,12,0,2770,1651,844,1487,1573,1636,1382,1564,1802,1482,1432,1538,1485,1484,106,-50,156
528,350000,2a2ab41f8f6ff1cb,12,0,476,264,148,314,267,427,418,348,436,384,415,479,447,426,64,31,33
569,210000,2a2ab41f8f6ff1cb,12,0,513,241,211,360,293,362,342,372,462,408,449,502,476,453,53,41,12
899,500000,2a2ab41f8f6ff1cb,12,0,1149,803,328,472,453,543,623,549,633,579,475,575,525,543,100,-104,204
863,610000,2a2ab41f8f6ff1cb,12,0,845,620,247,468,497,551,436,566,577,553,626,533,580,571,-93,73,-166
641,230000,2a2ab41f8f6ff1cb,12,0,1032,399,306,506,449,585,503,512,594,572,502,654,578,576,152,-70,222
1307,310000,c06a2a387c0ee510,12,0,1212,1265,890,1247,1119,1184,1456,1316,1194,1258,958,1329,1144,1182,371,-300,671
353,530000,c06a2a387c0ee510,12,0,119,104,63,214,133,132,248,173,187,150,190,144,167,161,-46,40,-86
183,150000,c06a2a387c0ee510,12,0,75,86,64,154,131,164,163,146,193,187,137,144,140,156,7,-50,57
1358,110000,c06a2a387c0ee510,12,0,1627,1352,1114,1508,1132,1430,1670,1367,1416,1463,1056,1425,1240,1315,369,-407,776
419,510000,c06a2a387c0ee510,12,0,321,208,187,254,335,308,285,276,420,431,254,309,282,331,55,-177,232
408,340000,c06a2a387c0ee510,12,0,251,253,175,322,340,315,352,311,384,398,291,357,324,349,66,-107,173
1388,370000,c06a2a387c0ee510,12,0,1047,878,649,1303,1248,1216,1405,1283,1284,1321,1189,1365,1277,1292,176,-132,308
361,140000,c06a2a387c0ee510,12,0,184,165,123,244,320,272,242,233,292,344,209,376,292,310,167,-135,302
1508,440000,c06a2a387c0ee510,12,0,819,762,448,944,1100,1025,1038,994,984,1134,946,1148,1047,1076,202,-188,390
140,450000,c06a2a387c0ee510,12,0,96,92,54,103,134,119,86,123,99,126,97,133,115,119,36,-29,65
1287,320000,c06a2a387c0ee510,12,0,1002,974,650,1188,1289,1048,1276,1137,1253,1328,1121,1341,1231,1263,220,-207,427
233,360000,c06a2a387c0ee510,12,0,97,118,85,164,140,153,162,165,154,204,178,201,190,194,23,-26,49
781,130000,c06a2a387c0ee510,12,0,493,470,361,599,660,769,569,656,773,873,579,821,700,758,242,-294,536
950,410000,c06a2a387c0ee510,12,0,596,517,345,763,731,685,764,754,849,909,743,742,742,798,-1,-166,165
1213,330000,c06a2a387c0ee510,12,0,736,534,424,754,915,865,808,908,999,1113,743,1029,886,962,286,-370,656
368,420000,c06a2a387c0ee510,12,0,173,151,103,240,253,187,234,272,286,270,205,266,236,247,61,-65,126
229,430000,c06a2a387c0ee510,12,0,119,101,59,203,163,182,206,192,239,250,170,213,192,211,43,-80,123
234,350000,c06a2a387c0ee510,12,0,170,123,106,206,303,187,204,204,249,241,181,243,212,222,62,-60,122
456,210000,c06a2a387c0ee510,12,0,300,181,154,357,324,363,378,413,435,413,296,399,348,369,103,-117,220
208,500000,c06a2a387c0ee510,12,0,100,60,71,130,181,128,151,124,150,168,111,139,125,139,28,-57,85
372,610000,c06a2a387c0ee510,12,0,313,234,179,320,305,340,358,313,390,434,291,339,315,355,48,-143,191
260,230000,c06a2a387c0ee510,12,0,177,129,74,323,185,255,260,224,227,281,192,276,234,250,84,-89,173
777,310000,7023efdab9cedc03,12,0,697,325,168,288,309,527,516,379,272,357,325,514,420,399,189,-32,221
159,530000,7023efdab9cedc03,12,0,112,40,25,38,54,68,55,75,116,109,89,134,112,111,45,-20,65
65,150000,7023efdab9cedc03,12,0,75,31,18,29,46,51,51,61,78,46,46,54,50,49,8,0,8
145,110000,7023efdab9cedc03,12,0,132,40,51,59,50,54,60,151,111,68,85,105,95,86,20,17,3
409,510000,7023efdab9cedc03,12,0,408,216,117,192,175,229,259,209,437,371,295,259,277,308,-36,-76,40
816,340000,7023efdab9cedc03,12,0,587,357,148,207,278,368,463,445,401,385,356,460,408,400,104,-29,133
555,370000,7023efdab9cedc03,12,0,555,320,180,373,400,374,355,402,517,287,263,333,298,294,70,-24,94
113,140000,7023efdab9cedc03,12,0,64,30,23,28,38,44,60,71,103,47,63,79,71,63,16,16,0
681,440000,7023efdab9cedc03,12,0,408,121,39,166,158,211,185,222,453,438,420,538,479,465,118,-18,136
165,450000,7023efdab9cedc03,12,0,129,68,34,47,50,71,60,56,125,119,131,111,121,120,-20,12,-32
1853,320000,7023efdab9cedc03,12,0,1767,893,628,788,879,1067,1002,995,690,648,797,1072,934,839,275,149,126
371,360000,7023efdab9cedc03,12,0,302,169,92,161,188,202,170,233,263,198,189,283,236,223,94,-9,103
334,130000,7023efdab9cedc03,12,0,215,80,56,93,108,163,149,199,289,190,211,214,212,205,3,21,-18
640,410000,7023efdab9cedc03,12,0,368,183,97,185,329,340,259,262,298,278,272,313,292,288,41,-6,47
1174,330000,7023efdab9cedc03,12,0,1163,445,309,478,511,775,845,706,532,466,593,691,642,583,98,127,-29
477,420000,7023efdab9cedc03,12,0,401,211,94,172,184,195,243,185,256,244,251,275,263,257,24,7,17
428,430000,7023efdab9cedc03,12,0,315,201,83,173,167,198,189,202,231,221,183,298,240,234,115,-38,153
239,350000,7023efdab9cedc03,12,0,145,54,20,51,78,114,140,134,168,156,185,156,170,166,-29,29,-58
100,210000,7023efdab9cedc03,12,0,104,28,21,52,82,45,37,92,119,77,81,81,81,80,0,4,-4
157,500000,7023efdab9cedc03,12,0,62,28,20,37,37,33,64,92,101,91,99,133,116,108,34,8,26
270,610000,7023efdab9cedc03,12,0,177,107,51,78,83,124,102,102,142,134,146,140,143,140,-6,12,-18
72,230000,7023efdab9cedc03,12,0,30,11,11,8,18,20,17,27,60,33,21,34,28,29,13,-12,25
1476,310000,af6f4f548684e14d,12,0,1734,940,540,957,807,919,933,755,914,982,870,1135,1002,996,265,-112,377
460,530000,af6f4f548684e14d,12,0,732,400,288,346,301,327,290,401,329,345,355,366,360,355,11,10,1
404,150000,af6f4f548684e14d,12,0,573,322,195,323,333,363,302,240,293,382,398,354,376,378,-44,16,-60
601,110000,af6f4f548684e14d,12,0,1057,659,394,601,489,595,532,503,449,472,373,574,474,473,201,-99,300
1309,510000,af6f4f548684e14d,12,0,1876,1072,611,873,761,808,800,793,898,1218,888,1018,953,1041,130,-330,460
1540,340000,af6f4f548684e14d,12,0,1597,1015,457,773,664,769,751,688,875,1020,977,994,986,997,17,-43,60
1912,370000,af6f4f548684e14d,12,0,2394,1077,522,1253,1236,1215,1019,955,1078,1388,1080,1407,1244,1292,327,-308,635
603,140000,af6f4f548684e14d,12,0,742,375,248,450,310,404,335,340,378,448,532,597,564,526,65,84,-19
1666,440000,af6f4f548684e14d,12,0,2594,949,463,1024,892,976,1062,838,972,1048,1071,1472,1272,1197,401,23,378
452,450000,af6f4f548684e14d,12,0,713,341,210,322,222,345,302,257,262,298,338,411,374,349,73,40,33
2311,320000,af6f4f548684e14d,12,0,2647,1466,939,1519,1181,1355,1281,1072,1305,1574,1407,1600,1504,1527,193,-167,360
1457,360000,af6f4f548684e14d,12,0,1527,753,397,757,746,837,677,745,886,1080,1037,1127,1082,1081,90,-43,133
1186,130000,af6f4f548684e14d,12,0,1235,691,404,655,694,773,655,680,691,793,740,923,832,819,183,-53,236
1718,410000,af6f4f548684e14d,12,0,2122,1000,589,1119,1013,903,937,951,1080,1247,1099,1363,1231,1236,264,-148,412
1599,330000,af6f4f548684e14d,12,0,2068,1003,537,978,796,1015,879,797,986,1136,1153,1265,1209,1185,112,17,95
1687,420000,af6f4f548684e14d,12,0,1632,1025,485,1058,873,1015,949,835,965,1376,1214,1261,1238,1284,47,-162,209
1665,430000,af6f4f548684e14d,12,0,2178,1217,467,1068,962,1084,875,893,959,1329,1057,1310,1184,1232,253,-272,525
610,350000,af6f4f548684e14d,12,0,913,522,257,433,373,497,408,356,398,487,518,526,522,510,8,31,-23
528,210000,af6f4f548684e14d,12,0,594,254,172,277,329,290,263,262,428,438,320,413,366,390,93,-118,211
653,500000,af6f4f548684e14d,12,0,762,420,252,342,321,324,387,329,286,390,312,436,374,379,124,-78,202
545,610000,af6f4f548684e14d,12,0,651,365,184,306,238,357,732,447,312,423,398,433,416,418,35,-25,60
253,230000,af6f4f548684e14d,12,0,372,142,121,207,187,231,186,143,232,203,179,234,206,205,55,-24,79
1456,310000,7cf283430b3b5e38,12,0,1428,635,513,975,1070,1137,2596,1172,1207,1337,691,798,744,942,107,-646,753
628,530000,7cf283430b3b5e38,12,0,626,249,167,333,316,408,510,602,649,565,362,313,338,413,-49,-203,154
528,150000,7cf283430b3b5e38,12,0,701,285,178,320,330,439,413,440,575,685,372,350,361,469,-22,-313,291
129,110000,7cf283430b3b5e38,12,0,913,106,74,113,101,453,335,314,124,110,37,81,59,76,44,-73,117
2127,510000,7cf283430b3b5e38,12,0,2691,1134,763,1522,1501,1649,1954,1996,2318,2175,1415,1425,1420,1672,10,-760,770
3502,340000,7cf283430b3b5e38,12,0,2356,1607,968,1908,2068,2171,2517,2384,2828,2098,1480,1747,1614,1775,267,-618,885
4833,370000,7cf283430b3b5e38,12,0,4830,2048,1323,3138,3779,4223,3954,4263,5234,4184,2802,2819,2810,3268,17,-1382,1399
1287,140000,7cf283430b3b5e38,12,0,1073,317,283,629,610,883,1085,1017,1391,967,750,729,740,815,-21,-217,196
2408,440000,7cf283430b3b5e38,12,0,2500,695,488,1495,1512,1848,2203,1964,2643,2750,2176,1693,1934,2206,-483,-574,91
1181,450000,7cf283430b3b5e38,12,0,869,475,293,738,554,830,966,1021,1065,1006,598,719,658,774,121,-408,529
5860,320000,7cf283430b3b5e38,12,0,5865,2657,2401,4119,4083,4704,4995,4877,5866,4453,3479,3686,3582,3873,207,-974,1181
3171,360000,7cf283430b3b5e38,12,0,1737,923,549,1502,1828,1895,1662,1811,1988,1776,1261,1656,1458,1564,395,-515,910
3116,130000,7cf283430b3b5e38,12,0,2621,900,720,1379,2198,2809,2761,2856,3219,1969,1711,1899,1805,1860,188,-258,446
4994,410000,7cf283430b3b5e38,12,0,3243,1683,1042,2558,3199,3067,3400,3871,4333,3047,2328,3052,2690,2809,724,-719,1443
3947,330000,7cf283430b3b5e38,12,0,3490,1289,1038,1965,1876,2506,2778,3135,3712,3209,2554,2117,2336,2627,-437,-655,218
2711,420000,7cf283430b3b5e38,12,0,1624,929,480,1234,1278,1437,1882,1699,1835,1719,1162,1291,1226,1391,129,-557,686
2429,430000,7cf283430b3b5e38,12,0,1952,989,516,1513,1616,1696,1720,1686,2057,2090,1239,1356,1298,1562,117,-851,968
1548,350000,7cf283430b3b5e38,12,0,958,546,402,859,878,1319,1184,1258,1327,1317,1081,840,960,1079,-241,-236,-5
716,210000,7cf283430b3b5e38,12,0,821,205,149,446,498,474,571,727,964,874,497,533,515,635,36,-377,413
838,500000,7cf283430b3b5e38,12,0,597,296,163,296,401,429,660,507,590,674,413,337,375,475,-76,-261,185
1087,610000,7cf283430b3b5e38,12,0,1151,413,242,475,689,883,1688,1091,1205,1047,626,569,598,747,-57,-421,364
224,230000,7cf283430b3b5e38,12,0,415,118,130,301,193,254,310,279,412,382,247,186,216,272,-61,-135,74
272,310000,d4efbebb087fd03f,12,0,270,79,27,45,95,103,101,83,103,129,99,145,122,124,46,-30,76
526,530000,d4efbebb087fd03f,12,0,384,296,172,285,192,231,213,247,282,327,422,431,426,393,9,95,-86
414,150000,d4efbebb087fd03f,12,0,450,248,124,211,203,178,177,181,202,244,274,322,298,280,48,30,18
337,110000,d4efbebb087fd03f,12,0,1287,118,74,556,952,1106,818,968,836,546,268,322,295,379,54,-278,332
1801,510000,d4efbebb087fd03f,12,0,2805,1326,797,891,676,702,734,761,905,1065,1092,1163,1128,1107,71,27,44
1197,340000,d4efbebb087fd03f,12,0,1443,903,436,535,520,582,612,532,660,692,828,845,836,788,17,136,-119
3100,370000,d4efbebb087fd03f,12,0,3785,1878,1009,1343,1575,1488,1335,1337,1747,1744,1960,1965,1962,1890,5,216,-211
1457,140000,d4efbebb087fd03f,12,0,2925,603,248,417,464,574,426,448,540,518,746,814,780,693,68,228,-160
2825,440000,d4efbebb087fd03f,12,0,2419,914,399,1078,1095,1082,1215,1038,1245,1500,1591,1867,1729,1653,276,91,185
1161,450000,d4efbebb087fd03f,12,0,935,666,303,492,403,512,470,474,495,629,719,806,762,718,87,90,-3
1890,320000,d4efbebb087fd03f,12,0,2308,910,648,752,1041,985,944,821,908,982,1078,1100,1089,1053,22,96,-74
1287,360000,d4efbebb087fd03f,12,0,1377,999,364,509,561,555,561,469,643,721,910,952,931,861,42,189,-147
2361,130000,d4efbebb087fd03f,12,0,2067,1110,641,741,953,1002,876,936,1050,1031,1362,1448,1405,1280,86,331,-245
3785,410000,d4efbebb087fd03f,12,0,3560,2272,888,1199,1423,1368,1487,1652,1740,1822,2212,2155,2184,2063,-57,390,-447
4449,330000,d4efbebb087fd03f,12,0,4324,1028,639,1114,1097,2340,1882,1700,2222,2001,2752,4073,3412,2942,1321,751,570
1629,420000,d4efbebb087fd03f,12,0,1534,1004,347,476,456,410,475,460,525,1167,723,753,738,881,30,-444,474
1881,430000,d4efbebb087fd03f,12,0,1719,1133,438,685,688,650,716,659,750,1015,980,1001,990,999,21,-35,56
1279,350000,d4efbebb087fd03f,12,0,1967,434,268,656,565,712,722,602,609,775,965,976,970,905,11,190,-179
480,210000,d4efbebb087fd03f,12,0,520,199,149,205,202,188,167,160,157,192,253,319,286,255,66,61,5
995,500000,d4efbebb087fd03f,12,0,532,432,291,409,310,302,286,280,366,470,485,545,515,500,60,15,45
2927,610000,d4efbebb087fd03f,12,0,1651,919,422,609,612,587,580,1155,818,1081,1331,1915,1623,1442,584,250,334
230,230000,d4efbebb087fd03f,12,0,257,135,104,114,128,104,132,112,136,138,80,126,103,115,46,-58,104
106,310000,7245e0ee27b195cd,12,0,158,63,40,60,51,45,46,45,48,64,47,74,60,62,27,-17,44
643,530000,7245e0ee27b195cd,12,0,535,421,246,288,240,252,266,378,341,384,421,469,445,425,48,37,11
486,150000,7245e0ee27b195cd,12,0,676,363,164,250,212,180,206,169,180,292,330,410,370,344,80,38,42
115,110000,7245e0ee27b195cd,12,0,496,86,74,109,80,71,61,54,68,80,56,77,66,71,21,-24,45
1369,510000,7245e0ee27b195cd,12,0,1260,724,451,621,526,535,628,654,720,912,881,794,838,862,-87,-31,-56
1013,340000,7245e0ee27b195cd,12,0,806,576,272,358,315,316,346,322,391,446,556,617,586,540,61,110,-49
2076,370000,7245e0ee27b195cd,12,0,2915,1529,762,977,1071,1025,958,930,1153,1156,1444,1428,1436,1343,-16,288,-304
1389,140000,7245e0ee27b195cd,12,0,1092,615,366,578,543,590,543,530,702,862,804,954,879,873,150,-58,208
2248,440000,7245e0ee27b195cd,12,0,1437,718,363,821,836,734,867,743,867,1000,961,1391,1176,1117,430,-39,469
869,450000,7245e0ee27b195cd,12,0,659,452,233,370,288,292,316,346,373,423,428,645,536,499,217,5,212
1013,320000,7245e0ee27b195cd,12,0,1008,543,405,518,460,406,448,428,481,488,651,828,740,656,177,163,14
926,360000,7245e0ee27b195cd,12,0,816,634,247,323,301,331,301,285,348,422,444,545,494,470,101,22,79
2644,130000,7245e0ee27b195cd,12,0,2365,1304,951,1023,1070,1210,930,1140,1221,1304,1511,1557,1534,1457,46,207,-161
2367,410000,7245e0ee27b195cd,12,0,2228,1526,717,888,888,823,850,1053,1131,1233,1386,1268,1327,1296,-118,153,-271
1312,330000,7245e0ee27b195cd,12,0,1121,438,306,511,460,520,507,491,573,625,628,936,782,730,308,3,305
862,420000,7245e0ee27b195cd,12,0,903,635,255,364,342,325,362,407,342,478,502,562,532,514,60,24,36
1281,430000,7245e0ee27b195cd,12,0,1216,773,321,479,531,540,517,429,513,640,693,667,680,667,-26,53,-79
439,350000,7245e0ee27b195cd,12,0,420,249,153,274,195,252,248,212,300,311,264,381,322,319,117,-47,164
798,210000,7245e0ee27b195cd,12,0,641,287,222,321,326,279,247,251,291,348,358,578,468,428,220,10,210
658,500000,7245e0ee27b195cd,12,0,402,296,142,238,207,233,232,240,260,352,335,350,342,346,15,-17,32
1597,610000,7245e0ee27b195cd,12,0,1158,815,410,484,484,492,471,470,664,857,802,911,856,857,109,-55,164
531,230000,7245e0ee27b195cd,12,0,336,166,145,205,161,183,216,199,211,200,279,399,339,293,120,79,41
161,310000,8c915fe4632fb9fa,12,0,461,180,102,190,125,145,92,77,83,77,70,89,80,79,19,-7,26
1127,530000,8c915fe4632fb9fa,12,0,1396,1059,575,778,650,682,486,654,573,601,737,746,742,695,9,136,-127
699,150000,8c915fe4632fb9fa,12,0,720,520,270,473,409,472,356,344,415,453,477,480,478,470,3,24,-21
96,110000,8c915fe4632fb9fa,12,0,487,101,86,162,127,117,78,41,43,61,36,66,51,54,30,-25,55
1876,510000,8c915fe4632fb9fa,12,0,2433,1860,1194,1302,1156,1192,925,872,1055,1302,1043,1171,1107,1172,128,-259,387
1487,340000,8c915fe4632fb9fa,12,0,2298,1440,720,878,861,934,738,651,739,952,974,954,964,960,-20,22,-42
2685,370000,8c915fe4632fb9fa,12,0,3804,2217,1109,1504,1812,1956,1321,1432,1563,1725,1648,1598,1623,1657,-50,-77,27
1125,140000,8c915fe4632fb9fa,12,0,1215,772,404,591,661,732,531,562,597,623,673,692,682,663,19,50,-31
1541,440000,8c915fe4632fb9fa,12,0,2021,1040,446,977,1064,948,854,663,649,829,797,933,865,853,136,-32,168
837,450000,8c915fe4632fb9fa,12,0,880,738,330,660,454,586,385,399,303,460,395,496,446,450,101,-65,166
1779,320000,8c915fe4632fb9fa,12,0,2525,1540,1130,1441,1246,1265,930,913,863,957,1065,1077,1071,1033,12,108,-96
1306,360000,8c915fe4632fb9fa,12,0,1320,1015,377,598,631,632,491,445,477,574,678,645,662,632,-33,104,-137
2875,130000,8c915fe4632fb9fa,12,0,3281,1882,1126,1456,2041,2368,1518,1714,1628,1540,1628,1737,1682,1635,109,88,21
2708,410000,8c915fe4632fb9fa,12,0,2975,2324,1002,1413,1518,1509,1135,1362,1395,1473,1530,1501,1516,1501,-29,57,-86
1439,330000,8c915fe4632fb9fa,12,0,2235,958,565,880,893,948,697,814,804,930,965,959,962,951,-6,35,-41
1562,420000,8c915fe4632fb9fa,12,0,1557,1148,463,782,723,758,663,696,627,825,791,880,836,832,89,-34,123
1306,430000,8c915fe4632fb9fa,12,0,1281,1235,439,733,664,655,498,506,508,651,664,797,730,704,133,13,120
628,350000,8c915fe4632fb9fa,12,0,877,518,365,529,461,541,380,328,306,337,330,453,392,373,123,-7,130
410,210000,8c915fe4632fb9fa,12,0,542,311,224,349,397,405,266,303,286,359,298,341,320,333,43,-61,104
641,500000,8c915fe4632fb9fa,12,0,666,489,274,346,334,368,358,284,258,335,284,301,292,307,17,-51,68
1015,610000,8c915fe4632fb9fa,12,0,1549,1036,394,463,535,597,405,487,551,603,672,616,644,630,-56,69,-125
645,230000,8c915fe4632fb9fa,12,0,998,401,372,684,679,736,526,592,672,585,481,632,556,566,151,-104,255
578,310000,6155b214590c66e6,12,0,1047,423,192,279,354,355,429,362,376,371,244,388,316,334,144,-127,271
2038,530000,6155b214590c66e6,12,0,1879,1354,680,631,992,1295,955,1148,1036,994,1360,1355,1358,1236,-5,366,-371
1503,150000,6155b214590c66e6,12,0,1442,814,347,566,786,1042,724,802,839,925,923,1180,1052,1009,257,-2,259
475,110000,6155b214590c66e6,12,0,1295,274,176,281,280,376,386,433,291,293,235,405,320,311,170,-58,228
4075,510000,6155b214590c66e6,12,0,4188,2540,1081,1111,1488,1668,1412,1619,1860,2342,1859,2496,2178,2232,637,-483,1120
3368,340000,6155b214590c66e6,12,0,3650,2495,863,893,1218,1582,1360,1404,1555,1685,1690,1970,1830,1782,280,5,275
5833,370000,6155b214590c66e6,12,0,6275,3467,1356,2002,3249,3444,2666,3057,2942,3377,3085,3780,3432,3414,695,-292,987
1551,140000,6155b214590c66e6,12,0,1576,743,357,500,790,998,720,798,855,911,936,1098,1017,982,162,25,137
4934,440000,6155b214590c66e6,12,0,4342,1784,653,1364,1722,2162,2247,2038,2128,2302,2021,3107,2564,2477,1086,-281,1367
1408,450000,6155b214590c66e6,12,0,1316,892,381,556,538,802,574,699,609,693,620,871,746,728,251,-73,324
5381,320000,6155b214590c66e6,12,0,5864,3032,1760,2316,2607,3244,2604,2564,2570,2743,2663,3457,3060,2954,794,-80,874
2144,360000,6155b214590c66e6,12,0,2160,1579,453,603,962,960,811,902,887,1133,1043,1296,1170,1157,253,-90,343
4576,130000,6155b214590c66e6,12,0,4551,2375,1231,1427,2467,3049,2213,2567,2481,2466,2211,2880,2546,2519,669,-255,924
6966,410000,6155b214590c66e6,12,0,8018,5309,1586,1915,2716,3025,2701,2930,3143,3339,3184,4188,3686,3570,1004,-155,1159
4554,330000,6155b214590c66e6,12,0,4336,1679,826,1161,1890,2275,1899,2230,2234,2335,2198,3021,2610,2518,823,-137,960
2842,420000,6155b214590c66e6,12,0,3179,2049,551,906,1028,1278,1264,1359,1217,1693,1417,1849,1633,1653,432,-276,708
3453,430000,6155b214590c66e6,12,0,3747,2461,732,1157,1395,1621,1288,1479,1482,1887,1640,2246,1943,1924,606,-247,853
1342,350000,6155b214590c66e6,12,0,1306,596,364,463,616,759,757,740,708,723,786,928,857,812,142,63,79
1902,210000,6155b214590c66e6,12,0,1784,769,415,765,1227,1203,969,1200,1102,1144,952,1415,1184,1170,463,-192,655
1620,500000,6155b214590c66e6,12,0,1417,877,373,399,529,594,627,619,620,836,742,844,793,807,102,-94,196
1875,610000,6155b214590c66e6,12,0,1546,1008,303,361,648,917,661,790,773,918,1016,1193,1104,1042,177,98,79
1034,230000,6155b214590c66e6,12,0,1290,579,365,604,725,778,831,876,865,867,758,1022,890,882,264,-109,373
668,310000,28e29f2c03dcd84c,12,0,1293,851,433,764,667,727,689,522,968,719,517,661,589,632,144,-202,346
482,530000,28e29f2c03dcd84c,12,0,639,509,300,415,361,462,414,443,436,471,370,430,400,424,60,-101,161
503,150000,28e29f2c03dcd84c,12,0,580,494,276,556,527,562,528,446,576,531,533,499,516,521,-34,2,-36
839,110000,28e29f2c03dcd84c,12,0,2146,1327,923,1308,982,1002,1096,834,1075,842,705,996,850,848,291,-137,428
880,510000,28e29f2c03dcd84c,12,0,1105,856,454,680,597,621,651,776,861,835,604,738,671,726,134,-231,365
1238,340000,28e29f2c03dcd84c,12,0,1070,953,364,644,584,685,706,708,895,856,786,924,855,855,138,-70,208
1662,370000,28e29f2c03dcd84c,12,0,1837,1329,778,1244,1284,1298,1141,1319,1334,1363,1113,1322,1218,1266,209,-250,459
772,140000,28e29f2c03dcd84c,12,0,1203,945,474,746,713,727,660,639,991,794,659,777,718,743,118,-135,253
621,440000,28e29f2c03dcd84c,12,0,825,423,180,427,549,477,696,389,618,526,381,555,468,487,174,-145,319
176,450000,28e29f2c03dcd84c,12,0,243,179,71,140,141,183,151,137,141,191,116,136,126,148,20,-75,95
1918,320000,28e29f2c03dcd84c,12,0,2643,1820,1058,1565,1288,1340,1313,1263,1676,1620,1295,1548,1422,1488,253,-325,578
460,360000,28e29f2c03dcd84c,12,0,571,408,151,325,301,312,293,255,351,379,320,372,346,357,52,-59,111
1772,130000,28e29f2c03dcd84c,12,0,1923,1604,884,1377,1523,1631,1539,1425,1590,1515,1285,1653,1469,1484,368,-230,598
1516,410000,28e29f2c03dcd84c,12,0,1482,1178,548,1003,1062,1044,1052,1125,1238,1016,988,1131,1060,1045,143,-28,171
909,330000,28e29f2c03dcd84c,12,0,1112,767,352,679,681,651,616,628,814,733,614,823,718,723,209,-119,328
378,420000,28e29f2c03dcd84c,12,0,483,446,164,271,261,296,275,330,388,373,300,273,286,315,-27,-73,46
630,430000,28e29f2c03dcd84c,12,0,783,487,262,452,359,428,383,395,447,527,425,461,443,471,36,-102,138
275,350000,28e29f2c03dcd84c,12,0,456,397,140,227,217,291,297,182,259,217,256,253,254,242,-3,39,-42
194,210000,28e29f2c03dcd84c,12,0,310,270,165,356,218,179,255,221,255,217,176,183,180,192,7,-41,48
452,500000,28e29f2c03dcd84c,12,0,644,555,263,408,381,378,462,374,447,448,311,353,332,371,42,-137,179
602,610000,28e29f2c03dcd84c,12,0,758,719,361,603,579,645,499,553,624,536,522,551,536,536,29,-14,43
91,230000,28e29f2c03dcd84c,12,0,169,104,79,149,106,141,121,123,121,96,100,74,87,90,-26,4,-30
50,310000,37aa9169b575ef79,12,0,117,63,37,86,109,100,151,123,42,55,43,69,56,56,26,-12,38
1707,530000,37aa9169b575ef79,12,0,1590,946,692,1035,755,884,765,1277,1207,1465,1333,1653,1493,1484,320,-132,452
1157,150000,37aa9169b575ef79,12,0,982,602,413,714,724,743,629,652,1139,1161,1060,1217,1138,1146,157,-101,258
470,110000,37aa9169b575ef79,12,0,985,300,271,404,282,274,292,278,289,341,277,438,358,352,161,-64,225
3557,510000,37aa9169b575ef79,12,0,3340,1470,1639,3175,2405,2457,2398,2530,2754,3201,2401,2911,2656,2838,510,-800,1310
647,340000,37aa9169b575ef79,12,0,575,248,260,384,279,286,452,366,371,478,493,479,486,483,-14,15,-29
4485,370000,37aa9169b575ef79,12,0,4024,1903,1708,2748,2376,2932,2420,2797,3096,3668,3505,3426,3466,3533,-79,-163,84
1661,140000,37aa9169b575ef79,12,0,1616,679,442,672,792,892,815,1028,1189,1434,1465,1372,1418,1424,-93,31,-124
2864,440000,37aa9169b575ef79,12,0,2398,1196,1075,2249,1558,2005,1936,1682,1885,2157,2044,2682,2363,2294,638,-113,751
553,450000,37aa9169b575ef79,12,0,435,440,301,449,664,501,523,446,573,488,369,373,371,410,4,-119,123
1047,320000,37aa9169b575ef79,12,0,930,527,626,655,605,586,670,623,694,810,917,910,914,879,-7,107,-114
567,360000,37aa9169b575ef79,12,0,540,354,189,356,270,359,296,244,355,399,425,430,428,418,5,26,-21
4404,130000,37aa9169b575ef79,12,0,4206,2068,1780,2633,2656,3148,2856,3242,3648,3843,3840,3797,3818,3827,-43,-3,-40
2932,410000,37aa9169b575ef79,12,0,2962,1570,1050,1823,1515,1509,1506,1785,1836,2094,2086,2076,2081,2085,-10,-8,-2
979,330000,37aa9169b575ef79,12,0,886,424,422,628,555,606,538,517,542,822,660,837,748,773,177,-162,339
704,420000,37aa9169b575ef79,12,0,920,483,270,442,304,376,403,430,440,533,573,565,569,557,-8,40,-48
1505,430000,37aa9169b575ef79,12,0,2336,1714,653,1232,835,1023,1076,1149,1284,1450,1174,1327,1250,1317,153,-276,429
648,350000,37aa9169b575ef79,12,0,622,308,292,460,424,486,428,470,413,661,640,624,632,642,-16,-21,5
1895,210000,37aa9169b575ef79,12,0,1878,681,691,1319,1119,1215,1237,1419,1601,1582,1557,1850,1704,1663,293,-25,318
348,500000,37aa9169b575ef79,12,0,247,131,105,125,160,126,176,161,199,234,262,286,274,261,24,28,-4
1137,610000,37aa9169b575ef79,12,0,1051,558,384,605,487,577,560,603,780,777,886,963,924,875,77,109,-32
2042,230000,37aa9169b575ef79,12,0,1781,730,952,1556,1254,1336,1463,1649,2283,2187,1730,2069,1900,1995,339,-457,796
4031,310000,63065128401bb3ff,12,0,3060,1909,501,2672,4039,883,4181,1421,1782,1879,887,1453,1170,1406,566,-992,1558
2108,530000,63065128401bb3ff,12,0,1402,656,504,651,603,785,827,1300,1307,1367,1252,1286,1269,1302,34,-115,149
1015,150000,63065128401bb3ff,12,0,827,268,214,376,413,543,491,575,777,749,772,819,796,780,47,23,24
1168,110000,63065128401bb3ff,12,0,2145,217,200,2331,1550,280,361,498,297,355,265,923,594,514,658,-90,748
4160,510000,63065128401bb3ff,12,0,2450,1355,937,1478,2078,1399,1459,1801,2351,2567,2053,2483,2268,2368,430,-514,944
3814,340000,63065128401bb3ff,12,0,3132,1460,775,1436,1362,1591,1598,1947,2510,2710,2516,2761,2638,2662,245,-194,439
5881,370000,63065128401bb3ff,12,0,5401,1885,1225,2010,2269,2615,2569,3263,3929,4366,4122,4579,4350,4356,457,-244,701
2204,140000,63065128401bb3ff,12,0,2066,692,491,877,974,1192,1135,1670,2019,1865,1828,1763,1796,1819,-65,-37,-28
2576,440000,63065128401bb3ff,12,0,2519,625,462,1475,1506,1216,1544,1515,1754,1731,1687,1766,1726,1728,79,-44,123
935,450000,63065128401bb3ff,12,0,616,308,176,366,289,407,451,518,551,689,586,649,618,641,63,-103,166
6650,320000,63065128401bb3ff,12,0,5643,2143,1862,2644,2631,3008,3307,4299,4173,4430,4745,5223,4984,4799,478,315,163
2823,360000,63065128401bb3ff,12,0,2357,973,442,916,895,1031,1009,1333,1810,1734,1615,1930,1772,1760,315,-119,434
6715,130000,63065128401bb3ff,12,0,5424,1723,1261,2043,2652,2981,2611,4091,4869,4197,4377,4580,4478,4385,203,180,23
7066,410000,63065128401bb3ff,12,0,5119,2463,1238,2429,2562,2723,3091,4009,4961,4989,4481,4887,4684,4786,406,-508,914
3570,330000,63065128401bb3ff,12,0,2755,895,768,1359,1321,1533,1474,1767,2205,2322,2259,2546,2402,2376,287,-63,350
2455,420000,63065128401bb3ff,12,0,1985,1002,357,841,848,822,1085,1431,1415,1567,1474,1785,1630,1609,311,-93,404
3403,430000,63065128401bb3ff,12,0,2533,1085,531,1104,1014,1204,1328,1663,1969,2202,1856,2467,2162,2175,611,-346,957
1980,350000,63065128401bb3ff,12,0,1549,440,400,775,721,1235,973,1141,1223,1242,1298,1293,1296,1278,-5,56,-61
1220,210000,63065128401bb3ff,12,0,1098,268,212,386,587,555,690,977,861,746,692,979,836,806,287,-54,341
1756,500000,63065128401bb3ff,12,0,1120,617,359,603,607,619,800,1027,1072,1122,870,978,924,990,108,-252,360
2002,610000,63065128401bb3ff,12,0,1748,631,397,661,1831,842,1735,1691,1436,1577,1777,1588,1682,1647,-189,200,-389
463,230000,63065128401bb3ff,12,0,480,162,156,276,218,323,452,354,467,458,427,445,436,443,18,-31,49
544,310000,ea489c253676aafc,12,0,754,315,362,767,319,351,300,314,334,352,238,335,286,308,97,-114,211
1391,530000,ea489c253676aafc,12,0,866,452,295,448,404,525,442,543,578,599,835,753,794,729,-82,236,-318
1616,150000,ea489c253676aafc,12,0,941,427,254,591,556,550,476,504,704,679,805,969,887,818,164,126,38
195,110000,ea489c253676aafc,12,0,546,125,89,159,100,115,114,150,110,113,75,167,121,118,92,-38,130
2230,510000,ea489c253676aafc,12,0,1812,1017,704,1344,1235,1081,1056,878,1050,1236,1013,1386,1200,1212,373,-223,596
2414,340000,ea489c253676aafc,12,0,1669,741,475,869,701,638,694,733,857,812,1004,1382,1193,1066,378,192,186
8288,370000,ea489c253676aafc,12,0,5496,2330,1515,2865,2841,2834,2558,2825,3266,3132,3700,4698,4199,3843,998,568,430
3670,140000,ea489c253676aafc,12,0,2626,1165,641,1247,1425,1531,1329,1557,1538,1282,1762,2132,1947,1725,370,480,-110
892,440000,ea489c253676aafc,12,0,1055,368,255,433,540,513,805,467,681,614,408,685,546,569,277,-206,483
582,450000,ea489c253676aafc,12,0,448,365,155,240,485,249,405,222,128,107,185,206,196,166,21,78,-57
2594,320000,ea489c253676aafc,12,0,2261,1167,1028,1507,1281,827,792,892,955,1053,993,1433,1213,1160,440,-60,500
814,360000,ea489c253676aafc,12,0,847,641,223,316,236,253,238,242,217,309,282,453,368,348,171,-27,198
8972,130000,ea489c253676aafc,12,0,5478,1932,1551,2981,3513,3250,2524,3284,3386,2904,3615,5099,4357,3873,1484,711,773
4199,410000,ea489c253676aafc,12,0,3092,1731,893,1695,1504,1408,1487,1714,1721,1597,1924,2619,2272,2047,695,327,368
1272,330000,ea489c253676aafc,12,0,1205,504,467,741,598,514,446,578,432,623,523,753,638,633,230,-100,330
565,420000,ea489c253676aafc,12,0,657,298,154,273,222,166,164,170,172,198,208,244,226,217,36,10,26
993,430000,ea489c253676aafc,12,0,1351,576,253,448,437,409,373,484,393,425,410,464,437,433,54,-15,69
663,350000,ea489c253676aafc,12,0,617,215,148,255,232,240,199,231,301,352,251,383,317,329,132,-101,233
1855,210000,ea489c253676aafc,12,0,1026,394,408,768,721,776,679,667,892,902,982,1252,1117,1045,270,80,190
621,500000,ea489c253676aafc,12,0,694,353,248,346,329,249,207,249,199,233,246,277,262,252,31,13,18
1652,610000,ea489c253676aafc,12,0,1400,754,418,791,600,553,553,625,614,777,930,1142,1036,950,212,153,59
1204,230000,ea489c253676aafc,12,0,710,280,266,503,464,518,466,471,859,943,658,999,828,867,341,-285,626
398,310000,cd5841d44fd7625e,12,0,359,339,177,321,249,248,328,254,307,237,241,314,278,264,73,4,69
537,530000,cd5841d44fd7625e,12,0,485,409,248,357,375,412,347,430,418,363,355,506,430,408,151,-8,159
562,150000,cd5841d44fd7625e,12,0,434,519,319,522,443,583,484,431,411,444,497,501,499,481,4,53,-49
1146,110000,cd5841d44fd7625e,12,0,1802,1263,877,1267,1047,1549,1033,967,860,855,791,996,894,881,205,-64,269
1191,510000,cd5841d44fd7625e,12,0,1083,1390,565,951,827,852,794,845,1009,1048,823,948,886,940,125,-225,350
754,340000,cd5841d44fd7625e,12,0,629,667,315,471,534,553,570,581,499,590,552,657,604,600,105,-38,143
2059,370000,cd5841d44fd7625e,12,0,1642,1861,878,1578,1694,1792,1554,1627,1927,1942,1727,2049,1888,1906,322,-215,537
527,140000,cd5841d44fd7625e,12,0,414,426,317,451,395,445,395,431,409,455,463,508,486,475,45,8,37
1278,440000,cd5841d44fd7625e,12,0,1243,727,322,827,693,791,804,769,839,878,889,996,942,921,107,11,96
363,450000,cd5841d44fd7625e,12,0,214,225,119,204,139,193,190,168,192,190,217,221,219,209,4,27,-23
1479,320000,cd5841d44fd7625e,12,0,1374,1336,868,1301,1124,1278,1241,1197,1296,1046,1162,1396,1279,1201,234,116,118
456,360000,cd5841d44fd7625e,12,0,329,364,141,291,237,315,278,285,309,268,301,381,341,317,80,33,47
1970,130000,cd5841d44fd7625e,12,0,1615,1768,1165,1697,1805,2074,1714,1806,1864,1750,1625,1780,1702,1718,155,-125,280
1901,410000,cd5841d44fd7625e,12,0,1443,1429,856,1325,1403,1419,1413,1478,1579,1504,1582,1735,1658,1607,153,78,75
1059,330000,cd5841d44fd7625e,12,0,863,742,356,707,633,707,646,663,732,701,734,955,844,797,221,33,188
709,420000,cd5841d44fd7625e,12,0,566,558,262,443,396,470,482,493,546,551,501,557,529,536,56,-50,106
648,430000,cd5841d44fd7625e,12,0,494,519,230,424,383,397,379,387,399,409,410,492,451,437,82,1,81
518,350000,cd5841d44fd7625e,12,0,402,404,188,330,251,340,301,284,315,604,431,529,480,521,98,-173,271
881,210000,cd5841d44fd7625e,12,0,1082,704,546,870,783,781,790,785,765,828,793,792,792,804,-1,-35,34
463,500000,cd5841d44fd7625e,12,0,391,433,202,335,319,317,436,335,381,329,373,351,362,351,-22,44,-66
610,610000,cd5841d44fd7625e,12,0,497,487,257,378,390,460,393,519,500,482,768,590,679,613,-178,286,-464
992,230000,cd5841d44fd7625e,12,0,964,785,666,1198,1070,1179,970,890,1044,870,813,1027,920,903,214,-57,271
347,310000,b25c4e2e3856af22,12,0,1504,815,447,731,532,612,632,552,602,639,404,495,450,513,91,-235,326
208,530000,b25c4e2e3856af22,12,0,785,585,277,403,310,422,368,501,439,383,371,382,376,379,11,-12,23
66,150000,b25c4e2e3856af22,12,0,430,303,110,229,177,183,153,136,170,141,127,115,121,128,-12,-14,2
95,110000,b25c4e2e3856af22,12,0,1127,376,284,427,371,462,336,275,270,272,206,198,202,225,-8,-66,58
284,510000,b25c4e2e3856af22,12,0,1775,1096,562,764,657,680,772,616,717,828,542,499,520,623,-43,-286,243
399,340000,b25c4e2e3856af22,12,0,1490,952,364,600,581,589,605,632,685,690,608,574,591,624,-34,-82,48
606,370000,b25c4e2e3856af22,12,0,1739,940,501,805,813,957,836,892,940,1047,835,856,846,913,21,-212,233
60,140000,b25c4e2e3856af22,12,0,371,229,113,151,138,130,107,102,135,123,108,86,97,106,-22,-15,-7
454,440000,b25c4e2e3856af22,12,0,2216,854,451,986,862,846,947,768,780,800,819,825,822,815,6,19,-13
123,450000,b25c4e2e3856af22,12,0,372,218,114,237,155,197,163,181,169,173,175,153,164,167,-22,2,-24
694,320000,b25c4e2e3856af22,12,0,3132,1586,987,1345,1015,1158,1068,1086,1181,1123,952,921,936,999,-31,-171,140
274,360000,b25c4e2e3856af22,12,0,1144,754,284,498,430,503,444,457,461,471,423,426,424,440,3,-48,51
287,130000,b25c4e2e3856af22,12,0,1218,652,442,599,687,716,543,668,679,581,499,505,502,528,6,-82,88
283,410000,b25c4e2e3856af22,12,0,1578,856,471,700,719,644,669,703,653,571,445,437,441,484,-8,-126,118
656,330000,b25c4e2e3856af22,12,0,3371,1749,893,1369,1150,1156,1037,1172,1334,1278,1146,1084,1115,1169,-62,-132,70
234,420000,b25c4e2e3856af22,12,0,1333,941,363,579,523,593,600,621,519,533,456,435,446,475,-21,-77,56
344,430000,b25c4e2e3856af22,12,0,1561,1003,386,716,610,659,562,594,642,673,494,526,510,564,32,-179,211
160,350000,b25c4e2e3856af22,12,0,1102,667,370,551,387,534,372,366,372,338,360,306,333,335,-54,22,-76
141,210000,b25c4e2e3856af22,12,0,555,253,188,258,212,206,203,265,272,248,226,236,231,237,10,-22,32
167,500000,b25c4e2e3856af22,12,0,740,452,184,293,290,264,303,274,250,248,200,193,196,214,-7,-48,41
107,610000,b25c4e2e3856af22,12,0,533,395,223,292,216,328,233,285,238,205,191,169,180,188,-22,-14,-8
115,230000,b25c4e2e3856af22,12,0,428,213,219,281,217,259,239,210,238,179,150,155,152,161,5,-29,34
864,310000,4a103c30d593fbbe,12,0,688,275,231,396,369,368,427,353,607,636,687,666,676,663,-21,51,-72
899,530000,4a103c30d593fbbe,12,0,1001,409,321,443,427,437,368,556,556,634,776,798,787,736,22,142,-120
887,150000,4a103c30d593fbbe,12,0,789,370,239,440,455,525,460,522,607,660,829,779,804,756,-50,169,-219
559,110000,4a103c30d593fbbe,12,0,1807,402,360,619,496,497,491,482,542,549,493,616,554,553,123,-56,179
3143,510000,4a103c30d593fbbe,12,0,3590,1589,1106,1523,1538,1537,1666,1861,2475,3069,2341,2533,2437,2648,192,-728,920
2187,340000,4a103c30d593fbbe,12,0,1968,921,593,995,1124,1199,1070,1346,1713,1638,1809,1647,1728,1698,-162,171,-333
3294,370000,4a103c30d593fbbe,12,0,3299,1329,945,1856,2083,2108,1738,2082,2655,2980,2964,2721,2842,2888,-243,-16,-227
940,140000,4a103c30d593fbbe,12,0,1130,401,261,510,549,610,526,688,866,791,915,926,920,877,11,124,-113
1928,440000,4a103c30d593fbbe,12,0,2397,475,354,1081,908,1044,1235,994,1368,1488,1712,1916,1814,1705,204,224,-20
551,450000,4a103c30d593fbbe,12,0,595,225,179,348,224,290,274,316,397,424,502,451,476,459,-51,78,-129
4141,320000,4a103c30d593fbbe,12,0,4302,1623,1477,2234,2129,2434,2155,2485,3088,3158,3744,3224,3484,3375,-520,586,-1106
1012,360000,4a103c30d593fbbe,12,0,1016,398,230,537,551,590,548,652,808,842,1004,916,960,921,-88,162,-250
4237,130000,4a103c30d593fbbe,12,0,3954,1565,1311,2239,2725,3260,2705,3344,4173,4034,4164,3884,4024,4027,-280,130,-410
3906,410000,4a103c30d593fbbe,12,0,3291,1489,872,1684,1948,1801,1780,2489,2996,3374,3430,3303,3366,3369,-127,56,-183
3228,330000,4a103c30d593fbbe,12,0,2897,961,793,1491,1417,1453,1417,1645,2472,2753,3040,2713,2876,2835,-327,287,-614
1298,420000,4a103c30d593fbbe,12,0,1304,805,357,634,667,656,762,898,966,1182,1166,938,1052,1095,-228,-16,-212
1312,430000,4a103c30d593fbbe,12,0,1222,427,264,565,544,561,563,728,991,1080,998,1178,1088,1085,180,-82,262
1080,350000,4a103c30d593fbbe,12,0,924,385,327,518,415,620,444,541,690,728,859,918,888,835,59,131,-72
1282,210000,4a103c30d593fbbe,12,0,1513,414,423,828,916,847,707,895,1272,1162,1131,1259,1195,1184,128,-31,159
635,500000,4a103c30d593fbbe,12,0,612,296,209,288,300,336,388,329,435,559,585,545,565,563,-40,26,-66
1184,610000,4a103c30d593fbbe,12,0,1143,404,239,410,468,587,452,654,835,911,1108,886,997,968,-222,197,-419
1104,230000,4a103c30d593fbbe,12,0,1198,462,436,1058,713,772,690,729,1100,842,859,1078,968,926,219,17,202
1012,310000,7a7885e2d7c00bcf,12,0,925,325,455,653,555,624,740,612,758,1004,810,1382,1096,1065,572,-194,766
428,530000,7a7885e2d7c00bcf,12,0,546,194,218,317,270,316,211,290,290,300,338,342,340,327,4,38,-34
349,150000,7a7885e2d7c00bcf,12,0,418,168,163,287,292,335,266,288,328,334,323,334,328,330,11,-11,22
739,110000,7a7885e2d7c00bcf,12,0,1615,471,523,831,698,714,664,617,559,655,482,726,604,621,244,-173,417
910,510000,7a7885e2d7c00bcf,12,0,1167,445,516,738,665,640,630,656,820,1044,665,802,734,837,137,-379,516
887,340000,7a7885e2d7c00bcf,12,0,1003,374,418,658,653,606,565,618,791,819,792,825,808,812,33,-27,60
2250,370000,7a7885e2d7c00bcf,12,0,2766,875,984,1739,1860,1899,1420,1615,2002,2507,2148,2497,2322,2384,349,-359,708
316,140000,7a7885e2d7c00bcf,12,0,484,139,184,247,243,229,225,247,307,331,274,309,292,305,35,-57,92
953,440000,7a7885e2d7c00bcf,12,0,1464,402,402,896,629,772,826,680,829,845,876,919,898,880,43,31,12
298,450000,7a7885e2d7c00bcf,12,0,384,118,109,224,157,222,215,154,183,203,224,236,230,221,12,21,-9
2732,320000,7a7885e2d7c00bcf,12,0,3241,1057,1612,2234,1953,2227,1909,2048,2422,2463,2396,2598,2497,2486,202,-67,269
478,360000,7a7885e2d7c00bcf,12,0,511,213,176,385,307,351,273,345,404,431,370,388,379,396,18,-61,79
1907,130000,7a7885e2d7c00bcf,12,0,2115,754,885,1533,1690,1813,1571,1661,1916,1901,1771,1881,1826,1851,110,-130,240
1630,410000,7a7885e2d7c00bcf,12,0,1740,591,724,1200,1228,1058,967,1158,1211,1356,1347,1448,1398,1384,101,-9,110
2406,330000,7a7885e2d7c00bcf,12,0,2662,818,1237,1764,1676,1729,1525,1884,2258,2311,2171,2155,2163,2212,-16,-140,124
518,420000,7a7885e2d7c00bcf,12,0,685,305,279,470,356,444,412,438,504,557,493,433,463,494,-60,-64,4
552,430000,7a7885e2d7c00bcf,12,0,768,256,278,497,347,424,341,409,480,525,413,527,470,488,114,-112,226
448,350000,7a7885e2d7c00bcf,12,0,608,216,257,389,262,395,326,356,356,363,428,434,431,408,6,65,-59
393,210000,7a7885e2d7c00bcf,12,0,595,169,217,412,408,386,321,346,352,385,344,400,372,376,56,-41,97
165,500000,7a7885e2d7c00bcf,12,0,258,69,99,133,100,129,180,126,116,163,123,156,140,147,33,-40,73
556,610000,7a7885e2d7c00bcf,12,0,657,185,238,361,306,395,301,417,437,460,507,470,488,479,-37,47,-84
347,230000,7a7885e2d7c00bcf,12,0,533,157,228,535,404,398,359,345,475,357,314,335,324,335,21,-43,64
50,310000,346393c2c6305fb1,12,0,215,76,41,45,61,38,52,37,39,38,27,26,26,30,-1,-11,10
69,530000,346393c2c6305fb1,12,0,182,95,41,34,36,31,58,44,55,41,52,57,54,50,5,11,-6
69,150000,346393c2c6305fb1,12,0,205,99,66,95,76,72,76,74,85,79,66,85,76,77,19,-13,32
60,110000,346393c2c6305fb1,12,0,439,74,40,54,53,41,27,32,51,39,40,36,38,38,-4,1,-5
217,510000,346393c2c6305fb1,12,0,513,309,153,136,133,149,150,134,136,183,129,148,138,153,19,-54,73
568,340000,346393c2c6305fb1,12,0,1047,578,273,312,307,331,314,279,347,395,358,404,381,386,46,-37,83
979,370000,346393c2c6305fb1,12,0,1844,902,381,538,572,675,544,536,649,690,646,674,660,670,28,-44,72
378,140000,346393c2c6305fb1,12,0,545,238,158,237,226,236,217,178,237,265,271,262,266,266,-9,6,-15
121,440000,346393c2c6305fb1,12,0,373,126,71,118,103,101,96,92,121,141,114,105,110,120,-9,-27,18
143,450000,346393c2c6305fb1,12,0,162,93,53,69,35,53,40,48,50,56,61,70,66,62,9,5,4
327,320000,346393c2c6305fb1,12,0,621,300,168,197,206,183,203,185,213,207,225,239,232,224,14,18,-4
105,360000,346393c2c6305fb1,12,0,266,151,36,61,68,60,40,53,57,59,62,57,60,59,-5,3,-8
930,130000,346393c2c6305fb1,12,0,1460,748,389,430,459,518,401,452,524,544,517,550,534,537,33,-27,60
527,410000,346393c2c6305fb1,12,0,1100,524,174,251,240,290,254,290,316,303,354,329,342,329,-25,51,-76
102,330000,346393c2c6305fb1,12,0,260,101,55,63,66,67,90,77,72,74,78,75,76,76,-3,4,-7
240,420000,346393c2c6305fb1,12,0,534,275,79,103,125,96,138,125,127,182,178,155,166,172,-23,-4,-19
228,430000,346393c2c6305fb1,12,0,535,308,119,163,126,142,139,138,161,166,159,176,168,167,17,-7,24
58,350000,346393c2c6305fb1,12,0,129,60,25,51,31,35,42,33,28,56,34,32,33,41,-2,-22,20
247,210000,346393c2c6305fb1,12,0,371,149,91,133,121,130,132,148,200,180,119,203,161,167,84,-61,145
101,500000,346393c2c6305fb1,12,0,335,168,84,69,66,80,88,67,79,85,68,53,60,69,-15,-17,2
170,610000,346393c2c6305fb1,12,0,360,209,62,83,76,106,84,83,85,110,130,105,118,115,-25,20,-45
125,230000,346393c2c6305fb1,12,0,312,126,95,154,101,143,86,105,123,132,70,154,112,119,84,-62,146
616,310000,02aab221aabc03b9,12,0,362,679,494,731,600,672,772,704,727,654,627,624,626,635,-3,-27,24
250,530000,02aab221aabc03b9,12,0,155,229,130,223,186,188,194,250,267,174,213,221,217,203,8,39,-31
88,150000,02aab221aabc03b9,12,0,59,106,63,136,99,113,83,99,112,92,79,72,76,81,-7,-13,6
640,110000,02aab221aabc03b9,12,0,521,798,532,838,575,694,618,670,630,659,544,647,596,617,103,-115,218
597,510000,02aab221aabc03b9,12,0,474,703,394,653,524,606,614,549,576,507,629,544,586,560,-85,122,-207
315,340000,02aab221aabc03b9,12,0,187,338,203,372,311,341,346,340,353,335,325,345,335,335,20,-10,30
480,370000,02aab221aabc03b9,12,0,353,610,362,607,527,608,548,531,526,473,504,529,516,502,25,31,-6
121,140000,02aab221aabc03b9,12,0,105,129,94,160,139,138,152,130,124,119,114,110,112,114,-4,-5,1
1182,440000,02aab221aabc03b9,12,0,1007,1207,847,1361,1093,1267,1219,1095,1304,1161,1178,1233,1206,1191,55,17,38
165,450000,02aab221aabc03b9,12,0,119,159,102,172,121,154,153,137,153,146,149,132,140,142,-17,3,-20
1340,320000,02aab221aabc03b9,12,0,1077,1735,1066,1713,1523,1554,1639,1493,1583,1338,1428,1399,1414,1388,-29,90,-119
209,360000,02aab221aabc03b9,12,0,152,242,146,291,216,232,253,206,215,224,199,233,216,219,34,-25,59
334,130000,02aab221aabc03b9,12,0,182,340,242,360,379,362,327,372,362,376,325,346,336,349,21,-51,72
311,410000,02aab221aabc03b9,12,0,223,320,199,311,289,319,320,350,407,332,310,322,316,321,12,-22,34
1295,330000,02aab221aabc03b9,12,0,1024,1529,973,1602,1326,1507,1501,1473,1537,1190,1401,1357,1379,1316,-44,211,-255
342,420000,02aab221aabc03b9,12,0,274,370,238,369,296,339,369,331,321,338,311,327,319,325,16,-27,43
301,430000,02aab221aabc03b9,12,0,215,305,186,346,275,278,289,275,275,299,270,266,268,278,-4,-29,25
365,350000,02aab221aabc03b9,12,0,324,518,242,572,350,498,528,403,477,413,401,478,440,431,77,-12,89
206,210000,02aab221aabc03b9,12,0,174,292,205,321,225,242,252,295,316,266,226,255,240,249,29,-40,69
255,500000,02aab221aabc03b9,12,0,217,267,199,277,240,244,232,258,263,190,261,210,236,220,-51,71,-122
197,610000,02aab221aabc03b9,12,0,197,285,151,281,203,248,250,270,252,210,232,204,218,215,-28,22,-50
51,230000,02aab221aabc03b9,12,0,53,93,68,133,85,82,113,113,134,92,79,76,78,82,-3,-13,10
451,310000,5d7fb682edd0f937,12,0,225,315,160,297,263,287,314,230,299,290,307,324,316,307,17,17,0
190,530000,5d7fb682edd0f937,12,0,176,164,108,164,133,153,126,180,169,187,139,179,159,168,40,-48,88
114,150000,5d7fb682edd0f937,12,0,86,86,62,103,111,102,97,88,89,103,85,91,88,93,6,-18,24
373,110000,5d7fb682edd0f937,12,0,417,323,190,356,270,290,257,234,246,289,227,292,260,269,65,-62,127
421,510000,5d7fb682edd0f937,12,0,337,483,166,411,313,351,316,288,271,389,298,353,326,347,55,-91,146
251,340000,5d7fb682edd0f937,12,0,174,188,119,173,183,210,172,186,222,219,180,232,206,210,52,-39,91
381,370000,5d7fb682edd0f937,12,0,253,339,160,306,297,331,234,253,292,332,281,323,302,312,42,-51,93
115,140000,5d7fb682edd0f937,12,0,91,111,56,97,101,97,84,91,94,102,75,77,76,85,2,-27,29
765,440000,5d7fb682edd0f937,12,0,512,581,314,531,409,540,562,422,478,505,502,589,546,532,87,-3,90
169,450000,5d7fb682edd0f937,12,0,109,128,57,103,59,104,114,85,94,92,94,107,100,98,13,2,11
941,320000,5d7fb682edd0f937,12,0,734,807,456,741,678,793,643,655,701,797,673,806,740,759,133,-124,257
181,360000,5d7fb682edd0f937,12,0,138,165,79,158,126,152,118,104,127,138,158,140,149,145,-18,20,-38
244,130000,5d7fb682edd0f937,12,0,178,203,126,201,195,251,175,165,222,247,198,194,196,213,-4,-49,45
264,410000,5d7fb682edd0f937,12,0,173,186,103,191,191,194,156,186,216,215,183,191,187,196,8,-32,40
950,330000,5d7fb682edd0f937,12,0,595,656,382,738,625,720,647,584,732,718,681,710,696,703,29,-37,66
332,420000,5d7fb682edd0f937,12,0,266,270,142,257,214,255,256,231,241,262,216,268,242,249,52,-46,98
270,430000,5d7fb682edd0f937,12,0,191,210,114,205,161,191,162,167,198,213,168,187,178,189,19,-45,64
366,350000,5d7fb682edd0f937,12,0,205,241,127,267,183,283,239,197,201,237,226,219,222,227,-7,-11,4
173,210000,5d7fb682edd0f937,12,0,128,140,90,113,125,138,146,129,145,130,114,155,134,133,41,-16,57
190,500000,5d7fb682edd0f937,12,0,134,131,54,117,102,136,130,124,110,144,134,137,136,138,3,-10,13
169,610000,5d7fb682edd0f937,12,0,145,159,85,142,119,156,144,123,140,138,149,133,141,140,-16,11,-27
66,230000,5d7fb682edd0f937,12,0,61,68,34,78,65,79,70,61,83,81,56,48,52,62,-8,-25,17
554,310000,a207df29ec9583f0,12,0,474,835,424,592,562,626,644,634,694,593,524,572,548,563,48,-69,117
267,530000,a207df29ec9583f0,12,0,215,310,178,234,223,203,223,258,250,238,175,252,214,222,77,-63,140
106,150000,a207df29ec9583f0,12,0,74,139,87,116,104,125,105,116,128,105,107,97,102,103,-10,2,-12
703,110000,a207df29ec9583f0,12,0,817,1033,648,841,763,792,726,727,824,751,607,773,690,710,166,-144,310
485,510000,a207df29ec9583f0,12,0,382,695,383,524,456,456,507,479,440,615,366,469,418,483,103,-249,352
238,340000,a207df29ec9583f0,12,0,177,354,152,225,259,222,223,254,259,255,231,246,238,244,15,-24,39
439,370000,a207df29ec9583f0,12,0,336,608,328,530,488,475,451,429,468,468,361,427,394,419,66,-107,173
137,140000,a207df29ec9583f0,12,0,100,165,96,130,118,97,142,140,152,138,125,143,134,135,18,-13,31
1060,440000,a207df29ec9583f0,12,0,825,1178,690,1101,964,1020,962,1084,1109,1111,990,946,968,1016,-44,-121,77
144,450000,a207df29ec9583f0,12,0,114,160,106,163,133,138,136,134,129,148,137,150,144,145,13,-11,24
967,320000,a207df29ec9583f0,12,0,1007,1591,766,1115,1026,1072,1033,982,1080,1012,891,978,934,960,87,-121,208
167,360000,a207df29ec9583f0,12,0,108,227,115,167,214,182,168,165,197,175,164,177,170,172,13,-11,24
244,130000,a207df29ec9583f0,12,0,219,376,209,316,289,290,301,301,298,260,239,251,245,250,12,-21,33
249,410000,a207df29ec9583f0,12,0,262,357,201,287,304,275,256,289,287,329,268,301,284,299,33,-61,94
870,330000,a207df29ec9583f0,12,0,908,1436,623,970,967,965,954,954,1063,930,896,805,850,877,-91,-34,-57
405,420000,a207df29ec9583f0,12,0,356,436,202,366,316,282,393,360,384,379,336,340,338,352,4,-43,47
272,430000,a207df29ec9583f0,12,0,192,302,179,246,255,226,219,246,249,252,213,211,212,225,-2,-39,37
278,350000,a207df29ec9583f0,12,0,256,500,212,338,297,357,330,288,330,361,323,344,334,343,21,-38,59
210,210000,a207df29ec9583f0,12,0,227,304,176,286,261,241,263,276,299,268,233,247,240,249,14,-35,49
227,500000,a207df29ec9583f0,12,0,194,265,152,205,197,174,223,187,198,223,169,183,176,192,14,-54,68
173,610000,a207df29ec9583f0,12,0,216,307,140,222,205,251,252,248,224,226,202,230,216,219,28,-24,52
69,230000,a207df29ec9583f0,12,0,85,102,84,125,116,121,127,86,123,92,77,84,80,84,7,-15,22
333,310000,b4be3a4917289c82,12,0,262,80,97,160,113,154,142,142,182,210,219,168,194,199,-51,9,-60
75,530000,b4be3a4917289c82,12,0,59,26,35,34,50,78,51,74,46,58,61,81,71,67,20,3,17
40,150000,b4be3a4917289c82,12,0,37,22,17,26,37,25,21,17,27,25,23,32,28,27,9,-2,11
284,110000,b4be3a4917289c82,12,0,226,93,117,153,137,139,94,88,112,163,169,148,158,160,-21,6,-27
180,510000,b4be3a4917289c82,12,0,223,57,76,90,137,164,128,144,184,277,125,154,140,185,29,-152,181
190,340000,b4be3a4917289c82,12,0,121,57,59,72,81,74,76,100,108,95,113,95,104,101,-18,18,-36
338,370000,b4be3a4917289c82,12,0,199,113,137,218,152,167,149,160,180,268,232,188,210,229,-44,-36,-8
43,140000,b4be3a4917289c82,12,0,33,16,10,28,22,76,22,26,27,34,36,30,33,33,-6,2,-8
254,440000,b4be3a4917289c82,12,0,384,120,115,231,223,244,188,202,225,232,206,270,238,236,64,-26,90
48,450000,b4be3a4917289c82,12,0,40,20,18,18,25,33,31,30,38,53,32,41,36,42,9,-21,30
693,320000,b4be3a4917289c82,12,0,591,225,325,414,342,390,329,340,426,503,487,468,478,486,-19,-16,-3
67,360000,b4be3a4917289c82,12,0,85,10,18,37,40,39,37,38,50,58,43,56,50,52,13,-15,28
248,130000,b4be3a4917289c82,12,0,161,78,99,131,131,102,71,97,118,127,156,140,148,141,-16,29,-45
148,410000,b4be3a4917289c82,12,0,163,57,77,90,88,75,84,92,121,128,128,102,115,119,-26,0,-26
747,330000,b4be3a4917289c82,12,0,567,168,290,344,386,300,355,415,511,575,426,526,476,509,100,-149,249
104,420000,b4be3a4917289c82,12,0,142,48,54,76,88,66,69,75,103,111,77,89,83,92,12,-34,46
94,430000,b4be3a4917289c82,12,0,124,41,43,61,74,75,46,72,85,92,69,62,66,74,-7,-23,16
63,350000,b4be3a4917289c82,12,0,127,23,28,50,51,59,58,62,64,70,54,58,56,61,4,-16,20
104,210000,b4be3a4917289c82,12,0,83,28,38,67,45,65,40,54,75,89,57,75,66,74,18,-32,50
63,500000,b4be3a4917289c82,12,0,67,17,20,19,34,34,37,30,40,56,32,56,44,48,24,-24,48
79,610000,b4be3a4917289c82,12,0,82,41,52,48,66,99,56,51,90,75,83,64,74,74,-19,8,-27
30,230000,b4be3a4917289c82,12,0,45,18,18,48,30,46,28,19,30,30,25,16,20,24,-9,-5,-4
794,310000,ef76a85c4b39f693,12,0,492,378,283,374,311,427,498,475,609,825,487,659,573,657,172,-338,510
219,530000,ef76a85c4b39f693,12,0,154,140,101,145,149,178,192,272,277,259,213,219,216,230,6,-46,52
162,150000,ef76a85c4b39f693,12,0,109,121,79,109,124,169,140,135,176,185,176,166,171,176,-10,-9,-1
628,110000,ef76a85c4b39f693,12,0,576,511,299,438,522,580,543,591,697,730,557,639,598,642,82,-173,255
689,510000,ef76a85c4b39f693,12,0,526,495,291,361,444,497,529,571,643,1038,541,610,576,730,69,-497,566
434,340000,ef76a85c4b39f693,12,0,307,304,148,259,319,271,331,363,453,565,402,464,433,477,62,-163,225
659,370000,ef76a85c4b39f693,12,0,378,406,284,400,479,557,520,550,741,941,568,645,606,718,77,-373,450
162,140000,ef76a85c4b39f693,12,0,83,94,61,99,97,93,99,121,177,185,168,164,166,172,-4,-17,13
1130,440000,ef76a85c4b39f693,12,0,912,598,355,607,642,701,764,756,899,1094,934,958,946,995,24,-160,184
149,450000,ef76a85c4b39f693,12,0,68,74,33,77,72,113,104,139,145,158,129,132,130,140,3,-29,32
1571,320000,ef76a85c4b39f693,12,0,1028,993,652,891,910,1046,1085,1159,1451,1727,1253,1408,1330,1463,155,-474,629
305,360000,ef76a85c4b39f693,12,0,208,200,69,151,150,175,152,209,258,344,206,272,239,274,66,-138,204
489,130000,ef76a85c4b39f693,12,0,340,342,250,323,382,440,423,438,563,630,455,508,482,531,53,-175,228
432,410000,ef76a85c4b39f693,12,0,239,290,184,293,341,325,356,405,492,560,422,427,424,470,5,-138,143
1916,330000,ef76a85c4b39f693,12,0,1300,996,708,969,1088,1209,1284,1524,1958,2180,1479,1666,1572,1775,187,-701,888
425,420000,ef76a85c4b39f693,12,0,331,334,134,250,279,305,303,339,437,473,371,410,390,418,39,-102,141
420,430000,ef76a85c4b39f693,12,0,310,284,146,251,271,354,267,331,429,484,339,366,352,396,27,-145,172
278,350000,ef76a85c4b39f693,12,0,176,229,97,153,164,270,221,253,308,353,274,306,290,311,32,-79,111
531,210000,ef76a85c4b39f693,12,0,261,256,190,274,317,341,370,440,648,531,397,431,414,453,34,-134,168
240,500000,ef76a85c4b39f693,12,0,157,115,82,120,97,175,209,162,190,256,142,200,171,199,58,-114,172
353,610000,ef76a85c4b39f693,12,0,205,223,136,166,239,247,199,284,366,387,357,344,350,363,-13,-30,17
156,230000,ef76a85c4b39f693,12,0,145,104,92,153,138,145,157,161,240,210,129,159,144,166,30,-81,111
525,310000,bb9fbec9a2833839,12,0,507,266,214,347,256,335,387,323,471,449,434,528,481,470,94,-15,109
201,530000,bb9fbec9a2833839,12,0,225,142,99,142,158,164,176,231,206,157,158,222,190,179,64,1,63
167,150000,bb9fbec9a2833839,12,0,169,76,74,105,133,145,136,151,168,178,179,172,176,176,-7,1,-8
361,110000,bb9fbec9a2833839,12,0,450,177,170,259,234,290,279,265,274,353,267,381,324,334,114,-86,200
446,510000,bb9fbec9a2833839,12,0,394,242,224,324,333,361,319,358,452,596,393,398,396,462,5,-203,208
331,340000,bb9fbec9a2833839,12,0,310,160,139,211,231,217,227,254,298,323,290,307,298,307,17,-33,50
626,370000,bb9fbec9a2833839,12,0,507,305,251,332,402,428,398,413,574,597,509,607,558,571,98,-88,186
158,140000,bb9fbec9a2833839,12,0,97,55,43,101,86,111,100,106,169,173,150,174,162,166,24,-23,47
864,440000,bb9fbec9a2833839,12,0,895,435,271,630,599,641,694,710,772,788,776,849,812,804,73,-12,85
153,450000,bb9fbec9a2833839,12,0,124,79,66,108,95,119,99,124,137,118,143,133,138,131,-10,25,-35
1181,320000,bb9fbec9a2833839,12,0,1154,552,589,835,807,903,879,877,1098,1019,1157,1139,1148,1105,-18,138,-156
242,360000,bb9fbec9a2833839,12,0,178,106,91,145,142,176,146,152,202,227,235,230,232,231,-5,8,-13
400,130000,bb9fbec9a2833839,12,0,378,179,188,251,302,319,290,307,411,362,402,398,400,387,-4,40,-44
347,410000,bb9fbec9a2833839,12,0,308,156,143,260,258,238,212,252,290,348,286,346,316,327,60,-62,122
1499,330000,bb9fbec9a2833839,12,0,1169,550,543,759,841,892,995,1035,1285,1388,1216,1398,1307,1334,182,-172,354
464,420000,bb9fbec9a2833839,12,0,378,261,177,285,262,281,264,324,372,438,443,366,404,416,-77,5,-82
386,430000,bb9fbec9a2833839,12,0,309,145,129,251,238,285,222,261,332,310,299,299,299,303,0,-11,11
287,350000,bb9fbec9a2833839,12,0,293,168,110,183,202,270,233,236,280,255,305,311,308,290,6,50,-44
206,210000,bb9fbec9a2833839,12,0,213,86,85,121,151,164,140,139,209,233,143,187,165,188,44,-90,134
156,500000,bb9fbec9a2833839,12,0,130,65,59,92,68,101,131,82,96,144,114,131,122,130,17,-30,47
158,610000,bb9fbec9a2833839,12,0,174,112,81,131,150,180,137,151,189,198,226,155,190,193,-71,28,-99
97,230000,bb9fbec9a2833839,12,0,85,44,40,74,82,95,78,104,128,90,82,74,78,82,-8,-8,0
610,310000,da457d15788fe8ee,12,0,748,538,251,456,315,445,485,411,558,671,391,672,532,578,281,-280,561
228,530000,da457d15788fe8ee,12,0,344,263,166,191,198,263,290,341,252,328,261,267,264,285,6,-67,73
153,150000,da457d15788fe8ee,12,0,200,197,109,152,165,213,178,177,172,194,149,185,167,176,36,-45,81
1126,110000,da457d15788fe8ee,12,0,1050,755,424,693,651,781,754,805,949,920,743,1158,950,940,415,-177,592
584,510000,da457d15788fe8ee,12,0,641,624,348,443,468,502,547,611,673,959,435,590,512,661,155,-524,679
348,340000,da457d15788fe8ee,12,0,409,330,200,229,256,264,317,284,317,394,291,394,342,360,103,-103,206
661,370000,da457d15788fe8ee,12,0,646,659,309,458,540,534,523,541,632,768,491,603,547,621,112,-277,389
160,140000,da457d15788fe8ee,12,0,103,120,44,90,120,136,128,136,187,160,129,168,148,152,39,-31,70
1586,440000,da457d15788fe8ee,12,0,1829,1269,499,1006,894,1099,1203,1068,1323,1501,1221,1433,1327,1385,212,-280,492
210,450000,da457d15788fe8ee,12,0,255,213,82,152,117,156,149,174,198,193,169,169,169,177,0,-24,24
1308,320000,da457d15788fe8ee,12,0,1430,1304,649,954,933,1003,955,1112,1268,1354,983,1276,1130,1204,293,-371,664
309,360000,da457d15788fe8ee,12,0,247,282,85,186,198,229,203,249,256,341,219,291,255,284,72,-122,194
452,130000,da457d15788fe8ee,12,0,527,425,254,337,412,434,405,458,546,548,398,497,448,481,99,-150,249
428,410000,da457d15788fe8ee,12,0,502,442,251,354,426,325,372,375,398,412,339,431,385,394,92,-73,165
1605,330000,da457d15788fe8ee,12,0,1500,938,567,836,888,1017,1178,1317,1460,1660,1157,1678,1418,1498,521,-503,1024
488,420000,da457d15788fe8ee,12,0,526,572,259,428,363,377,445,438,468,503,382,559,470,481,177,-121,298
448,430000,da457d15788fe8ee,12,0,505,374,207,342,370,431,366,451,421,470,359,483,421,437,124,-111,235
312,350000,da457d15788fe8ee,12,0,358,335,144,206,194,282,238,262,319,348,276,355,316,326,79,-72,151
495,210000,da457d15788fe8ee,12,0,454,281,156,268,293,330,277,371,482,484,306,516,411,435,210,-178,388
210,500000,da457d15788fe8ee,12,0,244,199,108,153,121,186,284,146,224,267,164,244,204,225,80,-103,183
309,610000,da457d15788fe8ee,12,0,346,325,174,210,225,299,236,330,298,331,274,311,292,305,37,-57,94
173,230000,da457d15788fe8ee,12,0,198,139,94,144,137,133,149,128,210,136,95,172,134,134,77,-41,118
648,310000,6858d6dfe680bdf7,12,0,576,543,384,696,487,649,633,685,664,518,503,567,535,529,64,-15,79
281,530000,6858d6dfe680bdf7,12,0,257,243,199,312,234,314,249,292,267,233,166,210,188,203,44,-67,111
89,150000,6858d6dfe680bdf7,12,0,80,54,43,84,76,64,93,74,68,76,58,71,64,68,13,-18,31
696,110000,6858d6dfe680bdf7,12,0,816,536,311,688,527,617,587,668,640,578,411,581,496,523,170,-167,337
580,510000,6858d6dfe680bdf7,12,0,593,591,337,640,478,571,603,551,645,659,365,510,438,511,145,-294,439
466,340000,6858d6dfe680bdf7,12,0,385,322,230,435,350,391,362,386,364,400,336,325,330,354,-11,-64,53
491,370000,6858d6dfe680bdf7,12,0,440,468,289,622,538,593,498,535,586,540,332,443,388,438,111,-208,319
89,140000,6858d6dfe680bdf7,12,0,103,57,64,78,79,91,70,76,114,91,72,83,78,82,11,-19,30
1468,440000,6858d6dfe680bdf7,12,0,1319,1274,618,1449,1061,1394,1469,1265,1360,1372,1116,1163,1140,1217,47,-256,303
185,450000,6858d6dfe680bdf7,12,0,167,115,84,164,123,176,156,157,172,190,125,138,132,151,13,-65,78
1432,320000,6858d6dfe680bdf7,12,0,1160,1203,919,1681,1193,1428,1269,1375,1458,1073,894,1153,1024,1040,259,-179,438
230,360000,6858d6dfe680bdf7,12,0,200,185,89,224,198,224,201,206,230,203,138,173,156,171,35,-65,100
380,130000,6858d6dfe680bdf7,12,0,283,417,232,460,496,484,423,463,437,409,277,360,318,349,83,-132,215
390,410000,6858d6dfe680bdf7,12,0,350,258,224,388,425,429,397,410,418,393,275,329,302,332,54,-118,172
2059,330000,6858d6dfe680bdf7,12,0,1724,1540,1004,2273,1596,1876,1650,1852,1906,1579,1310,1686,1498,1525,376,-269,645
325,420000,6858d6dfe680bdf7,12,0,283,271,143,325,266,300,353,314,383,331,242,312,277,295,70,-89,159
430,430000,6858d6dfe680bdf7,12,0,374,375,195,380,321,402,363,372,409,397,243,350,296,330,107,-154,261
320,350000,6858d6dfe680bdf7,12,0,346,352,161,369,304,419,307,353,366,384,305,333,319,341,28,-79,107
246,210000,6858d6dfe680bdf7,12,0,186,215,146,225,256,285,240,260,305,212,189,228,208,210,39,-23,62
248,500000,6858d6dfe680bdf7,12,0,253,198,131,290,195,274,315,277,268,213,164,247,206,208,83,-49,132
234,610000,6858d6dfe680bdf7,12,0,174,188,135,235,193,286,212,215,219,199,188,186,187,191,-2,-11,9
86,230000,6858d6dfe680bdf7,12,0,76,70,44,104,104,97,90,78,104,69,44,94,69,69,50,-25,75
395,310000,79de4e4b24c35b04,12,0,825,333,136,253,217,192,208,169,209,261,157,325,241,248,168,-104,272
908,530000,79de4e4b24c35b04,12,0,1393,1050,634,598,559,552,559,568,496,633,817,622,720,691,-195,184,-379
222,150000,79de4e4b24c35b04,12,0,405,185,132,207,141,156,128,146,189,194,188,211,200,198,23,-6,29
164,110000,79de4e4b24c35b04,12,0,852,178,127,199,127,128,132,116,105,91,84,126,105,100,42,-7,49
589,510000,79de4e4b24c35b04,12,0,1509,1063,565,512,413,385,387,456,447,479,394,423,408,432,29,-85,114
1540,340000,79de4e4b24c35b04,12,0,2601,1965,1072,936,771,749,842,897,904,1032,1004,994,999,1010,-10,-28,18
3244,370000,79de4e4b24c35b04,12,0,5360,2858,1598,1729,1694,1756,1539,1936,1912,2146,2072,2048,2060,2089,-24,-74,50
839,140000,79de4e4b24c35b04,12,0,1442,701,396,447,437,462,390,470,484,542,537,572,554,550,35,-5,40
4687,440000,79de4e4b24c35b04,12,0,8421,3465,1872,3263,2465,2754,2779,2551,2831,3372,3213,3185,3199,3257,-28,-159,131
3603,450000,79de4e4b24c35b04,12,0,6171,2981,1510,1845,1206,1444,1326,1376,2120,1771,1953,1932,1942,1885,-21,182,-203
2577,320000,79de4e4b24c35b04,12,0,3757,2028,1542,1465,1325,1301,1251,1387,1382,1410,1551,1529,1540,1497,-22,141,-163
707,360000,79de4e4b24c35b04,12,0,1319,827,443,434,359,341,393,389,426,463,502,520,511,495,18,39,-21
2104,130000,79de4e4b24c35b04,12,0,2863,1366,1047,1021,1146,1168,1072,1294,1269,1276,1339,1412,1376,1342,73,63,10
5667,410000,79de4e4b24c35b04,12,0,9539,6024,2842,2528,2423,2523,2603,3162,2973,3080,3382,3241,3312,3234,-141,302,-443
1628,330000,79de4e4b24c35b04,12,0,2646,934,580,745,680,733,621,813,822,894,995,1020,1008,970,25,101,-76
719,420000,79de4e4b24c35b04,12,0,1629,1137,521,524,406,468,397,454,447,595,540,450,495,528,-90,-55,-35
1368,430000,79de4e4b24c35b04,12,0,2352,1658,771,808,663,615,657,743,779,889,856,851,854,865,-5,-33,28
493,350000,79de4e4b24c35b04,12,0,1086,453,316,456,314,359,319,319,322,371,355,542,448,423,187,-16,203
911,210000,79de4e4b24c35b04,12,0,1039,408,313,505,468,482,534,500,483,512,500,698,599,570,198,-12,210
244,500000,79de4e4b24c35b04,12,0,514,324,210,169,172,136,158,183,160,169,141,157,149,156,16,-28,44
1112,610000,79de4e4b24c35b04,12,0,1704,937,403,499,452,488,436,535,576,634,679,692,686,668,13,45,-32
668,230000,79de4e4b24c35b04,12,0,1045,394,365,562,482,469,565,521,543,559,428,606,517,531,178,-131,309
1335,310000,12f8b7e14947c34d,12,0,1483,389,338,505,521,647,608,619,726,770,537,944,740,750,407,-233,640
451,530000,12f8b7e14947c34d,12,0,567,208,160,208,214,226,198,297,263,248,248,339,294,278,91,0,91
646,150000,12f8b7e14947c34d,12,0,789,413,215,340,311,387,355,326,370,370,413,451,432,411,38,43,-5
127,110000,12f8b7e14947c34d,12,0,488,143,102,126,84,102,87,71,101,86,53,85,69,75,32,-33,65
1310,510000,12f8b7e14947c34d,12,0,1117,531,374,577,521,559,581,527,664,831,558,780,669,723,222,-273,495
680,340000,12f8b7e14947c34d,12,0,705,385,198,241,246,257,285,305,420,360,450,462,456,424,12,90,-78
1682,370000,12f8b7e14947c34d,12,0,1707,803,424,738,843,928,824,912,1138,1251,1154,1149,1152,1185,-5,-97,92
508,140000,12f8b7e14947c34d,12,0,464,131,87,174,169,231,178,188,345,260,267,296,282,274,29,7,22
352,440000,12f8b7e14947c34d,12,0,475,130,117,221,195,239,246,184,249,327,211,291,251,276,80,-116,196
153,450000,12f8b7e14947c34d,12,0,231,93,43,77,54,89,79,95,76,109,105,108,106,107,3,-4,7
2275,320000,12f8b7e14947c34d,12,0,2181,991,782,1094,1007,1280,1090,1058,1318,1361,1434,1500,1467,1432,66,73,-7
660,360000,12f8b7e14947c34d,12,0,495,251,128,183,180,217,188,232,281,331,328,426,377,362,98,-3,101
1339,130000,12f8b7e14947c34d,12,0,1229,546,360,592,598,847,611,670,860,765,645,710,678,707,65,-120,185
1234,410000,12f8b7e14947c34d,12,0,1053,508,259,492,410,471,586,659,755,577,697,765,731,680,68,120,-52
1267,330000,12f8b7e14947c34d,12,0,1213,348,291,556,450,632,576,610,714,681,755,881,818,772,126,74,52
442,420000,12f8b7e14947c34d,12,0,440,200,80,136,138,174,236,210,228,238,222,273,248,244,51,-16,67
847,430000,12f8b7e14947c34d,12,0,749,385,150,254,224,307,284,328,398,464,369,463,416,432,94,-95,189
451,350000,12f8b7e14947c34d,12,0,408,188,136,178,176,297,240,200,252,252,280,302,291,278,22,28,-6
161,210000,12f8b7e14947c34d,12,0,210,53,54,81,84,109,71,94,144,110,80,102,91,97,22,-30,52
244,500000,12f8b7e14947c34d,12,0,295,131,85,113,117,117,161,107,136,118,97,128,112,114,31,-21,52
1617,610000,12f8b7e14947c34d,12,0,1286,412,280,531,610,649,548,736,763,674,958,1013,986,882,55,284,-229
168,230000,12f8b7e14947c34d,12,0,228,66,80,160,104,150,105,113,153,106,123,117,120,115,-6,17,-23
485,310000,04e66e578f653ab9,12,0,679,950,175,263,226,214,231,1376,364,429,271,431,351,377,160,-158,318
197,530000,04e66e578f653ab9,12,0,293,131,118,135,108,106,85,183,133,193,170,219,194,194,49,-23,72
95,150000,04e66e578f653ab9,12,0,118,60,38,63,48,62,45,54,52,67,84,86,85,79,2,17,-15
112,110000,04e66e578f653ab9,12,0,280,180,87,167,105,117,108,135,120,201,105,148,126,151,43,-96,139
273,510000,04e66e578f653ab9,12,0,404,151,140,210,163,126,156,158,240,401,151,299,225,284,148,-250,398
203,340000,04e66e578f653ab9,12,0,201,116,64,85,74,80,96,91,141,190,131,225,178,182,94,-59,153
430,370000,04e66e578f653ab9,12,0,451,230,146,276,296,237,243,266,313,411,311,495,403,406,184,-100,284
101,140000,04e66e578f653ab9,12,0,95,42,23,68,34,43,37,45,67,94,54,109,82,86,55,-40,95
199,440000,04e66e578f653ab9,12,0,268,104,54,144,101,111,106,100,115,132,132,135,134,133,3,0,3
59,450000,04e66e578f653ab9,12,0,71,30,28,32,17,42,31,35,34,44,32,40,36,39,8,-12,20
651,320000,04e66e578f653ab9,12,0,669,334,279,388,278,361,289,335,427,537,405,723,564,555,318,-132,450
100,360000,04e66e578f653ab9,12,0,86,64,32,40,53,58,44,58,62,97,53,129,91,93,76,-44,120
304,130000,04e66e578f653ab9,12,0,272,140,97,162,151,190,159,151,222,288,202,316,259,269,114,-86,200
337,410000,04e66e578f653ab9,12,0,319,144,90,156,142,133,159,150,253,275,177,360,268,271,183,-98,281
533,330000,04e66e578f653ab9,12,0,452,190,120,235,179,236,184,200,265,399,223,510,366,377,287,-176,463
89,420000,04e66e578f653ab9,12,0,82,146,33,61,41,44,47,128,75,99,64,118,91,94,54,-35,89
199,430000,04e66e578f653ab9,12,0,228,105,59,115,89,71,92,97,142,167,127,193,160,162,66,-40,106
116,350000,04e66e578f653ab9,12,0,139,77,43,64,62,76,55,207,71,81,95,102,98,93,7,14,-7
54,210000,04e66e578f653ab9,12,0,81,42,40,28,19,48,46,42,41,57,41,66,54,55,25,-16,41
135,500000,04e66e578f653ab9,12,0,87,44,31,56,52,34,81,74,75,97,76,133,104,102,57,-21,78
159,610000,04e66e578f653ab9,12,0,238,124,83,169,151,120,99,145,151,182,131,211,171,175,80,-51,131
43,230000,04e66e578f653ab9,12,0,48,22,17,60,50,40,34,50,39,45,36,50,43,44,14,-9,23
249,310000,dff803b4024d261d,12,0,317,238,124,175,178,198,247,172,229,295,178,186,182,220,8,-117,125
104,530000,dff803b4024d261d,12,0,94,64,55,50,58,59,74,82,64,64,71,93,82,76,22,7,15
105,150000,dff803b4024d261d,12,0,114,119,58,88,84,113,93,124,126,127,119,94,106,113,-25,-8,-17
620,110000,dff803b4024d261d,12,0,954,488,303,463,422,404,405,524,536,639,464,491,478,531,27,-175,202
471,510000,dff803b4024d261d,12,0,560,493,212,308,310,321,356,354,476,541,437,373,405,450,-64,-104,40
258,340000,dff803b4024d261d,12,0,192,238,108,126,152,161,181,221,244,275,225,225,225,242,0,-50,50
861,370000,dff803b4024d261d,12,0,714,609,352,736,802,743,732,752,968,895,828,667,748,797,-161,-67,-94
234,140000,dff803b4024d261d,12,0,230,168,75,152,133,162,155,176,214,192,218,193,206,201,-25,26,-51
2769,440000,dff803b4024d261d,12,0,1893,1283,554,1157,1342,1371,1506,1365,1632,2543,2393,1966,2180,2301,-427,-150,-277
419,450000,dff803b4024d261d,12,0,333,316,132,218,179,232,209,214,240,299,302,319,310,307,17,3,14
1053,320000,dff803b4024d261d,12,0,865,785,520,701,575,790,696,727,808,884,890,866,878,880,-24,6,-30
328,360000,dff803b4024d261d,12,0,280,264,100,195,178,199,185,190,228,334,263,249,256,282,-14,-71,57
591,130000,dff803b4024d261d,12,0,454,387,248,489,372,444,470,561,546,540,446,469,458,485,23,-94,117
360,410000,dff803b4024d261d,12,0,300,319,141,195,250,224,252,313,287,373,278,291,284,314,13,-95,108
883,330000,dff803b4024d261d,12,0,787,577,391,567,562,623,668,663,739,794,766,751,758,770,-15,-28,13
676,420000,dff803b4024d261d,12,0,566,545,193,390,310,389,475,504,667,583,520,592,556,565,72,-63,135
513,430000,dff803b4024d261d,12,0,412,412,410,531,262,352,341,399,402,522,391,380,386,431,-11,-131,120
678,350000,dff803b4024d261d,12,0,562,555,242,485,658,692,517,589,652,643,659,727,693,676,68,16,52
328,210000,dff803b4024d261d,12,0,340,230,163,328,229,232,286,261,346,342,250,273,262,288,23,-92,115
412,500000,dff803b4024d261d,12,0,846,378,203,261,239,256,499,348,265,359,273,292,282,308,19,-86,105
227,610000,dff803b4024d261d,12,0,126,138,68,103,103,121,139,167,222,209,183,176,180,189,-7,-26,19
90,230000,dff803b4024d261d,12,0,107,57,72,88,195,88,95,117,126,705,86,104,95,298,18,-619,637
252,310000,61e73e32ad101892,12,0,374,264,140,173,111,133,219,252,305,253,189,224,206,222,35,-64,99
400,530000,61e73e32ad101892,12,0,423,403,246,278,240,349,251,370,328,322,342,384,363,349,42,20,22
578,150000,61e73e32ad101892,12,0,619,534,251,398,363,397,446,439,554,594,520,540,530,551,20,-74,94
747,110000,61e73e32ad101892,12,0,1441,741,459,672,521,645,648,738,710,716,555,804,680,692,249,-161,410
896,510000,61e73e32ad101892,12,0,1078,940,507,616,610,516,696,747,853,964,787,750,768,834,-37,-177,140
302,340000,61e73e32ad101892,12,0,273,247,107,152,149,170,178,202,240,274,256,234,245,255,-22,-18,-4
1000,370000,61e73e32ad101892,12,0,1011,688,350,548,657,631,628,667,792,970,906,824,865,900,-82,-64,-18
427,140000,61e73e32ad101892,12,0,348,274,115,219,218,272,224,246,326,337,407,371,389,372,-36,70,-106
2378,440000,61e73e32ad101892,12,0,2562,1849,777,1549,1067,1547,1898,1873,2104,2281,2270,2201,2236,2251,-69,-11,-58
383,450000,61e73e32ad101892,12,0,443,364,194,278,172,226,248,272,340,365,351,360,356,359,9,-14,23
750,320000,61e73e32ad101892,12,0,857,658,425,546,407,545,534,592,698,728,718,580,649,675,-138,-10,-128
363,360000,61e73e32ad101892,12,0,382,334,121,180,176,242,230,289,241,378,316,286,301,327,-30,-62,32
1203,130000,61e73e32ad101892,12,0,1042,804,407,572,721,849,721,962,1094,1052,1033,1012,1022,1032,-21,-19,-2
892,410000,61e73e32ad101892,12,0,656,654,303,427,422,450,484,638,714,768,669,651,660,696,-18,-99,81
820,330000,61e73e32ad101892,12,0,970,632,338,464,407,503,544,617,739,738,663,674,668,692,11,-75,86
1482,420000,61e73e32ad101892,12,0,1458,1429,526,890,740,929,1121,1218,1196,1452,1245,1203,1224,1300,-42,-207,165
749,430000,61e73e32ad101892,12,0,879,712,262,444,376,475,496,530,587,687,558,506,532,584,-52,-129,77
401,350000,61e73e32ad101892,12,0,523,387,223,336,237,399,355,340,322,385,473,382,428,413,-91,88,-179
1011,210000,61e73e32ad101892,12,0,1105,571,424,658,595,611,583,678,909,852,761,829,795,814,68,-91,159
591,500000,61e73e32ad101892,12,0,732,616,327,364,351,290,544,368,383,473,447,430,438,450,-17,-26,9
635,610000,61e73e32ad101892,12,0,618,561,288,381,522,505,419,505,615,617,643,476,560,579,-167,26,-193
508,230000,61e73e32ad101892,12,0,497,267,165,333,307,314,331,413,428,410,378,440,409,409,62,-32,94
180,310000,a432c483b5beb856,12,0,237,68,37,61,48,42,46,60,56,89,75,92,84,85,17,-14,31
275,530000,a432c483b5beb856,12,0,271,140,100,100,97,72,92,101,116,117,159,182,170,153,23,42,-19
211,150000,a432c483b5beb856,12,0,195,78,54,74,78,87,84,89,105,134,146,180,163,153,34,12,22
105,110000,a432c483b5beb856,12,0,205,34,44,59,36,32,45,41,40,42,48,82,65,57,34,6,28
654,510000,a432c483b5beb856,12,0,560,275,186,178,154,123,197,155,287,297,268,393,330,319,125,-29,154
376,340000,a432c483b5beb856,12,0,496,209,109,109,97,103,125,123,120,141,192,188,190,174,-4,51,-55
574,370000,a432c483b5beb856,12,0,599,241,156,188,181,193,211,187,260,255,349,312,330,305,-37,94,-131
214,140000,a432c483b5beb856,12,0,226,67,52,65,70,76,81,82,108,105,132,143,138,127,11,27,-16
1862,440000,a432c483b5beb856,12,0,1753,510,290,467,429,504,568,492,615,692,978,1185,1082,952,207,286,-79
372,450000,a432c483b5beb856,12,0,314,161,76,113,66,89,103,111,120,142,206,230,218,193,24,64,-40
995,320000,a432c483b5beb856,12,0,1176,484,399,360,358,395,364,346,423,460,571,596,584,542,25,111,-86
521,360000,a432c483b5beb856,12,0,556,258,99,139,120,123,138,130,192,210,317,296,306,274,-21,107,-128
523,130000,a432c483b5beb856,12,0,435,164,126,133,165,184,178,191,217,243,293,344,318,293,51,50,1
819,410000,a432c483b5beb856,12,0,562,252,130,136,161,188,248,234,365,372,457,425,441,418,-32,85,-117
1015,330000,a432c483b5beb856,12,0,1102,332,255,331,293,293,451,433,549,507,551,587,569,548,36,44,-8
368,420000,a432c483b5beb856,12,0,526,267,110,92,100,79,129,117,148,188,203,243,223,211,40,15,25
656,430000,a432c483b5beb856,12,0,627,286,115,133,96,119,133,162,229,236,300,359,330,298,59,64,-5
409,350000,a432c483b5beb856,12,0,500,185,128,160,130,141,134,138,134,168,231,259,245,219,28,63,-35
386,210000,a432c483b5beb856,12,0,299,101,86,133,111,127,127,138,164,160,216,222,219,199,6,56,-50
230,500000,a432c483b5beb856,12,0,317,179,87,70,59,80,101,84,95,112,155,125,140,131,-30,43,-73
186,610000,a432c483b5beb856,12,0,242,89,58,62,55,62,48,76,86,87,115,113,114,105,-2,28,-30
161,230000,a432c483b5beb856,12,0,126,60,44,65,66,61,78,87,93,69,84,113,98,89,29,15,14
454,310000,0797526c057dcf5b,12,0,571,175,135,300,320,311,280,332,341,475,288,330,309,364,42,-187,229
438,530000,0797526c057dcf5b,12,0,393,160,154,201,154,174,208,237,210,296,354,527,440,392,173,58,115
736,150000,0797526c057dcf5b,12,0,631,236,164,278,287,352,354,352,396,368,451,533,492,451,82,83,-1
489,110000,0797526c057dcf5b,12,0,980,232,253,315,319,299,344,411,421,374,323,378,350,358,55,-51,106
1713,510000,0797526c057dcf5b,12,0,1536,609,478,708,677,703,870,874,1179,1263,1119,1083,1101,1155,-36,-144,108
951,340000,0797526c057dcf5b,12,0,750,358,257,522,447,450,474,531,638,743,737,778,758,753,41,-6,47
3961,370000,0797526c057dcf5b,12,0,5481,1788,1203,1635,2012,1985,2046,2150,2770,3225,3176,2804,2990,3068,-372,-49,-323
2044,140000,0797526c057dcf5b,12,0,1474,502,371,567,626,775,870,822,1077,1141,1396,1289,1342,1275,-107,255,-362
12138,440000,0797526c057dcf5b,12,0,15317,5306,3718,8079,6812,7957,8612,8119,10514,11327,10929,10485,10707,10914,-444,-398,-46
2963,450000,0797526c057dcf5b,12,0,2693,1195,777,1366,1087,1463,1613,1736,2291,2448,2230,2157,2194,2278,-73,-218,145
3369,320000,0797526c057dcf5b,12,0,3296,1247,1529,2148,2087,2259,2343,2472,2603,2698,2915,2532,2724,2715,-383,217,-600
1982,360000,0797526c057dcf5b,12,0,1764,857,484,797,835,979,1050,1189,1342,1563,1467,1393,1430,1474,-74,-96,22
3609,130000,0797526c057dcf5b,12,0,3796,1214,995,1259,1697,1832,1815,2279,2449,2337,2523,2518,2520,2459,-5,186,-191
3105,410000,0797526c057dcf5b,12,0,3130,1278,848,1290,1492,1391,1525,1910,2272,2311,2004,1999,2002,2105,-5,-307,302
2419,330000,0797526c057dcf5b,12,0,2088,700,801,1246,1369,1509,1644,1767,1896,1932,1907,1935,1921,1925,28,-25,53
2165,420000,0797526c057dcf5b,12,0,1562,736,376,772,827,842,1061,1101,1051,1206,1327,1303,1315,1279,-24,121,-145
2417,430000,0797526c057dcf5b,12,0,3168,1244,677,1105,1093,1503,1476,1786,1858,2160,1767,1696,1732,1874,-71,-393,322
1920,350000,0797526c057dcf5b,12,0,1981,769,598,1058,945,1316,1163,1316,1476,1544,1688,1572,1630,1601,-116,144,-260
3014,210000,0797526c057dcf5b,12,0,3705,1059,1132,1642,1541,1606,1822,1931,2151,2147,2045,2285,2165,2159,240,-102,342
866,500000,0797526c057dcf5b,12,0,828,333,235,331,330,400,708,364,385,467,671,547,609,562,-124,204,-328
642,610000,0797526c057dcf5b,12,0,722,289,175,287,284,326,299,382,387,425,432,390,411,416,-42,7,-49
1521,230000,0797526c057dcf5b,12,0,1064,350,347,604,509,589,621,701,1075,927,822,1104,963,951,282,-105,387
405,310000,936168bd4850913d,12,0,272,250,161,224,213,175,131,62,223,288,334,333,334,318,-1,46,-47
555,530000,936168bd4850913d,12,0,383,494,162,297,298,329,209,81,389,480,466,533,500,493,67,-14,81
507,150000,936168bd4850913d,12,0,374,412,213,364,399,353,232,84,339,393,355,458,406,402,103,-38,141
676,110000,936168bd4850913d,12,0,798,336,255,324,347,230,135,126,317,411,461,689,575,520,228,50,178
649,510000,936168bd4850913d,12,0,502,560,198,280,354,296,108,64,382,522,529,642,586,564,113,7,106
681,340000,936168bd4850913d,12,0,449,378,228,339,365,359,86,125,393,488,570,622,596,560,52,82,-30
1640,370000,936168bd4850913d,12,0,1083,1132,648,948,1214,1085,369,273,1000,1192,1241,1423,1332,1285,182,49,133
723,140000,936168bd4850913d,12,0,454,373,276,370,403,345,137,148,396,551,467,595,531,538,128,-84,212
4066,440000,936168bd4850913d,12,0,3119,2859,1337,2735,2621,2524,1566,594,2431,2956,3252,3829,3540,3346,577,296,281
481,450000,936168bd4850913d,12,0,316,376,154,306,255,297,140,103,277,336,389,407,398,377,18,53,-35
1390,320000,936168bd4850913d,12,0,1057,1012,579,905,787,820,405,226,838,926,1064,1203,1134,1064,139,138,1
576,360000,936168bd4850913d,12,0,414,397,195,355,439,342,151,95,317,402,446,437,442,428,-9,44,-53
1370,130000,936168bd4850913d,12,0,778,797,602,842,1066,971,374,253,922,911,1078,1205,1142,1065,127,167,-40
1705,410000,936168bd4850913d,12,0,1154,954,596,986,1159,919,330,428,1111,1295,1278,1512,1395,1362,234,-17,251
1341,330000,936168bd4850913d,12,0,819,752,388,650,682,669,277,191,789,847,1023,1105,1064,992,82,176,-94
2055,420000,936168bd4850913d,12,0,1497,1405,549,1164,1131,1057,674,316,1053,1385,1304,1723,1514,1471,419,-81,500
911,430000,936168bd4850913d,12,0,953,623,341,556,689,570,218,194,551,712,695,816,756,741,121,-17,138
796,350000,936168bd4850913d,12,0,611,627,347,556,479,612,226,137,543,591,622,700,661,638,78,31,47
1243,210000,936168bd4850913d,12,0,851,758,485,709,730,631,387,271,733,853,891,1081,986,942,190,38,152
322,500000,936168bd4850913d,12,0,208,248,87,111,125,128,35,39,154,285,243,301,272,276,58,-42,100
587,610000,936168bd4850913d,12,0,482,463,229,331,386,360,198,125,357,434,525,578,552,512,53,91,-38
814,230000,936168bd4850913d,12,0,549,617,346,607,485,461,268,130,519,630,543,729,636,634,186,-87,273
229,310000,cc21c7e91a3b5a0c,12,0,456,114,153,205,172,211,259,235,234,227,143,177,160,182,34,-84,118
309,530000,cc21c7e91a3b5a0c,12,0,442,406,203,364,347,383,359,548,448,420,225,359,292,335,134,-195,329
246,150000,cc21c7e91a3b5a0c,12,0,382,195,193,311,298,379,324,426,353,305,214,215,214,245,1,-91,92
257,110000,cc21c7e91a3b5a0c,12,0,580,121,115,186,128,156,127,143,113,150,121,198,160,156,77,-29,106
424,510000,cc21c7e91a3b5a0c,12,0,804,459,234,390,378,467,472,512,561,494,291,364,328,383,73,-203,276
457,340000,cc21c7e91a3b5a0c,12,0,503,403,244,376,434,485,530,589,548,523,287,377,332,396,90,-236,326
713,370000,cc21c7e91a3b5a0c,12,0,1164,554,505,703,953,906,900,978,952,895,531,700,616,709,169,-364,533
361,140000,cc21c7e91a3b5a0c,12,0,428,223,193,301,299,310,314,437,371,333,194,278,236,268,84,-139,223
2412,440000,cc21c7e91a3b5a0c,12,0,3730,1930,1262,2615,2284,2880,3003,3073,3157,2906,1622,2189,1906,2239,567,-1284,1851
313,450000,cc21c7e91a3b5a0c,12,0,417,266,187,309,304,370,332,440,396,386,211,275,243,291,64,-175,239
1015,320000,cc21c7e91a3b5a0c,12,0,1527,877,754,1069,1130,1243,1239,1359,1276,1127,677,913,795,906,236,-450,686
374,360000,cc21c7e91a3b5a0c,12,0,507,305,161,323,377,500,498,505,477,346,244,301,272,297,57,-102,159
612,130000,cc21c7e91a3b5a0c,12,0,797,453,434,572,723,877,842,1076,876,738,454,591,522,594,137,-284,421
867,410000,cc21c7e91a3b5a0c,12,0,1036,630,391,702,797,764,826,1251,974,822,486,743,614,684,257,-336,593
1000,330000,cc21c7e91a3b5a0c,12,0,1258,739,529,861,969,1092,1188,1336,1191,1013,688,900,794,867,212,-325,537
962,420000,cc21c7e91a3b5a0c,12,0,1511,963,454,719,775,822,1002,1247,1129,844,697,736,716,759,39,-147,186
440,430000,cc21c7e91a3b5a0c,12,0,737,420,189,443,430,470,484,597,615,466,266,399,332,377,133,-200,333
497,350000,cc21c7e91a3b5a0c,12,0,779,473,353,640,561,659,677,791,724,521,382,471,426,458,89,-139,228
510,210000,cc21c7e91a3b5a0c,12,0,602,285,241,431,475,512,466,627,589,508,353,426,390,429,73,-155,228
155,500000,cc21c7e91a3b5a0c,12,0,305,185,95,179,155,153,233,211,194,180,134,160,147,158,26,-46,72
287,610000,cc21c7e91a3b5a0c,12,0,496,293,157,234,292,346,246,352,406,274,153,229,191,219,76,-121,197
353,230000,cc21c7e91a3b5a0c,12,0,422,214,206,322,309,385,388,444,380,359,210,246,228,272,36,-149,185
194,310000,7aab7fca2470987e,12,0,348,224,140,212,313,130,176,126,150,183,117,199,158,166,82,-66,148
12,530000,7aab7fca2470987e,12,0,33,19,19,18,22,20,12,9,9,13,11,17,14,14,6,-2,8
27,150000,7aab7fca2470987e,12,0,22,21,19,29,36,17,19,26,22,19,25,21,23,22,-4,6,-10
216,110000,7aab7fca2470987e,12,0,511,424,244,378,320,244,260,250,268,314,181,257,219,251,76,-133,209
40,510000,7aab7fca2470987e,12,0,64,69,42,47,33,29,34,13,37,22,23,31,27,25,8,1,7
57,340000,7aab7fca2470987e,12,0,75,83,59,59,57,45,62,31,45,37,42,61,52,47,19,5,14
293,370000,7aab7fca2470987e,12,0,341,430,189,295,303,192,237,256,222,242,190,268,229,233,78,-52,130
97,140000,7aab7fca2470987e,12,0,78,105,64,83,78,62,75,85,83,109,96,93,94,99,-3,-13,10
847,440000,7aab7fca2470987e,12,0,1235,1009,443,848,749,579,865,757,844,906,781,910,846,866,129,-125,254
20,450000,7aab7fca2470987e,12,0,26,34,17,20,12,20,22,16,21,17,17,20,18,18,3,0,3
325,320000,7aab7fca2470987e,12,0,481,397,258,351,301,241,305,301,319,353,284,342,313,326,58,-69,127
32,360000,7aab7fca2470987e,12,0,37,61,16,26,40,25,30,32,20,29,23,32,28,28,9,-6,15
223,130000,7aab7fca2470987e,12,0,316,308,172,236,271,218,215,233,230,258,218,226,222,234,8,-40,48
148,410000,7aab7fca2470987e,12,0,209,242,134,155,146,105,140,155,161,153,126,142,134,140,16,-27,43
471,330000,7aab7fca2470987e,12,0,375,353,222,270,371,311,449,354,283,365,291,299,295,318,8,-74,82
47,420000,7aab7fca2470987e,12,0,62,54,47,52,51,39,64,44,59,48,34,63,48,48,29,-14,43
27,430000,7aab7fca2470987e,12,0,44,54,26,27,28,26,30,22,38,28,29,40,34,32,11,1,10
58,350000,7aab7fca2470987e,12,0,105,92,41,56,43,37,75,57,57,54,58,65,62,59,7,4,3
127,210000,7aab7fca2470987e,12,0,187,158,103,124,129,115,148,126,163,128,97,127,112,117,30,-31,61
21,500000,7aab7fca2470987e,12,0,27,22,12,27,12,19,15,18,21,16,10,19,14,15,9,-6,15
20,610000,7aab7fca2470987e,12,0,46,61,16,38,37,27,23,27,20,22,12,31,22,22,19,-10,29
37,230000,7aab7fca2470987e,12,0,65,66,41,61,62,37,56,42,70,58,32,39,36,43,7,-26,33
333,310000,fde95ea242abd896,12,0,369,161,142,190,140,165,214,189,313,284,306,224,265,271,-82,22,-104
333,530000,fde95ea242abd896,12,0,651,386,202,309,233,292,232,382,379,387,509,302,406,399,-207,122,-329
161,150000,fde95ea242abd896,12,0,234,146,90,139,127,131,111,141,187,208,204,142,173,185,-62,-4,-58
272,110000,fde95ea242abd896,12,0,382,210,141,181,149,153,130,100,130,167,151,159,155,159,8,-16,24
508,510000,fde95ea242abd896,12,0,839,509,240,360,342,344,334,430,617,773,547,429,488,583,-118,-226,108
330,340000,fde95ea242abd896,12,0,690,387,163,254,266,293,273,348,415,368,351,286,318,335,-65,-17,-48
970,370000,fde95ea242abd896,12,0,964,444,303,464,570,555,507,649,847,877,968,697,832,847,-271,91,-362
284,140000,fde95ea242abd896,12,0,443,175,132,238,204,221,191,257,331,373,351,213,282,312,-138,-22,-116
3599,440000,fde95ea242abd896,12,0,5547,3229,1517,2906,3040,2996,3064,2940,3296,3858,4197,3592,3894,3882,-605,339,-944
345,450000,fde95ea242abd896,12,0,665,381,181,321,247,278,230,271,353,423,346,374,360,381,28,-77,105
959,320000,fde95ea242abd896,12,0,1139,690,508,722,614,698,656,855,923,861,961,683,822,835,-278,100,-378
358,360000,fde95ea242abd896,12,0,625,381,184,276,300,321,252,286,354,387,280,246,263,304,-34,-107,73
757,130000,fde95ea242abd896,12,0,830,407,320,433,514,507,400,601,794,756,775,544,660,692,-231,19,-250
509,410000,fde95ea242abd896,12,0,920,507,247,499,530,473,405,626,853,641,609,449,529,566,-160,-32,-128
1215,330000,fde95ea242abd896,12,0,1424,732,558,806,842,817,859,969,1255,1091,1244,748,996,1028,-496,153,-649
730,420000,fde95ea242abd896,12,0,1347,698,270,511,498,504,540,672,774,908,619,630,624,719,11,-289,300
557,430000,fde95ea242abd896,12,0,988,570,203,418,421,498,401,577,729,628,544,384,464,519,-160,-84,-76
644,350000,fde95ea242abd896,12,0,1043,605,368,580,595,656,635,615,765,815,822,678,750,772,-144,7,-151
542,210000,fde95ea242abd896,12,0,600,253,193,341,357,363,293,369,581,567,618,502,560,562,-116,51,-167
183,500000,fde95ea242abd896,12,0,229,139,105,116,140,127,159,132,163,253,237,225,231,238,-12,-16,4
185,610000,fde95ea242abd896,12,0,293,140,96,140,126,155,135,199,252,297,330,178,254,268,-152,33,-185
251,230000,fde95ea242abd896,12,0,322,111,123,264,218,232,182,233,390,264,192,239,216,232,47,-72,119
462,310000,97f15de12cfabbd5,12,0,516,264,193,369,368,312,223,311,325,374,342,377,360,364,35,-32,67
141,530000,97f15de12cfabbd5,12,0,253,206,111,144,116,120,119,120,92,116,114,130,122,120,16,-2,18
254,150000,97f15de12cfabbd5,12,0,238,219,114,172,145,184,185,176,175,180,177,210,194,189,33,-3,36
498,110000,97f15de12cfabbd5,12,0,1094,601,390,482,397,375,385,359,390,493,438,628,533,520,190,-55,245
475,510000,97f15de12cfabbd5,12,0,543,391,237,325,296,251,270,231,353,472,247,331,289,350,84,-225,309
437,340000,97f15de12cfabbd5,12,0,578,495,153,185,233,254,279,190,233,316,289,283,286,296,-6,-27,21
1080,370000,97f15de12cfabbd5,12,0,1221,1031,476,846,727,791,753,709,746,888,910,988,949,929,78,22,56
495,140000,97f15de12cfabbd5,12,0,605,316,221,369,335,297,249,379,331,458,381,376,378,405,-5,-77,72
2800,440000,97f15de12cfabbd5,12,0,3747,2666,1125,2377,2460,2143,2250,2148,2251,2790,2698,2999,2848,2829,301,-92,393
152,450000,97f15de12cfabbd5,12,0,174,193,92,119,101,114,104,103,130,136,127,131,129,131,4,-9,13
1164,320000,97f15de12cfabbd5,12,0,1524,1070,552,1008,901,895,803,803,813,980,1039,1098,1068,1039,59,59,0
262,360000,97f15de12cfabbd5,12,0,409,346,81,166,179,201,165,187,208,207,235,216,226,219,-19,28,-47
985,130000,97f15de12cfabbd5,12,0,1119,789,422,734,762,790,652,806,800,941,861,973,917,925,112,-80,192
795,410000,97f15de12cfabbd5,12,0,866,692,326,488,531,450,448,469,417,510,471,591,531,524,120,-39,159
1724,330000,97f15de12cfabbd5,12,0,1515,1138,549,969,1010,1108,1385,1507,1239,1522,1512,1557,1534,1530,45,-10,55
653,420000,97f15de12cfabbd5,12,0,906,749,253,446,434,381,436,412,489,521,449,482,466,484,33,-72,105
628,430000,97f15de12cfabbd5,12,0,839,710,238,437,402,430,431,398,373,459,387,452,420,433,65,-72,137
487,350000,97f15de12cfabbd5,12,0,638,509,288,542,508,519,527,327,322,360,452,513,482,442,61,92,-31
1150,210000,97f15de12cfabbd5,12,0,1395,898,506,962,872,971,851,914,875,950,831,1106,968,962,275,-119,394
180,500000,97f15de12cfabbd5,12,0,213,159,106,164,130,104,160,133,125,141,144,162,153,149,18,3,15
296,610000,97f15de12cfabbd5,12,0,371,227,159,225,195,179,129,173,160,195,208,237,222,213,29,13,16
573,230000,97f15de12cfabbd5,12,0,783,366,217,537,358,448,306,533,522,375,424,571,498,457,147,49,98
270,310000,f5d69960089c3614,12,0,291,260,125,252,169,218,208,195,239,288,307,317,312,304,10,19,-9
57,530000,f5d69960089c3614,12,0,95,78,48,59,48,61,43,79,64,53,60,89,74,67,29,7,22
47,150000,f5d69960089c3614,12,0,64,35,18,51,53,69,55,61,64,72,82,60,71,71,-22,10,-32
290,110000,f5d69960089c3614,12,0,739,435,233,445,341,391,396,426,482,578,448,408,428,478,-40,-130,90
209,510000,f5d69960089c3614,12,0,296,270,133,178,212,190,231,208,233,444,241,312,276,332,71,-203,274
113,340000,f5d69960089c3614,12,0,125,156,59,89,69,81,70,72,75,150,124,107,116,127,-17,-26,9
213,370000,f5d69960089c3614,12,0,356,218,112,223,197,226,179,193,249,344,254,263,258,287,9,-90,99
43,140000,f5d69960089c3614,12,0,51,47,21,35,29,43,35,45,44,57,33,41,37,44,8,-24,32
321,440000,f5d69960089c3614,12,0,572,437,152,310,246,338,497,305,362,444,473,433,453,450,-40,29,-69
17,450000,f5d69960089c3614,12,0,46,44,34,25,32,38,35,50,44,68,69,57,63,65,-12,1,-13
212,320000,f5d69960089c3614,12,0,301,251,138,200,177,214,189,187,223,290,301,232,266,274,-69,11,-80
48,360000,f5d69960089c3614,12,0,92,84,32,51,53,76,51,70,67,97,77,76,76,83,-1,-20,19
126,130000,f5d69960089c3614,12,0,131,106,79,112,113,144,111,129,162,213,174,139,156,175,-35,-39,4
112,410000,f5d69960089c3614,12,0,187,131,57,111,155,108,118,135,163,164,158,129,144,150,-29,-6,-23
99,330000,f5d69960089c3614,12,0,230,149,78,139,107,108,142,110,130,142,139,127,133,136,-12,-3,-9
114,420000,f5d69960089c3614,12,0,184,148,61,111,94,101,110,110,157,162,143,138,140,148,-5,-19,14
109,430000,f5d69960089c3614,12,0,211,135,74,132,109,108,118,96,135,209,137,157,147,168,20,-72,92
89,350000,f5d69960089c3614,12,0,124,108,57,77,71,97,95,75,85,112,118,111,114,114,-7,6,-13
74,210000,f5d69960089c3614,12,0,129,69,51,75,76,107,67,96,152,173,146,141,144,153,-5,-27,22
101,500000,f5d69960089c3614,12,0,160,125,77,112,97,87,149,112,142,157,158,145,152,153,-13,1,-14
83,610000,f5d69960089c3614,12,0,182,148,77,137,111,172,117,112,144,202,224,152,188,193,-72,22,-94
51,230000,f5d69960089c3614,12,0,77,53,34,68,53,50,51,50,100,75,78,68,73,74,-10,3,-13
239,310000,5b1c11c3efed5312,12,0,388,154,85,126,92,105,104,90,95,93,83,143,113,106,60,-10,70
123,530000,5b1c11c3efed5312,12,0,267,194,91,60,53,77,69,54,60,68,102,97,100,89,-5,34,-39
85,150000,5b1c11c3efed5312,12,0,259,127,62,61,62,68,40,53,87,64,46,52,49,54,6,-18,24
25,110000,5b1c11c3efed5312,12,0,370,71,41,51,25,21,23,21,16,13,11,23,17,16,12,-2,14
282,510000,5b1c11c3efed5312,12,0,691,448,194,129,110,118,105,113,152,138,140,173,156,150,33,2,31
745,340000,5b1c11c3efed5312,12,0,1253,712,250,227,217,259,222,209,229,284,331,381,356,332,50,47,3
746,370000,5b1c11c3efed5312,12,0,1449,549,320,297,347,332,246,290,297,412,443,438,440,431,-5,31,-36
182,140000,5b1c11c3efed5312,12,0,426,153,81,103,83,114,108,86,92,80,88,97,92,88,9,8,1
684,440000,5b1c11c3efed5312,12,0,1628,496,168,342,246,344,349,247,271,470,547,535,541,517,-12,77,-89
86,450000,5b1c11c3efed5312,12,0,240,121,56,54,26,39,23,31,45,41,46,67,56,51,21,5,16
1207,320000,5b1c11c3efed5312,12,0,1908,768,543,404,402,487,371,340,347,446,468,640,554,518,172,22,150
552,360000,5b1c11c3efed5312,12,0,733,453,153,150,168,191,126,131,163,222,258,313,286,264,55,36,19
458,130000,5b1c11c3efed5312,12,0,1158,476,272,257,300,350,276,304,321,274,306,304,305,295,-2,32,-34
892,410000,5b1c11c3efed5312,12,0,1883,910,372,312,380,366,295,321,290,401,454,489,472,448,35,53,-18
1459,330000,5b1c11c3efed5312,12,0,2202,744,430,386,337,361,407,360,410,487,673,779,726,646,106,186,-80
413,420000,5b1c11c3efed5312,12,0,749,443,143,138,130,145,146,117,118,165,198,265,232,209,67,33,34
361,430000,5b1c11c3efed5312,12,0,744,378,131,137,149,138,134,113,150,189,192,193,192,191,1,3,-2
275,350000,5b1c11c3efed5312,12,0,594,265,149,173,130,137,127,100,127,140,178,178,178,165,0,38,-38
59,210000,5b1c11c3efed5312,12,0,256,75,62,80,75,84,47,39,66,55,56,54,55,55,-2,1,-3
45,500000,5b1c11c3efed5312,12,0,172,124,38,29,23,20,27,17,21,36,14,32,23,27,18,-22,40
111,610000,5b1c11c3efed5312,12,0,325,144,79,70,64,97,57,67,82,80,101,63,82,81,-38,21,-59
50,230000,5b1c11c3efed5312,12,0,152,43,36,52,38,43,41,34,44,43,32,42,37,39,10,-11,21
134,310000,17363f08d683d52b,12,0,96,65,19,37,175,5,12,7,8,136,3,21,12,53,18,-133,151
103,530000,17363f08d683d52b,12,0,182,216,75,82,86,83,57,67,66,46,65,58,62,56,-7,19,-26
101,150000,17363f08d683d52b,12,0,141,132,46,66,45,69,41,38,46,34,32,29,30,32,-3,-2,-1
109,110000,17363f08d683d52b,12,0,277,124,81,65,48,29,26,33,15,60,11,26,18,32,15,-49,64
320,510000,17363f08d683d52b,12,0,292,350,117,93,78,81,64,97,44,63,63,88,76,71,25,0,25
375,340000,17363f08d683d52b,12,0,384,513,121,108,92,90,118,107,99,88,111,193,152,131,82,23,59
664,370000,17363f08d683d52b,12,0,596,555,214,153,209,203,175,145,127,346,326,468,397,380,142,-20,162
128,140000,17363f08d683d52b,12,0,67,66,26,12,22,19,12,23,3,3,7,16,12,9,9,4,5
599,440000,17363f08d683d52b,12,0,84,62,19,63,37,30,29,26,25,17,16,30,23,21,14,-1,15
99,450000,17363f08d683d52b,12,0,50,45,14,26,20,6,2,8,5,11,8,15,12,11,7,-3,10
770,320000,17363f08d683d52b,12,0,569,538,214,216,188,191,134,129,86,151,201,328,264,227,127,50,77
275,360000,17363f08d683d52b,12,0,309,360,94,101,91,90,79,82,62,58,77,105,91,80,28,19,9
827,130000,17363f08d683d52b,12,0,383,353,154,150,162,149,131,144,91,180,201,209,205,197,8,21,-13
924,410000,17363f08d683d52b,12,0,457,538,139,100,129,104,87,70,63,93,117,258,188,156,141,24,117
1039,330000,17363f08d683d52b,12,0,453,388,129,152,151,108,106,91,89,167,264,360,312,264,96,97,-1
356,420000,17363f08d683d52b,12,0,421,474,120,139,119,158,186,109,65,89,106,178,142,124,72,17,55
450,430000,17363f08d683d52b,12,0,428,459,95,148,114,114,115,100,92,163,156,282,219,200,126,-7,133
263,350000,17363f08d683d52b,12,0,159,136,38,44,37,55,51,15,28,29,27,50,38,35,23,-2,25
208,210000,17363f08d683d52b,12,0,238,151,59,93,137,105,53,60,48,51,55,71,63,59,16,4,12
121,500000,17363f08d683d52b,12,0,126,110,41,27,16,19,16,22,15,14,6,10,8,10,4,-8,12
306,610000,17363f08d683d52b,12,0,288,180,80,67,82,94,70,81,86,60,43,74,58,59,31,-17,48
153,230000,17363f08d683d52b,12,0,156,75,46,57,45,34,22,28,31,17,28,51,40,32,23,11,12
587,310000,06880909932890ca,12,0,384,208,78,136,169,219,267,195,272,379,301,407,354,362,106,-78,184
146,530000,06880909932890ca,12,0,206,142,56,68,79,116,111,106,126,142,139,120,130,134,-19,-3,-16
61,150000,06880909932890ca,12,0,115,74,44,45,52,72,39,48,70,69,60,55,58,61,-5,-9,4
226,110000,06880909932890ca,12,0,771,253,139,206,162,160,198,159,181,170,152,213,182,178,61,-18,79
1067,510000,06880909932890ca,12,0,933,673,263,243,304,396,459,464,505,768,629,730,680,709,101,-139,240
862,340000,06880909932890ca,12,0,993,964,338,340,389,526,609,640,679,780,759,659,709,733,-100,-21,-79
1059,370000,06880909932890ca,12,0,1332,1011,383,430,537,623,546,597,690,912,884,749,816,848,-135,-28,-107
211,140000,06880909932890ca,12,0,275,128,67,102,111,136,137,121,130,151,145,151,148,149,6,-6,12
1784,440000,06880909932890ca,12,0,1546,767,278,638,579,734,773,669,732,1150,1234,1385,1310,1256,151,84,67
271,450000,06880909932890ca,12,0,276,186,86,105,86,125,135,129,121,150,190,199,194,180,9,40,-31
2888,320000,06880909932890ca,12,0,2642,2094,991,984,1074,1356,1448,1465,1619,1956,2009,2157,2083,2041,148,53,95
634,360000,06880909932890ca,12,0,691,614,157,211,274,326,317,295,445,614,519,502,510,545,-17,-95,78
731,130000,06880909932890ca,12,0,773,530,290,330,342,436,385,393,514,507,523,510,516,513,-13,16,-29
2402,410000,06880909932890ca,12,0,2409,1865,640,650,891,1055,1267,1138,1176,1439,1566,1428,1497,1478,-138,127,-265
2496,330000,06880909932890ca,12,0,2222,1022,501,663,715,913,1088,1232,1489,1624,1714,1730,1722,1689,16,90,-74
632,420000,06880909932890ca,12,0,661,605,178,211,256,312,333,394,414,526,562,510,536,533,-52,36,-88
704,430000,06880909932890ca,12,0,698,488,170,228,287,352,372,388,447,540,497,509,503,515,12,-43,55
626,350000,06880909932890ca,12,0,601,361,197,246,246,307,332,263,303,408,504,538,521,483,34,96,-62
233,210000,06880909932890ca,12,0,328,161,100,120,120,168,137,149,154,182,162,212,187,185,50,-20,70
406,500000,06880909932890ca,12,0,430,326,140,158,145,189,295,272,251,352,358,391,374,367,33,6,27
340,610000,06880909932890ca,12,0,562,349,119,145,167,210,170,185,229,259,243,242,242,248,-1,-16,15
77,230000,06880909932890ca,12,0,100,69,37,53,48,62,47,72,53,77,99,216,158,131,117,22,95
96,310000,9c1c7ee8ebdda299,12,0,46,32,19,54,17,10,12,11,6,11,22,53,38,29,31,11,20
321,530000,9c1c7ee8ebdda299,12,0,169,142,104,91,53,62,66,54,100,120,234,204,219,186,-30,114,-144
691,150000,9c1c7ee8ebdda299,12,0,430,278,168,258,163,176,174,153,161,172,446,334,390,317,-112,274,-386
57,110000,9c1c7ee8ebdda299,12,0,112,52,38,30,13,7,12,11,3,21,34,42,38,32,8,13,-5
1053,510000,9c1c7ee8ebdda299,12,0,641,617,336,250,134,145,143,161,174,211,648,454,551,438,-194,437,-631
501,340000,9c1c7ee8ebdda299,12,0,190,278,146,119,59,72,88,63,82,153,349,313,331,272,-36,196,-232
3022,370000,9c1c7ee8ebdda299,12,0,2281,1763,885,746,509,752,650,656,635,554,1575,1169,1372,1099,-406,1021,-1427
1957,140000,9c1c7ee8ebdda299,12,0,886,691,295,401,285,317,252,283,337,321,1057,768,912,715,-289,736,-1025
905,440000,9c1c7ee8ebdda299,12,0,1008,472,229,471,212,177,139,130,131,160,443,430,436,344,-13,283,-296
461,450000,9c1c7ee8ebdda299,12,0,308,251,110,119,55,137,102,134,127,148,260,278,269,229,18,112,-94
715,320000,9c1c7ee8ebdda299,12,0,309,370,299,211,106,111,126,119,95,124,351,373,362,283,22,227,-205
319,360000,9c1c7ee8ebdda299,12,0,182,224,84,107,42,42,52,41,45,96,201,174,188,157,-27,105,-132
4005,130000,9c1c7ee8ebdda299,12,0,1840,1468,940,941,733,782,635,713,852,807,2258,1482,1870,1516,-776,1451,-2227
1909,410000,9c1c7ee8ebdda299,12,0,911,1101,433,362,211,283,281,280,284,399,1114,743,928,752,-371,715,-1086
901,330000,9c1c7ee8ebdda299,12,0,352,327,197,195,168,241,204,240,223,277,513,546,530,445,33,236,-203
377,420000,9c1c7ee8ebdda299,12,0,125,211,58,65,32,39,46,41,44,51,166,179,172,132,13,115,-102
544,430000,9c1c7ee8ebdda299,12,0,165,230,105,87,42,50,62,55,47,92,309,357,333,253,48,217,-169
597,350000,9c1c7ee8ebdda299,12,0,215,204,105,130,66,70,71,48,58,86,260,305,282,217,45,174,-129
1725,210000,9c1c7ee8ebdda299,12,0,619,375,317,409,425,215,168,173,244,317,715,776,746,603,61,398,-337
159,500000,9c1c7ee8ebdda299,12,0,104,116,61,54,25,34,33,27,26,25,81,121,101,76,40,56,-16
815,610000,9c1c7ee8ebdda299,12,0,250,261,108,136,75,123,125,148,123,127,394,274,334,265,-120,267,-387
873,230000,9c1c7ee8ebdda299,12,0,342,207,144,192,137,117,137,97,118,219,569,647,608,478,78,350,-272
753,310000,c6833cb891626c17,12,0,596,174,80,151,177,200,272,204,286,381,357,433,395,390,76,-24,100
449,530000,c6833cb891626c17,12,0,699,444,236,185,176,241,235,239,233,242,311,298,304,284,-13,69,-82
357,150000,c6833cb891626c17,12,0,485,221,94,125,138,233,182,202,244,226,285,221,253,244,-64,59,-123
547,110000,c6833cb891626c17,12,0,1517,309,174,289,242,251,279,287,271,285,203,331,267,273,128,-82,210
1008,510000,c6833cb891626c17,12,0,1305,743,339,285,287,359,363,364,444,612,527,497,512,545,-30,-85,55
1522,340000,c6833cb891626c17,12,0,1597,855,344,344,422,524,660,677,843,847,868,889,878,868,21,21,0
1459,370000,c6833cb891626c17,12,0,1740,687,383,327,543,829,670,841,808,972,862,827,844,887,-35,-110,75
389,140000,c6833cb891626c17,12,0,514,192,100,117,126,207,172,186,212,232,248,256,252,245,8,16,-8
1566,440000,c6833cb891626c17,12,0,1899,542,186,403,360,460,604,483,479,704,825,938,882,822,113,121,-8
290,450000,c6833cb891626c17,12,0,514,260,96,110,81,120,111,123,118,114,164,155,160,144,-9,50,-59
2267,320000,c6833cb891626c17,12,0,2279,939,574,593,645,899,941,918,876,1073,1193,1192,1192,1153,-1,120,-121
1102,360000,c6833cb891626c17,12,0,900,502,180,199,229,302,289,342,439,577,631,653,642,620,22,54,-32
1451,130000,c6833cb891626c17,12,0,1749,708,414,412,600,843,768,843,1013,870,860,978,919,903,118,-10,128
2375,410000,c6833cb891626c17,12,0,2735,1331,509,557,792,1003,1139,1208,1046,1173,1225,1246,1236,1215,21,52,-31
3318,330000,c6833cb891626c17,12,0,3255,1119,581,616,676,899,1179,1212,1449,1568,1840,1878,1859,1762,38,272,-234
992,420000,c6833cb891626c17,12,0,1014,597,202,210,256,309,467,354,417,541,558,609,584,569,51,17,34
796,430000,c6833cb891626c17,12,0,978,498,212,209,272,280,287,311,368,495,434,537,486,489,103,-61,164
586,350000,c6833cb891626c17,12,0,782,311,141,184,131,214,223,160,193,287,353,357,355,332,4,66,-62
281,210000,c6833cb891626c17,12,0,424,127,80,97,131,161,165,176,170,202,187,199,193,196,12,-15,27
543,500000,c6833cb891626c17,12,0,532,260,104,78,93,126,161,148,159,170,178,257,218,202,79,8,71
624,610000,c6833cb891626c17,12,0,620,315,130,154,179,263,204,263,363,295,450,379,414,375,-71,155,-226
208,230000,c6833cb891626c17,12,0,274,80,52,66,71,97,87,91,116,90,100,154,127,115,54,10,44
255,310000,3e21824be728cbec,12,0,396,369,177,174,163,140,140,130,154,202,176,154,165,177,-22,-26,4
272,530000,3e21824be728cbec,12,0,334,203,134,207,159,159,199,202,227,215,226,218,222,220,-8,11,-19
62,150000,3e21824be728cbec,12,0,90,51,29,42,27,40,31,39,40,40,103,45,74,63,-58,63,-121
96,110000,3e21824be728cbec,12,0,242,93,60,87,42,47,47,40,41,55,59,53,56,56,-6,4,-10
476,510000,3e21824be728cbec,12,0,781,288,239,321,272,333,406,352,417,499,361,398,380,419,37,-138,175
418,340000,3e21824be728cbec,12,0,661,309,266,301,237,309,289,297,345,293,432,310,371,345,-122,139,-261
860,370000,3e21824be728cbec,12,0,994,540,419,572,464,433,395,383,432,535,703,469,586,569,-234,168,-402
142,140000,3e21824be728cbec,12,0,201,88,44,87,60,67,72,87,105,82,107,83,95,91,-24,25,-49
719,440000,3e21824be728cbec,12,0,1135,331,231,477,411,394,418,380,461,499,508,525,516,511,17,9,8
224,450000,3e21824be728cbec,12,0,403,140,92,140,131,131,161,121,124,149,158,183,170,163,25,9,16
1203,320000,3e21824be728cbec,12,0,1781,805,710,885,641,740,693,656,701,768,937,856,896,854,-81,169,-250
330,360000,3e21824be728cbec,12,0,431,157,97,173,170,210,195,175,219,261,224,240,232,242,16,-37,53
909,130000,3e21824be728cbec,12,0,806,391,375,484,404,455,438,404,455,455,703,481,592,546,-222,248,-470
767,410000,3e21824be728cbec,12,0,896,363,334,528,418,445,554,381,446,510,591,459,525,520,-132,81,-213
830,330000,3e21824be728cbec,12,0,1044,341,386,475,363,466,458,443,473,505,595,543,569,548,-52,90,-142
342,420000,3e21824be728cbec,12,0,461,270,123,194,119,150,177,181,200,192,242,232,237,222,-10,50,-60
304,430000,3e21824be728cbec,12,0,478,157,99,182,167,188,184,200,195,251,207,207,207,222,0,-44,44
345,350000,3e21824be728cbec,12,0,593,250,154,266,219,283,228,214,225,227,321,273,297,274,-48,94,-142
124,210000,3e21824be728cbec,12,0,149,45,36,75,66,76,84,71,67,64,113,104,108,94,-9,49,-58
203,500000,3e21824be728cbec,12,0,475,136,124,148,136,160,225,137,123,161,136,162,149,153,26,-25,51
255,610000,3e21824be728cbec,12,0,464,194,145,188,141,176,186,164,204,187,239,174,206,200,-65,52,-117
74,230000,3e21824be728cbec,12,0,87,40,47,82,54,34,48,39,38,37,82,78,80,66,-4,45,-49
656,310000,f8a6975573af1b33,12,0,579,371,131,288,266,225,283,286,352,425,361,419,390,402,58,-64,122
282,530000,f8a6975573af1b33,12,0,338,215,134,179,192,167,169,217,170,285,214,266,240,255,52,-71,123
53,150000,f8a6975573af1b33,12,0,48,41,28,59,37,53,61,54,60,50,57,51,54,53,-6,7,-13
160,110000,f8a6975573af1b33,12,0,383,131,61,110,108,70,103,89,94,106,75,102,88,94,27,-31,58
958,510000,f8a6975573af1b33,12,0,820,550,286,428,433,456,497,476,571,730,570,689,630,663,119,-160,279
929,340000,f8a6975573af1b33,12,0,758,508,322,432,425,545,563,499,558,654,651,661,656,655,10,-3,13
673,370000,f8a6975573af1b33,12,0,729,410,227,320,381,388,394,345,413,508,427,535,481,490,108,-81,189
82,140000,f8a6975573af1b33,12,0,136,74,57,53,62,47,59,62,56,65,82,70,76,72,-12,17,-29
2187,440000,f8a6975573af1b33,12,0,2232,1023,444,1072,1007,969,1190,954,1225,1539,1459,1711,1585,1570,252,-80,332
331,450000,f8a6975573af1b33,12,0,328,208,107,160,131,178,209,223,211,264,238,253,246,252,15,-26,41
1804,320000,f8a6975573af1b33,12,0,1846,1142,747,1023,870,969,1040,1045,1132,1384,1302,1350,1326,1345,48,-82,130
505,360000,f8a6975573af1b33,12,0,436,290,111,237,235,226,237,243,304,361,365,384,374,370,19,4,15
584,130000,f8a6975573af1b33,12,0,475,287,194,265,298,335,339,355,444,469,418,474,446,454,56,-51,107
840,410000,f8a6975573af1b33,12,0,747,459,249,457,513,513,571,508,547,706,610,638,624,651,28,-96,124
1568,330000,f8a6975573af1b33,12,0,1454,752,503,780,679,725,759,836,1202,1060,1245,1225,1235,1177,-20,185,-205
614,420000,f8a6975573af1b33,12,0,481,312,158,246,258,251,428,347,390,481,444,482,463,469,38,-37,75
571,430000,f8a6975573af1b33,12,0,425,324,139,263,238,293,308,308,344,467,351,445,398,421,94,-116,210
739,350000,f8a6975573af1b33,12,0,699,508,260,395,323,426,506,406,485,547,533,645,589,575,112,-14,126
136,210000,f8a6975573af1b33,12,0,125,66,52,82,116,125,102,110,143,125,94,134,114,118,40,-31,71
522,500000,f8a6975573af1b33,12,0,548,310,185,288,287,285,378,280,285,380,307,322,314,336,15,-73,88
240,610000,f8a6975573af1b33,12,0,259,170,96,124,121,134,165,167,184,227,205,179,192,204,-26,-22,-4
86,230000,f8a6975573af1b33,12,0,115,61,52,76,85,53,52,53,68,53,58,78,68,63,20,5,15
338,310000,54fc07138d70374c,12,0,473,415,199,338,303,272,297,230,306,310,217,312,264,280,95,-93,188
334,530000,54fc07138d70374c,12,0,535,500,259,353,295,304,293,320,299,296,284,309,296,296,25,-12,37
181,150000,54fc07138d70374c,12,0,234,273,129,208,180,191,167,194,197,191,163,181,172,178,18,-28,46
494,110000,54fc07138d70374c,12,0,681,534,295,402,398,365,374,341,360,397,323,419,371,380,96,-74,170
566,510000,54fc07138d70374c,12,0,849,933,442,540,493,508,553,476,460,610,426,533,480,523,107,-184,291
252,340000,54fc07138d70374c,12,0,368,404,198,210,162,176,206,197,185,206,181,197,189,195,16,-25,41
640,370000,54fc07138d70374c,12,0,936,911,376,595,546,558,596,483,522,642,489,566,528,566,77,-153,230
173,140000,54fc07138d70374c,12,0,244,213,113,141,101,103,104,107,143,141,135,151,143,142,16,-6,22
1350,440000,54fc07138d70374c,12,0,2078,1526,521,1068,875,905,1067,825,969,1188,973,1118,1046,1093,145,-215,360
168,450000,54fc07138d70374c,12,0,317,323,145,236,156,189,166,140,172,167,131,153,142,150,22,-36,58
550,320000,54fc07138d70374c,12,0,820,821,461,589,458,423,545,436,500,549,440,501,470,497,61,-109,170
180,360000,54fc07138d70374c,12,0,262,297,113,164,151,133,139,150,149,170,140,130,135,147,-10,-30,20
538,130000,54fc07138d70374c,12,0,750,758,431,483,470,474,415,495,501,519,421,480,450,473,59,-98,157
485,410000,54fc07138d70374c,12,0,820,826,447,615,567,493,543,423,493,437,366,448,407,417,82,-71,153
467,330000,54fc07138d70374c,12,0,684,550,252,401,254,311,325,307,322,340,344,355,350,346,11,4,7
291,420000,54fc07138d70374c,12,0,425,481,197,299,246,238,274,238,273,295,246,247,246,263,1,-49,50
357,430000,54fc07138d70374c,12,0,493,505,239,383,321,315,341,325,336,378,286,338,312,334,52,-92,144
185,350000,54fc07138d70374c,12,0,338,400,163,217,128,161,123,141,139,151,131,141,136,141,10,-20,30
282,210000,54fc07138d70374c,12,0,450,249,117,274,320,298,258,236,274,251,198,202,200,217,4,-53,57
445,500000,54fc07138d70374c,12,0,575,576,284,403,314,306,439,296,285,331,263,289,276,294,26,-68,94
232,610000,54fc07138d70374c,12,0,404,376,178,272,285,266,201,203,229,236,216,225,220,226,9,-20,29
265,230000,54fc07138d70374c,12,0,410,324,206,341,242,239,273,292,251,258,237,262,250,252,25,-21,46
414,310000,212083a9246d2fd3,12,0,846,241,179,180,191,192,253,247,261,249,228,289,258,255,61,-21,82
500,530000,212083a9246d2fd3,12,0,493,290,145,117,124,158,128,183,166,200,277,390,334,289,113,77,36
272,150000,212083a9246d2fd3,12,0,562,284,123,119,71,119,101,97,110,137,180,181,180,166,1,43,-42
215,110000,212083a9246d2fd3,12,0,824,105,71,55,60,50,59,51,57,65,85,133,109,94,48,20,28
1207,510000,212083a9246d2fd3,12,0,1730,983,504,400,394,380,436,516,607,641,550,820,685,670,270,-91,361
2004,340000,212083a9246d2fd3,12,0,2243,1186,528,593,566,477,521,594,770,1036,1137,1281,1209,1151,144,101,43
1782,370000,212083a9246d2fd3,12,0,2998,1261,553,503,551,645,651,724,836,994,1041,1155,1098,1063,114,47,67
537,140000,212083a9246d2fd3,12,0,645,313,178,140,164,178,173,195,230,273,274,315,294,287,41,1,40
1686,440000,212083a9246d2fd3,12,0,3191,905,337,855,959,831,614,794,1007,844,769,1092,930,902,323,-75,398
660,450000,212083a9246d2fd3,12,0,697,471,179,227,188,213,224,204,252,332,309,466,388,369,157,-23,180
2188,320000,212083a9246d2fd3,12,0,3836,1631,972,777,763,993,802,889,897,976,1122,1300,1211,1133,178,146,32
683,360000,212083a9246d2fd3,12,0,1270,658,229,229,221,283,227,273,344,417,442,472,457,444,30,25,5
1263,130000,212083a9246d2fd3,12,0,2232,950,551,442,578,697,555,544,666,625,757,859,808,747,102,132,-30
2832,410000,212083a9246d2fd3,12,0,3243,1894,828,807,1011,1085,1013,1189,1300,1393,1655,1872,1764,1640,217,262,-45
1040,330000,212083a9246d2fd3,12,0,1850,574,328,328,361,426,423,467,565,573,676,798,737,682,122,103,19
558,420000,212083a9246d2fd3,12,0,1354,755,244,256,243,222,247,223,230,310,348,406,377,355,58,38,20
1420,430000,212083a9246d2fd3,12,0,1756,938,322,403,371,448,412,466,511,628,666,904,785,733,238,38,200
655,350000,212083a9246d2fd3,12,0,1041,462,182,250,215,304,238,233,338,522,511,576,544,536,65,-11,76
284,210000,212083a9246d2fd3,12,0,561,181,92,144,178,144,111,123,123,146,152,205,178,168,53,6,47
698,500000,212083a9246d2fd3,12,0,1136,557,231,195,203,189,260,190,212,306,281,420,350,336,139,-25,164
1410,610000,212083a9246d2fd3,12,0,1567,639,298,275,310,369,282,381,491,525,649,759,704,644,110,124,-14
159,230000,212083a9246d2fd3,12,0,305,102,62,72,62,93,71,101,93,80,111,145,128,112,34,31,3
48,310000,4f79773e600518a6,12,0,159,95,31,32,33,18,19,21,31,33,32,30,31,32,-2,-1,-1
74,530000,4f79773e600518a6,12,0,195,181,91,58,50,67,48,56,60,70,109,74,92,84,-35,39,-74
164,150000,4f79773e600518a6,12,0,336,327,113,110,91,126,86,83,105,142,150,176,163,156,26,8,18
42,110000,4f79773e600518a6,12,0,246,99,35,29,28,28,17,19,21,32,18,23,20,24,5,-14,19
168,510000,4f79773e600518a6,12,0,387,398,155,108,95,80,69,76,114,107,93,88,90,96,-5,-14,9
204,340000,4f79773e600518a6,12,0,471,484,121,103,101,118,103,101,112,137,149,153,151,146,4,12,-8
486,370000,4f79773e600518a6,12,0,961,723,263,300,312,311,242,273,332,372,387,361,374,373,-26,15,-41
101,140000,4f79773e600518a6,12,0,167,149,66,59,57,51,58,45,92,92,77,100,88,90,23,-15,38
48,440000,4f79773e600518a6,12,0,176,97,19,44,38,31,35,30,38,44,35,58,46,46,23,-9,32
19,450000,4f79773e600518a6,12,0,62,66,20,31,15,25,9,23,18,12,17,23,20,17,6,5,1
128,320000,4f79773e600518a6,12,0,450,333,168,137,94,101,95,97,80,87,93,107,100,96,14,6,8
160,360000,4f79773e600518a6,12,0,252,264,69,58,63,82,66,58,86,106,109,99,104,105,-10,3,-13
268,130000,4f79773e600518a6,12,0,473,362,182,165,226,205,142,157,221,184,175,195,185,185,20,-9,29
454,410000,4f79773e600518a6,12,0,679,669,213,223,212,206,190,239,237,292,323,297,310,304,-26,31,-57
94,330000,4f79773e600518a6,12,0,255,131,59,54,69,64,57,47,53,54,59,50,54,54,-9,5,-14
207,420000,4f79773e600518a6,12,0,385,450,105,110,104,89,90,81,127,134,149,148,148,144,-1,15,-16
688,430000,4f79773e600518a6,12,0,776,857,222,262,247,257,219,243,308,415,419,451,435,428,32,4,28
25,350000,4f79773e600518a6,12,0,65,41,21,20,20,33,19,21,25,14,25,17,21,19,-8,11,-19
88,210000,4f79773e600518a6,12,0,166,109,50,66,72,45,46,43,59,62,69,76,72,69,7,7,0
121,500000,4f79773e600518a6,12,0,306,256,58,77,65,70,84,67,84,87,77,85,81,83,8,-10,18
432,610000,4f79773e600518a6,12,0,634,493,193,190,176,193,161,204,222,237,320,276,298,278,-44,83,-127
128,230000,4f79773e600518a6,12,0,277,131,70,96,70,62,54,66,59,76,95,139,117,103,44,19,25
166,310000,fc32b1a017b34efe,12,0,361,138,71,95,74,75,111,81,104,108,82,91,86,94,9,-26,35
688,530000,fc32b1a017b34efe,12,0,743,406,299,256,259,276,323,373,379,361,567,467,517,465,-100,206,-306
779,150000,fc32b1a017b34efe,12,0,683,304,135,211,181,248,260,314,339,378,412,513,462,434,101,34,67
209,110000,fc32b1a017b34efe,12,0,675,173,56,121,79,138,89,102,103,129,115,160,138,135,45,-14,59
2246,510000,fc32b1a017b34efe,12,0,2057,1186,681,782,644,814,979,1044,1182,1106,1202,1558,1380,1289,356,96,260
731,340000,fc32b1a017b34efe,12,0,865,574,194,213,248,307,345,317,346,361,391,456,424,403,65,30,35
1563,370000,fc32b1a017b34efe,12,0,1538,723,282,412,473,536,614,680,774,720,826,848,837,798,22,106,-84
1703,140000,fc32b1a017b34efe,12,0,974,417,214,254,346,509,560,656,816,685,1059,1000,1030,915,-59,374,-433
1064,440000,fc32b1a017b34efe,12,0,1105,569,259,493,354,430,585,484,578,575,619,790,704,661,171,44,127
377,450000,fc32b1a017b34efe,12,0,406,260,101,165,105,174,218,194,217,225,224,290,257,246,66,-1,67
1164,320000,fc32b1a017b34efe,12,0,1332,698,402,409,494,495,557,550,609,567,672,754,713,664,82,105,-23
589,360000,fc32b1a017b34efe,12,0,774,420,110,193,205,216,298,283,295,291,351,389,370,344,38,60,-22
2807,130000,fc32b1a017b34efe,12,0,2069,891,397,516,929,990,983,1137,1295,1153,1509,1715,1612,1459,206,356,-150
2183,410000,fc32b1a017b34efe,12,0,1916,1026,330,387,521,645,908,946,966,847,1114,1276,1195,1079,162,267,-105
796,330000,fc32b1a017b34efe,12,0,982,370,195,281,311,304,395,371,467,405,469,528,498,467,59,64,-5
531,420000,fc32b1a017b34efe,12,0,721,401,105,159,186,195,272,290,243,277,326,353,340,319,27,49,-22
995,430000,fc32b1a017b34efe,12,0,1290,631,205,298,333,363,464,424,425,552,559,607,583,573,48,7,41
359,350000,fc32b1a017b34efe,12,0,385,180,95,138,114,150,154,163,198,154,199,231,215,195,32,45,-13
287,210000,fc32b1a017b34efe,12,0,330,135,104,181,144,138,167,145,200,198,175,219,197,197,44,-23,67
1321,500000,fc32b1a017b34efe,12,0,1420,661,420,464,477,481,631,557,639,617,667,807,737,697,140,50,90
1582,610000,fc32b1a017b34efe,12,0,1234,604,184,336,402,415,468,687,690,661,909,892,900,821,-17,248,-265
236,230000,fc32b1a017b34efe,12,0,236,76,111,111,78,108,134,127,165,146,158,232,195,179,74,12,62
600,310000,feabbf46658382b9,12,0,805,357,95,198,187,218,252,286,379,461,354,390,372,402,36,-107,143
1227,530000,feabbf46658382b9,12,0,1249,829,418,522,444,470,542,766,801,741,996,965,980,901,-31,255,-286
1163,150000,feabbf46658382b9,12,0,925,601,288,415,322,461,499,595,688,789,875,960,918,875,85,86,-1
362,110000,feabbf46658382b9,12,0,1421,437,212,313,278,276,253,302,320,338,287,368,328,331,81,-51,132
2632,510000,feabbf46658382b9,12,0,2915,2183,903,1084,938,1042,1247,1538,1846,1788,1737,1869,1803,1798,132,-51,183
1083,340000,feabbf46658382b9,12,0,1307,1141,304,330,322,356,545,585,712,755,739,765,752,753,26,-16,42
1637,370000,feabbf46658382b9,12,0,1610,1006,389,569,611,624,776,1014,1189,1170,1211,1183,1197,1188,-28,41,-69
959,140000,feabbf46658382b9,12,0,970,406,198,368,305,370,503,552,733,652,718,658,688,676,-60,66,-126
2001,440000,feabbf46658382b9,12,0,2685,1203,341,825,879,785,1142,1134,1550,1490,1748,1989,1868,1742,241,258,-17
463,450000,feabbf46658382b9,12,0,665,433,149,235,168,197,226,296,330,369,365,417,391,384,52,-4,56
2479,320000,feabbf46658382b9,12,0,2752,1481,650,861,854,961,1280,1420,1671,1770,1868,2033,1950,1890,165,98,67
644,360000,feabbf46658382b9,12,0,802,624,159,229,268,266,354,440,475,407,474,514,494,465,40,67,-27
2397,130000,feabbf46658382b9,12,0,1551,970,478,608,767,810,890,1254,1423,1432,1560,1629,1594,1540,69,128,-59
3060,410000,feabbf46658382b9,12,0,2696,1928,502,672,701,850,1415,1787,1789,1724,2048,1912,1980,1895,-136,324,-460
2439,330000,feabbf46658382b9,12,0,2124,704,292,530,641,696,932,1254,1486,1797,1857,1925,1891,1860,68,60,8
916,420000,feabbf46658382b9,12,0,1252,837,201,313,330,347,462,609,643,609,716,696,706,674,-20,107,-127
1811,430000,feabbf46658382b9,12,0,2360,1657,503,671,579,591,827,934,1043,1138,1066,1187,1126,1130,121,-72,193
605,350000,feabbf46658382b9,12,0,698,428,129,211,219,281,359,378,470,543,521,626,574,563,105,-22,127
323,210000,feabbf46658382b9,12,0,459,235,125,226,187,250,248,334,351,316,290,309,300,305,19,-26,45
2262,500000,feabbf46658382b9,12,0,2727,1846,758,896,740,908,1151,1313,1405,1572,1555,1445,1500,1524,-110,-17,-93
1581,610000,feabbf46658382b9,12,0,1319,905,333,426,445,444,565,798,975,991,1110,967,1038,1023,-143,119,-262
326,230000,feabbf46658382b9,12,0,397,173,117,199,155,143,190,253,271,281,258,403,330,314,145,-23,168
36,310000,f270f6a489c6a9d7,12,0,34,19,29,28,25,38,29,32,29,27,26,23,24,25,-3,-1,-2
852,530000,f270f6a489c6a9d7,12,0,1939,1680,1190,1187,815,815,786,875,755,817,1016,720,868,851,-296,199,-495
46,150000,f270f6a489c6a9d7,12,0,108,54,78,117,71,70,60,56,65,70,61,41,51,57,-20,-9,-11
321,110000,f270f6a489c6a9d7,12,0,504,106,118,157,120,110,104,70,81,80,59,99,79,79,40,-21,61
445,510000,f270f6a489c6a9d7,12,0,955,603,645,678,519,472,474,468,514,523,495,344,420,454,-151,-28,-123
113,340000,f270f6a489c6a9d7,12,0,272,216,223,191,165,153,149,145,130,226,119,115,117,153,-4,-107,103
400,370000,f270f6a489c6a9d7,12,0,1105,629,541,513,451,400,375,388,431,348,319,283,301,317,-36,-29,-7
111,140000,f270f6a489c6a9d7,12,0,233,166,115,127,118,117,113,93,103,99,118,123,120,113,5,19,-14
661,440000,f270f6a489c6a9d7,12,0,866,346,505,757,513,503,519,390,440,464,326,357,342,382,31,-138,169
30,450000,f270f6a489c6a9d7,12,0,97,92,50,85,53,57,36,20,17,40,26,18,22,28,-8,-14,6
533,320000,f270f6a489c6a9d7,12,0,1150,610,843,857,623,558,495,522,542,537,383,409,396,443,26,-154,180
55,360000,f270f6a489c6a9d7,12,0,148,132,89,105,90,70,62,87,69,109,55,55,55,73,0,-54,54
641,130000,f270f6a489c6a9d7,12,0,983,537,616,685,621,541,500,570,609,477,446,517,482,480,71,-31,102
596,410000,f270f6a489c6a9d7,12,0,1314,922,778,753,612,592,519,715,609,950,530,431,480,637,-99,-420,321
380,330000,f270f6a489c6a9d7,12,0,653,312,498,511,368,351,319,353,307,303,303,273,288,293,-30,0,-30
352,420000,f270f6a489c6a9d7,12,0,903,514,438,482,408,403,314,306,325,383,287,301,294,324,14,-96,110
249,430000,f270f6a489c6a9d7,12,0,575,405,314,375,353,267,377,276,257,258,207,210,208,225,3,-51,54
109,350000,f270f6a489c6a9d7,12,0,195,85,140,157,133,146,133,94,101,94,103,86,94,94,-17,9,-26
216,210000,f270f6a489c6a9d7,12,0,370,158,187,236,191,184,170,200,162,165,162,172,167,166,10,-3,13
641,500000,f270f6a489c6a9d7,12,0,955,636,643,771,438,521,498,470,463,469,462,351,406,427,-111,-7,-104
195,610000,f270f6a489c6a9d7,12,0,324,195,155,198,180,157,132,131,161,154,118,145,132,139,27,-36,63
54,230000,f270f6a489c6a9d7,12,0,90,35,48,67,46,41,40,28,43,38,20,21,20,26,1,-18,19
157,310000,d0f245b8781e3631,12,0,281,60,52,74,61,69,81,59,68,101,59,64,62,75,5,-42,47
201,530000,d0f245b8781e3631,12,0,356,181,119,130,103,154,125,106,113,128,230,173,202,177,-57,102,-159
194,150000,d0f245b8781e3631,12,0,244,117,67,81,65,79,55,51,79,82,89,101,95,91,12,7,5
135,110000,d0f245b8781e3631,12,0,805,105,52,132,97,103,144,172,170,133,91,116,104,113,25,-42,67
825,510000,d0f245b8781e3631,12,0,1456,816,454,505,463,516,491,453,624,583,533,557,545,558,24,-50,74
408,340000,d0f245b8781e3631,12,0,463,251,96,133,88,118,91,110,111,129,108,229,168,155,121,-21,142
507,370000,d0f245b8781e3631,12,0,1182,600,283,311,395,408,271,332,415,347,344,280,312,324,-64,-3,-61
233,140000,d0f245b8781e3631,12,0,497,192,96,135,117,169,144,132,175,152,197,166,182,172,-31,45,-76
448,440000,d0f245b8781e3631,12,0,869,297,127,271,262,258,278,238,265,297,267,378,322,314,111,-30,141
219,450000,d0f245b8781e3631,12,0,425,254,71,136,107,135,145,104,103,124,139,128,134,130,-11,15,-26
874,320000,d0f245b8781e3631,12,0,1017,461,270,342,363,373,289,260,265,382,334,313,324,343,-21,-48,27
201,360000,d0f245b8781e3631,12,0,315,211,60,84,84,68,64,78,105,104,111,118,114,111,7,7,0
901,130000,d0f245b8781e3631,12,0,1430,754,390,398,481,498,419,459,630,477,524,519,522,507,-5,47,-52
777,410000,d0f245b8781e3631,12,0,1601,892,268,371,333,363,396,440,436,415,417,417,417,416,0,2,-2
362,330000,d0f245b8781e3631,12,0,845,174,81,170,192,246,204,243,235,258,263,241,252,254,-22,5,-27
76,420000,d0f245b8781e3631,12,0,246,134,39,47,55,60,48,51,63,57,69,58,64,61,-11,12,-23
350,430000,d0f245b8781e3631,12,0,756,439,130,231,191,211,178,177,209,244,199,247,223,230,48,-45,93
138,350000,d0f245b8781e3631,12,0,247,102,51,67,60,67,91,79,101,94,80,198,139,124,118,-14,132
52,210000,d0f245b8781e3631,12,0,113,47,21,29,27,30,22,21,21,18,20,34,27,24,14,2,12
2478,500000,d0f245b8781e3631,12,0,1578,630,283,298,337,395,444,428,519,438,436,552,494,475,116,-2,118
723,610000,d0f245b8781e3631,12,0,938,498,189,261,260,236,226,286,349,325,354,355,354,345,1,29,-28
31,230000,d0f245b8781e3631,12,0,45,7,10,21,11,20,18,12,17,12,8,32,20,17,24,-4,28
3668,310000,c6cd4e0e073f5ac2,12,0,746,228,125,223,190,233,237,1154,290,404,302,1094,698,600,792,-102,894
124,530000,c6cd4e0e073f5ac2,12,0,235,105,67,68,72,70,100,79,62,75,86,105,96,89,19,11,8
121,150000,c6cd4e0e073f5ac2,12,0,340,208,63,95,64,75,89,75,89,111,84,104,94,100,20,-27,47
50,110000,c6cd4e0e073f5ac2,12,0,362,72,29,64,61,50,56,417,666,51,34,72,53,52,38,-17,55
1150,510000,c6cd4e0e073f5ac2,12,0,1027,542,251,246,265,230,226,834,315,368,297,307,302,324,10,-71,81
669,340000,c6cd4e0e073f5ac2,12,0,1434,792,244,232,308,344,363,315,452,583,523,551,537,552,28,-60,88
698,370000,c6cd4e0e073f5ac2,12,0,1685,823,326,341,453,371,362,372,520,630,555,505,530,563,-50,-75,25
283,140000,c6cd4e0e073f5ac2,12,0,604,321,126,162,162,182,154,558,292,187,206,250,228,214,44,19,25
810,440000,c6cd4e0e073f5ac2,12,0,1493,451,130,374,366,407,481,329,409,478,509,593,551,527,84,31,53
261,450000,c6cd4e0e073f5ac2,12,0,543,250,76,136,99,136,130,103,145,204,198,227,212,210,29,-6,35
1420,320000,c6cd4e0e073f5ac2,12,0,2828,1205,656,751,787,807,758,1395,929,1015,1091,1085,1088,1064,-6,76,-82
560,360000,c6cd4e0e073f5ac2,12,0,1241,549,138,232,271,262,250,268,377,418,451,461,456,443,10,33,-23
579,130000,c6cd4e0e073f5ac2,12,0,1020,602,249,293,362,351,329,285,374,411,366,401,384,393,35,-45,80
1764,410000,c6cd4e0e073f5ac2,12,0,1584,992,320,512,660,557,721,719,991,1189,1206,1267,1236,1221,61,17,44
668,330000,c6cd4e0e073f5ac2,12,0,1272,386,193,342,341,375,377,337,402,499,496,510,503,502,14,-3,17
542,420000,c6cd4e0e073f5ac2,12,0,1208,523,161,272,326,270,280,775,316,371,390,456,423,406,66,19,47
706,430000,c6cd4e0e073f5ac2,12,0,891,508,132,232,212,222,268,261,329,457,434,466,450,452,32,-23,55
201,350000,c6cd4e0e073f5ac2,12,0,431,173,74,106,104,121,115,77,91,131,145,172,158,149,27,14,13
75,210000,c6cd4e0e073f5ac2,12,0,225,91,51,75,101,66,42,52,68,79,54,48,51,60,-6,-25,19
123,500000,c6cd4e0e073f5ac2,12,0,242,128,33,53,51,65,76,57,46,63,70,100,85,78,30,7,23
321,610000,c6cd4e0e073f5ac2,12,0,432,182,64,143,136,155,142,754,199,271,274,293,284,279,19,3,16
25,230000,c6cd4e0e073f5ac2,12,0,140,53,29,33,28,48,27,21,28,21,14,20,17,18,6,-7,13
143,310000,a9a43d1a7ecbe75d,12,0,163,142,84,128,99,108,102,143,141,92,87,172,130,117,85,-5,90
102,530000,a9a43d1a7ecbe75d,12,0,131,146,84,119,80,84,87,136,120,95,78,103,90,92,25,-17,42
70,150000,a9a43d1a7ecbe75d,12,0,90,83,41,62,87,86,67,58,68,69,69,79,74,72,10,0,10
75,110000,a9a43d1a7ecbe75d,12,0,123,88,65,74,70,62,63,53,50,55,67,92,80,71,25,12,13
221,510000,a9a43d1a7ecbe75d,12,0,330,341,184,223,201,224,188,192,262,301,197,237,217,245,40,-104,144
193,340000,a9a43d1a7ecbe75d,12,0,198,254,107,149,150,152,146,136,174,138,155,169,162,154,14,17,-3
165,370000,a9a43d1a7ecbe75d,12,0,191,159,74,162,163,162,117,116,158,179,155,169,162,168,14,-24,38
33,140000,a9a43d1a7ecbe75d,12,0,28,41,25,46,41,28,30,28,32,32,26,40,33,33,14,-6,20
677,440000,a9a43d1a7ecbe75d,12,0,638,568,264,527,387,410,437,440,502,480,480,728,604,563,248,0,248
190,450000,a9a43d1a7ecbe75d,12,0,213,297,121,197,152,163,152,143,162,143,132,158,145,144,26,-11,37
412,320000,a9a43d1a7ecbe75d,12,0,439,430,213,408,324,345,284,373,290,342,314,428,371,361,114,-28,142
101,360000,a9a43d1a7ecbe75d,12,0,120,103,50,101,76,71,82,82,105,75,85,87,86,82,2,10,-8
125,130000,a9a43d1a7ecbe75d,12,0,95,109,50,116,95,137,104,134,131,121,110,110,110,114,0,-11,11
153,410000,a9a43d1a7ecbe75d,12,0,164,130,78,142,114,90,124,140,149,132,125,118,122,125,-7,-7,0
354,330000,a9a43d1a7ecbe75d,12,0,397,466,185,307,317,322,277,351,327,287,278,377,328,314,99,-9,108
230,420000,a9a43d1a7ecbe75d,12,0,236,270,129,200,183,140,190,186,222,164,183,225,204,191,42,19,23
283,430000,a9a43d1a7ecbe75d,12,0,445,519,215,330,301,296,262,319,373,282,230,301,266,271,71,-52,123
112,350000,a9a43d1a7ecbe75d,12,0,99,145,57,96,88,101,91,78,106,100,89,130,110,106,41,-11,52
104,210000,a9a43d1a7ecbe75d,12,0,155,89,59,109,102,100,85,79,140,123,99,119,109,114,20,-24,44
125,500000,a9a43d1a7ecbe75d,12,0,214,160,89,140,134,104,264,151,136,117,92,123,108,111,31,-25,56
265,610000,a9a43d1a7ecbe75d,12,0,263,274,154,228,212,258,163,256,338,207,301,277,289,262,-24,94,-118
58,230000,a9a43d1a7ecbe75d,12,0,57,65,35,91,67,47,50,39,70,62,56,83,70,67,27,-6,33